"","frag1","frag2","dist","rawCount","qval","start","start2","end","end2","chromosome","index","AluJ_count","AluS_count","AluY_count","alu_peak","chromosome2","atac_peak","node_weights"
"1","chr1.11735000.11740000","chr1.11785000.11790000",50000,24,0.001605476,11735000,11785000,11740000,11790000,"chr1",41,0,2,2,4,"chr1",1,0.0112517580872011
"2","chr1.160165000.160170000","chr1.160260000.160265000",95000,19,0.0003929148,160165000,160260000,160170000,160265000,"chr1",53,0,2,2,4,"chr1",1,0.00890764181903422
"3","chr1.155970000.155975000","chr1.156020000.156025000",50000,25,0.0006470043,155970000,156020000,155975000,156025000,"chr1",89,9,9,10,28,"chr1",1,0.0820440693858415
"4","chr1.62395000.62400000","chr1.62435000.62440000",40000,28,0.0005784227,62395000,62435000,62400000,62440000,"chr1",127,0,7,5,12,"chr1",1,0.0393811533052039
"5","chr1.8435000.8440000","chr1.8460000.8465000",25000,38,0.0003847014,8435000,8460000,8440000,8465000,"chr1",153,1,4,3,8,"chr1",1,0.0356305672761369
"6","chr1.27010000.27015000","chr1.27070000.27075000",60000,20,0.00869379,27010000,27070000,27015000,27075000,"chr1",184,2,3,2,7,"chr1",1,0.0164088138771683
"7","chr1.6610000.6615000","chr1.6635000.6640000",25000,49,1.727148e-08,6610000,6635000,6615000,6640000,"chr1",198,6,6,11,23,"chr1",1,0.132090951711205
"8","chr1.39730000.39735000","chr1.39750000.39755000",20000,36,0.008632247,39730000,39750000,39735000,39755000,"chr1",200,5,5,8,18,"chr1",1,0.0759493670886076
"9","chr1.19880000.19885000","chr1.19915000.19920000",35000,35,6.593574e-06,19880000,19915000,19885000,19920000,"chr1",203,4,5,12,21,"chr1",1,0.0861462728551336
"10","chr1.27725000.27730000","chr1.27830000.27835000",105000,20,4.589527e-05,27725000,27830000,27730000,27835000,"chr1",214,0,2,2,4,"chr1",1,0.00937646507266761
"11","chr1.229480000.229485000","chr1.229625000.229630000",145000,17,0.0001595167,229480000,229625000,229485000,229630000,"chr1",242,2,1,2,5,"chr1",1,0.00996249413970933
"12","chr1.45880000.45885000","chr1.45910000.45915000",30000,46,1.804555e-09,45880000,45910000,45885000,45915000,"chr1",312,0,3,5,8,"chr1",1,0.043131739334271
"13","chr1.64745000.64750000","chr1.65220000.65225000",475000,10,0.000940042,64745000,65220000,64750000,65225000,"chr1",319,3,4,4,11,"chr1",1,0.012892639474918
"14","chr1.44810000.44815000","chr1.44835000.44840000",25000,36,0.001641975,44810000,44835000,44815000,44840000,"chr1",324,0,7,8,15,"chr1",1,0.0632911392405063
"15","chr1.8460000.8465000","chr1.8685000.8690000",225000,13,0.0011796,8460000,8685000,8465000,8690000,"chr1",331,6,11,15,32,"chr1",1,0.0487576183778715
"16","chr1.11035000.11040000","chr1.11270000.11275000",235000,13,0.0008544039,11035000,11270000,11040000,11275000,"chr1",351,4,12,14,30,"chr1",1,0.0457102672292546
"17","chr1.27010000.27015000","chr1.27110000.27115000",100000,21,2.069424e-05,27010000,27110000,27015000,27115000,"chr1",354,2,1,5,8,"chr1",1,0.019690576652602
"18","chr1.201505000.201510000","chr1.201730000.201735000",225000,17,2.958669e-06,201505000,201730000,201510000,201735000,"chr1",360,1,1,0,2,"chr1",1,0.00398499765588373
"19","chr1.230205000.230210000","chr1.230245000.230250000",40000,36,1.492376e-07,230205000,230245000,230210000,230250000,"chr1",400,3,4,2,9,"chr1",1,0.0379746835443038
"20","chr1.8085000.8090000","chr1.8370000.8375000",285000,16,1.501241e-06,8085000,8370000,8090000,8375000,"chr1",432,0,0,5,5,"chr1",1,0.00937646507266761
"21","chr1.19730000.19735000","chr1.19765000.19770000",35000,37,8.177368e-07,19730000,19765000,19735000,19770000,"chr1",466,0,2,2,4,"chr1",1,0.0173464603844351
"22","chr1.235365000.235370000","chr1.235580000.235585000",215000,13,0.001605476,235365000,235580000,235370000,235585000,"chr1",550,0,2,5,7,"chr1",1,0.0106657290201594
"23","chr1.243880000.243885000","chr1.244075000.244080000",195000,12,0.009750873,243880000,244075000,243885000,244080000,"chr1",607,2,9,7,18,"chr1",1,0.0253164556962025
"24","chr1.9950000.9955000","chr1.10150000.10155000",200000,13,0.00261335,9950000,10150000,9955000,10155000,"chr1",624,7,38,35,80,"chr1",1,0.121894045944679
"25","chr1.156580000.156585000","chr1.156600000.156605000",20000,42,0.0001481797,156580000,156600000,156585000,156605000,"chr1",625,0,4,2,6,"chr1",1,0.029535864978903
"26","chr1.43660000.43665000","chr1.43945000.43950000",285000,13,0.0002162115,43660000,43945000,43665000,43950000,"chr1",636,0,2,2,4,"chr1",1,0.00609470229723394
"27","chr1.10070000.10075000","chr1.10470000.10475000",400000,10,0.002527826,10070000,10470000,10075000,10475000,"chr1",668,7,11,15,33,"chr1",1,0.0386779184247539
"28","chr1.44545000.44550000","chr1.44660000.44665000",115000,16,0.002529278,44545000,44660000,44550000,44665000,"chr1",679,3,7,9,19,"chr1",1,0.0356305672761369
"29","chr1.11790000.11795000","chr1.11860000.11865000",70000,26,2.649753e-06,11790000,11860000,11795000,11865000,"chr1",754,1,3,2,6,"chr1",1,0.0182841068917018
"30","chr1.155830000.155835000","chr1.155860000.155865000",30000,37,2.278292e-05,155830000,155860000,155835000,155865000,"chr1",772,9,39,35,83,"chr1",1,0.359939052977028
"31","chr1.160075000.160080000","chr1.160115000.160120000",40000,26,0.003086748,160075000,160115000,160080000,160120000,"chr1",811,0,0,1,1,"chr1",1,0.00304735114861697
"32","chr1.201995000.202000000","chr1.202085000.202090000",90000,25,3.161766e-07,201995000,202085000,2.02e+08,202090000,"chr1",887,1,12,6,19,"chr1",1,0.0556727613689639
"33","chr1.154735000.154740000","chr1.154875000.154880000",140000,17,0.000209311,154735000,154875000,154740000,154880000,"chr1",924,3,12,13,28,"chr1",1,0.0557899671823722
"34","chr1.9730000.9735000","chr1.10430000.10435000",700000,10,6.78923e-05,9730000,10430000,9735000,10435000,"chr1",942,3,15,10,28,"chr1",1,0.0328176277543366
"35","chr1.8470000.8475000","chr1.8510000.8515000",40000,37,4.587309e-08,8470000,8510000,8475000,8515000,"chr1",949,2,12,8,22,"chr1",1,0.0954055321143929
"36","chr1.39405000.39410000","chr1.39490000.39495000",85000,23,9.882479e-06,39405000,39490000,39410000,39495000,"chr1",952,0,1,0,1,"chr1",1,0.00269573370839194
"37","chr1.153475000.153480000","chr1.153695000.153700000",220000,12,0.004800128,153475000,153695000,153480000,153700000,"chr1",976,10,16,20,46,"chr1",1,0.0646976090014065
"38","chr1.202835000.202840000","chr1.202900000.202905000",65000,21,0.001695142,202835000,202900000,202840000,202905000,"chr1",980,3,9,14,26,"chr1",1,0.0639943741209564
"39","chr1.161155000.161160000","chr1.161290000.161295000",135000,17,0.0002678324,161155000,161290000,161160000,161295000,"chr1",1033,0,2,3,5,"chr1",1,0.00996249413970933
"40","chr1.212255000.212260000","chr1.212545000.212550000",290000,17,2.021852e-07,212255000,212545000,212260000,212550000,"chr1",1092,1,4,0,5,"chr1",1,0.00996249413970933
"41","chr1.234735000.234740000","chr1.235265000.235270000",530000,11,8.040092e-05,234735000,235265000,234740000,235270000,"chr1",1165,1,7,3,11,"chr1",1,0.0141819034224098
"42","chr1.92775000.92780000","chr1.93075000.93080000",300000,13,0.0001481797,92775000,93075000,92780000,93080000,"chr1",1167,2,14,23,39,"chr1",1,0.0594233473980309
"43","chr1.54330000.54335000","chr1.54500000.54505000",170000,13,0.00702836,54330000,54500000,54335000,54505000,"chr1",1182,6,10,8,24,"chr1",1,0.0365682137834037
"44","chr1.244215000.244220000","chr1.244430000.244435000",215000,25,1.64957e-12,244215000,244430000,244220000,244435000,"chr1",1195,0,2,4,6,"chr1",1,0.0175808720112518
"45","chr1.51950000.51955000","chr1.52000000.52005000",50000,25,0.0006470043,51950000,5.2e+07,51955000,52005000,"chr1",1230,1,4,8,13,"chr1",1,0.0380918893577121
"46","chr1.52565000.52570000","chr1.53235000.53240000",670000,10,9.219509e-05,52565000,53235000,52570000,53240000,"chr1",1272,5,13,9,27,"chr1",1,0.0316455696202532
"47","chr1.155900000.155905000","chr1.155985000.155990000",85000,22,3.458094e-05,155900000,155985000,155905000,155990000,"chr1",1308,1,13,14,28,"chr1",1,0.0721987810595406
"48","chr1.205230000.205235000","chr1.205300000.205305000",70000,24,3.073313e-05,205230000,205300000,205235000,205305000,"chr1",1316,1,3,4,8,"chr1",1,0.0225035161744023
"49","chr1.45300000.45305000","chr1.45800000.45805000",500000,11,0.0001245509,45300000,45800000,45305000,45805000,"chr1",1338,1,2,6,9,"chr1",1,0.0116033755274262
"50","chr1.150365000.150370000","chr1.150920000.150925000",555000,8,0.008632247,150365000,150920000,150370000,150925000,"chr1",1363,4,27,18,49,"chr1",1,0.0459446788560713
"51","chr1.180480000.180485000","chr1.181020000.181025000",540000,10,0.0004153543,180480000,181020000,180485000,181025000,"chr1",1372,0,2,1,3,"chr1",1,0.00351617440225035
"52","chr1.9690000.9695000","chr1.9910000.9915000",220000,18,7.065063e-07,9690000,9910000,9695000,9915000,"chr1",1398,4,15,24,43,"chr1",1,0.0907172995780591
"53","chr1.228835000.228840000","chr1.229250000.229255000",415000,10,0.00206337,228835000,229250000,228840000,229255000,"chr1",1403,3,10,3,16,"chr1",1,0.0187529301453352
"54","chr1.25950000.25955000","chr1.25995000.26000000",45000,23,0.009597206,25950000,25995000,25955000,2.6e+07,"chr1",1412,2,2,11,15,"chr1",1,0.040436005625879
"55","chr1.150970000.150975000","chr1.151165000.151170000",195000,14,0.0008677022,150970000,151165000,150975000,151170000,"chr1",1434,4,0,3,7,"chr1",1,0.0114861697140178
"56","chr1.94095000.94100000","chr1.94275000.94280000",180000,31,1.301217e-16,94095000,94275000,94100000,94280000,"chr1",1454,0,1,3,4,"chr1",1,0.0145335208626348
"57","chr1.156385000.156390000","chr1.156570000.156575000",185000,17,2.06366e-05,156385000,156570000,156390000,156575000,"chr1",1461,1,1,1,3,"chr1",1,0.0059774964838256
"58","chr1.27935000.27940000","chr1.28105000.28110000",170000,13,0.00702836,27935000,28105000,27940000,28110000,"chr1",1483,3,14,6,23,"chr1",1,0.0350445382090952
"59","chr1.156355000.156360000","chr1.156390000.156395000",35000,39,8.974978e-08,156355000,156390000,156360000,156395000,"chr1",1500,0,3,3,6,"chr1",1,0.0274261603375527
"60","chr1.222640000.222645000","chr1.222815000.222820000",175000,18,7.719683e-06,222640000,222815000,222645000,222820000,"chr1",1527,0,2,5,7,"chr1",1,0.0147679324894515
"61","chr1.45325000.45330000","chr1.45495000.45500000",170000,14,0.002238629,45325000,45495000,45330000,45500000,"chr1",1550,4,6,6,16,"chr1",1,0.0262541022034693
"62","chr1.25975000.25980000","chr1.26015000.26020000",40000,27,0.001354847,25975000,26015000,25980000,26020000,"chr1",1652,10,22,14,46,"chr1",1,0.145569620253165
"63","chr1.27625000.27630000","chr1.27715000.27720000",90000,23,4.954213e-06,27625000,27715000,27630000,27720000,"chr1",1700,7,12,12,31,"chr1",1,0.08356774496015
"64","chr1.227430000.227435000","chr1.227480000.227485000",50000,22,0.008541777,227430000,227480000,227435000,227485000,"chr1",1703,0,3,3,6,"chr1",1,0.0154711673699015
"65","chr1.21310000.21315000","chr1.21330000.21335000",20000,50,1.454336e-07,21310000,21330000,21315000,21335000,"chr1",1733,4,11,10,25,"chr1",1,0.146507266760431
"66","chr1.150320000.150325000","chr1.150410000.150415000",90000,19,0.0006470043,150320000,150410000,150325000,150415000,"chr1",1735,0,11,9,20,"chr1",1,0.0445382090951711
"67","chr1.21320000.21325000","chr1.21395000.21400000",75000,22,0.0001362782,21320000,21395000,21325000,21400000,"chr1",1805,0,10,10,20,"chr1",1,0.0515705578996718
"68","chr1.204325000.204330000","chr1.204365000.204370000",40000,25,0.006608083,204325000,204365000,204330000,204370000,"chr1",1852,0,1,2,3,"chr1",1,0.00879043600562588
"69","chr1.9820000.9825000","chr1.9875000.9880000",55000,23,0.001500618,9820000,9875000,9825000,9880000,"chr1",1877,0,3,3,6,"chr1",1,0.0161744022503516
"70","chr1.150550000.150555000","chr1.150970000.150975000",420000,10,0.001921749,150550000,150970000,150555000,150975000,"chr1",1907,1,0,0,1,"chr1",1,0.00117205813408345
"71","chr1.77680000.77685000","chr1.78005000.78010000",325000,10,0.006950379,77680000,78005000,77685000,78010000,"chr1",1908,1,5,4,10,"chr1",1,0.0117205813408345
"72","chr1.244010000.244015000","chr1.244430000.244435000",420000,11,0.0004079793,244010000,244430000,244015000,244435000,"chr1",1920,1,5,7,13,"chr1",1,0.0167604313173933
"73","chr1.203305000.203310000","chr1.203590000.203595000",285000,11,0.00367059,203305000,203590000,203310000,203595000,"chr1",1961,0,3,2,5,"chr1",1,0.00644631973745898
"74","chr1.28055000.28060000","chr1.28105000.28110000",50000,22,0.008541777,28055000,28105000,28060000,28110000,"chr1",1970,2,9,1,12,"chr1",1,0.0309423347398031
"75","chr1.6830000.6835000","chr1.7720000.7725000",890000,7,0.004030049,6830000,7720000,6835000,7725000,"chr1",2003,4,9,11,24,"chr1",1,0.019690576652602
"76","chr1.54895000.54900000","chr1.54935000.54940000",40000,30,9.14609e-05,54895000,54935000,54900000,54940000,"chr1",2061,0,7,9,16,"chr1",1,0.0562587904360056
"77","chr1.210580000.210585000","chr1.211355000.211360000",775000,7,0.008222685,210580000,211355000,210585000,211360000,"chr1",2066,0,2,0,2,"chr1",1,0.00164088138771683
"78","chr1.8525000.8530000","chr1.8685000.8690000",160000,15,0.001000244,8525000,8685000,8530000,8690000,"chr1",2100,0,0,3,3,"chr1",1,0.00527426160337553
"79","chr1.234755000.234760000","chr1.234860000.234865000",105000,21,1.247901e-05,234755000,234860000,234760000,234865000,"chr1",2136,0,1,2,3,"chr1",1,0.00738396624472574
"80","chr1.203265000.203270000","chr1.203305000.203310000",40000,38,1.349954e-08,203265000,203305000,203270000,203310000,"chr1",2188,0,3,2,5,"chr1",1,0.0222691045475856
"81","chr1.62080000.62085000","chr1.62100000.62105000",20000,41,0.0003129283,62080000,62100000,62085000,62105000,"chr1",2218,4,14,7,25,"chr1",1,0.120135958743554
"82","chr1.78110000.78115000","chr1.78135000.78140000",25000,35,0.003277108,78110000,78135000,78115000,78140000,"chr1",2257,7,6,9,22,"chr1",1,0.0902484763244257
"83","chr1.171955000.171960000","chr1.172395000.172400000",440000,10,0.001500618,171955000,172395000,171960000,172400000,"chr1",2282,0,0,1,1,"chr1",1,0.00117205813408345
"84","chr1.116825000.116830000","chr1.116845000.116850000",20000,57,1.009568e-10,116825000,116845000,116830000,116850000,"chr1",2299,0,4,0,4,"chr1",1,0.0267229254571027
"85","chr1.155305000.155310000","chr1.155645000.155650000",340000,10,0.005618157,155305000,155645000,155310000,155650000,"chr1",2317,1,9,4,14,"chr1",1,0.0164088138771683
"86","chr1.224330000.224335000","chr1.224495000.224500000",165000,16,0.0002232684,224330000,224495000,224335000,224500000,"chr1",2321,3,11,9,23,"chr1",1,0.043131739334271
"87","chr1.94525000.94530000","chr1.94750000.94755000",225000,13,0.0011796,94525000,94750000,94530000,94755000,"chr1",2332,0,3,0,3,"chr1",1,0.00457102672292546
"88","chr1.204270000.204275000","chr1.204305000.204310000",35000,28,0.003304886,204270000,204305000,204275000,204310000,"chr1",2403,3,1,4,8,"chr1",1,0.0262541022034693
"89","chr1.212230000.212235000","chr1.212475000.212480000",245000,20,5.089011e-09,212230000,212475000,212235000,212480000,"chr1",2434,0,1,4,5,"chr1",1,0.0117205813408345
"90","chr1.28885000.28890000","chr1.28955000.28960000",70000,19,0.00555421,28885000,28955000,28890000,28960000,"chr1",2621,0,0,4,4,"chr1",1,0.00890764181903422
"91","chr1.229480000.229485000","chr1.229575000.229580000",95000,16,0.009001332,229480000,229575000,229485000,229580000,"chr1",2718,2,6,2,10,"chr1",1,0.0187529301453352
"92","chr1.116845000.116850000","chr1.116910000.116915000",65000,26,7.652881e-06,116845000,116910000,116850000,116915000,"chr1",2728,0,4,0,4,"chr1",1,0.0121894045944679
"93","chr1.155900000.155905000","chr1.156050000.156055000",150000,14,0.004757005,155900000,156050000,155905000,156055000,"chr1",2744,0,3,1,4,"chr1",1,0.00656352555086732
"94","chr1.8525000.8530000","chr1.8870000.8875000",345000,14,9.976584e-06,8525000,8870000,8530000,8875000,"chr1",2760,0,0,3,3,"chr1",1,0.00492264416315049
"95","chr1.204140000.204145000","chr1.204350000.204355000",210000,12,0.00640887,204140000,204350000,204145000,204355000,"chr1",2765,1,5,3,9,"chr1",1,0.0126582278481013
"96","chr1.240730000.240735000","chr1.240785000.240790000",55000,23,0.001500618,240730000,240785000,240735000,240790000,"chr1",2766,1,8,1,10,"chr1",1,0.0269573370839194
"97","chr1.155065000.155070000","chr1.155135000.155140000",70000,43,5.570323e-18,155065000,155135000,155070000,155140000,"chr1",2776,1,4,9,14,"chr1",1,0.0705578996718237
"98","chr1.8815000.8820000","chr1.8855000.8860000",40000,26,0.003086748,8815000,8855000,8820000,8860000,"chr1",2798,0,7,5,12,"chr1",1,0.0365682137834037
"99","chr1.113680000.113685000","chr1.114230000.114235000",550000,10,0.0003661034,113680000,114230000,113685000,114235000,"chr1",2835,1,2,2,5,"chr1",1,0.00586029067041725
"100","chr1.156485000.156490000","chr1.156505000.156510000",20000,38,0.00252151,156485000,156505000,156490000,156510000,"chr1",2845,5,10,10,25,"chr1",1,0.111345522737928
"101","chr1.21330000.21335000","chr1.21395000.21400000",65000,29,1.688833e-07,21330000,21395000,21335000,21400000,"chr1",2847,0,10,10,20,"chr1",1,0.0679793717768401
"102","chr1.156130000.156135000","chr1.156160000.156165000",30000,38,8.886415e-06,156130000,156160000,156135000,156165000,"chr1",2876,5,6,4,15,"chr1",1,0.0668073136427567
"103","chr1.155470000.155475000","chr1.155645000.155650000",175000,13,0.005981441,155470000,155645000,155475000,155650000,"chr1",2878,2,22,22,46,"chr1",1,0.0700890764181903
"104","chr1.205255000.205260000","chr1.205300000.205305000",45000,40,7.095345e-11,205255000,205300000,205260000,205305000,"chr1",2898,0,2,1,3,"chr1",1,0.0140646976090014
"105","chr1.230495000.230500000","chr1.230565000.230570000",70000,21,0.0008075999,230495000,230565000,230500000,230570000,"chr1",2984,0,3,2,5,"chr1",1,0.0123066104078762
"106","chr1.156080000.156085000","chr1.156190000.156195000",110000,19,0.0001060244,156080000,156190000,156085000,156195000,"chr1",3008,0,4,0,4,"chr1",1,0.00890764181903422
"107","chr1.156095000.156100000","chr1.156190000.156195000",95000,19,0.0003929148,156095000,156190000,156100000,156195000,"chr1",3046,3,11,8,22,"chr1",1,0.0489920300046882
"108","chr1.54540000.54545000","chr1.54670000.54675000",130000,15,0.003565021,54540000,54670000,54545000,54675000,"chr1",3077,2,4,9,15,"chr1",1,0.0263713080168776
"109","chr1.203475000.203480000","chr1.203670000.203675000",195000,44,4.009036e-31,203475000,203670000,203480000,203675000,"chr1",3083,1,1,0,2,"chr1",1,0.0103141115799344
"110","chr1.8465000.8470000","chr1.8915000.8920000",450000,10,0.001308829,8465000,8915000,8470000,8920000,"chr1",3144,6,22,23,51,"chr1",1,0.059774964838256
"111","chr1.39570000.39575000","chr1.39750000.39755000",180000,16,0.000110791,39570000,39750000,39575000,39755000,"chr1",3159,4,5,6,15,"chr1",1,0.0281293952180028
"112","chr1.154735000.154740000","chr1.154785000.154790000",50000,25,0.0006470043,154735000,154785000,154740000,154790000,"chr1",3204,0,6,3,9,"chr1",1,0.0263713080168776
"113","chr1.242690000.242695000","chr1.243475000.243480000",785000,7,0.007719712,242690000,243475000,242695000,243480000,"chr1",3206,0,1,1,2,"chr1",1,0.00164088138771683
"114","chr1.10065000.10070000","chr1.10505000.10510000",440000,12,5.493956e-05,10065000,10505000,10070000,10510000,"chr1",3224,6,14,16,36,"chr1",1,0.0506329113924051
"115","chr1.21395000.21400000","chr1.21435000.21440000",40000,31,3.426866e-05,21395000,21435000,21400000,21440000,"chr1",3249,0,10,10,20,"chr1",1,0.0726676043131739
"116","chr1.235265000.235270000","chr1.235580000.235585000",315000,21,2.309877e-11,235265000,235580000,235270000,235585000,"chr1",3290,0,2,5,7,"chr1",1,0.0172292545710267
"117","chr1.223065000.223070000","chr1.223085000.223090000",20000,56,3.002802e-10,223065000,223085000,223070000,223090000,"chr1",3291,4,17,16,37,"chr1",1,0.242850445382091
"118","chr1.9730000.9735000","chr1.9765000.9770000",35000,27,0.00691274,9730000,9765000,9735000,9770000,"chr1",3317,0,13,9,22,"chr1",1,0.069620253164557
"119","chr1.77775000.77780000","chr1.77975000.77980000",200000,15,0.0001884219,77775000,77975000,77780000,77980000,"chr1",3343,0,5,5,10,"chr1",1,0.0175808720112518
"120","chr1.153475000.153480000","chr1.153545000.153550000",70000,20,0.002190239,153475000,153545000,153480000,153550000,"chr1",3374,3,6,5,14,"chr1",1,0.0328176277543366
"121","chr1.77865000.77870000","chr1.78000000.78005000",135000,14,0.008425895,77865000,7.8e+07,77870000,78005000,"chr1",3403,4,11,7,22,"chr1",1,0.0360993905297703
"122","chr1.150565000.150570000","chr1.150925000.150930000",360000,17,2.258961e-08,150565000,150925000,150570000,150930000,"chr1",3488,5,7,13,25,"chr1",1,0.0498124706985466
"123","chr1.205245000.205250000","chr1.205300000.205305000",55000,26,7.710059e-05,205245000,205300000,205250000,205305000,"chr1",3495,1,2,2,5,"chr1",1,0.0152367557430849
"124","chr1.156335000.156340000","chr1.156485000.156490000",150000,17,0.0001234709,156335000,156485000,156340000,156490000,"chr1",3553,4,7,3,14,"chr1",1,0.0278949835911861
"125","chr1.153645000.153650000","chr1.153745000.153750000",100000,29,1.23774e-10,153645000,153745000,153650000,153750000,"chr1",3554,2,8,4,14,"chr1",1,0.0475855602437881
"126","chr1.155250000.155255000","chr1.155680000.155685000",430000,11,0.0003508079,155250000,155680000,155255000,155685000,"chr1",3581,2,21,12,35,"chr1",1,0.0451242381622128
"127","chr1.155945000.155950000","chr1.156020000.156025000",75000,18,0.007861949,155945000,156020000,155950000,156025000,"chr1",3586,10,21,17,48,"chr1",1,0.10126582278481
"128","chr1.26920000.26925000","chr1.27115000.27120000",195000,22,2.599827e-09,26920000,27115000,26925000,27120000,"chr1",3602,1,4,5,10,"chr1",1,0.0257852789498359
"129","chr1.84610000.84615000","chr1.84915000.84920000",305000,13,0.000131934,84610000,84915000,84615000,84920000,"chr1",3611,0,1,1,2,"chr1",1,0.00304735114861697
"130","chr1.243405000.243410000","chr1.243475000.243480000",70000,28,1.909902e-07,243405000,243475000,243410000,243480000,"chr1",3645,0,1,1,2,"chr1",1,0.00656352555086732
"131","chr1.39605000.39610000","chr1.39650000.39655000",45000,27,0.0003258119,39605000,39650000,39610000,39655000,"chr1",3666,0,3,4,7,"chr1",1,0.0221518987341772
"132","chr1.178090000.178095000","chr1.178135000.178140000",45000,26,0.0008075999,178090000,178135000,178095000,178140000,"chr1",3668,1,1,0,2,"chr1",1,0.00609470229723394
"133","chr1.150615000.150620000","chr1.150965000.150970000",350000,10,0.00486492,150615000,150965000,150620000,150970000,"chr1",3671,0,14,15,29,"chr1",1,0.0339896858884201
"134","chr1.155190000.155195000","chr1.155560000.155565000",370000,10,0.003722807,155190000,155560000,155195000,155565000,"chr1",3672,0,1,0,1,"chr1",1,0.00117205813408345
"135","chr1.26800000.26805000","chr1.27030000.27035000",230000,12,0.003666933,26800000,27030000,26805000,27035000,"chr1",3743,4,17,25,46,"chr1",1,0.0646976090014065
"136","chr1.178235000.178240000","chr1.178310000.178315000",75000,20,0.001171509,178235000,178310000,178240000,178315000,"chr1",3808,0,1,1,2,"chr1",1,0.0046882325363338
"137","chr1.171780000.171785000","chr1.171955000.171960000",175000,22,1.101923e-08,171780000,171955000,171785000,171960000,"chr1",3823,0,0,5,5,"chr1",1,0.012892639474918
"138","chr1.36090000.36095000","chr1.36185000.36190000",95000,16,0.009001332,36090000,36185000,36095000,36190000,"chr1",3841,11,5,10,26,"chr1",1,0.0487576183778715
"139","chr1.164555000.164560000","chr1.164750000.164755000",195000,12,0.009750873,164555000,164750000,164560000,164755000,"chr1",3883,0,4,1,5,"chr1",1,0.0070323488045007
"140","chr1.228795000.228800000","chr1.229230000.229235000",435000,12,5.973985e-05,228795000,229230000,228800000,229235000,"chr1",3907,0,0,2,2,"chr1",1,0.00281293952180028
"141","chr1.8525000.8530000","chr1.8670000.8675000",145000,14,0.005764312,8525000,8670000,8530000,8675000,"chr1",3908,0,0,3,3,"chr1",1,0.00492264416315049
"142","chr1.11715000.11720000","chr1.11785000.11790000",70000,24,3.073313e-05,11715000,11785000,11720000,11790000,"chr1",3971,3,2,4,9,"chr1",1,0.0253164556962025
"143","chr1.161175000.161180000","chr1.161260000.161265000",85000,19,0.001070775,161175000,161260000,161180000,161265000,"chr1",4010,2,11,13,26,"chr1",1,0.0578996718237225
"144","chr1.31265000.31270000","chr1.31390000.31395000",125000,21,2.157778e-06,31265000,31390000,31270000,31395000,"chr1",4019,5,15,23,43,"chr1",1,0.105836849507736
"145","chr1.203130000.203135000","chr1.203190000.203195000",60000,25,7.2355e-05,203130000,203190000,203135000,203195000,"chr1",4041,0,8,4,12,"chr1",1,0.0351617440225035
"146","chr1.232980000.232985000","chr1.233025000.233030000",45000,23,0.009597206,232980000,233025000,232985000,233030000,"chr1",4056,0,2,1,3,"chr1",1,0.00808720112517581
"147","chr1.11890000.11895000","chr1.11960000.11965000",70000,20,0.002190239,11890000,11960000,11895000,11965000,"chr1",4100,4,9,18,31,"chr1",1,0.0726676043131739
"148","chr1.10125000.10130000","chr1.10160000.10165000",35000,40,2.826444e-08,10125000,10160000,10130000,10165000,"chr1",4104,2,7,3,12,"chr1",1,0.0562587904360056
"149","chr1.10130000.10135000","chr1.10160000.10165000",30000,52,1.07875e-12,10130000,10160000,10135000,10165000,"chr1",4110,9,38,32,79,"chr1",1,0.481481481481481
"150","chr1.153605000.153610000","chr1.153695000.153700000",90000,21,6.373704e-05,153605000,153695000,153610000,153700000,"chr1",4118,0,7,5,12,"chr1",1,0.029535864978903
"151","chr1.153695000.153700000","chr1.153945000.153950000",250000,19,2.611253e-08,153695000,153945000,153700000,153950000,"chr1",4181,2,4,2,8,"chr1",1,0.0178152836380684
"152","chr1.84615000.84620000","chr1.84920000.84925000",305000,10,0.009342944,84615000,84920000,84620000,84925000,"chr1",4186,1,4,4,9,"chr1",1,0.0105485232067511
"153","chr1.183650000.183655000","chr1.183815000.183820000",165000,15,0.0008057805,183650000,183815000,183655000,183820000,"chr1",4201,1,2,1,4,"chr1",1,0.0070323488045007
"154","chr1.223085000.223090000","chr1.223140000.223145000",55000,29,2.655108e-06,223085000,223140000,223090000,223145000,"chr1",4232,1,5,5,11,"chr1",1,0.0373886544772621
"155","chr1.183595000.183600000","chr1.183875000.183880000",280000,16,1.791283e-06,183595000,183875000,183600000,183880000,"chr1",4251,2,2,4,8,"chr1",1,0.0150023441162682
"156","chr1.151045000.151050000","chr1.151120000.151125000",75000,21,0.0004093387,151045000,151120000,151050000,151125000,"chr1",4267,5,5,9,19,"chr1",1,0.0467651195499297
"157","chr1.9290000.9295000","chr1.9310000.9315000",20000,36,0.008632247,9290000,9310000,9295000,9315000,"chr1",4278,6,15,17,38,"chr1",1,0.160337552742616
"158","chr1.24070000.24075000","chr1.24110000.24115000",40000,25,0.006608083,24070000,24110000,24075000,24115000,"chr1",4280,0,7,4,11,"chr1",1,0.0322315986872949
"159","chr1.243890000.243895000","chr1.244430000.244435000",540000,8,0.009838485,243890000,244430000,243895000,244435000,"chr1",4306,0,6,6,12,"chr1",1,0.0112517580872011
"160","chr1.8090000.8095000","chr1.8370000.8375000",280000,15,9.976584e-06,8090000,8370000,8095000,8375000,"chr1",4355,0,0,4,4,"chr1",1,0.0070323488045007
"161","chr1.174795000.174800000","chr1.174940000.174945000",145000,14,0.005764312,174795000,174940000,174800000,174945000,"chr1",4389,3,9,14,26,"chr1",1,0.0426629160806376
"162","chr1.27415000.27420000","chr1.27935000.27940000",520000,9,0.002714357,27415000,27935000,27420000,27940000,"chr1",4395,0,6,5,11,"chr1",1,0.0116033755274262
"163","chr1.150055000.150060000","chr1.150160000.150165000",105000,19,0.0001598251,150055000,150160000,150060000,150165000,"chr1",4407,1,2,4,7,"chr1",1,0.0155883731833099
"164","chr1.162035000.162040000","chr1.162105000.162110000",70000,26,2.649753e-06,162035000,162105000,162040000,162110000,"chr1",4417,2,5,5,12,"chr1",1,0.0365682137834037
"165","chr1.155240000.155245000","chr1.155275000.155280000",35000,31,0.0002882227,155240000,155275000,155245000,155280000,"chr1",4438,6,17,6,29,"chr1",1,0.105368026254102
"166","chr1.27935000.27940000","chr1.27980000.27985000",45000,31,5.563018e-06,27935000,27980000,27940000,27985000,"chr1",4503,11,23,17,51,"chr1",1,0.185302390998594
"167","chr1.8370000.8375000","chr1.8710000.8715000",340000,10,0.005618157,8370000,8710000,8375000,8715000,"chr1",4506,0,0,5,5,"chr1",1,0.00586029067041725
"168","chr1.201465000.201470000","chr1.201480000.201485000",15000,40,0.0006470043,201465000,201480000,201470000,201485000,"chr1",4535,1,5,0,6,"chr1",1,0.0281293952180028
"169","chr1.23865000.23870000","chr1.23955000.23960000",90000,26,7.303681e-08,23865000,23955000,23870000,23960000,"chr1",4565,5,16,8,29,"chr1",1,0.0883731833098922
"170","chr1.182110000.182115000","chr1.182300000.182305000",190000,17,1.606819e-05,182110000,182300000,182115000,182305000,"chr1",4578,1,4,2,7,"chr1",1,0.0139474917955931
"171","chr1.233440000.233445000","chr1.234220000.234225000",780000,7,0.007954228,233440000,234220000,233445000,234225000,"chr1",4599,1,2,2,5,"chr1",1,0.00410220346929208
"172","chr1.161200000.161205000","chr1.161260000.161265000",60000,21,0.003722807,161200000,161260000,161205000,161265000,"chr1",4603,1,3,2,6,"chr1",1,0.0147679324894515
"173","chr1.8055000.8060000","chr1.8510000.8515000",455000,12,4.243319e-05,8055000,8510000,8060000,8515000,"chr1",4628,2,12,13,27,"chr1",1,0.0379746835443038
"174","chr1.11270000.11275000","chr1.11720000.11725000",450000,9,0.005812245,11270000,11720000,11275000,11725000,"chr1",4655,1,15,14,30,"chr1",1,0.0316455696202532
"175","chr1.11155000.11160000","chr1.11715000.11720000",560000,8,0.00838272,11155000,11715000,11160000,11720000,"chr1",4699,1,3,3,7,"chr1",1,0.00656352555086732
"176","chr1.9765000.9770000","chr1.10000000.10005000",235000,13,0.0008544039,9765000,1e+07,9770000,10005000,"chr1",4707,0,13,9,22,"chr1",1,0.0335208626347867
"177","chr1.29265000.29270000","chr1.29300000.29305000",35000,37,8.177368e-07,29265000,29300000,29270000,29305000,"chr1",4733,0,2,3,5,"chr1",1,0.0216830754805438
"178","chr1.156125000.156130000","chr1.156150000.156155000",25000,34,0.006227396,156125000,156150000,156130000,156155000,"chr1",4748,0,1,0,1,"chr1",1,0.00398499765588373
"179","chr1.212230000.212235000","chr1.212495000.212500000",265000,11,0.005556037,212230000,212495000,212235000,212500000,"chr1",4764,0,1,4,5,"chr1",1,0.00644631973745898
"180","chr1.11715000.11720000","chr1.11790000.11795000",75000,18,0.007861949,11715000,11790000,11720000,11795000,"chr1",4783,1,3,2,6,"chr1",1,0.0126582278481013
"181","chr1.182110000.182115000","chr1.182315000.182320000",205000,22,1.296392e-09,182110000,182315000,182115000,182320000,"chr1",4798,3,9,3,15,"chr1",1,0.0386779184247539
"182","chr1.205665000.205670000","chr1.205710000.205715000",45000,27,0.0003258119,205665000,205710000,205670000,205715000,"chr1",4861,5,14,19,38,"chr1",1,0.120253164556962
"183","chr1.201530000.201535000","chr1.201770000.201775000",240000,16,8.00102e-06,201530000,201770000,201535000,201775000,"chr1",4895,4,2,7,13,"chr1",1,0.0243788091889358
"184","chr1.25785000.25790000","chr1.25805000.25810000",20000,44,3.073313e-05,25785000,25805000,25790000,25810000,"chr1",4906,0,1,2,3,"chr1",1,0.0154711673699015
"185","chr1.16620000.16625000","chr1.16640000.16645000",20000,63,9.213933e-14,16620000,16640000,16625000,16645000,"chr1",4913,2,2,6,10,"chr1",1,0.0738396624472574
"186","chr1.10000000.10005000","chr1.10475000.10480000",475000,10,0.000940042,1e+07,10475000,10005000,10480000,"chr1",4926,5,11,24,40,"chr1",1,0.046882325363338
"187","chr1.228795000.228800000","chr1.229405000.229410000",610000,9,0.001061997,228795000,229405000,228800000,229410000,"chr1",4928,4,10,5,19,"chr1",1,0.020042194092827
"188","chr1.202965000.202970000","chr1.203305000.203310000",340000,12,0.0003081464,202965000,203305000,202970000,203310000,"chr1",4959,0,3,2,5,"chr1",1,0.0070323488045007
"189","chr1.201530000.201535000","chr1.201845000.201850000",315000,11,0.002113121,201530000,201845000,201535000,201850000,"chr1",5014,1,2,7,10,"chr1",1,0.012892639474918
"190","chr1.153785000.153790000","chr1.153925000.153930000",140000,20,3.216314e-06,153785000,153925000,153790000,153930000,"chr1",5023,8,18,23,49,"chr1",1,0.114861697140178
"191","chr1.226935000.226940000","chr1.226965000.226970000",30000,36,5.590942e-05,226935000,226965000,226940000,226970000,"chr1",5030,0,0,4,4,"chr1",1,0.0168776371308017
"192","chr1.2190000.2195000","chr1.2225000.2230000",35000,29,0.001520338,2190000,2225000,2195000,2230000,"chr1",5042,2,3,0,5,"chr1",1,0.01699484294421
"193","chr1.32875000.32880000","chr1.33095000.33100000",220000,12,0.004800128,32875000,33095000,32880000,33100000,"chr1",5043,0,9,1,10,"chr1",1,0.0140646976090014
"194","chr1.229970000.229975000","chr1.230135000.230140000",165000,13,0.00838272,229970000,230135000,229975000,230140000,"chr1",5081,2,3,3,8,"chr1",1,0.0121894045944679
"195","chr1.212255000.212260000","chr1.212475000.212480000",220000,17,3.717423e-06,212255000,212475000,212260000,212480000,"chr1",5083,4,4,5,13,"chr1",1,0.0259024847632443
"196","chr1.54795000.54800000","chr1.54855000.54860000",60000,20,0.00869379,54795000,54855000,54800000,54860000,"chr1",5098,0,3,1,4,"chr1",1,0.00937646507266761
"197","chr1.178055000.178060000","chr1.178235000.178240000",180000,13,0.005018612,178055000,178235000,178060000,178240000,"chr1",5106,0,1,1,2,"chr1",1,0.00304735114861697
"198","chr1.178500000.178505000","chr1.178725000.178730000",225000,13,0.0011796,178500000,178725000,178505000,178730000,"chr1",5112,1,6,5,12,"chr1",1,0.0182841068917018
"199","chr1.153780000.153785000","chr1.153945000.153950000",165000,15,0.0008057805,153780000,153945000,153785000,153950000,"chr1",5152,2,4,2,8,"chr1",1,0.0140646976090014
"200","chr1.10105000.10110000","chr1.10150000.10155000",45000,28,0.0001254468,10105000,10150000,10110000,10155000,"chr1",5173,0,7,5,12,"chr1",1,0.0393811533052039
"201","chr1.67500000.67505000","chr1.67610000.67615000",110000,15,0.009294725,67500000,67610000,67505000,67615000,"chr1",5184,1,4,2,7,"chr1",1,0.0123066104078762
"202","chr1.16870000.16875000","chr1.17050000.17055000",180000,36,1.574744e-21,16870000,17050000,16875000,17055000,"chr1",5198,1,2,2,5,"chr1",1,0.0210970464135021
"203","chr1.8870000.8875000","chr1.8915000.8920000",45000,24,0.004449684,8870000,8915000,8875000,8920000,"chr1",5201,0,5,3,8,"chr1",1,0.0225035161744023
"204","chr1.234985000.234990000","chr1.235070000.235075000",85000,18,0.003006639,234985000,235070000,234990000,235075000,"chr1",5229,3,1,6,10,"chr1",1,0.0210970464135021
"205","chr1.45495000.45500000","chr1.45685000.45690000",190000,25,1.273483e-11,45495000,45685000,45500000,45690000,"chr1",5259,1,7,5,13,"chr1",1,0.0380918893577121
"206","chr1.39570000.39575000","chr1.40040000.40045000",470000,9,0.004654588,39570000,40040000,39575000,40045000,"chr1",5279,4,5,6,15,"chr1",1,0.0158227848101266
"207","chr1.8625000.8630000","chr1.8915000.8920000",290000,13,0.0001899761,8625000,8915000,8630000,8920000,"chr1",5293,6,10,22,38,"chr1",1,0.0578996718237225
"208","chr1.28665000.28670000","chr1.28865000.28870000",200000,13,0.00261335,28665000,28865000,28670000,28870000,"chr1",5312,7,9,8,24,"chr1",1,0.0365682137834037
"209","chr1.9930000.9935000","chr1.9950000.9955000",20000,42,0.0001481797,9930000,9950000,9935000,9955000,"chr1",5344,10,27,20,57,"chr1",1,0.280590717299578
"210","chr1.151020000.151025000","chr1.151045000.151050000",25000,35,0.003277108,151020000,151045000,151025000,151050000,"chr1",5349,5,5,9,19,"chr1",1,0.0779418659165495
"211","chr1.93325000.93330000","chr1.93345000.93350000",20000,48,9.466554e-07,93325000,93345000,93330000,93350000,"chr1",5393,2,1,1,4,"chr1",1,0.0225035161744023
"212","chr1.21635000.21640000","chr1.21690000.21695000",55000,21,0.00838272,21635000,21690000,21640000,21695000,"chr1",5394,1,12,6,19,"chr1",1,0.0467651195499297
"213","chr1.14435000.14440000","chr1.15340000.15345000",905000,7,0.00365728,14435000,15340000,14440000,15345000,"chr1",5415,1,9,1,11,"chr1",1,0.00902484763244257
"214","chr1.42775000.42780000","chr1.42920000.42925000",145000,14,0.005764312,42775000,42920000,42780000,42925000,"chr1",5419,0,3,5,8,"chr1",1,0.0131270511017346
"215","chr1.178000000.178005000","chr1.178235000.178240000",235000,13,0.0008544039,1.78e+08,178235000,178005000,178240000,"chr1",5440,0,1,1,2,"chr1",1,0.00304735114861697
"216","chr1.54545000.54550000","chr1.54970000.54975000",425000,10,0.001810359,54545000,54970000,54550000,54975000,"chr1",5494,0,5,2,7,"chr1",1,0.00820440693858415
"217","chr1.26830000.26835000","chr1.26890000.26895000",60000,20,0.00869379,26830000,26890000,26835000,26895000,"chr1",5505,0,6,1,7,"chr1",1,0.0164088138771683
"218","chr1.36420000.36425000","chr1.36760000.36765000",340000,10,0.005618157,36420000,36760000,36425000,36765000,"chr1",5554,0,4,4,8,"chr1",1,0.00937646507266761
"219","chr1.228900000.228905000","chr1.229020000.229025000",120000,16,0.001909676,228900000,229020000,228905000,229025000,"chr1",5582,1,1,2,4,"chr1",1,0.00750117205813408
"220","chr1.39555000.39560000","chr1.40035000.40040000",480000,10,0.000877084,39555000,40035000,39560000,40040000,"chr1",5612,6,10,9,25,"chr1",1,0.0293014533520863
"221","chr1.155225000.155230000","chr1.155275000.155280000",50000,44,1.4963e-14,155225000,155275000,155230000,155280000,"chr1",5625,7,25,10,42,"chr1",1,0.216596343178622
"222","chr1.236265000.236270000","chr1.236675000.236680000",410000,13,1.580613e-05,236265000,236675000,236270000,236680000,"chr1",5667,2,4,1,7,"chr1",1,0.0106657290201594
"223","chr1.46155000.46160000","chr1.46345000.46350000",190000,21,2.212558e-08,46155000,46345000,46160000,46350000,"chr1",5676,4,13,8,25,"chr1",1,0.0615330520393812
"224","chr1.8630000.8635000","chr1.8700000.8705000",70000,19,0.00555421,8630000,8700000,8635000,8705000,"chr1",5727,0,2,1,3,"chr1",1,0.00668073136427567
"225","chr1.243505000.243510000","chr1.244075000.244080000",570000,9,0.001590574,243505000,244075000,243510000,244080000,"chr1",5748,0,2,1,3,"chr1",1,0.00316455696202532
"226","chr1.64745000.64750000","chr1.65215000.65220000",470000,12,3.301979e-05,64745000,65215000,64750000,65220000,"chr1",5761,3,4,4,11,"chr1",1,0.0154711673699015
"227","chr1.162070000.162075000","chr1.162105000.162110000",35000,27,0.00691274,162070000,162105000,162075000,162110000,"chr1",5774,3,5,6,14,"chr1",1,0.0443037974683544
"228","chr1.43690000.43695000","chr1.43760000.43765000",70000,25,9.231573e-06,43690000,43760000,43695000,43765000,"chr1",5819,0,3,5,8,"chr1",1,0.023441162681669
"229","chr1.171780000.171785000","chr1.172370000.172375000",590000,9,0.001295085,171780000,172370000,171785000,172375000,"chr1",5848,2,0,2,4,"chr1",1,0.00421940928270042
"230","chr1.243880000.243885000","chr1.244110000.244115000",230000,13,0.001007514,243880000,244110000,243885000,244115000,"chr1",5879,0,9,9,18,"chr1",1,0.0274261603375527
"231","chr1.204150000.204155000","chr1.204355000.204360000",205000,12,0.007361476,204150000,204355000,204155000,204360000,"chr1",5888,0,2,4,6,"chr1",1,0.00843881856540084
"232","chr1.77775000.77780000","chr1.77795000.77800000",20000,43,6.896909e-05,77775000,77795000,77780000,77800000,"chr1",5928,5,18,9,32,"chr1",1,0.161275199249883
"233","chr1.8560000.8565000","chr1.8885000.8890000",325000,10,0.006950379,8560000,8885000,8565000,8890000,"chr1",5930,2,4,3,9,"chr1",1,0.0105485232067511
"234","chr1.161205000.161210000","chr1.161290000.161295000",85000,17,0.007758048,161205000,161290000,161210000,161295000,"chr1",6123,4,23,18,45,"chr1",1,0.089662447257384
"235","chr1.201455000.201460000","chr1.201480000.201485000",25000,76,7.292804e-24,201455000,201480000,201460000,201485000,"chr1",6126,0,5,0,5,"chr1",1,0.0445382090951711
"236","chr1.42420000.42425000","chr1.42460000.42465000",40000,36,1.492376e-07,42420000,42460000,42425000,42465000,"chr1",6159,0,1,2,3,"chr1",1,0.0126582278481013
"237","chr1.109575000.109580000","chr1.109635000.109640000",60000,21,0.003722807,109575000,109635000,109580000,109640000,"chr1",6166,0,4,2,6,"chr1",1,0.0147679324894515
"238","chr1.168600000.168605000","chr1.169305000.169310000",705000,9,0.0004279485,168600000,169305000,168605000,169310000,"chr1",6170,0,2,0,2,"chr1",1,0.00210970464135021
"239","chr1.8595000.8600000","chr1.8915000.8920000",320000,10,0.007480566,8595000,8915000,8600000,8920000,"chr1",6174,6,4,5,15,"chr1",1,0.0175808720112518
"240","chr1.201995000.202000000","chr1.202020000.202025000",25000,39,0.0001793477,201995000,202020000,2.02e+08,202025000,"chr1",6238,1,12,6,19,"chr1",1,0.0868495077355837
"241","chr1.228900000.228905000","chr1.229225000.229230000",325000,11,0.001778335,228900000,229225000,228905000,229230000,"chr1",6245,2,1,2,5,"chr1",1,0.00644631973745898
"242","chr1.149935000.149940000","chr1.150005000.150010000",70000,22,0.0002882227,149935000,150005000,149940000,150010000,"chr1",6252,0,6,6,12,"chr1",1,0.0309423347398031
"243","chr1.8510000.8515000","chr1.8870000.8875000",360000,10,0.004288904,8510000,8870000,8515000,8875000,"chr1",6328,0,5,3,8,"chr1",1,0.00937646507266761
"244","chr1.161150000.161155000","chr1.161365000.161370000",215000,14,0.0004233859,161150000,161365000,161155000,161370000,"chr1",6348,3,5,2,10,"chr1",1,0.0164088138771683
"245","chr1.203115000.203120000","chr1.203130000.203135000",15000,41,0.0003129283,203115000,203130000,203120000,203135000,"chr1",6419,0,8,0,8,"chr1",1,0.0384435067979372
"246","chr1.17235000.17240000","chr1.17375000.17380000",140000,15,0.002324276,17235000,17375000,17240000,17380000,"chr1",6420,4,4,8,16,"chr1",1,0.0281293952180028
"247","chr1.16930000.16935000","chr1.17375000.17380000",445000,12,5.006043e-05,16930000,17375000,16935000,17380000,"chr1",6428,10,24,14,48,"chr1",1,0.0675105485232067
"248","chr1.149895000.149900000","chr1.150160000.150165000",265000,13,0.0003607747,149895000,150160000,149900000,150165000,"chr1",6444,1,2,4,7,"chr1",1,0.0106657290201594
"249","chr1.89685000.89690000","chr1.89740000.89745000",55000,23,0.001500618,89685000,89740000,89690000,89745000,"chr1",6456,0,3,5,8,"chr1",1,0.0215658696671355
"250","chr1.228860000.228865000","chr1.229090000.229095000",230000,12,0.003666933,228860000,229090000,228865000,229095000,"chr1",6468,2,12,7,21,"chr1",1,0.029535864978903
"251","chr1.201510000.201515000","chr1.201790000.201795000",280000,16,1.791283e-06,201510000,201790000,201515000,201795000,"chr1",6489,0,2,1,3,"chr1",1,0.00562587904360056
"252","chr1.110335000.110340000","chr1.110490000.110495000",155000,22,4.846389e-08,110335000,110490000,110340000,110495000,"chr1",6502,0,2,0,2,"chr1",1,0.00515705578996718
"253","chr1.8625000.8630000","chr1.8885000.8890000",260000,13,0.0004157809,8625000,8885000,8630000,8890000,"chr1",6554,6,10,15,31,"chr1",1,0.0472339428035631
"254","chr1.153750000.153755000","chr1.153955000.153960000",205000,12,0.007361476,153750000,153955000,153755000,153960000,"chr1",6577,3,5,7,15,"chr1",1,0.0210970464135021
"255","chr1.243945000.243950000","chr1.244295000.244300000",350000,10,0.00486492,243945000,244295000,243950000,244300000,"chr1",6614,2,9,7,18,"chr1",1,0.0210970464135021
"256","chr1.155275000.155280000","chr1.155685000.155690000",410000,10,0.002213559,155275000,155685000,155280000,155690000,"chr1",6621,0,7,9,16,"chr1",1,0.0187529301453352
"257","chr1.153955000.153960000","chr1.154155000.154160000",200000,18,2.006467e-06,153955000,154155000,153960000,154160000,"chr1",6636,1,2,1,4,"chr1",1,0.00843881856540084
"258","chr1.11300000.11305000","chr1.11700000.11705000",400000,24,6.350649e-16,11300000,11700000,11305000,11705000,"chr1",6676,0,2,1,3,"chr1",1,0.00843881856540084
"259","chr1.110335000.110340000","chr1.110545000.110550000",210000,19,2.148805e-07,110335000,110545000,110340000,110550000,"chr1",6741,0,4,4,8,"chr1",1,0.0178152836380684
"260","chr1.17000000.17005000","chr1.17055000.17060000",55000,105,7.12399e-74,1.7e+07,17055000,17005000,17060000,"chr1",6779,3,11,12,26,"chr1",1,0.319971870604782
"261","chr1.205230000.205235000","chr1.205285000.205290000",55000,26,7.710059e-05,205230000,205285000,205235000,205290000,"chr1",6790,4,3,4,11,"chr1",1,0.0335208626347867
"262","chr1.168600000.168605000","chr1.169085000.169090000",485000,10,0.0008196246,168600000,169085000,168605000,169090000,"chr1",6812,0,1,0,1,"chr1",1,0.00117205813408345
"263","chr1.183635000.183640000","chr1.183830000.183835000",195000,12,0.009750873,183635000,183830000,183640000,183835000,"chr1",6819,1,1,0,2,"chr1",1,0.00281293952180028
"264","chr1.205195000.205200000","chr1.205230000.205235000",35000,27,0.00691274,205195000,205230000,205200000,205235000,"chr1",6834,3,3,4,10,"chr1",1,0.0316455696202532
"265","chr1.39575000.39580000","chr1.39605000.39610000",30000,33,0.0006782985,39575000,39605000,39580000,39610000,"chr1",6854,4,5,23,32,"chr1",1,0.123769338959212
"266","chr1.205105000.205110000","chr1.205180000.205185000",75000,30,3.557209e-09,205105000,205180000,205110000,205185000,"chr1",6875,1,6,5,12,"chr1",1,0.0421940928270042
"267","chr1.153545000.153550000","chr1.153565000.153570000",20000,37,0.004733079,153545000,153565000,153550000,153570000,"chr1",6881,3,6,5,14,"chr1",1,0.0607126113455227
"268","chr1.204395000.204400000","chr1.204465000.204470000",70000,40,1.266773e-15,204395000,204465000,204400000,204470000,"chr1",6966,0,2,2,4,"chr1",1,0.0187529301453352
"269","chr1.151255000.151260000","chr1.151370000.151375000",115000,32,5.069829e-14,151255000,151370000,151260000,151375000,"chr1",6990,1,9,5,15,"chr1",1,0.0562587904360056
"270","chr1.26890000.26895000","chr1.27120000.27125000",230000,12,0.003666933,26890000,27120000,26895000,27125000,"chr1",6998,5,20,15,40,"chr1",1,0.0562587904360056
"271","chr1.54320000.54325000","chr1.54495000.54500000",175000,13,0.005981441,54320000,54495000,54325000,54500000,"chr1",7001,0,1,1,2,"chr1",1,0.00304735114861697
"272","chr1.40625000.40630000","chr1.40915000.40920000",290000,14,3.881624e-05,40625000,40915000,40630000,40920000,"chr1",7003,2,1,4,7,"chr1",1,0.0114861697140178
"273","chr1.149935000.149940000","chr1.150145000.150150000",210000,14,0.0005117364,149935000,150145000,149940000,150150000,"chr1",7009,0,5,5,10,"chr1",1,0.0164088138771683
"274","chr1.201705000.201710000","chr1.201730000.201735000",25000,51,2.041568e-09,201705000,201730000,201710000,201735000,"chr1",7030,4,7,10,21,"chr1",1,0.125527426160338
"275","chr1.153655000.153660000","chr1.153695000.153700000",40000,30,9.14609e-05,153655000,153695000,153660000,153700000,"chr1",7033,13,26,34,73,"chr1",1,0.256680731364276
"276","chr1.29230000.29235000","chr1.29350000.29355000",120000,16,0.001909676,29230000,29350000,29235000,29355000,"chr1",7080,0,1,0,1,"chr1",1,0.00187529301453352
"277","chr1.201530000.201535000","chr1.201760000.201765000",230000,35,3.923099e-23,201530000,201760000,201535000,201765000,"chr1",7088,3,2,1,6,"chr1",1,0.0246132208157525
"278","chr1.168250000.168255000","chr1.169130000.169135000",880000,7,0.004296559,168250000,169130000,168255000,169135000,"chr1",7098,0,2,2,4,"chr1",1,0.00328176277543366
"279","chr1.9165000.9170000","chr1.9250000.9255000",85000,29,1.939221e-09,9165000,9250000,9170000,9255000,"chr1",7114,4,12,16,32,"chr1",1,0.108766994842944
"280","chr1.39330000.39335000","chr1.39450000.39455000",120000,15,0.005618157,39330000,39450000,39335000,39455000,"chr1",7116,0,3,0,3,"chr1",1,0.00527426160337553
"281","chr1.21345000.21350000","chr1.21505000.21510000",160000,16,0.0002827585,21345000,21505000,21350000,21510000,"chr1",7180,0,4,2,6,"chr1",1,0.0112517580872011
"282","chr1.28170000.28175000","chr1.28365000.28370000",195000,12,0.009750873,28170000,28365000,28175000,28370000,"chr1",7191,9,12,11,32,"chr1",1,0.0450070323488045
"283","chr1.46155000.46160000","chr1.46200000.46205000",45000,24,0.004449684,46155000,46200000,46160000,46205000,"chr1",7262,5,13,8,26,"chr1",1,0.0731364275668073
"284","chr1.174770000.174775000","chr1.174965000.174970000",195000,15,0.0002307636,174770000,174965000,174775000,174970000,"chr1",7289,4,13,13,30,"chr1",1,0.0527426160337553
"285","chr1.150300000.150305000","chr1.150320000.150325000",20000,60,3.342866e-12,150300000,150320000,150305000,150325000,"chr1",7313,0,11,9,20,"chr1",1,0.140646976090014
"286","chr1.40640000.40645000","chr1.40660000.40665000",20000,41,0.0003129283,40640000,40660000,40645000,40665000,"chr1",7315,1,0,0,1,"chr1",1,0.00480543834974215
"287","chr1.168145000.168150000","chr1.169085000.169090000",940000,7,0.002913391,168145000,169085000,168150000,169090000,"chr1",7348,0,1,2,3,"chr1",1,0.00246132208157525
"288","chr1.234745000.234750000","chr1.234860000.234865000",115000,33,7.47115e-15,234745000,234860000,234750000,234865000,"chr1",7377,4,7,7,18,"chr1",1,0.069620253164557
"289","chr1.28830000.28835000","chr1.28880000.28885000",50000,31,1.11328e-06,28830000,28880000,28835000,28885000,"chr1",7419,6,17,19,42,"chr1",1,0.152601969057665
"290","chr1.203335000.203340000","chr1.203445000.203450000",110000,15,0.009294725,203335000,203445000,203340000,203450000,"chr1",7466,2,2,1,5,"chr1",1,0.00879043600562588
"291","chr1.205525000.205530000","chr1.205675000.205680000",150000,14,0.004757005,205525000,205675000,205530000,205680000,"chr1",7498,0,0,1,1,"chr1",1,0.00164088138771683
"292","chr1.28665000.28670000","chr1.28855000.28860000",190000,13,0.003611391,28665000,28855000,28670000,28860000,"chr1",7501,6,17,29,52,"chr1",1,0.0792311298640413
"293","chr1.109195000.109200000","chr1.109265000.109270000",70000,19,0.00555421,109195000,109265000,109200000,109270000,"chr1",7504,3,8,5,16,"chr1",1,0.0356305672761369
"294","chr1.46165000.46170000","chr1.46200000.46205000",35000,32,0.0001186414,46165000,46200000,46170000,46205000,"chr1",7521,4,10,9,23,"chr1",1,0.086263478668542
"295","chr1.156475000.156480000","chr1.156580000.156585000",105000,18,0.0005300991,156475000,156580000,156480000,156585000,"chr1",7550,0,4,2,6,"chr1",1,0.0126582278481013
"296","chr1.235935000.235940000","chr1.235970000.235975000",35000,27,0.00691274,235935000,235970000,235940000,235975000,"chr1",7562,3,6,7,16,"chr1",1,0.0506329113924051
"297","chr1.44525000.44530000","chr1.44545000.44550000",20000,41,0.0003129283,44525000,44545000,44530000,44550000,"chr1",7590,2,7,9,18,"chr1",1,0.0864978902953586
"298","chr1.225975000.225980000","chr1.226105000.226110000",130000,15,0.003565021,225975000,226105000,225980000,226110000,"chr1",7639,11,35,41,87,"chr1",1,0.15295358649789
"299","chr1.174050000.174055000","chr1.174160000.174165000",110000,15,0.009294725,174050000,174160000,174055000,174165000,"chr1",7664,1,3,2,6,"chr1",1,0.0105485232067511
"300","chr1.182065000.182070000","chr1.182110000.182115000",45000,27,0.0003258119,182065000,182110000,182070000,182115000,"chr1",7673,1,0,1,2,"chr1",1,0.00632911392405063
"301","chr1.156665000.156670000","chr1.156685000.156690000",20000,46,5.655326e-06,156665000,156685000,156670000,156690000,"chr1",7682,2,10,2,14,"chr1",1,0.0754805438349742
"302","chr1.182120000.182125000","chr1.182345000.182350000",225000,15,6.991763e-05,182120000,182345000,182125000,182350000,"chr1",7684,0,9,3,12,"chr1",1,0.0210970464135021
"303","chr1.202940000.202945000","chr1.202965000.202970000",25000,55,2.199034e-11,202940000,202965000,202945000,202970000,"chr1",7718,0,9,5,14,"chr1",1,0.0902484763244257
"304","chr1.94525000.94530000","chr1.94790000.94795000",265000,12,0.001500618,94525000,94790000,94530000,94795000,"chr1",7727,0,2,0,2,"chr1",1,0.00281293952180028
"305","chr1.8090000.8095000","chr1.8405000.8410000",315000,16,5.788663e-07,8090000,8405000,8095000,8410000,"chr1",7732,1,4,4,9,"chr1",1,0.0168776371308017
"306","chr1.160075000.160080000","chr1.160310000.160315000",235000,18,3.359245e-07,160075000,160310000,160080000,160315000,"chr1",7752,2,2,1,5,"chr1",1,0.0105485232067511
"307","chr1.84620000.84625000","chr1.84760000.84765000",140000,21,7.153834e-07,84620000,84760000,84625000,84765000,"chr1",7754,1,5,5,11,"chr1",1,0.0270745428973277
"308","chr1.23810000.23815000","chr1.23855000.23860000",45000,27,0.0003258119,23810000,23855000,23815000,23860000,"chr1",7770,6,17,13,36,"chr1",1,0.113924050632911
"309","chr1.158200000.158205000","chr1.158995000.159000000",795000,7,0.00723779,158200000,158995000,158205000,1.59e+08,"chr1",7777,0,0,3,3,"chr1",1,0.00246132208157525
"310","chr1.36575000.36580000","chr1.36595000.36600000",20000,43,6.896909e-05,36575000,36595000,36580000,36600000,"chr1",7792,0,2,0,2,"chr1",1,0.0100796999531177
"311","chr1.16175000.16180000","chr1.16930000.16935000",755000,8,0.00171529,16175000,16930000,16180000,16935000,"chr1",7804,0,12,4,16,"chr1",1,0.0150023441162682
"312","chr1.226390000.226395000","chr1.226415000.226420000",25000,38,0.0003847014,226390000,226415000,226395000,226420000,"chr1",7810,6,10,17,33,"chr1",1,0.146976090014065
"313","chr1.153780000.153785000","chr1.153880000.153885000",100000,16,0.006415049,153780000,153880000,153785000,153885000,"chr1",7817,2,12,14,28,"chr1",1,0.0525082044069386
"314","chr1.25895000.25900000","chr1.26125000.26130000",230000,13,0.001007514,25895000,26125000,25900000,26130000,"chr1",7821,0,2,6,8,"chr1",1,0.0121894045944679
"315","chr1.8710000.8715000","chr1.8915000.8920000",205000,19,2.856608e-07,8710000,8915000,8715000,8920000,"chr1",7847,1,15,11,27,"chr1",1,0.060126582278481
"316","chr1.54420000.54425000","chr1.54950000.54955000",530000,9,0.0024319,54420000,54950000,54425000,54955000,"chr1",7851,2,3,1,6,"chr1",1,0.00632911392405063
"317","chr1.27340000.27345000","chr1.27980000.27985000",640000,8,0.004222767,27340000,27980000,27345000,27985000,"chr1",7866,4,18,9,31,"chr1",1,0.0290670417252696
"318","chr1.11095000.11100000","chr1.11745000.11750000",650000,8,0.003870098,11095000,11745000,11100000,11750000,"chr1",7871,0,4,2,6,"chr1",1,0.00562587904360056
"319","chr1.12345000.12350000","chr1.12375000.12380000",30000,31,0.003104399,12345000,12375000,12350000,12380000,"chr1",7892,0,1,1,2,"chr1",1,0.00726676043131739
"320","chr1.40305000.40310000","chr1.40505000.40510000",200000,14,0.0007239502,40305000,40505000,40310000,40510000,"chr1",7948,0,4,8,12,"chr1",1,0.019690576652602
"321","chr1.20685000.20690000","chr1.20815000.20820000",130000,30,3.014845e-13,20685000,20815000,20690000,20820000,"chr1",8014,0,3,7,10,"chr1",1,0.0351617440225035
"322","chr1.23560000.23565000","chr1.23580000.23585000",20000,43,6.896909e-05,23560000,23580000,23565000,23585000,"chr1",8040,0,9,0,9,"chr1",1,0.0453586497890295
"323","chr1.9940000.9945000","chr1.10210000.10215000",270000,11,0.004966,9940000,10210000,9945000,10215000,"chr1",8044,6,16,13,35,"chr1",1,0.0451242381622128
"324","chr1.6865000.6870000","chr1.7665000.7670000",800000,8,0.00124165,6865000,7665000,6870000,7670000,"chr1",8049,3,4,2,9,"chr1",1,0.00843881856540084
"325","chr1.153655000.153660000","chr1.153675000.153680000",20000,36,0.008632247,153655000,153675000,153660000,153680000,"chr1",8088,11,39,45,95,"chr1",1,0.40084388185654
"326","chr1.243490000.243495000","chr1.243900000.243905000",410000,11,0.0004758657,243490000,243900000,243495000,243905000,"chr1",8134,0,1,2,3,"chr1",1,0.00386779184247539
"327","chr1.14435000.14440000","chr1.15110000.15115000",675000,11,1.195263e-05,14435000,15110000,14440000,15115000,"chr1",8169,0,7,1,8,"chr1",1,0.0103141115799344
"328","chr1.228865000.228870000","chr1.229250000.229255000",385000,14,4.215236e-06,228865000,229250000,228870000,229255000,"chr1",8190,4,10,10,24,"chr1",1,0.0393811533052039
"329","chr1.203475000.203480000","chr1.203595000.203600000",120000,17,0.0006133453,203475000,203595000,203480000,203600000,"chr1",8195,1,1,0,2,"chr1",1,0.00398499765588373
"330","chr1.153645000.153650000","chr1.153760000.153765000",115000,19,7.230743e-05,153645000,153760000,153650000,153765000,"chr1",8231,1,11,7,19,"chr1",1,0.0423112986404126
"331","chr1.2170000.2175000","chr1.2190000.2195000",20000,36,0.008632247,2170000,2190000,2175000,2195000,"chr1",8237,0,3,0,3,"chr1",1,0.0126582278481013
"332","chr1.77775000.77780000","chr1.78000000.78005000",225000,13,0.0011796,77775000,7.8e+07,77780000,78005000,"chr1",8317,5,11,9,25,"chr1",1,0.0380918893577121
"333","chr1.46035000.46040000","chr1.46215000.46220000",180000,14,0.001527903,46035000,46215000,46040000,46220000,"chr1",8346,0,3,1,4,"chr1",1,0.00656352555086732
"334","chr1.155225000.155230000","chr1.155560000.155565000",335000,14,1.259068e-05,155225000,155560000,155230000,155565000,"chr1",8366,0,2,0,2,"chr1",1,0.00328176277543366
"335","chr1.230250000.230255000","chr1.230320000.230325000",70000,20,0.002190239,230250000,230320000,230255000,230325000,"chr1",8368,0,2,1,3,"chr1",1,0.0070323488045007
"336","chr1.205690000.205695000","chr1.205710000.205715000",20000,49,3.736063e-07,205690000,205710000,205695000,205715000,"chr1",8406,2,14,5,21,"chr1",1,0.120604781997187
"337","chr1.153630000.153635000","chr1.153960000.153965000",330000,19,9.273068e-10,153630000,153960000,153635000,153965000,"chr1",8423,1,7,6,14,"chr1",1,0.0311767463666198
"338","chr1.9950000.9955000","chr1.10385000.10390000",435000,9,0.00691274,9950000,10385000,9955000,10390000,"chr1",8431,13,28,28,69,"chr1",1,0.0727848101265823
"339","chr1.54545000.54550000","chr1.54950000.54955000",405000,12,9.882639e-05,54545000,54950000,54550000,54955000,"chr1",8434,2,3,1,6,"chr1",1,0.00843881856540084
"340","chr1.11010000.11015000","chr1.11070000.11075000",60000,26,2.391654e-05,11010000,11070000,11015000,11075000,"chr1",8489,5,11,15,31,"chr1",1,0.0944678856071261
"341","chr1.182110000.182115000","chr1.182170000.182175000",60000,37,8.567321e-12,182110000,182170000,182115000,182175000,"chr1",8557,3,4,3,10,"chr1",1,0.0433661509610877
"342","chr1.10070000.10075000","chr1.10210000.10215000",140000,16,0.0007123297,10070000,10210000,10075000,10215000,"chr1",8570,6,11,13,30,"chr1",1,0.0562587904360056
"343","chr1.10030000.10035000","chr1.10075000.10080000",45000,25,0.001925343,10030000,10075000,10035000,10080000,"chr1",8595,0,6,12,18,"chr1",1,0.0527426160337553
"344","chr1.36395000.36400000","chr1.36550000.36555000",155000,17,9.494008e-05,36395000,36550000,36400000,36555000,"chr1",8597,1,3,2,6,"chr1",1,0.0119549929676512
"345","chr1.9250000.9255000","chr1.9585000.9590000",335000,10,0.006041478,9250000,9585000,9255000,9590000,"chr1",8607,4,12,16,32,"chr1",1,0.0375058602906704
"346","chr1.244230000.244235000","chr1.244335000.244340000",105000,16,0.004620068,244230000,244335000,244235000,244340000,"chr1",8635,3,10,7,20,"chr1",1,0.0375058602906704
"347","chr1.156055000.156060000","chr1.156125000.156130000",70000,21,0.0008075999,156055000,156125000,156060000,156130000,"chr1",8673,1,8,8,17,"chr1",1,0.0418424753867792
"348","chr1.223090000.223095000","chr1.223140000.223145000",50000,24,0.001605476,223090000,223140000,223095000,223145000,"chr1",8683,1,5,5,11,"chr1",1,0.0309423347398031
"349","chr1.17020000.17025000","chr1.17045000.17050000",25000,34,0.006227396,17020000,17045000,17025000,17050000,"chr1",8717,2,2,1,5,"chr1",1,0.0199249882794187
"350","chr1.178025000.178030000","chr1.178240000.178245000",215000,13,0.001605476,178025000,178240000,178030000,178245000,"chr1",8743,0,4,2,6,"chr1",1,0.00914205344585091
"351","chr1.204605000.204610000","chr1.204990000.204995000",385000,10,0.003098721,204605000,204990000,204610000,204995000,"chr1",8781,0,6,4,10,"chr1",1,0.0117205813408345
"352","chr1.204400000.204405000","chr1.204465000.204470000",65000,36,6.261646e-12,204400000,204465000,204405000,204470000,"chr1",8819,0,2,2,4,"chr1",1,0.0168776371308017
"353","chr1.26785000.26790000","chr1.27155000.27160000",370000,10,0.003722807,26785000,27155000,26790000,27160000,"chr1",8846,2,0,9,11,"chr1",1,0.012892639474918
"354","chr1.17000000.17005000","chr1.17050000.17055000",50000,33,9.706094e-08,1.7e+07,17050000,17005000,17055000,"chr1",8849,2,11,12,25,"chr1",1,0.0966947960618847
"355","chr1.247340000.247345000","chr1.247360000.247365000",20000,46,5.655326e-06,247340000,247360000,247345000,247365000,"chr1",8872,4,15,19,38,"chr1",1,0.204875761837787
"356","chr1.168600000.168605000","chr1.169080000.169085000",480000,19,8.443768e-12,168600000,169080000,168605000,169085000,"chr1",8873,0,2,0,2,"chr1",1,0.00445382090951711
"357","chr1.43705000.43710000","chr1.43855000.43860000",150000,14,0.004757005,43705000,43855000,43710000,43860000,"chr1",8876,4,12,9,25,"chr1",1,0.0410220346929208
"358","chr1.201790000.201795000","chr1.201945000.201950000",155000,15,0.001236846,201790000,201945000,201795000,201950000,"chr1",8898,0,2,1,3,"chr1",1,0.00527426160337553
"359","chr1.210580000.210585000","chr1.211305000.211310000",725000,23,1.232009e-19,210580000,211305000,210585000,211310000,"chr1",8915,0,2,0,2,"chr1",1,0.00539146741678387
"360","chr1.151175000.151180000","chr1.151365000.151370000",190000,13,0.003611391,151175000,151365000,151180000,151370000,"chr1",8932,2,7,12,21,"chr1",1,0.0319971870604782
"361","chr1.156065000.156070000","chr1.156190000.156195000",125000,17,0.0004573819,156065000,156190000,156070000,156195000,"chr1",8939,1,11,4,16,"chr1",1,0.0318799812470699
"362","chr1.11035000.11040000","chr1.11070000.11075000",35000,29,0.001520338,11035000,11070000,11040000,11075000,"chr1",8946,4,11,14,29,"chr1",1,0.0985700890764182
"363","chr1.78605000.78610000","chr1.79065000.79070000",460000,13,6.062584e-06,78605000,79065000,78610000,79070000,"chr1",8981,0,3,1,4,"chr1",1,0.00609470229723394
"364","chr1.234745000.234750000","chr1.234965000.234970000",220000,12,0.004800128,234745000,234965000,234750000,234970000,"chr1",8982,2,7,7,16,"chr1",1,0.0225035161744023
"365","chr1.11260000.11265000","chr1.11700000.11705000",440000,10,0.001500618,11260000,11700000,11265000,11705000,"chr1",8998,0,2,1,3,"chr1",1,0.00351617440225035
"366","chr1.39625000.39630000","chr1.39745000.39750000",120000,18,0.0001811171,39625000,39745000,39630000,39750000,"chr1",9031,0,3,4,7,"chr1",1,0.0147679324894515
"367","chr1.151295000.151300000","chr1.151370000.151375000",75000,33,3.473301e-11,151295000,151370000,151300000,151375000,"chr1",9045,1,9,5,15,"chr1",1,0.0580168776371308
"368","chr1.183650000.183655000","chr1.183830000.183835000",180000,13,0.005018612,183650000,183830000,183655000,183835000,"chr1",9086,1,1,0,2,"chr1",1,0.00304735114861697
"369","chr1.54315000.54320000","chr1.54420000.54425000",105000,16,0.004620068,54315000,54420000,54320000,54425000,"chr1",9115,7,15,16,38,"chr1",1,0.0712611345522738
"370","chr1.228830000.228835000","chr1.229595000.229600000",765000,7,0.008632247,228830000,229595000,228835000,229600000,"chr1",9132,2,2,5,9,"chr1",1,0.00738396624472574
"371","chr1.225730000.225735000","chr1.225815000.225820000",85000,22,3.458094e-05,225730000,225815000,225735000,225820000,"chr1",9140,4,12,11,27,"chr1",1,0.069620253164557
"372","chr1.155065000.155070000","chr1.155140000.155145000",75000,39,1.309478e-15,155065000,155140000,155070000,155145000,"chr1",9218,9,18,27,54,"chr1",1,0.246835443037975
"373","chr1.12190000.12195000","chr1.12270000.12275000",80000,28,2.339694e-08,12190000,12270000,12195000,12275000,"chr1",9257,1,3,3,7,"chr1",1,0.0229723394280356
"374","chr1.116905000.116910000","chr1.117030000.117035000",125000,16,0.001500618,116905000,117030000,116910000,117035000,"chr1",9266,3,2,2,7,"chr1",1,0.0131270511017346
"375","chr1.26995000.27000000","chr1.27100000.27105000",105000,19,0.0001598251,26995000,27100000,2.7e+07,27105000,"chr1",9391,1,2,2,5,"chr1",1,0.0111345522737928
"376","chr1.19680000.19685000","chr1.19915000.19920000",235000,14,0.0002134243,19680000,19915000,19685000,19920000,"chr1",9444,4,5,3,12,"chr1",1,0.019690576652602
"377","chr1.36090000.36095000","chr1.36175000.36180000",85000,21,0.0001156532,36090000,36175000,36095000,36180000,"chr1",9447,7,5,9,21,"chr1",1,0.0516877637130802
"378","chr1.174770000.174775000","chr1.174955000.174960000",185000,29,5.622173e-15,174770000,174955000,174775000,174960000,"chr1",9546,9,10,22,41,"chr1",1,0.139357712142522
"379","chr1.42430000.42435000","chr1.42460000.42465000",30000,31,0.003104399,42430000,42460000,42435000,42465000,"chr1",9552,1,1,3,5,"chr1",1,0.0181669010782935
"380","chr1.27030000.27035000","chr1.27045000.27050000",15000,38,0.00252151,27030000,27045000,27035000,27050000,"chr1",9557,5,5,13,23,"chr1",1,0.102437880918894
"381","chr1.205300000.205305000","chr1.205350000.205355000",50000,25,0.0006470043,205300000,205350000,205305000,205355000,"chr1",9565,1,3,2,6,"chr1",1,0.0175808720112518
"382","chr1.205360000.205365000","chr1.205590000.205595000",230000,12,0.003666933,205360000,205590000,205365000,205595000,"chr1",9606,1,5,9,15,"chr1",1,0.0210970464135021
"383","chr1.120175000.120180000","chr1.120195000.120200000",20000,37,0.004733079,120175000,120195000,120180000,120200000,"chr1",9636,0,0,2,2,"chr1",1,0.00867323019221753
"384","chr1.203595000.203600000","chr1.203640000.203645000",45000,49,8.952051e-17,203595000,203640000,203600000,203645000,"chr1",9696,3,8,4,15,"chr1",1,0.0861462728551336
"385","chr1.156445000.156450000","chr1.156615000.156620000",170000,13,0.00702836,156445000,156615000,156450000,156620000,"chr1",9714,7,17,23,47,"chr1",1,0.0716127519924988
"386","chr1.28755000.28760000","chr1.28775000.28780000",20000,38,0.00252151,28755000,28775000,28760000,28780000,"chr1",9718,2,8,1,11,"chr1",1,0.0489920300046882
"387","chr1.243505000.243510000","chr1.244460000.244465000",955000,21,1.515347e-19,243505000,244460000,243510000,244465000,"chr1",9753,0,2,1,3,"chr1",1,0.00738396624472574
"388","chr1.155830000.155835000","chr1.155945000.155950000",115000,22,1.156407e-06,155830000,155945000,155835000,155950000,"chr1",9765,16,41,28,85,"chr1",1,0.219174871073605
"389","chr1.9290000.9295000","chr1.9540000.9545000",250000,11,0.007719712,9290000,9540000,9295000,9545000,"chr1",9783,5,15,17,37,"chr1",1,0.0477027660571964
"390","chr1.8835000.8840000","chr1.8855000.8860000",20000,42,0.0001481797,8835000,8855000,8840000,8860000,"chr1",9803,14,36,41,91,"chr1",1,0.447960618846695
"391","chr1.8675000.8680000","chr1.8710000.8715000",35000,27,0.00691274,8675000,8710000,8680000,8715000,"chr1",9944,1,15,11,27,"chr1",1,0.0854430379746835
"392","chr1.46570000.46575000","chr1.46625000.46630000",55000,21,0.00838272,46570000,46625000,46575000,46630000,"chr1",9975,0,9,8,17,"chr1",1,0.0418424753867792
"393","chr1.27010000.27015000","chr1.27120000.27125000",110000,20,2.963273e-05,27010000,27120000,27015000,27125000,"chr1",10004,2,3,5,10,"chr1",1,0.023441162681669
"394","chr1.8590000.8595000","chr1.8710000.8715000",120000,16,0.001909676,8590000,8710000,8595000,8715000,"chr1",10049,1,11,10,22,"chr1",1,0.0412564463197375
"395","chr1.155275000.155280000","chr1.155900000.155905000",625000,10,0.0001515297,155275000,155900000,155280000,155905000,"chr1",10055,9,25,22,56,"chr1",1,0.0656352555086732
"396","chr1.161740000.161745000","chr1.161995000.162000000",255000,15,2.314126e-05,161740000,161995000,161745000,1.62e+08,"chr1",10080,0,0,3,3,"chr1",1,0.00527426160337553
"397","chr1.8455000.8460000","chr1.8590000.8595000",135000,15,0.00290255,8455000,8590000,8460000,8595000,"chr1",10107,2,3,6,11,"chr1",1,0.0193389592123769
"398","chr1.39690000.39695000","chr1.39750000.39755000",60000,24,0.0002105081,39690000,39750000,39695000,39755000,"chr1",10177,1,3,3,7,"chr1",1,0.019690576652602
"399","chr1.87175000.87180000","chr1.87410000.87415000",235000,13,0.0008544039,87175000,87410000,87180000,87415000,"chr1",10178,0,0,6,6,"chr1",1,0.00914205344585091
"400","chr1.234755000.234760000","chr1.235145000.235150000",390000,10,0.00290255,234755000,235145000,234760000,235150000,"chr1",10189,0,1,2,3,"chr1",1,0.00351617440225035
"401","chr1.21070000.21075000","chr1.21585000.21590000",515000,9,0.002872008,21070000,21585000,21075000,21590000,"chr1",10203,1,9,1,11,"chr1",1,0.0116033755274262
"402","chr1.9195000.9200000","chr1.9230000.9235000",35000,29,0.001520338,9195000,9230000,9200000,9235000,"chr1",10209,2,1,7,10,"chr1",1,0.0339896858884201
"403","chr1.67010000.67015000","chr1.67610000.67615000",600000,9,0.001177107,67010000,67610000,67015000,67615000,"chr1",10210,1,4,2,7,"chr1",1,0.00738396624472574
"404","chr1.155225000.155230000","chr1.155470000.155475000",245000,15,3.29545e-05,155225000,155470000,155230000,155475000,"chr1",10226,5,22,10,37,"chr1",1,0.0650492264416315
"405","chr1.28735000.28740000","chr1.28885000.28890000",150000,14,0.004757005,28735000,28885000,28740000,28890000,"chr1",10232,0,0,2,2,"chr1",1,0.00328176277543366
"406","chr1.231600000.231605000","chr1.231640000.231645000",40000,26,0.003086748,231600000,231640000,231605000,231645000,"chr1",10236,1,3,3,7,"chr1",1,0.0213314580403188
"407","chr1.8525000.8530000","chr1.8595000.8600000",70000,31,2.760412e-09,8525000,8595000,8530000,8600000,"chr1",10251,0,0,3,3,"chr1",1,0.0109001406469761
"408","chr1.156600000.156605000","chr1.156620000.156625000",20000,78,1.607144e-22,156600000,156620000,156605000,156625000,"chr1",10334,5,14,25,44,"chr1",1,0.40225035161744
"409","chr1.151575000.151580000","chr1.151840000.151845000",265000,16,3.039697e-06,151575000,151840000,151580000,151845000,"chr1",10348,2,12,10,24,"chr1",1,0.0450070323488045
"410","chr1.182050000.182055000","chr1.182085000.182090000",35000,27,0.00691274,182050000,182085000,182055000,182090000,"chr1",10349,0,1,1,2,"chr1",1,0.00632911392405063
"411","chr1.168145000.168150000","chr1.168195000.168200000",50000,23,0.003767084,168145000,168195000,168150000,168200000,"chr1",10366,2,10,7,19,"chr1",1,0.0512189404594468
"412","chr1.204205000.204210000","chr1.204360000.204365000",155000,14,0.00393986,204205000,204360000,204210000,204365000,"chr1",10392,0,3,0,3,"chr1",1,0.00492264416315049
"413","chr1.19675000.19680000","chr1.19760000.19765000",85000,18,0.003006639,19675000,19760000,19680000,19765000,"chr1",10460,2,4,3,9,"chr1",1,0.0189873417721519
"414","chr1.178310000.178315000","chr1.178500000.178505000",190000,14,0.001061267,178310000,178500000,178315000,178505000,"chr1",10495,1,4,5,10,"chr1",1,0.0164088138771683
"415","chr1.204840000.204845000","chr1.204900000.204905000",60000,26,2.391654e-05,204840000,204900000,204845000,204905000,"chr1",10558,1,8,5,14,"chr1",1,0.0426629160806376
"416","chr1.36080000.36085000","chr1.36175000.36180000",95000,16,0.009001332,36080000,36175000,36085000,36180000,"chr1",10568,7,17,9,33,"chr1",1,0.0618846694796062
"417","chr1.11070000.11075000","chr1.11330000.11335000",260000,12,0.001680009,11070000,11330000,11075000,11335000,"chr1",10578,4,5,9,18,"chr1",1,0.0253164556962025
"418","chr1.205175000.205180000","chr1.205225000.205230000",50000,26,0.0002506014,205175000,205225000,205180000,205230000,"chr1",10597,0,1,1,2,"chr1",1,0.00609470229723394
"419","chr1.244075000.244080000","chr1.244430000.244435000",355000,15,1.281512e-06,244075000,244430000,244080000,244435000,"chr1",10603,1,9,7,17,"chr1",1,0.029887482419128
"420","chr1.204240000.204245000","chr1.204345000.204350000",105000,17,0.001605476,204240000,204345000,204245000,204350000,"chr1",10612,0,2,1,3,"chr1",1,0.0059774964838256
"421","chr1.156090000.156095000","chr1.156160000.156165000",70000,22,0.0002882227,156090000,156160000,156095000,156165000,"chr1",10640,5,6,4,15,"chr1",1,0.0386779184247539
"422","chr1.156600000.156605000","chr1.156675000.156680000",75000,18,0.007861949,156600000,156675000,156605000,156680000,"chr1",10650,0,2,3,5,"chr1",1,0.0105485232067511
"423","chr1.110335000.110340000","chr1.110510000.110515000",175000,19,1.64907e-06,110335000,110510000,110340000,110515000,"chr1",10667,1,2,5,8,"chr1",1,0.0178152836380684
"424","chr1.210750000.210755000","chr1.211320000.211325000",570000,9,0.001590574,210750000,211320000,210755000,211325000,"chr1",10675,0,2,3,5,"chr1",1,0.00527426160337553
"425","chr1.155215000.155220000","chr1.155685000.155690000",470000,10,0.001007966,155215000,155685000,155220000,155690000,"chr1",10710,0,1,0,1,"chr1",1,0.00117205813408345
"426","chr1.28580000.28585000","chr1.28875000.28880000",295000,11,0.00307826,28580000,28875000,28585000,28880000,"chr1",10716,4,17,23,44,"chr1",1,0.056727613689639
"427","chr1.153960000.153965000","chr1.154155000.154160000",195000,21,1.593197e-08,153960000,154155000,153965000,154160000,"chr1",10723,1,2,1,4,"chr1",1,0.00984528832630099
"428","chr1.66445000.66450000","chr1.66640000.66645000",195000,12,0.009750873,66445000,66640000,66450000,66645000,"chr1",10727,1,4,0,5,"chr1",1,0.0070323488045007
"429","chr1.159130000.159135000","chr1.159165000.159170000",35000,87,5.508016e-42,159130000,159165000,159135000,159170000,"chr1",10747,1,3,2,6,"chr1",1,0.0611814345991561
"430","chr1.204240000.204245000","chr1.204330000.204335000",90000,19,0.0006470043,204240000,204330000,204245000,204335000,"chr1",10766,0,9,9,18,"chr1",1,0.040084388185654
"431","chr1.161205000.161210000","chr1.161305000.161310000",100000,19,0.0002491261,161205000,161305000,161210000,161310000,"chr1",10770,2,6,7,15,"chr1",1,0.0334036568213783
"432","chr1.221435000.221440000","chr1.221610000.221615000",175000,22,1.101923e-08,221435000,221610000,221440000,221615000,"chr1",10792,1,3,5,9,"chr1",1,0.0232067510548523
"433","chr1.210585000.210590000","chr1.211305000.211310000",720000,13,7.998992e-08,210585000,211305000,210590000,211310000,"chr1",10806,0,4,2,6,"chr1",1,0.00914205344585091
"434","chr1.212475000.212480000","chr1.212505000.212510000",30000,35,0.0001324766,212475000,212505000,212480000,212510000,"chr1",10831,2,10,3,15,"chr1",1,0.0615330520393812
"435","chr1.165390000.165395000","chr1.165540000.165545000",150000,27,1.043073e-11,165390000,165540000,165395000,165545000,"chr1",10881,0,3,5,8,"chr1",1,0.0253164556962025
"436","chr1.244780000.244785000","chr1.244970000.244975000",190000,15,0.000283605,244780000,244970000,244785000,244975000,"chr1",10896,3,12,11,26,"chr1",1,0.0457102672292546
"437","chr1.32750000.32755000","chr1.32825000.32830000",75000,20,0.001171509,32750000,32825000,32755000,32830000,"chr1",10901,2,4,3,9,"chr1",1,0.0210970464135021
"438","chr1.9765000.9770000","chr1.10470000.10475000",705000,8,0.002524156,9765000,10470000,9770000,10475000,"chr1",10910,0,13,9,22,"chr1",1,0.0206282231598687
"439","chr1.11720000.11725000","chr1.11785000.11790000",65000,21,0.001695142,11720000,11785000,11725000,11790000,"chr1",10921,1,2,4,7,"chr1",1,0.0172292545710267
"440","chr1.155745000.155750000","chr1.155775000.155780000",30000,40,1.244322e-06,155745000,155775000,155750000,155780000,"chr1",10935,2,9,8,19,"chr1",1,0.0890764181903422
"441","chr1.243505000.243510000","chr1.243900000.243905000",395000,14,3.377754e-06,243505000,243900000,243510000,243905000,"chr1",10989,0,1,1,2,"chr1",1,0.00328176277543366
"442","chr1.9190000.9195000","chr1.9625000.9630000",435000,9,0.00691274,9190000,9625000,9195000,9630000,"chr1",11008,6,11,13,30,"chr1",1,0.0316455696202532
"443","chr1.98465000.98470000","chr1.98930000.98935000",465000,9,0.004886133,98465000,98930000,98470000,98935000,"chr1",11009,0,2,1,3,"chr1",1,0.00316455696202532
"444","chr1.84940000.84945000","chr1.85150000.85155000",210000,12,0.00640887,84940000,85150000,84945000,85155000,"chr1",11017,1,3,3,7,"chr1",1,0.00984528832630099
"445","chr1.40610000.40615000","chr1.40860000.40865000",250000,14,0.0001287456,40610000,40860000,40615000,40865000,"chr1",11038,2,9,10,21,"chr1",1,0.0344585091420534
"446","chr1.66600000.66605000","chr1.66690000.66695000",90000,18,0.001865958,66600000,66690000,66605000,66695000,"chr1",11081,1,1,4,6,"chr1",1,0.0126582278481013
"447","chr1.171820000.171825000","chr1.171950000.171955000",130000,15,0.003565021,171820000,171950000,171825000,171955000,"chr1",11154,1,4,2,7,"chr1",1,0.0123066104078762
"448","chr1.155215000.155220000","chr1.155560000.155565000",345000,12,0.0002827585,155215000,155560000,155220000,155565000,"chr1",11175,0,1,0,1,"chr1",1,0.00140646976090014
"449","chr1.92775000.92780000","chr1.93080000.93085000",305000,14,2.624845e-05,92775000,93080000,92780000,93085000,"chr1",11200,2,7,8,17,"chr1",1,0.0278949835911861
"450","chr1.18285000.18290000","chr1.18905000.18910000",620000,8,0.004946176,18285000,18905000,18290000,18910000,"chr1",11281,2,1,9,12,"chr1",1,0.0112517580872011
"451","chr1.40305000.40310000","chr1.40370000.40375000",65000,45,1.263443e-18,40305000,40370000,40310000,40375000,"chr1",11282,0,4,8,12,"chr1",1,0.0632911392405063
"452","chr1.109575000.109580000","chr1.109645000.109650000",70000,26,2.649753e-06,109575000,109645000,109580000,109650000,"chr1",11286,1,2,4,7,"chr1",1,0.0213314580403188
"453","chr1.155645000.155650000","chr1.155900000.155905000",255000,11,0.00691274,155645000,155900000,155650000,155905000,"chr1",11305,2,26,25,53,"chr1",1,0.0683309892170652
"454","chr1.228860000.228865000","chr1.229270000.229275000",410000,17,5.764911e-09,228860000,229270000,228865000,229275000,"chr1",11319,2,11,7,20,"chr1",1,0.0398499765588373
"455","chr1.243595000.243600000","chr1.244430000.244435000",835000,7,0.005667308,243595000,244430000,243600000,244435000,"chr1",11334,1,1,0,2,"chr1",1,0.00164088138771683
"456","chr1.204805000.204810000","chr1.204900000.204905000",95000,29,2.935858e-10,204805000,204900000,204810000,204905000,"chr1",11358,7,8,10,25,"chr1",1,0.0849742147210502
"457","chr1.165600000.165605000","chr1.165870000.165875000",270000,12,0.001326741,165600000,165870000,165605000,165875000,"chr1",11393,1,3,4,8,"chr1",1,0.0112517580872011
"458","chr1.155830000.155835000","chr1.155900000.155905000",70000,50,7.554557e-24,155830000,155900000,155835000,155905000,"chr1",11431,16,43,40,99,"chr1",1,0.580168776371308
"459","chr1.155900000.155905000","chr1.156020000.156025000",120000,24,3.349354e-08,155900000,156020000,155905000,156025000,"chr1",11444,10,21,17,48,"chr1",1,0.135021097046413
"460","chr1.61565000.61570000","chr1.61720000.61725000",155000,15,0.001236846,61565000,61720000,61570000,61725000,"chr1",11447,5,8,8,21,"chr1",1,0.0369198312236287
"461","chr1.225770000.225775000","chr1.225825000.225830000",55000,21,0.00838272,225770000,225825000,225775000,225830000,"chr1",11473,0,5,2,7,"chr1",1,0.0172292545710267
"462","chr1.245040000.245045000","chr1.245150000.245155000",110000,16,0.00338394,245040000,245150000,245045000,245155000,"chr1",11492,2,2,6,10,"chr1",1,0.0187529301453352
"463","chr1.62435000.62440000","chr1.62510000.62515000",75000,20,0.001171509,62435000,62510000,62440000,62515000,"chr1",11513,0,1,1,2,"chr1",1,0.0046882325363338
"464","chr1.116360000.116365000","chr1.116535000.116540000",175000,13,0.005981441,116360000,116535000,116365000,116540000,"chr1",11573,2,3,0,5,"chr1",1,0.00761837787154243
"465","chr1.230205000.230210000","chr1.230250000.230255000",45000,25,0.001925343,230205000,230250000,230210000,230255000,"chr1",11628,0,2,1,3,"chr1",1,0.00879043600562588
"466","chr1.244230000.244235000","chr1.244430000.244435000",200000,16,4.450652e-05,244230000,244430000,244235000,244435000,"chr1",11671,1,10,9,20,"chr1",1,0.0375058602906704
"467","chr1.10110000.10115000","chr1.10160000.10165000",50000,34,2.722598e-08,10110000,10160000,10115000,10165000,"chr1",11723,7,17,16,40,"chr1",1,0.159399906235349
"468","chr1.210505000.210510000","chr1.211330000.211335000",825000,7,0.006051447,210505000,211330000,210510000,211335000,"chr1",11749,0,5,2,7,"chr1",1,0.00574308485700891
"469","chr1.156455000.156460000","chr1.156580000.156585000",125000,15,0.004449684,156455000,156580000,156460000,156585000,"chr1",11784,0,4,2,6,"chr1",1,0.0105485232067511
"470","chr1.28580000.28585000","chr1.28665000.28670000",85000,19,0.001070775,28580000,28665000,28585000,28670000,"chr1",11804,7,26,35,68,"chr1",1,0.151429910923582
"471","chr1.11155000.11160000","chr1.11270000.11275000",115000,18,0.0002518963,11155000,11270000,11160000,11275000,"chr1",11807,1,3,3,7,"chr1",1,0.0147679324894515
"472","chr1.100310000.100315000","chr1.100500000.100505000",190000,24,8.801951e-11,100310000,100500000,100315000,100505000,"chr1",11817,0,2,0,2,"chr1",1,0.00562587904360056
"473","chr1.160005000.160010000","chr1.160260000.160265000",255000,12,0.001902037,160005000,160260000,160010000,160265000,"chr1",11901,0,2,2,4,"chr1",1,0.00562587904360056
"474","chr1.10280000.10285000","chr1.10375000.10380000",95000,23,2.544721e-06,10280000,10375000,10285000,10380000,"chr1",11907,0,6,5,11,"chr1",1,0.0296530707923113
"475","chr1.42775000.42780000","chr1.42930000.42935000",155000,15,0.001236846,42775000,42930000,42780000,42935000,"chr1",11910,0,3,3,6,"chr1",1,0.0105485232067511
"476","chr1.201790000.201795000","chr1.201845000.201850000",55000,21,0.00838272,201790000,201845000,201795000,201850000,"chr1",11930,0,2,1,3,"chr1",1,0.00738396624472574
"477","chr1.10450000.10455000","chr1.10470000.10475000",20000,39,0.00129403,10450000,10470000,10455000,10475000,"chr1",11950,4,17,22,43,"chr1",1,0.196554149085795
"478","chr1.54760000.54765000","chr1.54790000.54795000",30000,39,3.363468e-06,54760000,54790000,54765000,54795000,"chr1",12024,3,5,9,17,"chr1",1,0.0777074542897328
"479","chr1.212230000.212235000","chr1.212515000.212520000",285000,21,8.804466e-11,212230000,212515000,212235000,212520000,"chr1",12095,0,1,4,5,"chr1",1,0.0123066104078762
"480","chr1.171880000.171885000","chr1.171955000.171960000",75000,23,4.328812e-05,171880000,171955000,171885000,171960000,"chr1",12129,0,0,5,5,"chr1",1,0.0134786685419597
"481","chr1.9980000.9985000","chr1.10210000.10215000",230000,13,0.001007514,9980000,10210000,9985000,10215000,"chr1",12133,6,16,10,32,"chr1",1,0.0487576183778715
"482","chr1.171985000.171990000","chr1.172395000.172400000",410000,10,0.002213559,171985000,172395000,171990000,172400000,"chr1",12145,0,1,1,2,"chr1",1,0.0023441162681669
"483","chr1.10125000.10130000","chr1.10210000.10215000",85000,23,9.882479e-06,10125000,10210000,10130000,10215000,"chr1",12164,2,7,3,12,"chr1",1,0.0323488045007032
"484","chr1.8460000.8465000","chr1.8725000.8730000",265000,11,0.005556037,8460000,8725000,8465000,8730000,"chr1",12166,1,11,15,27,"chr1",1,0.0348101265822785
"485","chr1.224305000.224310000","chr1.224510000.224515000",205000,18,1.527609e-06,224305000,224510000,224310000,224515000,"chr1",12193,11,11,8,30,"chr1",1,0.0632911392405063
"486","chr1.228790000.228795000","chr1.229520000.229525000",730000,8,0.002075175,228790000,229520000,228795000,229525000,"chr1",12260,0,2,1,3,"chr1",1,0.00281293952180028
"487","chr1.156600000.156605000","chr1.156625000.156630000",25000,43,6.060288e-06,156600000,156625000,156605000,156630000,"chr1",12315,7,12,25,44,"chr1",1,0.221753398968589
"488","chr1.201530000.201535000","chr1.201850000.201855000",320000,10,0.007480566,201530000,201850000,201535000,201855000,"chr1",12334,4,2,7,13,"chr1",1,0.0152367557430849
"489","chr1.43290000.43295000","chr1.43545000.43550000",255000,11,0.00691274,43290000,43545000,43295000,43550000,"chr1",12341,1,1,0,2,"chr1",1,0.00257852789498359
"490","chr1.153760000.153765000","chr1.153960000.153965000",200000,42,3.376041e-29,153760000,153960000,153765000,153965000,"chr1",12394,1,7,6,14,"chr1",1,0.0689170182841069
"491","chr1.110390000.110395000","chr1.110510000.110515000",120000,15,0.005618157,110390000,110510000,110395000,110515000,"chr1",12407,2,2,7,11,"chr1",1,0.0193389592123769
"492","chr1.160020000.160025000","chr1.160045000.160050000",25000,83,1.166961e-28,160020000,160045000,160025000,160050000,"chr1",12455,1,0,1,2,"chr1",1,0.0194561650257853
"493","chr1.24110000.24115000","chr1.24195000.24200000",85000,19,0.001070775,24110000,24195000,24115000,24200000,"chr1",12602,0,8,4,12,"chr1",1,0.0267229254571027
"494","chr1.155830000.155835000","chr1.156160000.156165000",330000,12,0.0003688879,155830000,156160000,155835000,156165000,"chr1",12644,5,6,4,15,"chr1",1,0.0210970464135021
"495","chr1.156355000.156360000","chr1.156385000.156390000",30000,53,2.895771e-13,156355000,156385000,156360000,156390000,"chr1",12705,1,1,1,3,"chr1",1,0.0186357243319269
"496","chr1.161165000.161170000","chr1.161285000.161290000",120000,18,0.0001811171,161165000,161285000,161170000,161290000,"chr1",12706,0,6,3,9,"chr1",1,0.0189873417721519
"497","chr1.244835000.244840000","chr1.244860000.244865000",25000,34,0.006227396,244835000,244860000,244840000,244865000,"chr1",12714,0,2,1,3,"chr1",1,0.0119549929676512
"498","chr1.26170000.26175000","chr1.26315000.26320000",145000,14,0.005764312,26170000,26315000,26175000,26320000,"chr1",12757,1,12,6,19,"chr1",1,0.0311767463666198
"499","chr1.204395000.204400000","chr1.204475000.204480000",80000,24,5.773374e-06,204395000,204475000,204400000,204480000,"chr1",12767,2,3,2,7,"chr1",1,0.019690576652602
"500","chr1.67465000.67470000","chr1.67610000.67615000",145000,16,0.0005758375,67465000,67610000,67470000,67615000,"chr1",12770,0,3,1,4,"chr1",1,0.00750117205813408
"501","chr1.26430000.26435000","chr1.26720000.26725000",290000,11,0.00333935,26430000,26720000,26435000,26725000,"chr1",12787,2,14,6,22,"chr1",1,0.0283638068448195
"502","chr1.161285000.161290000","chr1.161305000.161310000",20000,39,0.00129403,161285000,161305000,161290000,161310000,"chr1",12797,2,6,7,15,"chr1",1,0.0685654008438819
"503","chr1.233520000.233525000","chr1.234220000.234225000",700000,13,1.070224e-07,233520000,234220000,233525000,234225000,"chr1",12801,0,2,1,3,"chr1",1,0.00457102672292546
"504","chr1.23770000.23775000","chr1.23790000.23795000",20000,47,2.356529e-06,23770000,23790000,23775000,23795000,"chr1",12810,0,0,5,5,"chr1",1,0.0275433661509611
"505","chr1.153510000.153515000","chr1.153530000.153535000",20000,59,1.061711e-11,153510000,153530000,153515000,153535000,"chr1",12817,3,4,6,13,"chr1",1,0.0898968588842007
"506","chr1.178085000.178090000","chr1.178135000.178140000",50000,25,0.0006470043,178085000,178135000,178090000,178140000,"chr1",12873,1,1,0,2,"chr1",1,0.00586029067041725
"507","chr1.226405000.226410000","chr1.226465000.226470000",60000,23,0.0005784889,226405000,226465000,226410000,226470000,"chr1",12930,0,4,0,4,"chr1",1,0.0107829348335677
"508","chr1.224355000.224360000","chr1.224450000.224455000",95000,16,0.009001332,224355000,224450000,224360000,224455000,"chr1",12978,6,16,19,41,"chr1",1,0.0768870135958744
"509","chr1.150365000.150370000","chr1.150925000.150930000",560000,8,0.00838272,150365000,150925000,150370000,150930000,"chr1",12988,5,7,13,25,"chr1",1,0.023441162681669
"510","chr1.16185000.16190000","chr1.16240000.16245000",55000,22,0.003601062,16185000,16240000,16190000,16245000,"chr1",12989,6,9,12,27,"chr1",1,0.069620253164557
"511","chr1.87870000.87875000","chr1.87895000.87900000",25000,35,0.003277108,87870000,87895000,87875000,87900000,"chr1",13011,0,0,2,2,"chr1",1,0.00820440693858415
"512","chr1.10280000.10285000","chr1.10335000.10340000",55000,22,0.003601062,10280000,10335000,10285000,10340000,"chr1",13018,6,14,13,33,"chr1",1,0.0850914205344585
"513","chr1.9195000.9200000","chr1.9250000.9255000",55000,29,2.655108e-06,9195000,9250000,9200000,9255000,"chr1",13080,2,1,7,10,"chr1",1,0.0339896858884201
"514","chr1.234860000.234865000","chr1.235070000.235075000",210000,12,0.00640887,234860000,235070000,234865000,235075000,"chr1",13101,4,9,14,27,"chr1",1,0.0379746835443038
"515","chr1.202835000.202840000","chr1.202965000.202970000",130000,16,0.001164783,202835000,202965000,202840000,202970000,"chr1",13123,2,9,11,22,"chr1",1,0.0412564463197375
"516","chr1.54500000.54505000","chr1.55275000.55280000",775000,7,0.008222685,54500000,55275000,54505000,55280000,"chr1",13213,5,14,8,27,"chr1",1,0.0221518987341772
"517","chr1.156590000.156595000","chr1.156625000.156630000",35000,39,8.974978e-08,156590000,156625000,156595000,156630000,"chr1",13221,2,11,2,15,"chr1",1,0.0685654008438819
"518","chr1.155275000.155280000","chr1.155470000.155475000",195000,18,2.591232e-06,155275000,155470000,155280000,155475000,"chr1",13247,5,22,22,49,"chr1",1,0.10337552742616
"519","chr1.44840000.44845000","chr1.44900000.44905000",60000,26,2.391654e-05,44840000,44900000,44845000,44905000,"chr1",13250,9,21,21,51,"chr1",1,0.155414908579466
"520","chr1.10065000.10070000","chr1.10210000.10215000",145000,17,0.0001595167,10065000,10210000,10070000,10215000,"chr1",13271,6,16,13,35,"chr1",1,0.0697374589779653
"521","chr1.155725000.155730000","chr1.155860000.155865000",135000,14,0.008425895,155725000,155860000,155730000,155865000,"chr1",13306,8,35,31,74,"chr1",1,0.121425222691045
"522","chr1.201550000.201555000","chr1.201600000.201605000",50000,22,0.008541777,201550000,201600000,201555000,201605000,"chr1",13323,3,4,9,16,"chr1",1,0.0412564463197375
"523","chr1.161200000.161205000","chr1.161280000.161285000",80000,24,5.773374e-06,161200000,161280000,161205000,161285000,"chr1",13426,1,3,2,6,"chr1",1,0.0168776371308017
"524","chr1.156355000.156360000","chr1.156570000.156575000",215000,12,0.005556037,156355000,156570000,156360000,156575000,"chr1",13427,2,10,7,19,"chr1",1,0.0267229254571027
"525","chr1.197180000.197185000","chr1.197300000.197305000",120000,17,0.0006133453,197180000,197300000,197185000,197305000,"chr1",13452,1,6,6,13,"chr1",1,0.0259024847632443
"526","chr1.202155000.202160000","chr1.202685000.202690000",530000,11,8.040092e-05,202155000,202685000,202160000,202690000,"chr1",13569,2,6,12,20,"chr1",1,0.0257852789498359
"527","chr1.236265000.236270000","chr1.236750000.236755000",485000,10,0.0008196246,236265000,236750000,236270000,236755000,"chr1",13577,2,4,2,8,"chr1",1,0.00937646507266761
"528","chr1.100500000.100505000","chr1.101355000.101360000",855000,7,0.004999422,100500000,101355000,100505000,101360000,"chr1",13625,0,1,0,1,"chr1",1,0.000820440693858415
"529","chr1.204270000.204275000","chr1.204295000.204300000",25000,35,0.003277108,204270000,204295000,204275000,204300000,"chr1",13631,1,1,1,3,"chr1",1,0.0123066104078762
"530","chr1.179000000.179005000","chr1.179020000.179025000",20000,37,0.004733079,1.79e+08,179020000,179005000,179025000,"chr1",13639,0,1,0,1,"chr1",1,0.00433661509610877
"531","chr1.230175000.230180000","chr1.230400000.230405000",225000,12,0.004222767,230175000,230400000,230180000,230405000,"chr1",13648,0,4,3,7,"chr1",1,0.00984528832630099
"532","chr1.1720000.1725000","chr1.1775000.1780000",55000,26,7.710059e-05,1720000,1775000,1725000,1780000,"chr1",13716,6,6,17,29,"chr1",1,0.0883731833098922
"533","chr1.42035000.42040000","chr1.42360000.42365000",325000,11,0.001778335,42035000,42360000,42040000,42365000,"chr1",13733,0,0,5,5,"chr1",1,0.00644631973745898
"534","chr1.32750000.32755000","chr1.32945000.32950000",195000,12,0.009750873,32750000,32945000,32755000,32950000,"chr1",13749,2,9,5,16,"chr1",1,0.0225035161744023
"535","chr1.17335000.17340000","chr1.17375000.17380000",40000,29,0.0002333342,17335000,17375000,17340000,17380000,"chr1",13755,0,4,1,5,"chr1",1,0.01699484294421
"536","chr1.201530000.201535000","chr1.201700000.201705000",170000,25,6.997922e-11,201530000,201700000,201535000,201705000,"chr1",13768,4,2,7,13,"chr1",1,0.0380918893577121
"537","chr1.39570000.39575000","chr1.39650000.39655000",80000,18,0.004760983,39570000,39650000,39575000,39655000,"chr1",13778,0,3,4,7,"chr1",1,0.0147679324894515
"538","chr1.205655000.205660000","chr1.205710000.205715000",55000,25,0.0002173261,205655000,205710000,205660000,205715000,"chr1",13781,5,11,19,35,"chr1",1,0.102555086732302
"539","chr1.205255000.205260000","chr1.205280000.205285000",25000,54,6.997922e-11,205255000,205280000,205260000,205285000,"chr1",13789,0,2,1,3,"chr1",1,0.0189873417721519
"540","chr1.203625000.203630000","chr1.203670000.203675000",45000,25,0.001925343,203625000,203670000,203630000,203675000,"chr1",13802,0,0,3,3,"chr1",1,0.00879043600562588
"541","chr1.156390000.156395000","chr1.156410000.156415000",20000,62,3.109187e-13,156390000,156410000,156395000,156415000,"chr1",13811,0,3,3,6,"chr1",1,0.0436005625879044
"542","chr1.229230000.229235000","chr1.229275000.229280000",45000,23,0.009597206,229230000,229275000,229235000,229280000,"chr1",13820,0,0,2,2,"chr1",1,0.00539146741678387
"543","chr1.243595000.243600000","chr1.243900000.243905000",305000,10,0.009342944,243595000,243900000,243600000,243905000,"chr1",13833,0,1,0,1,"chr1",1,0.00117205813408345
"544","chr1.61565000.61570000","chr1.61695000.61700000",130000,15,0.003565021,61565000,61695000,61570000,61700000,"chr1",13848,5,8,8,21,"chr1",1,0.0369198312236287
"545","chr1.61720000.61725000","chr1.61740000.61745000",20000,59,1.061711e-11,61720000,61740000,61725000,61745000,"chr1",13884,6,18,11,35,"chr1",1,0.242030004688233
"546","chr1.153670000.153675000","chr1.153960000.153965000",290000,13,0.0001899761,153670000,153960000,153675000,153965000,"chr1",13909,1,7,6,14,"chr1",1,0.0213314580403188
"547","chr1.201530000.201535000","chr1.201550000.201555000",20000,67,6.11448e-16,201530000,201550000,201535000,201555000,"chr1",13943,4,2,7,13,"chr1",1,0.102086263478669
"548","chr1.204140000.204145000","chr1.204345000.204350000",205000,17,7.652881e-06,204140000,204345000,204145000,204350000,"chr1",13982,0,2,1,3,"chr1",1,0.0059774964838256
"549","chr1.165655000.165660000","chr1.165855000.165860000",200000,14,0.0007239502,165655000,165855000,165660000,165860000,"chr1",14000,3,5,5,13,"chr1",1,0.0213314580403188
"550","chr1.8625000.8630000","chr1.8875000.8880000",250000,15,2.763449e-05,8625000,8875000,8630000,8880000,"chr1",14009,5,10,18,33,"chr1",1,0.0580168776371308
"551","chr1.93345000.93350000","chr1.93445000.93450000",100000,19,0.0002491261,93345000,93445000,93350000,93450000,"chr1",14023,2,1,1,4,"chr1",1,0.00890764181903422
"552","chr1.153790000.153795000","chr1.153920000.153925000",130000,18,9.727861e-05,153790000,153920000,153795000,153925000,"chr1",14031,3,9,4,16,"chr1",1,0.0337552742616034
"553","chr1.243850000.243855000","chr1.243900000.243905000",50000,31,1.11328e-06,243850000,243900000,243855000,243905000,"chr1",14048,0,1,2,3,"chr1",1,0.0109001406469761
"554","chr1.153645000.153650000","chr1.153725000.153730000",80000,30,1.16278e-09,153645000,153725000,153650000,153730000,"chr1",14050,2,13,7,22,"chr1",1,0.0773558368495077
"555","chr1.171875000.171880000","chr1.171950000.171955000",75000,33,3.473301e-11,171875000,171950000,171880000,171955000,"chr1",14054,0,2,2,4,"chr1",1,0.0154711673699015
"556","chr1.11260000.11265000","chr1.11285000.11290000",25000,39,0.0001793477,11260000,11285000,11265000,11290000,"chr1",14067,4,16,15,35,"chr1",1,0.159985935302391
"557","chr1.8095000.8100000","chr1.8885000.8890000",790000,7,0.007471815,8095000,8885000,8100000,8890000,"chr1",14068,1,4,3,8,"chr1",1,0.00656352555086732
"558","chr1.212230000.212235000","chr1.212470000.212475000",240000,15,3.931393e-05,212230000,212470000,212235000,212475000,"chr1",14075,0,1,4,5,"chr1",1,0.00879043600562588
"559","chr1.233595000.233600000","chr1.233975000.233980000",380000,10,0.003291565,233595000,233975000,233600000,233980000,"chr1",14101,0,7,9,16,"chr1",1,0.0187529301453352
"560","chr1.153780000.153785000","chr1.153925000.153930000",145000,15,0.001879154,153780000,153925000,153785000,153930000,"chr1",14112,5,23,16,44,"chr1",1,0.0773558368495077
"561","chr1.19740000.19745000","chr1.19755000.19760000",15000,36,0.008632247,19740000,19755000,19745000,19760000,"chr1",14162,3,3,2,8,"chr1",1,0.0337552742616034
"562","chr1.27070000.27075000","chr1.27100000.27105000",30000,31,0.003104399,27070000,27100000,27075000,27105000,"chr1",14167,1,2,2,5,"chr1",1,0.0181669010782935
"563","chr1.182120000.182125000","chr1.182160000.182165000",40000,28,0.0005784227,182120000,182160000,182125000,182165000,"chr1",14170,0,4,2,6,"chr1",1,0.019690576652602
"564","chr1.8595000.8600000","chr1.8835000.8840000",240000,16,8.00102e-06,8595000,8835000,8600000,8840000,"chr1",14172,6,4,5,15,"chr1",1,0.0281293952180028
"565","chr1.10150000.10155000","chr1.10210000.10215000",60000,21,0.003722807,10150000,10210000,10155000,10215000,"chr1",14213,6,16,13,35,"chr1",1,0.0861462728551336
"566","chr1.212230000.212235000","chr1.212510000.212515000",280000,16,1.791283e-06,212230000,212510000,212235000,212515000,"chr1",14224,0,1,1,2,"chr1",1,0.00375058602906704
"567","chr1.7725000.7730000","chr1.7960000.7965000",235000,27,4.529529e-15,7725000,7960000,7730000,7965000,"chr1",14230,0,3,4,7,"chr1",1,0.0221518987341772
"568","chr1.46440000.46445000","chr1.46465000.46470000",25000,35,0.003277108,46440000,46465000,46445000,46470000,"chr1",14278,4,3,11,18,"chr1",1,0.0738396624472574
"569","chr1.155985000.155990000","chr1.156050000.156055000",65000,27,2.265923e-06,155985000,156050000,155990000,156055000,"chr1",14293,0,3,1,4,"chr1",1,0.0126582278481013
"570","chr1.202500000.202505000","chr1.202525000.202530000",25000,37,0.0008057805,202500000,202525000,202505000,202530000,"chr1",14387,0,4,0,4,"chr1",1,0.0173464603844351
"571","chr1.183735000.183740000","chr1.183805000.183810000",70000,19,0.00555421,183735000,183805000,183740000,183810000,"chr1",14406,3,1,5,9,"chr1",1,0.020042194092827
"572","chr1.65330000.65335000","chr1.65415000.65420000",85000,25,6.912566e-07,65330000,65415000,65335000,65420000,"chr1",14426,0,0,3,3,"chr1",1,0.00879043600562588
"573","chr1.66600000.66605000","chr1.66620000.66625000",20000,55,8.881329e-10,66600000,66620000,66605000,66625000,"chr1",14448,0,1,3,4,"chr1",1,0.0257852789498359
"574","chr1.183595000.183600000","chr1.183920000.183925000",325000,10,0.006950379,183595000,183920000,183600000,183925000,"chr1",14526,2,5,4,11,"chr1",1,0.012892639474918
"575","chr1.210505000.210510000","chr1.211355000.211360000",850000,8,0.0008494505,210505000,211355000,210510000,211360000,"chr1",14529,0,5,2,7,"chr1",1,0.00656352555086732
"576","chr1.27045000.27050000","chr1.27110000.27115000",65000,20,0.004296559,27045000,27110000,27050000,27115000,"chr1",14554,5,1,5,11,"chr1",1,0.0257852789498359
"577","chr1.155090000.155095000","chr1.155855000.155860000",765000,7,0.008632247,155090000,155855000,155095000,155860000,"chr1",14597,3,14,17,34,"chr1",1,0.0278949835911861
"578","chr1.9345000.9350000","chr1.9495000.9500000",150000,20,1.674205e-06,9345000,9495000,9350000,9500000,"chr1",14642,1,7,4,12,"chr1",1,0.0281293952180028
"579","chr1.9560000.9565000","chr1.9625000.9630000",65000,23,0.000229001,9560000,9625000,9565000,9630000,"chr1",14645,6,16,13,35,"chr1",1,0.0943506797937178
"580","chr1.43990000.43995000","chr1.44505000.44510000",515000,10,0.0005758375,43990000,44505000,43995000,44510000,"chr1",14680,0,5,3,8,"chr1",1,0.00937646507266761
"581","chr1.16155000.16160000","chr1.16300000.16305000",145000,29,3.794396e-13,16155000,16300000,16160000,16305000,"chr1",14697,5,13,10,28,"chr1",1,0.0951711204875762
"582","chr1.28435000.28440000","chr1.28535000.28540000",100000,24,3.257567e-07,28435000,28535000,28440000,28540000,"chr1",14777,2,12,7,21,"chr1",1,0.0590717299578059
"583","chr1.200620000.200625000","chr1.200735000.200740000",115000,16,0.002529278,200620000,200735000,200625000,200740000,"chr1",14796,1,9,4,14,"chr1",1,0.0262541022034693
"584","chr1.201500000.201505000","chr1.201530000.201535000",30000,50,1.404632e-11,201500000,201530000,201505000,201535000,"chr1",14844,2,2,3,7,"chr1",1,0.0410220346929208
"585","chr1.42920000.42925000","chr1.43380000.43385000",460000,9,0.005175406,42920000,43380000,42925000,43385000,"chr1",15049,2,0,2,4,"chr1",1,0.00421940928270042
"586","chr1.153645000.153650000","chr1.153955000.153960000",310000,17,1.017851e-07,153645000,153955000,153650000,153960000,"chr1",15086,2,5,7,14,"chr1",1,0.0278949835911861
"587","chr1.17415000.17420000","chr1.17435000.17440000",20000,62,3.109187e-13,17415000,17435000,17420000,17440000,"chr1",15116,0,7,3,10,"chr1",1,0.0726676043131739
"588","chr1.205325000.205330000","chr1.205520000.205525000",195000,12,0.009750873,205325000,205520000,205330000,205525000,"chr1",15122,0,3,2,5,"chr1",1,0.0070323488045007
"589","chr1.20705000.20710000","chr1.20815000.20820000",110000,18,0.0003587972,20705000,20815000,20710000,20820000,"chr1",15150,12,17,16,45,"chr1",1,0.0949367088607595
"590","chr1.156065000.156070000","chr1.156095000.156100000",30000,75,6.911622e-28,156065000,156095000,156070000,156100000,"chr1",15153,1,14,4,19,"chr1",1,0.167018284106892
"591","chr1.153510000.153515000","chr1.153645000.153650000",135000,16,0.0009028165,153510000,153645000,153515000,153650000,"chr1",15205,2,4,7,13,"chr1",1,0.0243788091889358
"592","chr1.203115000.203120000","chr1.203235000.203240000",120000,16,0.001909676,203115000,203235000,203120000,203240000,"chr1",15254,0,6,0,6,"chr1",1,0.0112517580872011
"593","chr1.160025000.160030000","chr1.160045000.160050000",20000,38,0.00252151,160025000,160045000,160030000,160050000,"chr1",15316,1,0,1,2,"chr1",1,0.00890764181903422
"594","chr1.150185000.150190000","chr1.150285000.150290000",100000,21,2.069424e-05,150185000,150285000,150190000,150290000,"chr1",15340,3,14,7,24,"chr1",1,0.0590717299578059
"595","chr1.244755000.244760000","chr1.245195000.245200000",440000,13,8.889787e-06,244755000,245195000,244760000,245200000,"chr1",15379,0,4,3,7,"chr1",1,0.0106657290201594
"596","chr1.86840000.86845000","chr1.87175000.87180000",335000,11,0.0015078,86840000,87175000,86845000,87180000,"chr1",15439,0,0,6,6,"chr1",1,0.00773558368495077
"597","chr1.183630000.183635000","chr1.183875000.183880000",245000,11,0.008599339,183630000,183875000,183635000,183880000,"chr1",15454,0,1,1,2,"chr1",1,0.00257852789498359
"598","chr1.149935000.149940000","chr1.150160000.150165000",225000,13,0.0011796,149935000,150160000,149940000,150165000,"chr1",15464,0,2,4,6,"chr1",1,0.00914205344585091
"599","chr1.16960000.16965000","chr1.17435000.17440000",475000,10,0.000940042,16960000,17435000,16965000,17440000,"chr1",15476,0,7,3,10,"chr1",1,0.0117205813408345
"600","chr1.6970000.6975000","chr1.7665000.7670000",695000,8,0.002731772,6970000,7665000,6975000,7670000,"chr1",15486,0,4,2,6,"chr1",1,0.00562587904360056
"601","chr1.28550000.28555000","chr1.28830000.28835000",280000,12,0.001052248,28550000,28830000,28555000,28835000,"chr1",15528,2,17,19,38,"chr1",1,0.0534458509142053
"602","chr1.228830000.228835000","chr1.229665000.229670000",835000,7,0.005667308,228830000,229665000,228835000,229670000,"chr1",15572,0,1,0,1,"chr1",1,0.000820440693858415
"603","chr1.151255000.151260000","chr1.151295000.151300000",40000,52,3.155193e-17,151255000,151295000,151260000,151300000,"chr1",15586,2,23,23,48,"chr1",1,0.292545710267229
"604","chr1.77680000.77685000","chr1.78000000.78005000",320000,23,2.098122e-13,77680000,7.8e+07,77685000,78005000,"chr1",15595,1,5,4,10,"chr1",1,0.0269573370839194
"605","chr1.92775000.92780000","chr1.93060000.93065000",285000,14,4.473238e-05,92775000,93060000,92780000,93065000,"chr1",15656,2,20,30,52,"chr1",1,0.0853258321612752
"606","chr1.25785000.25790000","chr1.25950000.25955000",165000,18,1.347837e-05,25785000,25950000,25790000,25955000,"chr1",15677,4,15,11,30,"chr1",1,0.0632911392405063
"607","chr1.183610000.183615000","chr1.183875000.183880000",265000,24,4.173635e-13,183610000,183875000,183615000,183880000,"chr1",15681,1,2,3,6,"chr1",1,0.0168776371308017
"608","chr1.162035000.162040000","chr1.162215000.162220000",180000,19,1.218337e-06,162035000,162215000,162040000,162220000,"chr1",15690,2,5,5,12,"chr1",1,0.0267229254571027
"609","chr1.179000000.179005000","chr1.179025000.179030000",25000,37,0.0008057805,1.79e+08,179025000,179005000,179030000,"chr1",15755,0,4,2,6,"chr1",1,0.0260196905766526
"610","chr1.45490000.45495000","chr1.45910000.45915000",420000,9,0.008177867,45490000,45910000,45495000,45915000,"chr1",15760,3,3,5,11,"chr1",1,0.0116033755274262
"611","chr1.26225000.26230000","chr1.26315000.26320000",90000,25,3.161766e-07,26225000,26315000,26230000,26320000,"chr1",15764,6,10,15,31,"chr1",1,0.0908345053914674
"612","chr1.15885000.15890000","chr1.15975000.15980000",90000,17,0.005066586,15885000,15975000,15890000,15980000,"chr1",15789,4,8,13,25,"chr1",1,0.0498124706985466
"613","chr1.155270000.155275000","chr1.155470000.155475000",200000,13,0.00261335,155270000,155470000,155275000,155475000,"chr1",15801,5,13,8,26,"chr1",1,0.0396155649320206
"614","chr1.182050000.182055000","chr1.182110000.182115000",60000,44,8.704875e-17,182050000,182110000,182055000,182115000,"chr1",15802,3,10,3,16,"chr1",1,0.0825128926394749
"615","chr1.9345000.9350000","chr1.9540000.9545000",195000,15,0.0002307636,9345000,9540000,9350000,9545000,"chr1",15815,1,7,4,12,"chr1",1,0.0210970464135021
"616","chr1.39650000.39655000","chr1.39685000.39690000",35000,31,0.0002882227,39650000,39685000,39655000,39690000,"chr1",15834,0,3,4,7,"chr1",1,0.0254336615096109
"617","chr1.205255000.205260000","chr1.205285000.205290000",30000,55,1.932068e-14,205255000,205285000,205260000,205290000,"chr1",15900,0,2,1,3,"chr1",1,0.0193389592123769
"618","chr1.64155000.64160000","chr1.64630000.64635000",475000,11,0.0001798882,64155000,64630000,64160000,64635000,"chr1",15924,3,5,2,10,"chr1",1,0.012892639474918
"619","chr1.21585000.21590000","chr1.21635000.21640000",50000,22,0.008541777,21585000,21635000,21590000,21640000,"chr1",15955,1,9,1,11,"chr1",1,0.0283638068448195
"620","chr1.173670000.173675000","chr1.173780000.173785000",110000,17,0.00115434,173670000,173780000,173675000,173785000,"chr1",15970,2,4,2,8,"chr1",1,0.0159399906235349
"621","chr1.197200000.197205000","chr1.197300000.197305000",100000,19,0.0002491261,197200000,197300000,197205000,197305000,"chr1",15981,0,5,1,6,"chr1",1,0.0133614627285513
"622","chr1.8435000.8440000","chr1.8595000.8600000",160000,16,0.0002827585,8435000,8595000,8440000,8600000,"chr1",16010,1,4,3,8,"chr1",1,0.0150023441162682
"623","chr1.1615000.1620000","chr1.1825000.1830000",210000,14,0.0005117364,1615000,1825000,1620000,1830000,"chr1",16014,0,0,2,2,"chr1",1,0.00328176277543366
"624","chr1.15665000.15670000","chr1.15700000.15705000",35000,30,0.0006685884,15665000,15700000,15670000,15705000,"chr1",16026,2,6,4,12,"chr1",1,0.0421940928270042
"625","chr1.40625000.40630000","chr1.40860000.40865000",235000,22,1.797162e-10,40625000,40860000,40630000,40865000,"chr1",16044,2,1,4,7,"chr1",1,0.0180496952648851
"626","chr1.10000000.10005000","chr1.10105000.10110000",105000,19,0.0001598251,1e+07,10105000,10005000,10110000,"chr1",16076,0,7,5,12,"chr1",1,0.0267229254571027
"627","chr1.39570000.39575000","chr1.39720000.39725000",150000,19,7.518871e-06,39570000,39720000,39575000,39725000,"chr1",16082,2,5,6,13,"chr1",1,0.0289498359118612
"628","chr1.155070000.155075000","chr1.155140000.155145000",70000,28,1.909902e-07,155070000,155140000,155075000,155145000,"chr1",16106,4,13,21,38,"chr1",1,0.124706985466479
"629","chr1.204185000.204190000","chr1.204330000.204335000",145000,20,2.347232e-06,204185000,204330000,204190000,204335000,"chr1",16109,2,12,9,23,"chr1",1,0.0539146741678387
"630","chr1.116710000.116715000","chr1.116925000.116930000",215000,17,4.73899e-06,116710000,116925000,116715000,116930000,"chr1",16209,0,1,1,2,"chr1",1,0.00398499765588373
"631","chr1.10055000.10060000","chr1.10475000.10480000",420000,9,0.008177867,10055000,10475000,10060000,10480000,"chr1",16242,7,11,24,42,"chr1",1,0.0443037974683544
"632","chr1.61565000.61570000","chr1.61740000.61745000",175000,14,0.001856842,61565000,61740000,61570000,61745000,"chr1",16288,5,8,8,21,"chr1",1,0.0344585091420534
"633","chr1.155195000.155200000","chr1.155275000.155280000",80000,20,0.0006470043,155195000,155275000,155200000,155280000,"chr1",16296,0,2,10,12,"chr1",1,0.0281293952180028
"634","chr1.16155000.16160000","chr1.16245000.16250000",90000,18,0.001865958,16155000,16245000,16160000,16250000,"chr1",16305,3,9,2,14,"chr1",1,0.029535864978903
"635","chr1.94525000.94530000","chr1.94805000.94810000",280000,15,9.976584e-06,94525000,94805000,94530000,94810000,"chr1",16311,0,3,0,3,"chr1",1,0.00527426160337553
"636","chr1.16870000.16875000","chr1.17045000.17050000",175000,18,7.719683e-06,16870000,17045000,16875000,17050000,"chr1",16382,1,2,2,5,"chr1",1,0.0105485232067511
"637","chr1.21195000.21200000","chr1.21360000.21365000",165000,13,0.00838272,21195000,21360000,21200000,21365000,"chr1",16388,1,7,6,14,"chr1",1,0.0213314580403188
"638","chr1.227430000.227435000","chr1.227450000.227455000",20000,40,0.0006470043,227430000,227450000,227435000,227455000,"chr1",16393,4,5,9,18,"chr1",1,0.0843881856540084
"639","chr1.183830000.183835000","chr1.183875000.183880000",45000,30,1.636532e-05,183830000,183875000,183835000,183880000,"chr1",16410,2,1,0,3,"chr1",1,0.0105485232067511
"640","chr1.204380000.204385000","chr1.204465000.204470000",85000,26,1.686423e-07,204380000,204465000,204385000,204470000,"chr1",16440,0,2,2,4,"chr1",1,0.0121894045944679
"641","chr1.234860000.234865000","chr1.234985000.234990000",125000,19,3.530743e-05,234860000,234985000,234865000,234990000,"chr1",16565,3,1,6,10,"chr1",1,0.0222691045475856
"642","chr1.183620000.183625000","chr1.184190000.184195000",570000,10,0.0002882227,183620000,184190000,183625000,184195000,"chr1",16601,0,3,1,4,"chr1",1,0.0046882325363338
"643","chr1.205345000.205350000","chr1.205590000.205595000",245000,16,6.525218e-06,205345000,205590000,205350000,205595000,"chr1",16667,1,5,9,15,"chr1",1,0.0281293952180028
"644","chr1.26430000.26435000","chr1.26600000.26605000",170000,14,0.002238629,26430000,26600000,26435000,26605000,"chr1",16738,3,14,6,23,"chr1",1,0.0377402719174871
"645","chr1.9345000.9350000","chr1.9625000.9630000",280000,11,0.004063209,9345000,9625000,9350000,9630000,"chr1",16774,1,7,4,12,"chr1",1,0.0154711673699015
"646","chr1.21295000.21300000","chr1.21505000.21510000",210000,13,0.001879154,21295000,21505000,21300000,21510000,"chr1",16777,4,7,17,28,"chr1",1,0.0426629160806376
"647","chr1.207485000.207490000","chr1.207575000.207580000",90000,22,1.823634e-05,207485000,207575000,207490000,207580000,"chr1",16822,1,6,10,17,"chr1",1,0.0438349742147211
"648","chr1.204940000.204945000","chr1.205060000.205065000",120000,15,0.005618157,204940000,205060000,204945000,205065000,"chr1",16844,0,4,0,4,"chr1",1,0.0070323488045007
"649","chr1.201505000.201510000","chr1.201740000.201745000",235000,16,9.838617e-06,201505000,201740000,201510000,201745000,"chr1",16903,1,1,0,2,"chr1",1,0.00375058602906704
"650","chr1.39575000.39580000","chr1.39735000.39740000",160000,15,0.001000244,39575000,39735000,39580000,39740000,"chr1",17006,1,10,9,20,"chr1",1,0.0351617440225035
"651","chr1.40370000.40375000","chr1.40420000.40425000",50000,23,0.003767084,40370000,40420000,40375000,40425000,"chr1",17010,1,1,3,5,"chr1",1,0.0134786685419597
"652","chr1.234745000.234750000","chr1.235070000.235075000",325000,12,0.0004079793,234745000,235070000,234750000,235075000,"chr1",17062,5,7,7,19,"chr1",1,0.0267229254571027
"653","chr1.155860000.155865000","chr1.155895000.155900000",35000,27,0.00691274,155860000,155895000,155865000,155900000,"chr1",17067,7,25,35,67,"chr1",1,0.212025316455696
"654","chr1.40280000.40285000","chr1.40370000.40375000",90000,24,1.270691e-06,40280000,40370000,40285000,40375000,"chr1",17229,5,13,14,32,"chr1",1,0.090014064697609
"655","chr1.204415000.204420000","chr1.204435000.204440000",20000,41,0.0003129283,204415000,204435000,204420000,204440000,"chr1",17275,6,3,12,21,"chr1",1,0.100914205344585
"656","chr1.201550000.201555000","chr1.201740000.201745000",190000,14,0.001061267,201550000,201740000,201555000,201745000,"chr1",17280,1,3,3,7,"chr1",1,0.0114861697140178
"657","chr1.229410000.229415000","chr1.229510000.229515000",100000,16,0.006415049,229410000,229510000,229415000,229515000,"chr1",17293,0,13,11,24,"chr1",1,0.0450070323488045
"658","chr1.21395000.21400000","chr1.21505000.21510000",110000,24,9.680725e-08,21395000,21505000,21400000,21510000,"chr1",17359,0,10,10,20,"chr1",1,0.0562587904360056
"659","chr1.162035000.162040000","chr1.162245000.162250000",210000,15,0.0001254468,162035000,162245000,162040000,162250000,"chr1",17378,2,5,5,12,"chr1",1,0.0210970464135021
"660","chr1.42360000.42365000","chr1.42380000.42385000",20000,41,0.0003129283,42360000,42380000,42365000,42385000,"chr1",17394,0,2,0,2,"chr1",1,0.00961087669948429
"661","chr1.42035000.42040000","chr1.42175000.42180000",140000,18,5.556461e-05,42035000,42175000,42040000,42180000,"chr1",17429,0,0,1,1,"chr1",1,0.00210970464135021
"662","chr1.153605000.153610000","chr1.153960000.153965000",355000,14,8.00102e-06,153605000,153960000,153610000,153965000,"chr1",17559,0,7,5,12,"chr1",1,0.019690576652602
"663","chr1.94525000.94530000","chr1.94820000.94825000",295000,23,7.091019e-13,94525000,94820000,94530000,94825000,"chr1",17560,0,3,0,3,"chr1",1,0.00808720112517581
"664","chr1.43365000.43370000","chr1.43545000.43550000",180000,18,5.857974e-06,43365000,43545000,43370000,43550000,"chr1",17574,0,1,0,1,"chr1",1,0.00210970464135021
"665","chr1.8525000.8530000","chr1.8630000.8635000",105000,18,0.0005300991,8525000,8630000,8530000,8635000,"chr1",17655,0,0,3,3,"chr1",1,0.00632911392405063
"666","chr1.230205000.230210000","chr1.230325000.230330000",120000,22,7.343546e-07,230205000,230325000,230210000,230330000,"chr1",17715,3,4,4,11,"chr1",1,0.0283638068448195
"667","chr1.173430000.173435000","chr1.173780000.173785000",350000,10,0.00486492,173430000,173780000,173435000,173785000,"chr1",17732,1,1,1,3,"chr1",1,0.00351617440225035
"668","chr1.16930000.16935000","chr1.17055000.17060000",125000,16,0.001500618,16930000,17055000,16935000,17060000,"chr1",17739,4,14,14,32,"chr1",1,0.0600093764650727
"669","chr1.153645000.153650000","chr1.153925000.153930000",280000,17,2.944382e-07,153645000,153925000,153650000,153930000,"chr1",17778,2,13,7,22,"chr1",1,0.0438349742147211
"670","chr1.211020000.211025000","chr1.211305000.211310000",285000,19,5.280374e-09,211020000,211305000,211025000,211310000,"chr1",17840,0,2,2,4,"chr1",1,0.00890764181903422
"671","chr1.150905000.150910000","chr1.150970000.150975000",65000,20,0.004296559,150905000,150970000,150910000,150975000,"chr1",17855,4,0,3,7,"chr1",1,0.0164088138771683
"672","chr1.201505000.201510000","chr1.201845000.201850000",340000,11,0.001394873,201505000,201845000,201510000,201850000,"chr1",17861,1,1,0,2,"chr1",1,0.00257852789498359
"673","chr1.39745000.39750000","chr1.39850000.39855000",105000,17,0.001605476,39745000,39850000,39750000,39855000,"chr1",17936,2,19,18,39,"chr1",1,0.0777074542897328
"674","chr1.42035000.42040000","chr1.42330000.42335000",295000,11,0.00307826,42035000,42330000,42040000,42335000,"chr1",17940,0,0,5,5,"chr1",1,0.00644631973745898
"675","chr1.150300000.150305000","chr1.150560000.150565000",260000,11,0.006197041,150300000,150560000,150305000,150565000,"chr1",17957,2,0,2,4,"chr1",1,0.00515705578996718
"676","chr1.28830000.28835000","chr1.28910000.28915000",80000,26,4.035206e-07,28830000,28910000,28835000,28915000,"chr1",18006,3,12,10,25,"chr1",1,0.0761837787154243
"677","chr1.150505000.150510000","chr1.150965000.150970000",460000,9,0.005175406,150505000,150965000,150510000,150970000,"chr1",18009,0,1,4,5,"chr1",1,0.00527426160337553
"678","chr1.161165000.161170000","chr1.161355000.161360000",190000,17,1.606819e-05,161165000,161355000,161170000,161360000,"chr1",18018,0,6,3,9,"chr1",1,0.0179324894514768
"679","chr1.229555000.229560000","chr1.229575000.229580000",20000,38,0.00252151,229555000,229575000,229560000,229580000,"chr1",18030,4,13,13,30,"chr1",1,0.133614627285513
"680","chr1.89720000.89725000","chr1.89740000.89745000",20000,52,2.001773e-08,89720000,89740000,89725000,89745000,"chr1",18105,0,0,3,3,"chr1",1,0.0182841068917018
"681","chr1.155275000.155280000","chr1.156050000.156055000",775000,7,0.008222685,155275000,156050000,155280000,156055000,"chr1",18147,0,3,1,4,"chr1",1,0.00328176277543366
"682","chr1.205630000.205635000","chr1.205675000.205680000",45000,36,1.463489e-08,205630000,205675000,205635000,205680000,"chr1",18164,0,5,1,6,"chr1",1,0.0253164556962025
"683","chr1.230205000.230210000","chr1.230365000.230370000",160000,14,0.003280797,230205000,230365000,230210000,230370000,"chr1",18176,2,2,3,7,"chr1",1,0.0114861697140178
"684","chr1.234755000.234760000","chr1.235090000.235095000",335000,11,0.0015078,234755000,235090000,234760000,235095000,"chr1",18191,0,1,2,3,"chr1",1,0.00386779184247539
"685","chr1.10495000.10500000","chr1.11070000.11075000",575000,8,0.007282493,10495000,11070000,10500000,11075000,"chr1",18199,2,2,2,6,"chr1",1,0.00562587904360056
"686","chr1.40610000.40615000","chr1.40920000.40925000",310000,13,0.0001182238,40610000,40920000,40615000,40925000,"chr1",18251,2,9,8,19,"chr1",1,0.0289498359118612
"687","chr1.151165000.151170000","chr1.151250000.151255000",85000,22,3.458094e-05,151165000,151250000,151170000,151255000,"chr1",18280,5,17,13,35,"chr1",1,0.0902484763244257
"688","chr1.178060000.178065000","chr1.178085000.178090000",25000,34,0.006227396,178060000,178085000,178065000,178090000,"chr1",18298,3,1,4,8,"chr1",1,0.0318799812470699
"689","chr1.66640000.66645000","chr1.66690000.66695000",50000,26,0.0002506014,66640000,66690000,66645000,66695000,"chr1",18321,1,5,2,8,"chr1",1,0.0243788091889358
"690","chr1.31295000.31300000","chr1.31370000.31375000",75000,19,0.003125299,31295000,31370000,31300000,31375000,"chr1",18324,2,2,3,7,"chr1",1,0.0155883731833099
"691","chr1.51950000.51955000","chr1.51990000.51995000",40000,28,0.0005784227,51950000,51990000,51955000,51995000,"chr1",18327,1,4,8,13,"chr1",1,0.0426629160806376
"692","chr1.155215000.155220000","chr1.155275000.155280000",60000,24,0.0002105081,155215000,155275000,155220000,155280000,"chr1",18339,2,1,0,3,"chr1",1,0.00843881856540084
"693","chr1.17050000.17055000","chr1.17120000.17125000",70000,26,2.649753e-06,17050000,17120000,17055000,17125000,"chr1",18342,0,2,1,3,"chr1",1,0.00914205344585091
"694","chr1.228865000.228870000","chr1.229075000.229080000",210000,18,1.175252e-06,228865000,229075000,228870000,229080000,"chr1",18355,5,10,8,23,"chr1",1,0.0485232067510548
"695","chr1.35770000.35775000","chr1.35810000.35815000",40000,29,0.0002333342,35770000,35810000,35775000,35815000,"chr1",18464,6,22,12,40,"chr1",1,0.13595874355368
"696","chr1.67010000.67015000","chr1.67130000.67135000",120000,15,0.005618157,67010000,67130000,67015000,67135000,"chr1",18485,3,4,3,10,"chr1",1,0.0175808720112518
"697","chr1.243900000.243905000","chr1.244430000.244435000",530000,11,8.040092e-05,243900000,244430000,243905000,244435000,"chr1",18507,0,1,2,3,"chr1",1,0.00386779184247539
"698","chr1.21255000.21260000","chr1.21330000.21335000",75000,18,0.007861949,21255000,21330000,21260000,21335000,"chr1",18574,4,8,6,18,"chr1",1,0.0379746835443038
"699","chr1.177065000.177070000","chr1.177830000.177835000",765000,7,0.008632247,177065000,177830000,177070000,177835000,"chr1",18623,0,1,0,1,"chr1",1,0.000820440693858415
"700","chr1.8055000.8060000","chr1.8710000.8715000",655000,8,0.003722807,8055000,8710000,8060000,8715000,"chr1",18641,1,15,11,27,"chr1",1,0.0253164556962025
"701","chr1.203260000.203265000","chr1.203290000.203295000",30000,30,0.006218027,203260000,203290000,203265000,203295000,"chr1",18657,1,5,4,10,"chr1",1,0.0351617440225035
"702","chr1.42745000.42750000","chr1.42785000.42790000",40000,25,0.006608083,42745000,42785000,42750000,42790000,"chr1",18660,1,3,1,5,"chr1",1,0.0146507266760431
"703","chr1.43660000.43665000","chr1.43950000.43955000",290000,12,0.0008248102,43660000,43950000,43665000,43955000,"chr1",18696,0,3,1,4,"chr1",1,0.00562587904360056
"704","chr1.93550000.93555000","chr1.93640000.93645000",90000,23,4.954213e-06,93550000,93640000,93555000,93645000,"chr1",18713,0,4,1,5,"chr1",1,0.0134786685419597
"705","chr1.243340000.243345000","chr1.243475000.243480000",135000,21,1.011018e-06,243340000,243475000,243345000,243480000,"chr1",18731,0,1,1,2,"chr1",1,0.00492264416315049
"706","chr1.151045000.151050000","chr1.151155000.151160000",110000,18,0.0003587972,151045000,151155000,151050000,151160000,"chr1",18733,5,5,9,19,"chr1",1,0.040084388185654
"707","chr1.9345000.9350000","chr1.9490000.9495000",145000,25,6.351304e-10,9345000,9490000,9350000,9495000,"chr1",18767,1,7,4,12,"chr1",1,0.0351617440225035
"708","chr1.201510000.201515000","chr1.201740000.201745000",230000,12,0.003666933,201510000,201740000,201515000,201745000,"chr1",18776,1,3,2,6,"chr1",1,0.00843881856540084
"709","chr1.16120000.16125000","chr1.16240000.16245000",120000,19,5.003204e-05,16120000,16240000,16125000,16245000,"chr1",18822,1,3,2,6,"chr1",1,0.0133614627285513
"710","chr1.230770000.230775000","chr1.230910000.230915000",140000,24,5.535288e-09,230770000,230910000,230775000,230915000,"chr1",18877,2,2,7,11,"chr1",1,0.0309423347398031
"711","chr1.205180000.205185000","chr1.205195000.205200000",15000,37,0.004733079,205180000,205195000,205185000,205200000,"chr1",18879,3,17,7,27,"chr1",1,0.117088607594937
"712","chr1.151535000.151540000","chr1.151575000.151580000",40000,27,0.001354847,151535000,151575000,151540000,151580000,"chr1",18884,0,2,1,3,"chr1",1,0.00949367088607595
"713","chr1.64160000.64165000","chr1.64630000.64635000",470000,13,5.08087e-06,64160000,64630000,64165000,64635000,"chr1",18927,1,2,0,3,"chr1",1,0.00457102672292546
"714","chr1.155250000.155255000","chr1.155275000.155280000",25000,36,0.001641975,155250000,155275000,155255000,155280000,"chr1",18945,2,21,12,35,"chr1",1,0.147679324894515
"715","chr1.201545000.201550000","chr1.201600000.201605000",55000,22,0.003601062,201545000,201600000,201550000,201605000,"chr1",19044,3,8,9,20,"chr1",1,0.0515705578996718
"716","chr1.32335000.32340000","chr1.32360000.32365000",25000,34,0.006227396,32335000,32360000,32340000,32365000,"chr1",19079,2,0,6,8,"chr1",1,0.0318799812470699
"717","chr1.156485000.156490000","chr1.156580000.156585000",95000,19,0.0003929148,156485000,156580000,156490000,156585000,"chr1",19157,0,4,2,6,"chr1",1,0.0133614627285513
"718","chr1.18940000.18945000","chr1.19135000.19140000",195000,14,0.0008677022,18940000,19135000,18945000,19140000,"chr1",19204,2,0,1,3,"chr1",1,0.00492264416315049
"719","chr1.203640000.203645000","chr1.203670000.203675000",30000,39,3.363468e-06,203640000,203670000,203645000,203675000,"chr1",19260,3,8,4,15,"chr1",1,0.0685654008438819
"720","chr1.156445000.156450000","chr1.156570000.156575000",125000,30,5.582297e-13,156445000,156570000,156450000,156575000,"chr1",19261,2,10,7,19,"chr1",1,0.0668073136427567
"721","chr1.42920000.42925000","chr1.43145000.43150000",225000,12,0.004222767,42920000,43145000,42925000,43150000,"chr1",19267,0,2,1,3,"chr1",1,0.00421940928270042
"722","chr1.9925000.9930000","chr1.9950000.9955000",25000,34,0.006227396,9925000,9950000,9930000,9955000,"chr1",19320,2,24,19,45,"chr1",1,0.179324894514768
"723","chr1.21310000.21315000","chr1.21505000.21510000",195000,12,0.009750873,21310000,21505000,21315000,21510000,"chr1",19371,4,21,21,46,"chr1",1,0.0646976090014065
"724","chr1.165695000.165700000","chr1.165855000.165860000",160000,14,0.003280797,165695000,165855000,165700000,165860000,"chr1",19382,3,5,5,13,"chr1",1,0.0213314580403188
"725","chr1.16215000.16220000","chr1.16640000.16645000",425000,10,0.001810359,16215000,16640000,16220000,16645000,"chr1",19395,0,1,1,2,"chr1",1,0.0023441162681669
"726","chr1.228790000.228795000","chr1.228860000.228865000",70000,22,0.0002882227,228790000,228860000,228795000,228865000,"chr1",19413,0,2,1,3,"chr1",1,0.00773558368495077
"727","chr1.43950000.43955000","chr1.44530000.44535000",580000,8,0.006962679,43950000,44530000,43955000,44535000,"chr1",19440,0,3,1,4,"chr1",1,0.00375058602906704
"728","chr1.161175000.161180000","chr1.161280000.161285000",105000,30,9.777136e-12,161175000,161280000,161180000,161285000,"chr1",19470,2,11,12,25,"chr1",1,0.0879043600562588
"729","chr1.77680000.77685000","chr1.77975000.77980000",295000,14,3.412721e-05,77680000,77975000,77685000,77980000,"chr1",19492,0,5,4,9,"chr1",1,0.0147679324894515
"730","chr1.84620000.84625000","chr1.84740000.84745000",120000,15,0.005618157,84620000,84740000,84625000,84745000,"chr1",19618,1,2,3,6,"chr1",1,0.0105485232067511
"731","chr1.27045000.27050000","chr1.27095000.27100000",50000,24,0.001605476,27045000,27095000,27050000,27100000,"chr1",19632,2,5,7,14,"chr1",1,0.0393811533052039
"732","chr1.201705000.201710000","chr1.201740000.201745000",35000,49,2.748878e-13,201705000,201740000,201710000,201745000,"chr1",19673,1,3,3,7,"chr1",1,0.0402015939990624
"733","chr1.204255000.204260000","chr1.204300000.204305000",45000,25,0.001925343,204255000,204300000,204260000,204305000,"chr1",19705,1,2,3,6,"chr1",1,0.0175808720112518
"734","chr1.39685000.39690000","chr1.39850000.39855000",165000,16,0.0002232684,39685000,39850000,39690000,39855000,"chr1",19734,8,14,21,43,"chr1",1,0.0806375996249414
"735","chr1.24150000.24155000","chr1.24185000.24190000",35000,27,0.00691274,24150000,24185000,24155000,24190000,"chr1",19741,0,5,2,7,"chr1",1,0.0221518987341772
"736","chr1.14435000.14440000","chr1.14685000.14690000",250000,13,0.000560038,14435000,14685000,14440000,14690000,"chr1",19747,0,3,1,4,"chr1",1,0.00609470229723394
"737","chr1.9345000.9350000","chr1.9385000.9390000",40000,25,0.006608083,9345000,9385000,9350000,9390000,"chr1",19802,1,7,4,12,"chr1",1,0.0351617440225035
"738","chr1.230780000.230785000","chr1.231355000.231360000",575000,8,0.007282493,230780000,231355000,230785000,231360000,"chr1",19821,0,4,3,7,"chr1",1,0.00656352555086732
"739","chr1.160165000.160170000","chr1.161095000.161100000",930000,7,0.00310932,160165000,161095000,160170000,161100000,"chr1",19827,0,5,5,10,"chr1",1,0.00820440693858415
"740","chr1.153760000.153765000","chr1.153920000.153925000",160000,16,0.0002827585,153760000,153920000,153765000,153925000,"chr1",19833,1,11,8,20,"chr1",1,0.0375058602906704
"741","chr1.228380000.228385000","chr1.228660000.228665000",280000,11,0.004063209,228380000,228660000,228385000,228665000,"chr1",19843,2,5,2,9,"chr1",1,0.0116033755274262
"742","chr1.204950000.204955000","chr1.205060000.205065000",110000,16,0.00338394,204950000,205060000,204955000,205065000,"chr1",19900,1,3,5,9,"chr1",1,0.0168776371308017
"743","chr1.39555000.39560000","chr1.39745000.39750000",190000,15,0.000283605,39555000,39745000,39560000,39750000,"chr1",19923,2,20,18,40,"chr1",1,0.070323488045007
"744","chr1.156020000.156025000","chr1.156160000.156165000",140000,16,0.0007123297,156020000,156160000,156025000,156165000,"chr1",19962,5,6,4,15,"chr1",1,0.0281293952180028
"745","chr1.204410000.204415000","chr1.204475000.204480000",65000,26,7.652881e-06,204410000,204475000,204415000,204480000,"chr1",19964,2,3,2,7,"chr1",1,0.0213314580403188
"746","chr1.209775000.209780000","chr1.209865000.209870000",90000,25,3.161766e-07,209775000,209865000,209780000,209870000,"chr1",19989,2,1,4,7,"chr1",1,0.0205110173464604
"747","chr1.64090000.64095000","chr1.64675000.64680000",585000,8,0.006690763,64090000,64675000,64095000,64680000,"chr1",20010,2,1,1,4,"chr1",1,0.00375058602906704
"748","chr1.54235000.54240000","chr1.54260000.54265000",25000,35,0.003277108,54235000,54260000,54240000,54265000,"chr1",20023,2,2,5,9,"chr1",1,0.0369198312236287
"749","chr1.204860000.204865000","chr1.204900000.204905000",40000,26,0.003086748,204860000,204900000,204865000,204905000,"chr1",20125,2,7,7,16,"chr1",1,0.0487576183778715
"750","chr1.234750000.234755000","chr1.235100000.235105000",350000,12,0.0002570617,234750000,235100000,234755000,235105000,"chr1",20126,2,2,2,6,"chr1",1,0.00843881856540084
"751","chr1.201505000.201510000","chr1.201760000.201765000",255000,11,0.00691274,201505000,201760000,201510000,201765000,"chr1",20182,1,1,0,2,"chr1",1,0.00257852789498359
"752","chr1.39730000.39735000","chr1.40035000.40040000",305000,12,0.0006128938,39730000,40035000,39735000,40040000,"chr1",20223,5,10,9,24,"chr1",1,0.0337552742616034
"753","chr1.155915000.155920000","chr1.155945000.155950000",30000,52,1.07875e-12,155915000,155945000,155920000,155950000,"chr1",20243,6,21,24,51,"chr1",1,0.310829817158931
"754","chr1.8625000.8630000","chr1.8855000.8860000",230000,14,0.0002509734,8625000,8855000,8630000,8860000,"chr1",20270,6,10,22,38,"chr1",1,0.0623534927332396
"755","chr1.116355000.116360000","chr1.116510000.116515000",155000,14,0.00393986,116355000,116510000,116360000,116515000,"chr1",20291,3,2,7,12,"chr1",1,0.019690576652602
"756","chr1.94525000.94530000","chr1.94800000.94805000",275000,57,3.013128e-53,94525000,94800000,94530000,94805000,"chr1",20455,0,2,0,2,"chr1",1,0.0133614627285513
"757","chr1.65215000.65220000","chr1.65330000.65335000",115000,15,0.007192145,65215000,65330000,65220000,65335000,"chr1",20477,0,0,3,3,"chr1",1,0.00527426160337553
"758","chr1.32215000.32220000","chr1.32480000.32485000",265000,12,0.001500618,32215000,32480000,32220000,32485000,"chr1",20529,3,12,17,32,"chr1",1,0.0450070323488045
"759","chr1.9860000.9865000","chr1.9875000.9880000",15000,44,3.073313e-05,9860000,9875000,9865000,9880000,"chr1",20690,0,3,3,6,"chr1",1,0.0309423347398031
"760","chr1.212475000.212480000","chr1.212630000.212635000",155000,14,0.00393986,212475000,212630000,212480000,212635000,"chr1",20691,5,8,11,24,"chr1",1,0.0393811533052039
"761","chr1.204250000.204255000","chr1.204300000.204305000",50000,22,0.008541777,204250000,204300000,204255000,204305000,"chr1",20789,1,2,3,6,"chr1",1,0.0154711673699015
"762","chr1.155250000.155255000","chr1.155500000.155505000",250000,12,0.002176934,155250000,155500000,155255000,155505000,"chr1",20795,2,21,12,35,"chr1",1,0.0492264416315049
"763","chr1.27960000.27965000","chr1.27980000.27985000",20000,47,2.356529e-06,27960000,27980000,27965000,27985000,"chr1",20836,8,18,4,30,"chr1",1,0.165260196905767
"764","chr1.84600000.84605000","chr1.85150000.85155000",550000,14,1.454336e-07,84600000,85150000,84605000,85155000,"chr1",20847,3,7,11,21,"chr1",1,0.0344585091420534
"765","chr1.23825000.23830000","chr1.23865000.23870000",40000,44,5.011802e-12,23825000,23865000,23830000,23870000,"chr1",20848,5,19,17,41,"chr1",1,0.211439287388654
"766","chr1.2120000.2125000","chr1.2190000.2195000",70000,26,2.649753e-06,2120000,2190000,2125000,2195000,"chr1",20911,0,3,0,3,"chr1",1,0.00914205344585091
"767","chr1.44270000.44275000","chr1.44320000.44325000",50000,23,0.003767084,44270000,44320000,44275000,44325000,"chr1",20912,0,0,1,1,"chr1",1,0.00269573370839194
"768","chr1.39575000.39580000","chr1.39625000.39630000",50000,35,7.365003e-09,39575000,39625000,39580000,39630000,"chr1",20927,0,3,4,7,"chr1",1,0.0287154242850445
"769","chr1.110390000.110395000","chr1.110475000.110480000",85000,17,0.007758048,110390000,110475000,110395000,110480000,"chr1",20958,3,0,2,5,"chr1",1,0.00996249413970933
"770","chr1.235415000.235420000","chr1.235580000.235585000",165000,36,1.209439e-20,235415000,235580000,235420000,235585000,"chr1",20989,0,2,5,7,"chr1",1,0.029535864978903
"771","chr1.243355000.243360000","chr1.243475000.243480000",120000,18,0.0001811171,243355000,243475000,243360000,243480000,"chr1",21007,0,1,1,2,"chr1",1,0.00421940928270042
"772","chr1.8095000.8100000","chr1.8870000.8875000",775000,8,0.001500618,8095000,8870000,8100000,8875000,"chr1",21052,0,4,3,7,"chr1",1,0.00656352555086732
"773","chr1.168615000.168620000","chr1.169130000.169135000",515000,14,2.853491e-07,168615000,169130000,168620000,169135000,"chr1",21066,0,2,0,2,"chr1",1,0.00328176277543366
"774","chr1.155960000.155965000","chr1.155985000.155990000",25000,40,7.966121e-05,155960000,155985000,155965000,155990000,"chr1",21114,1,10,14,25,"chr1",1,0.117205813408345
"775","chr1.182085000.182090000","chr1.182345000.182350000",260000,13,0.0004157809,182085000,182345000,182090000,182350000,"chr1",21121,0,1,1,2,"chr1",1,0.00304735114861697
"776","chr1.77975000.77980000","chr1.78000000.78005000",25000,43,6.060288e-06,77975000,7.8e+07,77980000,78005000,"chr1",21132,0,5,5,10,"chr1",1,0.0503984997655884
"777","chr1.225675000.225680000","chr1.225730000.225735000",55000,21,0.00838272,225675000,225730000,225680000,225735000,"chr1",21165,4,12,11,27,"chr1",1,0.0664556962025316
"778","chr1.156125000.156130000","chr1.156160000.156165000",35000,38,2.750985e-07,156125000,156160000,156130000,156165000,"chr1",21182,1,6,4,11,"chr1",1,0.0489920300046882
"779","chr1.11270000.11275000","chr1.11790000.11795000",520000,9,0.002714357,11270000,11790000,11275000,11795000,"chr1",21189,1,3,2,6,"chr1",1,0.00632911392405063
"780","chr1.156160000.156165000","chr1.156190000.156195000",30000,38,8.886415e-06,156160000,156190000,156165000,156195000,"chr1",21194,3,6,4,13,"chr1",1,0.0578996718237225
"781","chr1.228830000.228835000","chr1.229625000.229630000",795000,9,0.0001958223,228830000,229625000,228835000,229630000,"chr1",21222,3,1,5,9,"chr1",1,0.00949367088607595
"782","chr1.26240000.26245000","chr1.26315000.26320000",75000,28,6.466052e-08,26240000,26315000,26245000,26320000,"chr1",21223,5,12,9,26,"chr1",1,0.0853258321612752
"783","chr1.179205000.179210000","chr1.179250000.179255000",45000,23,0.009597206,179205000,179250000,179210000,179255000,"chr1",21252,2,3,2,7,"chr1",1,0.0188701359587436
"784","chr1.153760000.153765000","chr1.153925000.153930000",165000,23,4.012892e-09,153760000,153925000,153765000,153930000,"chr1",21322,1,11,8,20,"chr1",1,0.0539146741678387
"785","chr1.8055000.8060000","chr1.8370000.8375000",315000,17,8.712367e-08,8055000,8370000,8060000,8375000,"chr1",21352,0,0,5,5,"chr1",1,0.00996249413970933
"786","chr1.8660000.8665000","chr1.8710000.8715000",50000,28,3.2625e-05,8660000,8710000,8665000,8715000,"chr1",21359,1,4,2,7,"chr1",1,0.0229723394280356
"787","chr1.205335000.205340000","chr1.205395000.205400000",60000,25,7.2355e-05,205335000,205395000,205340000,205400000,"chr1",21375,3,11,5,19,"chr1",1,0.0556727613689639
"788","chr1.205520000.205525000","chr1.205540000.205545000",20000,38,0.00252151,205520000,205540000,205525000,205545000,"chr1",21423,0,3,2,5,"chr1",1,0.0222691045475856
"789","chr1.204245000.204250000","chr1.204345000.204350000",100000,18,0.0007807092,204245000,204345000,204250000,204350000,"chr1",21460,0,2,1,3,"chr1",1,0.00632911392405063
"790","chr1.26960000.26965000","chr1.27155000.27160000",195000,12,0.009750873,26960000,27155000,26965000,27160000,"chr1",21466,9,23,23,55,"chr1",1,0.0773558368495077
"791","chr1.26900000.26905000","chr1.27120000.27125000",220000,12,0.004800128,26900000,27120000,26905000,27125000,"chr1",21521,5,22,15,42,"chr1",1,0.0590717299578059
"792","chr1.109090000.109095000","chr1.109290000.109295000",200000,12,0.008520915,109090000,109290000,109095000,109295000,"chr1",21526,3,17,4,24,"chr1",1,0.0337552742616034
"793","chr1.205590000.205595000","chr1.205675000.205680000",85000,20,0.0003590682,205590000,205675000,205595000,205680000,"chr1",21541,0,5,1,6,"chr1",1,0.0140646976090014
"794","chr1.174800000.174805000","chr1.174940000.174945000",140000,14,0.006950379,174800000,174940000,174805000,174945000,"chr1",21578,1,9,14,24,"chr1",1,0.0393811533052039
"795","chr1.9690000.9695000","chr1.9925000.9930000",235000,20,8.702284e-09,9690000,9925000,9695000,9930000,"chr1",21600,2,15,19,36,"chr1",1,0.0843881856540084
"796","chr1.179090000.179095000","chr1.179140000.179145000",50000,25,0.0006470043,179090000,179140000,179095000,179145000,"chr1",21662,5,15,13,33,"chr1",1,0.0966947960618847
"797","chr1.155225000.155230000","chr1.155895000.155900000",670000,8,0.003304886,155225000,155895000,155230000,155900000,"chr1",21718,7,25,10,42,"chr1",1,0.0393811533052039
"798","chr1.9690000.9695000","chr1.10505000.10510000",815000,7,0.006415049,9690000,10505000,9695000,10510000,"chr1",21793,4,14,16,34,"chr1",1,0.0278949835911861
"799","chr1.161155000.161160000","chr1.161190000.161195000",35000,27,0.00691274,161155000,161190000,161160000,161195000,"chr1",21795,0,2,3,5,"chr1",1,0.0158227848101266
"800","chr1.23365000.23370000","chr1.23825000.23830000",460000,9,0.005175406,23365000,23825000,23370000,23830000,"chr1",21838,3,5,7,15,"chr1",1,0.0158227848101266
"801","chr1.178000000.178005000","chr1.178270000.178275000",270000,12,0.001326741,1.78e+08,178270000,178005000,178275000,"chr1",21841,0,2,1,3,"chr1",1,0.00421940928270042
"802","chr1.201530000.201535000","chr1.201740000.201745000",210000,23,1.348257e-10,201530000,201740000,201535000,201745000,"chr1",21877,1,2,3,6,"chr1",1,0.0161744022503516
"803","chr1.77755000.77760000","chr1.78000000.78005000",245000,13,0.0006470043,77755000,7.8e+07,77760000,78005000,"chr1",21927,2,11,8,21,"chr1",1,0.0319971870604782
"804","chr1.203325000.203330000","chr1.203375000.203380000",50000,23,0.003767084,203325000,203375000,203330000,203380000,"chr1",21949,0,0,2,2,"chr1",1,0.00539146741678387
"805","chr1.23775000.23780000","chr1.23800000.23805000",25000,34,0.006227396,23775000,23800000,23780000,23805000,"chr1",21957,2,10,10,22,"chr1",1,0.0876699484294421
"806","chr1.46215000.46220000","chr1.46345000.46350000",130000,15,0.003565021,46215000,46345000,46220000,46350000,"chr1",22014,4,13,6,23,"chr1",1,0.040436005625879
"807","chr1.39795000.39800000","chr1.39915000.39920000",120000,20,1.304936e-05,39795000,39915000,39800000,39920000,"chr1",22103,4,20,14,38,"chr1",1,0.0890764181903422
"808","chr1.242185000.242190000","chr1.242690000.242695000",505000,9,0.003186291,242185000,242690000,242190000,242695000,"chr1",22107,1,4,4,9,"chr1",1,0.00949367088607595
"809","chr1.201550000.201555000","chr1.201730000.201735000",180000,13,0.005018612,201550000,201730000,201555000,201735000,"chr1",22173,4,4,11,19,"chr1",1,0.0289498359118612
"810","chr1.9345000.9350000","chr1.9535000.9540000",190000,13,0.003611391,9345000,9535000,9350000,9540000,"chr1",22179,1,7,4,12,"chr1",1,0.0182841068917018
"811","chr1.151070000.151075000","chr1.151095000.151100000",25000,40,7.966121e-05,151070000,151095000,151075000,151100000,"chr1",22233,4,15,14,33,"chr1",1,0.154711673699015
"812","chr1.161535000.161540000","chr1.161705000.161710000",170000,21,8.720146e-08,161535000,161705000,161540000,161710000,"chr1",22317,2,7,7,16,"chr1",1,0.0393811533052039
"813","chr1.153605000.153610000","chr1.153645000.153650000",40000,27,0.001354847,153605000,153645000,153610000,153650000,"chr1",22328,0,7,5,12,"chr1",1,0.0379746835443038
"814","chr1.41320000.41325000","chr1.41400000.41405000",80000,18,0.004760983,41320000,41400000,41325000,41405000,"chr1",22351,0,1,1,2,"chr1",1,0.00421940928270042
"815","chr1.9690000.9695000","chr1.9765000.9770000",75000,25,3.673389e-06,9690000,9765000,9695000,9770000,"chr1",22383,0,13,9,22,"chr1",1,0.0644631973745898
"816","chr1.16185000.16190000","chr1.16215000.16220000",30000,41,4.470562e-07,16185000,16215000,16190000,16220000,"chr1",22395,0,1,1,2,"chr1",1,0.00961087669948429
"817","chr1.234755000.234760000","chr1.235070000.235075000",315000,12,0.0004991842,234755000,235070000,234760000,235075000,"chr1",22438,0,1,2,3,"chr1",1,0.00421940928270042
"818","chr1.153645000.153650000","chr1.153965000.153970000",320000,12,0.0004494463,153645000,153965000,153650000,153970000,"chr1",22452,2,13,7,22,"chr1",1,0.0309423347398031
"819","chr1.153625000.153630000","chr1.153960000.153965000",335000,10,0.006041478,153625000,153960000,153630000,153965000,"chr1",22597,1,7,6,14,"chr1",1,0.0164088138771683
"820","chr1.156385000.156390000","chr1.156410000.156415000",25000,58,5.866412e-13,156385000,156410000,156390000,156415000,"chr1",22604,0,1,1,2,"chr1",1,0.013595874355368
"821","chr1.155250000.155255000","chr1.155685000.155690000",435000,12,5.973985e-05,155250000,155685000,155255000,155690000,"chr1",22655,0,7,9,16,"chr1",1,0.0225035161744023
"822","chr1.183565000.183570000","chr1.183875000.183880000",310000,13,0.0001182238,183565000,183875000,183570000,183880000,"chr1",22659,2,2,5,9,"chr1",1,0.0137130801687764
"823","chr1.116710000.116715000","chr1.117030000.117035000",320000,28,1.146269e-18,116710000,117030000,116715000,117035000,"chr1",22700,0,1,1,2,"chr1",1,0.00656352555086732
"824","chr1.243890000.243895000","chr1.244215000.244220000",325000,13,8.43013e-05,243890000,244215000,243895000,244220000,"chr1",22770,0,2,4,6,"chr1",1,0.00914205344585091
"825","chr1.229230000.229235000","chr1.229250000.229255000",20000,49,3.736063e-07,229230000,229250000,229235000,229255000,"chr1",22783,0,0,2,2,"chr1",1,0.0114861697140178
"826","chr1.110390000.110395000","chr1.110425000.110430000",35000,31,0.0002882227,110390000,110425000,110395000,110430000,"chr1",22785,3,4,10,17,"chr1",1,0.0617674636661978
"827","chr1.64745000.64750000","chr1.65145000.65150000",400000,11,0.0005589688,64745000,65145000,64750000,65150000,"chr1",22804,0,2,2,4,"chr1",1,0.00515705578996718
"828","chr1.201510000.201515000","chr1.201530000.201535000",20000,61,1.037412e-12,201510000,201530000,201515000,201535000,"chr1",22883,2,2,2,6,"chr1",1,0.0428973277074543
"829","chr1.174715000.174720000","chr1.174955000.174960000",240000,19,4.362295e-08,174715000,174955000,174720000,174960000,"chr1",22895,7,10,20,37,"chr1",1,0.0823956868260666
"830","chr1.23790000.23795000","chr1.23855000.23860000",65000,20,0.004296559,23790000,23855000,23795000,23860000,"chr1",22925,0,0,5,5,"chr1",1,0.0117205813408345
"831","chr1.183620000.183625000","chr1.183815000.183820000",195000,12,0.009750873,183620000,183815000,183625000,183820000,"chr1",22932,0,2,3,5,"chr1",1,0.0070323488045007
"832","chr1.77620000.77625000","chr1.78000000.78005000",380000,11,0.0007423417,77620000,7.8e+07,77625000,78005000,"chr1",22960,5,8,10,23,"chr1",1,0.0296530707923113
"833","chr1.29110000.29115000","chr1.29195000.29200000",85000,30,4.040152e-10,29110000,29195000,29115000,29200000,"chr1",22980,4,8,15,27,"chr1",1,0.0949367088607595
"834","chr1.160075000.160080000","chr1.160170000.160175000",95000,17,0.003397074,160075000,160170000,160080000,160175000,"chr1",23002,1,2,1,4,"chr1",1,0.00796999531176746
"835","chr1.154155000.154160000","chr1.154305000.154310000",150000,15,0.001520338,154155000,154305000,154160000,154310000,"chr1",23029,1,2,1,4,"chr1",1,0.0070323488045007
"836","chr1.8510000.8515000","chr1.8915000.8920000",405000,11,0.0005159089,8510000,8915000,8515000,8920000,"chr1",23032,2,12,13,27,"chr1",1,0.0348101265822785
"837","chr1.150285000.150290000","chr1.151175000.151180000",890000,7,0.004030049,150285000,151175000,150290000,151180000,"chr1",23077,3,14,7,24,"chr1",1,0.019690576652602
"838","chr1.84620000.84625000","chr1.85025000.85030000",405000,10,0.002358895,84620000,85025000,84625000,85030000,"chr1",23097,1,3,5,9,"chr1",1,0.0105485232067511
"839","chr1.201955000.201960000","chr1.202085000.202090000",130000,25,2.475598e-09,201955000,202085000,201960000,202090000,"chr1",23103,3,10,7,20,"chr1",1,0.0586029067041725
"840","chr1.39745000.39750000","chr1.39795000.39800000",50000,26,0.0002506014,39745000,39795000,39750000,39800000,"chr1",23109,2,20,14,36,"chr1",1,0.109704641350211
"841","chr1.27625000.27630000","chr1.27775000.27780000",150000,14,0.004757005,27625000,27775000,27630000,27780000,"chr1",23128,7,12,12,31,"chr1",1,0.0508673230192218
"842","chr1.9345000.9350000","chr1.9395000.9400000",50000,27,9.219509e-05,9345000,9395000,9350000,9400000,"chr1",23139,1,7,4,12,"chr1",1,0.0379746835443038
"843","chr1.205320000.205325000","chr1.205345000.205350000",25000,36,0.001641975,205320000,205345000,205325000,205350000,"chr1",23186,0,10,10,20,"chr1",1,0.0843881856540084
"844","chr1.86755000.86760000","chr1.86790000.86795000",35000,31,0.0002882227,86755000,86790000,86760000,86795000,"chr1",23225,0,0,5,5,"chr1",1,0.0181669010782935
"845","chr1.204515000.204520000","chr1.204935000.204940000",420000,9,0.008177867,204515000,204935000,204520000,204940000,"chr1",23273,1,1,2,4,"chr1",1,0.00421940928270042
"846","chr1.11155000.11160000","chr1.11700000.11705000",545000,9,0.002062305,11155000,11700000,11160000,11705000,"chr1",23275,0,2,1,3,"chr1",1,0.00316455696202532
"847","chr1.54335000.54340000","chr1.54415000.54420000",80000,21,0.0002162115,54335000,54415000,54340000,54420000,"chr1",23282,2,6,1,9,"chr1",1,0.0221518987341772
"848","chr1.225710000.225715000","chr1.225730000.225735000",20000,37,0.004733079,225710000,225730000,225715000,225735000,"chr1",23285,4,12,11,27,"chr1",1,0.117088607594937
"849","chr1.160290000.160295000","chr1.160370000.160375000",80000,18,0.004760983,160290000,160370000,160295000,160375000,"chr1",23356,0,2,0,2,"chr1",1,0.00421940928270042
"850","chr1.160075000.160080000","chr1.160125000.160130000",50000,23,0.003767084,160075000,160125000,160080000,160130000,"chr1",23378,3,2,1,6,"chr1",1,0.0161744022503516
"851","chr1.179120000.179125000","chr1.179140000.179145000",20000,37,0.004733079,179120000,179140000,179125000,179145000,"chr1",23431,5,10,23,38,"chr1",1,0.164791373652133
"852","chr1.156600000.156605000","chr1.156685000.156690000",85000,25,6.912566e-07,156600000,156685000,156605000,156690000,"chr1",23435,7,14,23,44,"chr1",1,0.12892639474918
"853","chr1.223120000.223125000","chr1.223140000.223145000",20000,48,9.466554e-07,223120000,223140000,223125000,223145000,"chr1",23437,1,5,5,11,"chr1",1,0.0618846694796062
"854","chr1.169080000.169085000","chr1.169130000.169135000",50000,24,0.001605476,169080000,169130000,169085000,169135000,"chr1",23447,0,2,2,4,"chr1",1,0.0112517580872011
"855","chr1.160170000.160175000","chr1.160245000.160250000",75000,20,0.001171509,160170000,160245000,160175000,160250000,"chr1",23469,1,10,13,24,"chr1",1,0.0562587904360056
"856","chr1.202710000.202715000","chr1.202965000.202970000",255000,16,4.459714e-06,202710000,202965000,202715000,202970000,"chr1",23494,2,13,5,20,"chr1",1,0.0375058602906704
"857","chr1.174770000.174775000","chr1.174940000.174945000",170000,15,0.0006470043,174770000,174940000,174775000,174945000,"chr1",23542,3,9,14,26,"chr1",1,0.0457102672292546
"858","chr1.183605000.183610000","chr1.183650000.183655000",45000,23,0.009597206,183605000,183650000,183610000,183655000,"chr1",23548,1,4,1,6,"chr1",1,0.0161744022503516
"859","chr1.245040000.245045000","chr1.245195000.245200000",155000,17,9.494008e-05,245040000,245195000,245045000,245200000,"chr1",23557,0,4,3,7,"chr1",1,0.0139474917955931
"860","chr1.110390000.110395000","chr1.110410000.110415000",20000,44,3.073313e-05,110390000,110410000,110395000,110415000,"chr1",23562,3,4,10,17,"chr1",1,0.0876699484294421
"861","chr1.151255000.151260000","chr1.151300000.151305000",45000,29,4.600653e-05,151255000,151300000,151260000,151305000,"chr1",23577,15,31,41,87,"chr1",1,0.295710267229255
"862","chr1.228790000.228795000","chr1.229070000.229075000",280000,11,0.004063209,228790000,229070000,228795000,229075000,"chr1",23604,0,2,1,3,"chr1",1,0.00386779184247539
"863","chr1.151295000.151300000","chr1.151880000.151885000",585000,9,0.001366185,151295000,151880000,151300000,151885000,"chr1",23644,2,23,23,48,"chr1",1,0.0506329113924051
"864","chr1.108620000.108625000","chr1.108640000.108645000",20000,38,0.00252151,108620000,108640000,108625000,108645000,"chr1",23741,0,6,4,10,"chr1",1,0.0445382090951711
"865","chr1.243900000.243905000","chr1.244460000.244465000",560000,9,0.001761985,243900000,244460000,243905000,244465000,"chr1",23797,0,1,2,3,"chr1",1,0.00316455696202532
"866","chr1.225745000.225750000","chr1.225825000.225830000",80000,18,0.004760983,225745000,225825000,225750000,225830000,"chr1",23805,1,5,7,13,"chr1",1,0.0274261603375527
"867","chr1.28830000.28835000","chr1.28875000.28880000",45000,31,5.563018e-06,28830000,28875000,28835000,28880000,"chr1",23888,4,17,19,40,"chr1",1,0.145335208626348
"868","chr1.205520000.205525000","chr1.205590000.205595000",70000,22,0.0002882227,205520000,205590000,205525000,205595000,"chr1",23907,0,3,2,5,"chr1",1,0.012892639474918
"869","chr1.66400000.66405000","chr1.66980000.66985000",580000,9,0.001445779,66400000,66980000,66405000,66985000,"chr1",23936,0,0,2,2,"chr1",1,0.00210970464135021
"870","chr1.16365000.16370000","chr1.16385000.16390000",20000,122,3.464455e-55,16365000,16385000,16370000,16390000,"chr1",23947,3,15,13,31,"chr1",1,0.443272386310361
"871","chr1.21215000.21220000","chr1.21395000.21400000",180000,14,0.001527903,21215000,21395000,21220000,21400000,"chr1",23961,0,9,10,19,"chr1",1,0.0311767463666198
"872","chr1.174770000.174775000","chr1.174960000.174965000",190000,21,2.212558e-08,174770000,174960000,174775000,174965000,"chr1",24001,0,4,7,11,"chr1",1,0.0270745428973277
"873","chr1.26225000.26230000","chr1.26320000.26325000",95000,35,7.968149e-15,26225000,26320000,26230000,26325000,"chr1",24008,4,2,5,11,"chr1",1,0.0451242381622128
"874","chr1.226060000.226065000","chr1.226105000.226110000",45000,27,0.0003258119,226060000,226105000,226065000,226110000,"chr1",24010,0,2,4,6,"chr1",1,0.0189873417721519
"875","chr1.160020000.160025000","chr1.160260000.160265000",240000,11,0.009597206,160020000,160260000,160025000,160265000,"chr1",24021,0,2,2,4,"chr1",1,0.00515705578996718
"876","chr1.26430000.26435000","chr1.26745000.26750000",315000,12,0.0004991842,26430000,26745000,26435000,26750000,"chr1",24035,2,5,6,13,"chr1",1,0.0182841068917018
"877","chr1.84620000.84625000","chr1.85105000.85110000",485000,9,0.00393986,84620000,85105000,84625000,85110000,"chr1",24038,1,9,6,16,"chr1",1,0.0168776371308017
"878","chr1.39575000.39580000","chr1.39880000.39885000",305000,16,7.829034e-07,39575000,39880000,39580000,39885000,"chr1",24082,5,14,14,33,"chr1",1,0.0618846694796062
"879","chr1.156065000.156070000","chr1.156090000.156095000",25000,38,0.0003847014,156065000,156090000,156070000,156095000,"chr1",24086,1,14,4,19,"chr1",1,0.0846225972808251
"880","chr1.9950000.9955000","chr1.10000000.10005000",50000,35,7.365003e-09,9950000,1e+07,9955000,10005000,"chr1",24109,5,19,24,48,"chr1",1,0.19690576652602
"881","chr1.242180000.242185000","chr1.242620000.242625000",440000,10,0.001500618,242180000,242620000,242185000,242625000,"chr1",24162,0,0,4,4,"chr1",1,0.0046882325363338
"882","chr1.27775000.27780000","chr1.27805000.27810000",30000,35,0.0001324766,27775000,27805000,27780000,27810000,"chr1",24224,0,8,1,9,"chr1",1,0.0369198312236287
"883","chr1.210750000.210755000","chr1.211305000.211310000",555000,23,2.394212e-17,210750000,211305000,210755000,211310000,"chr1",24243,0,2,3,5,"chr1",1,0.0134786685419597
"884","chr1.161150000.161155000","chr1.161175000.161180000",25000,41,3.467397e-05,161150000,161175000,161155000,161180000,"chr1",24253,2,11,13,26,"chr1",1,0.124941397093296
"885","chr1.229090000.229095000","chr1.229130000.229135000",40000,31,3.426866e-05,229090000,229130000,229095000,229135000,"chr1",24306,3,4,3,10,"chr1",1,0.036333802156587
"886","chr1.171740000.171745000","chr1.171955000.171960000",215000,16,2.309654e-05,171740000,171955000,171745000,171960000,"chr1",24326,0,0,5,5,"chr1",1,0.00937646507266761
"887","chr1.230780000.230785000","chr1.230910000.230915000",130000,19,2.5832e-05,230780000,230910000,230785000,230915000,"chr1",24428,0,2,3,5,"chr1",1,0.0111345522737928
"888","chr1.201460000.201465000","chr1.201480000.201485000",20000,77,6.782393e-22,201460000,201480000,201465000,201485000,"chr1",24475,1,5,0,6,"chr1",1,0.0541490857946554
"889","chr1.45495000.45500000","chr1.45750000.45755000",255000,14,0.0001100245,45495000,45750000,45500000,45755000,"chr1",24489,4,7,5,16,"chr1",1,0.0262541022034693
"890","chr1.161150000.161155000","chr1.161285000.161290000",135000,20,4.517402e-06,161150000,161285000,161155000,161290000,"chr1",24575,7,27,26,60,"chr1",1,0.140646976090014
"891","chr1.54800000.54805000","chr1.54950000.54955000",150000,20,1.674205e-06,54800000,54950000,54805000,54955000,"chr1",24622,0,3,1,4,"chr1",1,0.00937646507266761
"892","chr1.171865000.171870000","chr1.171950000.171955000",85000,30,4.040152e-10,171865000,171950000,171870000,171955000,"chr1",24635,1,4,2,7,"chr1",1,0.0246132208157525
"893","chr1.155070000.155075000","chr1.155135000.155140000",65000,25,2.508188e-05,155070000,155135000,155075000,155140000,"chr1",24659,1,4,9,14,"chr1",1,0.0410220346929208
"894","chr1.16960000.16965000","chr1.17375000.17380000",415000,14,2.250166e-06,16960000,17375000,16965000,17380000,"chr1",24702,9,31,36,76,"chr1",1,0.124706985466479
"895","chr1.228810000.228815000","chr1.229595000.229600000",785000,8,0.001386725,228810000,229595000,228815000,229600000,"chr1",24752,0,5,2,7,"chr1",1,0.00656352555086732
"896","chr1.54670000.54675000","chr1.54795000.54800000",125000,16,0.001500618,54670000,54795000,54675000,54800000,"chr1",24770,1,3,1,5,"chr1",1,0.00937646507266761
"897","chr1.156065000.156070000","chr1.156160000.156165000",95000,18,0.001200097,156065000,156160000,156070000,156165000,"chr1",24851,1,6,4,11,"chr1",1,0.0232067510548523
"898","chr1.43950000.43955000","chr1.44505000.44510000",555000,8,0.008632247,43950000,44505000,43955000,44510000,"chr1",24912,0,3,1,4,"chr1",1,0.00375058602906704
"899","chr1.212205000.212210000","chr1.212540000.212545000",335000,16,3.269071e-07,212205000,212540000,212210000,212545000,"chr1",25011,0,4,2,6,"chr1",1,0.0112517580872011
"900","chr1.231105000.231110000","chr1.231355000.231360000",250000,11,0.007719712,231105000,231355000,231110000,231360000,"chr1",25026,2,6,6,14,"chr1",1,0.0180496952648851
"901","chr1.205230000.205235000","chr1.205325000.205330000",95000,21,3.530743e-05,205230000,205325000,205235000,205330000,"chr1",25030,1,3,4,8,"chr1",1,0.019690576652602
"902","chr1.8510000.8515000","chr1.8595000.8600000",85000,23,9.882479e-06,8510000,8595000,8515000,8600000,"chr1",25042,2,4,5,11,"chr1",1,0.0296530707923113
"903","chr1.116710000.116715000","chr1.116920000.116925000",210000,17,5.986221e-06,116710000,116920000,116715000,116925000,"chr1",25044,0,1,1,2,"chr1",1,0.00398499765588373
"904","chr1.162090000.162095000","chr1.162145000.162150000",55000,32,6.399316e-08,162090000,162145000,162095000,162150000,"chr1",25058,0,1,1,2,"chr1",1,0.00750117205813408
"905","chr1.204270000.204275000","chr1.204300000.204305000",30000,39,3.363468e-06,204270000,204300000,204275000,204305000,"chr1",25075,1,1,3,5,"chr1",1,0.0228551336146273
"906","chr1.205675000.205680000","chr1.205700000.205705000",25000,34,0.006227396,205675000,205700000,205680000,205705000,"chr1",25092,0,5,1,6,"chr1",1,0.0239099859353024
"907","chr1.205655000.205660000","chr1.205680000.205685000",25000,34,0.006227396,205655000,205680000,205660000,205685000,"chr1",25101,6,11,21,38,"chr1",1,0.151429910923582
"908","chr1.77830000.77835000","chr1.77975000.77980000",145000,16,0.0005758375,77830000,77975000,77835000,77980000,"chr1",25154,0,4,2,6,"chr1",1,0.0112517580872011
"909","chr1.33430000.33435000","chr1.33470000.33475000",40000,30,9.14609e-05,33430000,33470000,33435000,33475000,"chr1",25172,2,1,2,5,"chr1",1,0.0175808720112518
"910","chr1.212290000.212295000","chr1.212410000.212415000",120000,17,0.0006133453,212290000,212410000,212295000,212415000,"chr1",25177,0,2,1,3,"chr1",1,0.0059774964838256
"911","chr1.243850000.243855000","chr1.244110000.244115000",260000,18,1.049544e-07,243850000,244110000,243855000,244115000,"chr1",25184,0,10,9,19,"chr1",1,0.040084388185654
"912","chr1.23790000.23795000","chr1.23865000.23870000",75000,48,4.464702e-23,23790000,23865000,23795000,23870000,"chr1",25208,0,0,5,5,"chr1",1,0.0281293952180028
"913","chr1.16960000.16965000","chr1.17045000.17050000",85000,51,1.28664e-27,16960000,17045000,16965000,17050000,"chr1",25287,8,29,21,58,"chr1",1,0.346694796061885
"914","chr1.156445000.156450000","chr1.156685000.156690000",240000,12,0.002839254,156445000,156685000,156450000,156690000,"chr1",25305,8,18,23,49,"chr1",1,0.0689170182841069
"915","chr1.23440000.23445000","chr1.23495000.23500000",55000,51,5.406245e-21,23440000,23495000,23445000,23500000,"chr1",25344,5,15,9,29,"chr1",1,0.173347398030942
"916","chr1.8625000.8630000","chr1.8685000.8690000",60000,20,0.00869379,8625000,8685000,8630000,8690000,"chr1",25362,6,10,17,33,"chr1",1,0.0773558368495077
"917","chr1.38925000.38930000","chr1.39270000.39275000",345000,10,0.005218466,38925000,39270000,38930000,39275000,"chr1",25407,0,4,8,12,"chr1",1,0.0140646976090014
"918","chr1.205365000.205370000","chr1.205490000.205495000",125000,24,2.046798e-08,205365000,205490000,205370000,205495000,"chr1",25424,13,20,26,59,"chr1",1,0.165963431786217
"919","chr1.204245000.204250000","chr1.204295000.204300000",50000,25,0.0006470043,204245000,204295000,204250000,204300000,"chr1",25433,1,1,1,3,"chr1",1,0.00879043600562588
"920","chr1.10105000.10110000","chr1.10130000.10135000",25000,37,0.0008057805,10105000,10130000,10110000,10135000,"chr1",25443,0,7,5,12,"chr1",1,0.0520393811533052
"921","chr1.39570000.39575000","chr1.40035000.40040000",465000,12,3.538267e-05,39570000,40035000,39575000,40040000,"chr1",25491,4,5,6,15,"chr1",1,0.0210970464135021
"922","chr1.153795000.153800000","chr1.153955000.153960000",160000,13,0.009763887,153795000,153955000,153800000,153960000,"chr1",25500,0,2,2,4,"chr1",1,0.00609470229723394
"923","chr1.25030000.25035000","chr1.25120000.25125000",90000,21,6.373704e-05,25030000,25120000,25035000,25125000,"chr1",25511,0,3,2,5,"chr1",1,0.0123066104078762
"924","chr1.44295000.44300000","chr1.44320000.44325000",25000,35,0.003277108,44295000,44320000,44300000,44325000,"chr1",25539,0,0,2,2,"chr1",1,0.00820440693858415
"925","chr1.153925000.153930000","chr1.153960000.153965000",35000,28,0.003304886,153925000,153960000,153930000,153965000,"chr1",25541,1,7,6,14,"chr1",1,0.0459446788560713
"926","chr1.10050000.10055000","chr1.10210000.10215000",160000,13,0.009763887,10050000,10210000,10055000,10215000,"chr1",25542,6,16,13,35,"chr1",1,0.053328645100797
"927","chr1.32220000.32225000","chr1.32470000.32475000",250000,13,0.000560038,32220000,32470000,32225000,32475000,"chr1",25613,3,14,6,23,"chr1",1,0.0350445382090952
"928","chr1.174745000.174750000","chr1.174965000.174970000",220000,21,3.206301e-09,174745000,174965000,174750000,174970000,"chr1",25637,4,6,13,23,"chr1",1,0.0566104078762307
"929","chr1.169890000.169895000","chr1.170840000.170845000",950000,10,5.174797e-06,169890000,170840000,169895000,170845000,"chr1",25648,3,4,1,8,"chr1",1,0.00937646507266761
"930","chr1.15095000.15100000","chr1.15430000.15435000",335000,11,0.0015078,15095000,15430000,15100000,15435000,"chr1",25656,0,5,5,10,"chr1",1,0.012892639474918
"931","chr1.8685000.8690000","chr1.8700000.8705000",15000,43,6.896909e-05,8685000,8700000,8690000,8705000,"chr1",25666,0,2,1,3,"chr1",1,0.0151195499296765
"932","chr1.201550000.201555000","chr1.201770000.201775000",220000,15,8.43013e-05,201550000,201770000,201555000,201775000,"chr1",25682,5,4,11,20,"chr1",1,0.0351617440225035
"933","chr1.114470000.114475000","chr1.115300000.115305000",830000,9,0.0001439579,114470000,115300000,114475000,115305000,"chr1",25730,0,2,1,3,"chr1",1,0.00316455696202532
"934","chr1.39750000.39755000","chr1.39795000.39800000",45000,26,0.0008075999,39750000,39795000,39755000,39800000,"chr1",25758,4,5,8,17,"chr1",1,0.0518049695264885
"935","chr1.8095000.8100000","chr1.8345000.8350000",250000,24,1.090926e-12,8095000,8345000,8100000,8350000,"chr1",25771,0,2,1,3,"chr1",1,0.00843881856540084
"936","chr1.21215000.21220000","chr1.21255000.21260000",40000,28,0.0005784227,21215000,21255000,21220000,21260000,"chr1",25809,0,8,6,14,"chr1",1,0.0459446788560713
"937","chr1.155900000.155905000","chr1.155935000.155940000",35000,34,1.810507e-05,155900000,155935000,155905000,155940000,"chr1",25810,15,35,40,90,"chr1",1,0.358649789029536
"938","chr1.36420000.36425000","chr1.36450000.36455000",30000,36,5.590942e-05,36420000,36450000,36425000,36455000,"chr1",25842,1,4,4,9,"chr1",1,0.0379746835443038
"939","chr1.9765000.9770000","chr1.9980000.9985000",215000,13,0.001605476,9765000,9980000,9770000,9985000,"chr1",25856,0,13,9,22,"chr1",1,0.0335208626347867
"940","chr1.202900000.202905000","chr1.202925000.202930000",25000,39,0.0001793477,202900000,202925000,202905000,202930000,"chr1",25863,9,17,16,42,"chr1",1,0.191983122362869
"941","chr1.205300000.205305000","chr1.205495000.205500000",195000,17,1.253798e-05,205300000,205495000,205305000,205500000,"chr1",25893,1,7,8,16,"chr1",1,0.0318799812470699
"942","chr1.201495000.201500000","chr1.201670000.201675000",175000,14,0.001856842,201495000,201670000,201500000,201675000,"chr1",25913,0,0,1,1,"chr1",1,0.00164088138771683
"943","chr1.39575000.39580000","chr1.39685000.39690000",110000,18,0.0003587972,39575000,39685000,39580000,39690000,"chr1",25923,8,14,23,45,"chr1",1,0.0949367088607595
"944","chr1.161285000.161290000","chr1.161365000.161370000",80000,19,0.00180801,161285000,161365000,161290000,161370000,"chr1",25974,3,5,2,10,"chr1",1,0.0222691045475856
"945","chr1.207750000.207755000","chr1.207845000.207850000",95000,22,9.820331e-06,207750000,207845000,207755000,207850000,"chr1",26003,1,0,1,2,"chr1",1,0.00515705578996718
"946","chr1.11330000.11335000","chr1.11715000.11720000",385000,12,0.0001394881,11330000,11715000,11335000,11720000,"chr1",26028,4,5,9,18,"chr1",1,0.0253164556962025
"947","chr1.99665000.99670000","chr1.100250000.100255000",585000,8,0.006690763,99665000,100250000,99670000,100255000,"chr1",26074,0,4,8,12,"chr1",1,0.0112517580872011
"948","chr1.26145000.26150000","chr1.26320000.26325000",175000,16,0.0001391493,26145000,26320000,26150000,26325000,"chr1",26103,4,2,5,11,"chr1",1,0.0206282231598687
"949","chr1.180500000.180505000","chr1.180980000.180985000",480000,9,0.004178511,180500000,180980000,180505000,180985000,"chr1",26105,3,6,1,10,"chr1",1,0.0105485232067511
"950","chr1.2130000.2135000","chr1.2190000.2195000",60000,33,3.11164e-09,2130000,2190000,2135000,2195000,"chr1",26119,2,3,0,5,"chr1",1,0.0193389592123769
"951","chr1.228900000.228905000","chr1.229230000.229235000",330000,10,0.00645586,228900000,229230000,228905000,229235000,"chr1",26198,0,0,2,2,"chr1",1,0.0023441162681669
"952","chr1.226560000.226565000","chr1.226580000.226585000",20000,40,0.0006470043,226560000,226580000,226565000,226585000,"chr1",26305,0,2,1,3,"chr1",1,0.0140646976090014
"953","chr1.201540000.201545000","chr1.201670000.201675000",130000,19,2.5832e-05,201540000,201670000,201545000,201675000,"chr1",26310,0,0,2,2,"chr1",1,0.00445382090951711
"954","chr1.109240000.109245000","chr1.109295000.109300000",55000,25,0.0002173261,109240000,109295000,109245000,109300000,"chr1",26323,0,5,2,7,"chr1",1,0.0205110173464604
"955","chr1.32980000.32985000","chr1.33085000.33090000",105000,16,0.004620068,32980000,33085000,32985000,33090000,"chr1",26330,2,10,10,22,"chr1",1,0.0412564463197375
"956","chr1.31820000.31825000","chr1.32000000.32005000",180000,13,0.005018612,31820000,3.2e+07,31825000,32005000,"chr1",26353,2,26,11,39,"chr1",1,0.0594233473980309
"957","chr1.14435000.14440000","chr1.15045000.15050000",610000,8,0.005414923,14435000,15045000,14440000,15050000,"chr1",26357,1,5,1,7,"chr1",1,0.00656352555086732
"958","chr1.160075000.160080000","chr1.160260000.160265000",185000,16,8.796347e-05,160075000,160260000,160080000,160265000,"chr1",26394,0,2,1,3,"chr1",1,0.00562587904360056
"959","chr1.243495000.243500000","chr1.243880000.243885000",385000,13,2.567395e-05,243495000,243880000,243500000,243885000,"chr1",26397,1,0,1,2,"chr1",1,0.00304735114861697
"960","chr1.210920000.210925000","chr1.211305000.211310000",385000,10,0.003098721,210920000,211305000,210925000,211310000,"chr1",26426,0,0,3,3,"chr1",1,0.00351617440225035
"961","chr1.95130000.95135000","chr1.95230000.95235000",100000,18,0.0007807092,95130000,95230000,95135000,95235000,"chr1",26430,0,5,1,6,"chr1",1,0.0126582278481013
"962","chr1.39690000.39695000","chr1.39890000.39895000",200000,13,0.00261335,39690000,39890000,39695000,39895000,"chr1",26437,1,3,3,7,"chr1",1,0.0106657290201594
"963","chr1.21115000.21120000","chr1.21435000.21440000",320000,10,0.007480566,21115000,21435000,21120000,21440000,"chr1",26438,4,19,10,33,"chr1",1,0.0386779184247539
"964","chr1.162020000.162025000","chr1.162245000.162250000",225000,19,9.489251e-08,162020000,162245000,162025000,162250000,"chr1",26447,0,5,4,9,"chr1",1,0.020042194092827
"965","chr1.54540000.54545000","chr1.54970000.54975000",430000,10,0.001690346,54540000,54970000,54545000,54975000,"chr1",26448,0,4,2,6,"chr1",1,0.0070323488045007
"966","chr1.153605000.153610000","chr1.153945000.153950000",340000,11,0.001394873,153605000,153945000,153610000,153950000,"chr1",26459,0,4,2,6,"chr1",1,0.00773558368495077
"967","chr1.46550000.46555000","chr1.46570000.46575000",20000,44,3.073313e-05,46550000,46570000,46555000,46575000,"chr1",26465,2,2,8,12,"chr1",1,0.0618846694796062
"968","chr1.84610000.84615000","chr1.84760000.84765000",150000,22,6.961533e-08,84610000,84760000,84615000,84765000,"chr1",26488,0,5,3,8,"chr1",1,0.0206282231598687
"969","chr1.16610000.16615000","chr1.16640000.16645000",30000,36,5.590942e-05,16610000,16640000,16615000,16645000,"chr1",26502,3,2,7,12,"chr1",1,0.0506329113924051
"970","chr1.54540000.54545000","chr1.54760000.54765000",220000,12,0.004800128,54540000,54760000,54545000,54765000,"chr1",26548,3,4,9,16,"chr1",1,0.0225035161744023
"971","chr1.201500000.201505000","chr1.201760000.201765000",260000,15,1.939385e-05,201500000,201760000,201505000,201765000,"chr1",26566,2,8,1,11,"chr1",1,0.0193389592123769
"972","chr1.8455000.8460000","chr1.8595000.8600000",140000,17,0.000209311,8455000,8595000,8460000,8600000,"chr1",26588,2,3,5,10,"chr1",1,0.0199249882794187
"973","chr1.37130000.37135000","chr1.37690000.37695000",560000,9,0.001761985,37130000,37690000,37135000,37695000,"chr1",26597,0,3,2,5,"chr1",1,0.00527426160337553
"974","chr1.61695000.61700000","chr1.61740000.61745000",45000,27,0.0003258119,61695000,61740000,61700000,61745000,"chr1",26602,6,18,11,35,"chr1",1,0.110759493670886
"975","chr1.9860000.9865000","chr1.10470000.10475000",610000,8,0.005414923,9860000,10470000,9865000,10475000,"chr1",26612,3,7,10,20,"chr1",1,0.0187529301453352
"976","chr1.174715000.174720000","chr1.174960000.174965000",245000,13,0.0006470043,174715000,174960000,174720000,174965000,"chr1",26665,0,4,7,11,"chr1",1,0.0167604313173933
"977","chr1.234745000.234750000","chr1.234985000.234990000",240000,11,0.009597206,234745000,234985000,234750000,234990000,"chr1",26694,3,1,6,10,"chr1",1,0.012892639474918
"978","chr1.201545000.201550000","chr1.202085000.202090000",540000,10,0.0004153543,201545000,202085000,201550000,202090000,"chr1",26703,3,11,12,26,"chr1",1,0.0304735114861697
"979","chr1.153645000.153650000","chr1.153960000.153965000",315000,41,5.146187e-34,153645000,153960000,153650000,153965000,"chr1",26787,1,7,6,14,"chr1",1,0.0672761368963901
"980","chr1.51990000.51995000","chr1.52030000.52035000",40000,28,0.0005784227,51990000,52030000,51995000,52035000,"chr1",26796,1,14,10,25,"chr1",1,0.0820440693858415
"981","chr1.210600000.210605000","chr1.211305000.211310000",705000,15,8.197324e-10,210600000,211305000,210605000,211310000,"chr1",26830,0,2,0,2,"chr1",1,0.00351617440225035
"982","chr1.21235000.21240000","chr1.21255000.21260000",20000,36,0.008632247,21235000,21255000,21240000,21260000,"chr1",26903,3,8,6,17,"chr1",1,0.0717299578059072
"983","chr1.16960000.16965000","chr1.17000000.17005000",40000,25,0.006608083,16960000,1.7e+07,16965000,17005000,"chr1",26931,3,11,12,26,"chr1",1,0.0761837787154243
"984","chr1.237210000.237215000","chr1.237560000.237565000",350000,11,0.00119049,237210000,237560000,237215000,237565000,"chr1",26951,1,7,2,10,"chr1",1,0.012892639474918
"985","chr1.46405000.46410000","chr1.46445000.46450000",40000,26,0.003086748,46405000,46445000,46410000,46450000,"chr1",26970,1,1,10,12,"chr1",1,0.0365682137834037
"986","chr1.9250000.9255000","chr1.9345000.9350000",95000,17,0.003397074,9250000,9345000,9255000,9350000,"chr1",27008,1,7,4,12,"chr1",1,0.0239099859353024
"987","chr1.160075000.160080000","chr1.160180000.160185000",105000,20,4.589527e-05,160075000,160180000,160080000,160185000,"chr1",27038,1,2,1,4,"chr1",1,0.00937646507266761
"988","chr1.156130000.156135000","chr1.156225000.156230000",95000,16,0.009001332,156130000,156225000,156135000,156230000,"chr1",27076,5,19,16,40,"chr1",1,0.0750117205813408
"989","chr1.21330000.21335000","chr1.21435000.21440000",105000,16,0.004620068,21330000,21435000,21335000,21440000,"chr1",27297,4,11,10,25,"chr1",1,0.046882325363338
"990","chr1.43705000.43710000","chr1.43890000.43895000",185000,13,0.004288904,43705000,43890000,43710000,43895000,"chr1",27319,6,12,9,27,"chr1",1,0.0411392405063291
"991","chr1.43380000.43385000","chr1.43525000.43530000",145000,15,0.001879154,43380000,43525000,43385000,43530000,"chr1",27323,1,0,2,3,"chr1",1,0.00527426160337553
"992","chr1.155270000.155275000","chr1.155830000.155835000",560000,8,0.00838272,155270000,155830000,155275000,155835000,"chr1",27345,5,13,8,26,"chr1",1,0.0243788091889358
"993","chr1.10065000.10070000","chr1.10105000.10110000",40000,30,9.14609e-05,10065000,10105000,10070000,10110000,"chr1",27354,0,7,5,12,"chr1",1,0.0421940928270042
"994","chr1.161150000.161155000","chr1.161185000.161190000",35000,30,0.0006685884,161150000,161185000,161155000,161190000,"chr1",27362,7,9,5,21,"chr1",1,0.0738396624472574
"995","chr1.156050000.156055000","chr1.156190000.156195000",140000,17,0.000209311,156050000,156190000,156055000,156195000,"chr1",27368,0,3,1,4,"chr1",1,0.00796999531176746
"996","chr1.1775000.1780000","chr1.1795000.1800000",20000,36,0.008632247,1775000,1795000,1780000,1800000,"chr1",27466,1,6,11,18,"chr1",1,0.0759493670886076
"997","chr1.153655000.153660000","chr1.153960000.153965000",305000,16,7.829034e-07,153655000,153960000,153660000,153965000,"chr1",27499,1,7,6,14,"chr1",1,0.0262541022034693
"998","chr1.206910000.206915000","chr1.207075000.207080000",165000,16,0.0002232684,206910000,207075000,206915000,207080000,"chr1",27520,2,2,0,4,"chr1",1,0.00750117205813408
"999","chr1.19730000.19735000","chr1.19755000.19760000",25000,34,0.006227396,19730000,19755000,19735000,19760000,"chr1",27532,3,13,11,27,"chr1",1,0.107594936708861
"1000","chr1.155645000.155650000","chr1.155895000.155900000",250000,12,0.002176934,155645000,155895000,155650000,155900000,"chr1",27562,2,25,25,52,"chr1",1,0.0731364275668073
"1001","chr1.19740000.19745000","chr1.19760000.19765000",20000,44,3.073313e-05,19740000,19760000,19745000,19765000,"chr1",27565,3,3,2,8,"chr1",1,0.0412564463197375
"1002","chr1.8710000.8715000","chr1.8885000.8890000",175000,17,3.417486e-05,8710000,8885000,8715000,8890000,"chr1",27590,1,15,11,27,"chr1",1,0.0537974683544304
"1003","chr1.201540000.201545000","chr1.201705000.201710000",165000,18,1.347837e-05,201540000,201705000,201545000,201710000,"chr1",27594,1,2,2,5,"chr1",1,0.0105485232067511
"1004","chr1.202965000.202970000","chr1.203235000.203240000",270000,11,0.004966,202965000,203235000,202970000,203240000,"chr1",27629,2,6,7,15,"chr1",1,0.0193389592123769
"1005","chr1.78000000.78005000","chr1.78135000.78140000",135000,24,8.457785e-09,7.8e+07,78135000,78005000,78140000,"chr1",27638,5,11,10,26,"chr1",1,0.0731364275668073
"1006","chr1.197180000.197185000","chr1.197315000.197320000",135000,20,4.517402e-06,197180000,197315000,197185000,197320000,"chr1",27649,1,6,6,13,"chr1",1,0.0304735114861697
"1007","chr1.31295000.31300000","chr1.31380000.31385000",85000,24,2.655108e-06,31295000,31380000,31300000,31385000,"chr1",27665,1,2,3,6,"chr1",1,0.0168776371308017
"1008","chr1.11910000.11915000","chr1.11960000.11965000",50000,25,0.0006470043,11910000,11960000,11915000,11965000,"chr1",27724,5,6,7,18,"chr1",1,0.0527426160337553
"1009","chr1.39555000.39560000","chr1.39750000.39755000",195000,13,0.003098721,39555000,39750000,39560000,39755000,"chr1",27744,6,5,8,19,"chr1",1,0.0289498359118612
"1010","chr1.228830000.228835000","chr1.229275000.229280000",445000,14,1.181385e-06,228830000,229275000,228835000,229280000,"chr1",27756,1,2,5,8,"chr1",1,0.0131270511017346
"1011","chr1.95080000.95085000","chr1.95230000.95235000",150000,14,0.004757005,95080000,95230000,95085000,95235000,"chr1",27800,0,4,6,10,"chr1",1,0.0164088138771683
"1012","chr1.229425000.229430000","chr1.229595000.229600000",170000,13,0.00702836,229425000,229595000,229430000,229600000,"chr1",27820,2,6,7,15,"chr1",1,0.0228551336146273
"1013","chr1.171710000.171715000","chr1.171740000.171745000",30000,33,0.0006782985,171710000,171740000,171715000,171745000,"chr1",27859,4,3,3,10,"chr1",1,0.0386779184247539
"1014","chr1.16870000.16875000","chr1.17055000.17060000",185000,53,6.301276e-41,16870000,17055000,16875000,17060000,"chr1",27910,1,2,2,5,"chr1",1,0.0310595405532114
"1015","chr1.205345000.205350000","chr1.205420000.205425000",75000,21,0.0004093387,205345000,205420000,205350000,205425000,"chr1",27918,2,3,0,5,"chr1",1,0.0123066104078762
"1016","chr1.212410000.212415000","chr1.212430000.212435000",20000,38,0.00252151,212410000,212430000,212415000,212435000,"chr1",27926,0,2,1,3,"chr1",1,0.0133614627285513
"1017","chr1.32400000.32405000","chr1.32535000.32540000",135000,14,0.008425895,32400000,32535000,32405000,32540000,"chr1",27927,6,11,10,27,"chr1",1,0.0443037974683544
"1018","chr1.9765000.9770000","chr1.9860000.9865000",95000,19,0.0003929148,9765000,9860000,9770000,9865000,"chr1",27978,0,7,9,16,"chr1",1,0.0356305672761369
"1019","chr1.10000000.10005000","chr1.10210000.10215000",210000,26,3.109187e-13,1e+07,10210000,10005000,10215000,"chr1",27984,5,16,13,34,"chr1",1,0.103609939052977
"1020","chr1.32870000.32875000","chr1.33080000.33085000",210000,15,0.0001254468,32870000,33080000,32875000,33085000,"chr1",27995,0,2,2,4,"chr1",1,0.0070323488045007
"1021","chr1.204130000.204135000","chr1.204330000.204335000",200000,14,0.0007239502,204130000,204330000,204135000,204335000,"chr1",28012,1,3,5,9,"chr1",1,0.0147679324894515
"1022","chr1.171800000.171805000","chr1.171955000.171960000",155000,21,2.478881e-07,171800000,171955000,171805000,171960000,"chr1",28046,0,0,1,1,"chr1",1,0.00246132208157525
"1023","chr1.243850000.243855000","chr1.244340000.244345000",490000,10,0.0007771036,243850000,244340000,243855000,244345000,"chr1",28060,2,9,8,19,"chr1",1,0.0222691045475856
"1024","chr1.243505000.243510000","chr1.244110000.244115000",605000,11,2.919792e-05,243505000,244110000,243510000,244115000,"chr1",28063,0,2,1,3,"chr1",1,0.00386779184247539
"1025","chr1.153695000.153700000","chr1.154155000.154160000",460000,12,3.881624e-05,153695000,154155000,153700000,154160000,"chr1",28080,1,2,1,4,"chr1",1,0.00562587904360056
"1026","chr1.223990000.223995000","chr1.224355000.224360000",365000,10,0.003996944,223990000,224355000,223995000,224360000,"chr1",28146,7,25,23,55,"chr1",1,0.0644631973745898
"1027","chr1.203305000.203310000","chr1.203425000.203430000",120000,25,6.656583e-09,203305000,203425000,203310000,203430000,"chr1",28160,0,1,2,3,"chr1",1,0.00879043600562588
"1028","chr1.33050000.33055000","chr1.33070000.33075000",20000,37,0.004733079,33050000,33070000,33055000,33075000,"chr1",28171,1,7,7,15,"chr1",1,0.0650492264416315
"1029","chr1.8465000.8470000","chr1.8590000.8595000",125000,15,0.004449684,8465000,8590000,8470000,8595000,"chr1",28175,5,11,10,26,"chr1",1,0.0457102672292546
"1030","chr1.180500000.180505000","chr1.181140000.181145000",640000,8,0.004222767,180500000,181140000,180505000,181145000,"chr1",28193,0,2,1,3,"chr1",1,0.00281293952180028
"1031","chr1.204395000.204400000","chr1.204415000.204420000",20000,42,0.0001481797,204395000,204415000,204400000,204420000,"chr1",28224,11,25,18,54,"chr1",1,0.265822784810127
"1032","chr1.42035000.42040000","chr1.42655000.42660000",620000,8,0.004946176,42035000,42655000,42040000,42660000,"chr1",28239,0,0,5,5,"chr1",1,0.0046882325363338
"1033","chr1.43545000.43550000","chr1.43855000.43860000",310000,12,0.0005547613,43545000,43855000,43550000,43860000,"chr1",28249,1,1,0,2,"chr1",1,0.00281293952180028
"1034","chr1.201495000.201500000","chr1.201740000.201745000",245000,11,0.008599339,201495000,201740000,201500000,201745000,"chr1",28272,1,3,1,5,"chr1",1,0.00644631973745898
"1035","chr1.229660000.229665000","chr1.230320000.230325000",660000,8,0.003582442,229660000,230320000,229665000,230325000,"chr1",28306,3,3,2,8,"chr1",1,0.00750117205813408
"1036","chr1.228790000.228795000","chr1.229405000.229410000",615000,8,0.005163365,228790000,229405000,228795000,229410000,"chr1",28317,0,2,1,3,"chr1",1,0.00281293952180028
"1037","chr1.68230000.68235000","chr1.68310000.68315000",80000,18,0.004760983,68230000,68310000,68235000,68315000,"chr1",28365,0,2,3,5,"chr1",1,0.0105485232067511
"1038","chr1.44900000.44905000","chr1.44945000.44950000",45000,57,1.064257e-22,44900000,44945000,44905000,44950000,"chr1",28373,5,7,14,26,"chr1",1,0.173699015471167
"1039","chr1.153750000.153755000","chr1.153960000.153965000",210000,12,0.00640887,153750000,153960000,153755000,153965000,"chr1",28381,1,7,6,14,"chr1",1,0.019690576652602
"1040","chr1.11285000.11290000","chr1.11700000.11705000",415000,9,0.008599339,11285000,11700000,11290000,11705000,"chr1",28386,0,2,1,3,"chr1",1,0.00316455696202532
"1041","chr1.160005000.160010000","chr1.160045000.160050000",40000,29,0.0002333342,160005000,160045000,160010000,160050000,"chr1",28387,1,0,1,2,"chr1",1,0.00679793717768401
"1042","chr1.155195000.155200000","chr1.155830000.155835000",635000,9,0.0008171443,155195000,155830000,155200000,155835000,"chr1",28419,0,2,10,12,"chr1",1,0.0126582278481013
"1043","chr1.64160000.64165000","chr1.64685000.64690000",525000,10,0.0005052645,64160000,64685000,64165000,64690000,"chr1",28424,1,2,0,3,"chr1",1,0.00351617440225035
"1044","chr1.39575000.39580000","chr1.39720000.39725000",145000,22,1.017687e-07,39575000,39720000,39580000,39725000,"chr1",28452,2,6,7,15,"chr1",1,0.0386779184247539
"1045","chr1.10000000.10005000","chr1.10395000.10400000",395000,10,0.002714357,1e+07,10395000,10005000,10400000,"chr1",28497,5,19,24,48,"chr1",1,0.0562587904360056
"1046","chr1.204185000.204190000","chr1.204325000.204330000",140000,23,2.934927e-08,204185000,204325000,204190000,204330000,"chr1",28499,4,17,20,41,"chr1",1,0.110525082044069
"1047","chr1.54315000.54320000","chr1.55215000.55220000",900000,8,0.0005912251,54315000,55215000,54320000,55220000,"chr1",28510,2,6,3,11,"chr1",1,0.0103141115799344
"1048","chr1.10105000.10110000","chr1.10140000.10145000",35000,37,8.177368e-07,10105000,10140000,10110000,10145000,"chr1",28549,0,7,5,12,"chr1",1,0.0520393811533052
"1049","chr1.225675000.225680000","chr1.226110000.226115000",435000,11,0.0003253501,225675000,226110000,225680000,226115000,"chr1",28581,4,6,7,17,"chr1",1,0.0219174871073605
"1050","chr1.116910000.116915000","chr1.117015000.117020000",105000,17,0.001605476,116910000,117015000,116915000,117020000,"chr1",28615,2,1,0,3,"chr1",1,0.0059774964838256
"1051","chr1.160260000.160265000","chr1.160310000.160315000",50000,30,3.553513e-06,160260000,160310000,160265000,160315000,"chr1",28646,0,2,2,4,"chr1",1,0.0140646976090014
"1052","chr1.201480000.201485000","chr1.201505000.201510000",25000,34,0.006227396,201480000,201505000,201485000,201510000,"chr1",28682,1,1,0,2,"chr1",1,0.00796999531176746
"1053","chr1.202900000.202905000","chr1.202940000.202945000",40000,25,0.006608083,202900000,202940000,202905000,202945000,"chr1",28714,0,9,5,14,"chr1",1,0.0410220346929208
"1054","chr1.183610000.183615000","chr1.184015000.184020000",405000,11,0.0005159089,183610000,184015000,183615000,184020000,"chr1",28722,1,2,3,6,"chr1",1,0.00773558368495077
"1055","chr1.39880000.39885000","chr1.39900000.39905000",20000,40,0.0006470043,39880000,39900000,39885000,39905000,"chr1",28726,5,14,14,33,"chr1",1,0.154711673699015
"1056","chr1.204305000.204310000","chr1.204325000.204330000",20000,38,0.00252151,204305000,204325000,204310000,204330000,"chr1",28773,4,12,16,32,"chr1",1,0.142522269104548
"1057","chr1.202900000.202905000","chr1.203265000.203270000",365000,10,0.003996944,202900000,203265000,202905000,203270000,"chr1",28829,13,16,13,42,"chr1",1,0.0492264416315049
"1058","chr1.23015000.23020000","chr1.23215000.23220000",200000,12,0.008520915,23015000,23215000,23020000,23220000,"chr1",28849,4,5,15,24,"chr1",1,0.0337552742616034
"1059","chr1.203100000.203105000","chr1.203130000.203135000",30000,49,4.884895e-11,203100000,203130000,203105000,203135000,"chr1",28859,0,2,2,4,"chr1",1,0.0229723394280356
"1060","chr1.204380000.204385000","chr1.204475000.204480000",95000,36,1.23461e-15,204380000,204475000,204385000,204480000,"chr1",28885,2,3,2,7,"chr1",1,0.029535864978903
"1061","chr1.205630000.205635000","chr1.205680000.205685000",50000,23,0.003767084,205630000,205680000,205635000,205685000,"chr1",28898,1,6,4,11,"chr1",1,0.0296530707923113
"1062","chr1.153670000.153675000","chr1.153725000.153730000",55000,22,0.003601062,153670000,153725000,153675000,153730000,"chr1",28899,9,36,44,89,"chr1",1,0.22948898265354
"1063","chr1.26825000.26830000","chr1.27120000.27125000",295000,13,0.0001675256,26825000,27120000,26830000,27125000,"chr1",28905,0,3,1,4,"chr1",1,0.00609470229723394
"1064","chr1.167715000.167720000","chr1.167760000.167765000",45000,33,5.735131e-07,167715000,167760000,167720000,167765000,"chr1",28938,0,3,4,7,"chr1",1,0.0270745428973277
"1065","chr1.234310000.234315000","chr1.234430000.234435000",120000,15,0.005618157,234310000,234430000,234315000,234435000,"chr1",28940,0,4,2,6,"chr1",1,0.0105485232067511
"1066","chr1.155915000.155920000","chr1.155960000.155965000",45000,42,4.190888e-12,155915000,155960000,155920000,155965000,"chr1",28973,6,10,23,39,"chr1",1,0.191983122362869
"1067","chr1.182160000.182165000","chr1.182345000.182350000",185000,23,8.540441e-10,182160000,182345000,182165000,182350000,"chr1",28975,0,4,2,6,"chr1",1,0.0161744022503516
"1068","chr1.109655000.109660000","chr1.109700000.109705000",45000,30,1.636532e-05,109655000,109700000,109660000,109705000,"chr1",28988,0,0,2,2,"chr1",1,0.0070323488045007
"1069","chr1.43350000.43355000","chr1.43545000.43550000",195000,12,0.009750873,43350000,43545000,43355000,43550000,"chr1",29016,1,1,0,2,"chr1",1,0.00281293952180028
"1070","chr1.226825000.226830000","chr1.226910000.226915000",85000,18,0.003006639,226825000,226910000,226830000,226915000,"chr1",29034,1,13,7,21,"chr1",1,0.0443037974683544
"1071","chr1.204345000.204350000","chr1.204365000.204370000",20000,72,7.786356e-19,204345000,204365000,204350000,204370000,"chr1",29079,0,1,1,2,"chr1",1,0.0168776371308017
"1072","chr1.156130000.156135000","chr1.156150000.156155000",20000,38,0.00252151,156130000,156150000,156135000,156155000,"chr1",29083,0,1,0,1,"chr1",1,0.00445382090951711
"1073","chr1.155830000.155835000","chr1.156020000.156025000",190000,18,3.385262e-06,155830000,156020000,155835000,156025000,"chr1",29092,10,21,17,48,"chr1",1,0.10126582278481
"1074","chr1.150055000.150060000","chr1.150925000.150930000",870000,8,0.0007334153,150055000,150925000,150060000,150930000,"chr1",29114,3,7,13,23,"chr1",1,0.0215658696671355
"1075","chr1.116910000.116915000","chr1.117030000.117035000",120000,29,6.60818e-12,116910000,117030000,116915000,117035000,"chr1",29167,3,2,2,7,"chr1",1,0.023792780121894
"1076","chr1.153630000.153635000","chr1.153695000.153700000",65000,21,0.001695142,153630000,153695000,153635000,153700000,"chr1",29170,3,19,23,45,"chr1",1,0.110759493670886
"1077","chr1.201550000.201555000","chr1.201945000.201950000",395000,11,0.0006001318,201550000,201945000,201555000,201950000,"chr1",29228,2,3,4,9,"chr1",1,0.0116033755274262
"1078","chr1.35675000.35680000","chr1.36220000.36225000",545000,9,0.002062305,35675000,36220000,35680000,36225000,"chr1",29296,4,19,13,36,"chr1",1,0.0379746835443038
"1079","chr1.16930000.16935000","chr1.17045000.17050000",115000,36,1.91554e-17,16930000,17045000,16935000,17050000,"chr1",29299,8,24,14,46,"chr1",1,0.194092827004219
"1080","chr1.151145000.151150000","chr1.151165000.151170000",20000,43,6.896909e-05,151145000,151165000,151150000,151170000,"chr1",29305,0,5,3,8,"chr1",1,0.0403187998124707
"1081","chr1.116705000.116710000","chr1.116920000.116925000",215000,19,1.626214e-07,116705000,116920000,116710000,116925000,"chr1",29418,0,7,6,13,"chr1",1,0.0289498359118612
"1082","chr1.26220000.26225000","chr1.26315000.26320000",95000,40,4.986853e-19,26220000,26315000,26225000,26320000,"chr1",29453,8,12,15,35,"chr1",1,0.164088138771683
"1083","chr1.10030000.10035000","chr1.10160000.10165000",130000,28,1.263257e-11,10030000,10160000,10035000,10165000,"chr1",29475,0,6,12,18,"chr1",1,0.0590717299578059
"1084","chr1.88995000.89000000","chr1.89555000.89560000",560000,8,0.00838272,88995000,89555000,8.9e+07,89560000,"chr1",29490,2,0,4,6,"chr1",1,0.00562587904360056
"1085","chr1.16930000.16935000","chr1.17050000.17055000",120000,38,1.24493e-19,16930000,17050000,16935000,17055000,"chr1",29556,2,14,14,30,"chr1",1,0.133614627285513
"1086","chr1.160075000.160080000","chr1.160165000.160170000",90000,27,1.647941e-08,160075000,160165000,160080000,160170000,"chr1",29562,0,2,1,3,"chr1",1,0.00949367088607595
"1087","chr1.203860000.203865000","chr1.204075000.204080000",215000,13,0.001605476,203860000,204075000,203865000,204080000,"chr1",29564,0,5,6,11,"chr1",1,0.0167604313173933
"1088","chr1.116705000.116710000","chr1.116910000.116915000",205000,13,0.002217414,116705000,116910000,116710000,116915000,"chr1",29604,0,8,9,17,"chr1",1,0.0259024847632443
"1089","chr1.8470000.8475000","chr1.8915000.8920000",445000,10,0.00139887,8470000,8915000,8475000,8920000,"chr1",29641,5,13,8,26,"chr1",1,0.0304735114861697
"1090","chr1.155305000.155310000","chr1.155500000.155505000",195000,18,2.591232e-06,155305000,155500000,155310000,155505000,"chr1",29651,1,9,4,14,"chr1",1,0.029535864978903
"1091","chr1.40610000.40615000","chr1.40760000.40765000",150000,15,0.001520338,40610000,40760000,40615000,40765000,"chr1",29668,2,9,10,21,"chr1",1,0.0369198312236287
"1092","chr1.212230000.212235000","chr1.212410000.212415000",180000,13,0.005018612,212230000,212410000,212235000,212415000,"chr1",29769,0,1,1,2,"chr1",1,0.00304735114861697
"1093","chr1.16155000.16160000","chr1.16215000.16220000",60000,24,0.0002105081,16155000,16215000,16160000,16220000,"chr1",29789,0,1,1,2,"chr1",1,0.00562587904360056
"1094","chr1.109575000.109580000","chr1.109655000.109660000",80000,20,0.0006470043,109575000,109655000,109580000,109660000,"chr1",29795,0,3,3,6,"chr1",1,0.0140646976090014
"1095","chr1.110335000.110340000","chr1.110555000.110560000",220000,13,0.00137653,110335000,110555000,110340000,110560000,"chr1",29799,0,2,2,4,"chr1",1,0.00609470229723394
"1096","chr1.27010000.27015000","chr1.27030000.27035000",20000,42,0.0001481797,27010000,27030000,27015000,27035000,"chr1",29812,2,3,5,10,"chr1",1,0.0492264416315049
"1097","chr1.11380000.11385000","chr1.11485000.11490000",105000,16,0.004620068,11380000,11485000,11385000,11490000,"chr1",29835,2,3,2,7,"chr1",1,0.0131270511017346
"1098","chr1.155225000.155230000","chr1.156010000.156015000",785000,8,0.001386725,155225000,156010000,155230000,156015000,"chr1",29872,7,27,10,44,"chr1",1,0.0412564463197375
"1099","chr1.205590000.205595000","chr1.205680000.205685000",90000,19,0.0006470043,205590000,205680000,205595000,205685000,"chr1",29874,1,5,9,15,"chr1",1,0.0334036568213783
"1100","chr1.228840000.228845000","chr1.229625000.229630000",785000,7,0.007719712,228840000,229625000,228845000,229630000,"chr1",29881,2,1,5,8,"chr1",1,0.00656352555086732
"1101","chr1.23020000.23025000","chr1.23215000.23220000",195000,21,1.593197e-08,23020000,23215000,23025000,23220000,"chr1",29901,4,5,13,22,"chr1",1,0.0541490857946554
"1102","chr1.16640000.16645000","chr1.16930000.16935000",290000,11,0.00333935,16640000,16930000,16645000,16935000,"chr1",29902,3,2,7,12,"chr1",1,0.0154711673699015
"1103","chr1.211585000.211590000","chr1.211830000.211835000",245000,16,6.525218e-06,211585000,211830000,211590000,211835000,"chr1",29907,0,2,0,2,"chr1",1,0.00375058602906704
"1104","chr1.54670000.54675000","chr1.54935000.54940000",265000,15,1.636532e-05,54670000,54935000,54675000,54940000,"chr1",29946,2,10,9,21,"chr1",1,0.0369198312236287
"1105","chr1.10045000.10050000","chr1.10210000.10215000",165000,21,1.239633e-07,10045000,10210000,10050000,10215000,"chr1",29990,6,6,12,24,"chr1",1,0.0590717299578059
"1106","chr1.150230000.150235000","chr1.150255000.150260000",25000,47,1.359094e-07,150230000,150255000,150235000,150260000,"chr1",30006,0,5,1,6,"chr1",1,0.0330520393811533
"1107","chr1.10075000.10080000","chr1.10140000.10145000",65000,21,0.001695142,10075000,10140000,10080000,10145000,"chr1",30057,1,14,11,26,"chr1",1,0.0639943741209564
"1108","chr1.204935000.204940000","chr1.205230000.205235000",295000,16,1.074264e-06,204935000,205230000,204940000,205235000,"chr1",30062,1,1,2,4,"chr1",1,0.00750117205813408
"1109","chr1.155895000.155900000","chr1.155955000.155960000",60000,28,2.282334e-06,155895000,155955000,155900000,155960000,"chr1",30097,6,25,27,58,"chr1",1,0.190342240975152
"1110","chr1.235415000.235420000","chr1.235500000.235505000",85000,17,0.007758048,235415000,235500000,235420000,235505000,"chr1",30131,1,5,8,14,"chr1",1,0.0278949835911861
"1111","chr1.156410000.156415000","chr1.156570000.156575000",160000,16,0.0002827585,156410000,156570000,156415000,156575000,"chr1",30202,0,3,7,10,"chr1",1,0.0187529301453352
"1112","chr1.201530000.201535000","chr1.201970000.201975000",440000,9,0.006488163,201530000,201970000,201535000,201975000,"chr1",30307,4,2,7,13,"chr1",1,0.0137130801687764
"1113","chr1.9345000.9350000","chr1.9555000.9560000",210000,20,3.721265e-08,9345000,9555000,9350000,9560000,"chr1",30313,1,7,4,12,"chr1",1,0.0281293952180028
"1114","chr1.228865000.228870000","chr1.229235000.229240000",370000,12,0.0001816027,228865000,229235000,228870000,229240000,"chr1",30342,0,4,3,7,"chr1",1,0.00984528832630099
"1115","chr1.212505000.212510000","chr1.212540000.212545000",35000,30,0.0006685884,212505000,212540000,212510000,212545000,"chr1",30360,2,5,2,9,"chr1",1,0.0316455696202532
"1116","chr1.51235000.51240000","chr1.51410000.51415000",175000,16,0.0001391493,51235000,51410000,51240000,51415000,"chr1",30363,7,14,12,33,"chr1",1,0.0618846694796062
"1117","chr1.28735000.28740000","chr1.29200000.29205000",465000,9,0.004886133,28735000,29200000,28740000,29205000,"chr1",30365,1,3,2,6,"chr1",1,0.00632911392405063
"1118","chr1.9690000.9695000","chr1.10470000.10475000",780000,8,0.001445779,9690000,10470000,9695000,10475000,"chr1",30405,4,15,24,43,"chr1",1,0.0403187998124707
"1119","chr1.116705000.116710000","chr1.117030000.117035000",325000,21,1.535025e-11,116705000,117030000,116710000,117035000,"chr1",30412,0,2,2,4,"chr1",1,0.00984528832630099
"1120","chr1.109575000.109580000","chr1.109600000.109605000",25000,48,4.908096e-08,109575000,109600000,109580000,109605000,"chr1",30413,0,3,1,4,"chr1",1,0.0225035161744023
"1121","chr1.39570000.39575000","chr1.39815000.39820000",245000,13,0.0006470043,39570000,39815000,39575000,39820000,"chr1",30459,4,5,6,15,"chr1",1,0.0228551336146273
"1122","chr1.228900000.228905000","chr1.229235000.229240000",335000,10,0.006041478,228900000,229235000,228905000,229240000,"chr1",30567,0,1,2,3,"chr1",1,0.00351617440225035
"1123","chr1.9200000.9205000","chr1.9290000.9295000",90000,19,0.0006470043,9200000,9290000,9205000,9295000,"chr1",30575,0,0,4,4,"chr1",1,0.00890764181903422
"1124","chr1.2150000.2155000","chr1.2190000.2195000",40000,25,0.006608083,2150000,2190000,2155000,2195000,"chr1",30588,2,3,0,5,"chr1",1,0.0146507266760431
"1125","chr1.174745000.174750000","chr1.174955000.174960000",210000,19,2.148805e-07,174745000,174955000,174750000,174960000,"chr1",30591,6,6,14,26,"chr1",1,0.0578996718237225
"1126","chr1.234755000.234760000","chr1.234965000.234970000",210000,13,0.001879154,234755000,234965000,234760000,234970000,"chr1",30601,0,1,2,3,"chr1",1,0.00457102672292546
"1127","chr1.175445000.175450000","chr1.175855000.175860000",410000,10,0.002213559,175445000,175855000,175450000,175860000,"chr1",30627,0,3,1,4,"chr1",1,0.0046882325363338
"1128","chr1.42815000.42820000","chr1.42890000.42895000",75000,19,0.003125299,42815000,42890000,42820000,42895000,"chr1",30655,0,3,6,9,"chr1",1,0.020042194092827
"1129","chr1.9860000.9865000","chr1.10295000.10300000",435000,10,0.001590574,9860000,10295000,9865000,10300000,"chr1",30665,1,3,5,9,"chr1",1,0.0105485232067511
"1130","chr1.236520000.236525000","chr1.236540000.236545000",20000,37,0.004733079,236520000,236540000,236525000,236545000,"chr1",30700,2,4,7,13,"chr1",1,0.056375996249414
"1131","chr1.26415000.26420000","chr1.26740000.26745000",325000,10,0.006950379,26415000,26740000,26420000,26745000,"chr1",30706,0,4,8,12,"chr1",1,0.0140646976090014
"1132","chr1.19210000.19215000","chr1.19285000.19290000",75000,23,4.328812e-05,19210000,19285000,19215000,19290000,"chr1",30712,2,1,2,5,"chr1",1,0.0134786685419597
"1133","chr1.161285000.161290000","chr1.161355000.161360000",70000,22,0.0002882227,161285000,161355000,161290000,161360000,"chr1",30780,7,34,22,63,"chr1",1,0.162447257383966
"1134","chr1.171780000.171785000","chr1.171800000.171805000",20000,41,0.0003129283,171780000,171800000,171785000,171805000,"chr1",30835,1,1,1,3,"chr1",1,0.0144163150492264
"1135","chr1.39395000.39400000","chr1.39455000.39460000",60000,24,0.0002105081,39395000,39455000,39400000,39460000,"chr1",30874,0,2,1,3,"chr1",1,0.00843881856540084
"1136","chr1.10280000.10285000","chr1.10385000.10390000",105000,18,0.0005300991,10280000,10385000,10285000,10390000,"chr1",30884,9,28,28,65,"chr1",1,0.137130801687764
"1137","chr1.8455000.8460000","chr1.8510000.8515000",55000,27,2.643362e-05,8455000,8510000,8460000,8515000,"chr1",30894,2,3,6,11,"chr1",1,0.0348101265822785
"1138","chr1.27280000.27285000","chr1.27300000.27305000",20000,39,0.00129403,27280000,27300000,27285000,27305000,"chr1",30918,1,4,4,9,"chr1",1,0.0411392405063291
"1139","chr1.228900000.228905000","chr1.229510000.229515000",610000,8,0.005414923,228900000,229510000,228905000,229515000,"chr1",30976,2,1,2,5,"chr1",1,0.0046882325363338
"1140","chr1.203305000.203310000","chr1.203325000.203330000",20000,36,0.008632247,203305000,203325000,203310000,203330000,"chr1",30993,0,0,2,2,"chr1",1,0.00843881856540084
"1141","chr1.44725000.44730000","chr1.45135000.45140000",410000,12,9.14609e-05,44725000,45135000,44730000,45140000,"chr1",31007,5,22,33,60,"chr1",1,0.0843881856540084
"1142","chr1.65215000.65220000","chr1.65260000.65265000",45000,27,0.0003258119,65215000,65260000,65220000,65265000,"chr1",31017,2,2,1,5,"chr1",1,0.0158227848101266
"1143","chr1.54335000.54340000","chr1.54495000.54500000",160000,13,0.009763887,54335000,54495000,54340000,54500000,"chr1",31024,1,3,1,5,"chr1",1,0.00761837787154243
"1144","chr1.8815000.8820000","chr1.8835000.8840000",20000,42,0.0001481797,8815000,8835000,8820000,8840000,"chr1",31034,0,7,5,12,"chr1",1,0.0590717299578059
"1145","chr1.182110000.182115000","chr1.182280000.182285000",170000,13,0.00702836,182110000,182280000,182115000,182285000,"chr1",31049,3,7,3,13,"chr1",1,0.0198077824660103
"1146","chr1.109985000.109990000","chr1.110010000.110015000",25000,40,7.966121e-05,109985000,110010000,109990000,110015000,"chr1",31085,0,4,3,7,"chr1",1,0.0328176277543366
"1147","chr1.150160000.150165000","chr1.150180000.150185000",20000,42,0.0001481797,150160000,150180000,150165000,150185000,"chr1",31086,1,2,4,7,"chr1",1,0.0344585091420534
"1148","chr1.87895000.87900000","chr1.87950000.87955000",55000,23,0.001500618,87895000,87950000,87900000,87955000,"chr1",31122,0,0,4,4,"chr1",1,0.0107829348335677
"1149","chr1.21330000.21335000","chr1.21505000.21510000",175000,14,0.001856842,21330000,21505000,21335000,21510000,"chr1",31139,4,11,10,25,"chr1",1,0.0410220346929208
"1150","chr1.201550000.201555000","chr1.201655000.201660000",105000,19,0.0001598251,201550000,201655000,201555000,201660000,"chr1",31143,3,4,5,12,"chr1",1,0.0267229254571027
"1151","chr1.6285000.6290000","chr1.6610000.6615000",325000,10,0.006950379,6285000,6610000,6290000,6615000,"chr1",31151,5,11,10,26,"chr1",1,0.0304735114861697
"1152","chr1.161150000.161155000","chr1.161355000.161360000",205000,20,5.009599e-08,161150000,161355000,161155000,161360000,"chr1",31205,11,27,22,60,"chr1",1,0.140646976090014
"1153","chr1.9950000.9955000","chr1.10210000.10215000",260000,13,0.0004157809,9950000,10210000,9955000,10215000,"chr1",31217,6,16,13,35,"chr1",1,0.053328645100797
"1154","chr1.23365000.23370000","chr1.23395000.23400000",30000,45,5.709864e-09,23365000,23395000,23370000,23400000,"chr1",31260,1,5,2,8,"chr1",1,0.0421940928270042
"1155","chr1.40080000.40085000","chr1.40140000.40145000",60000,22,0.001506977,40080000,40140000,40085000,40145000,"chr1",31318,0,5,3,8,"chr1",1,0.0206282231598687
"1156","chr1.171985000.171990000","chr1.172370000.172375000",385000,11,0.0006842267,171985000,172370000,171990000,172375000,"chr1",31344,2,0,2,4,"chr1",1,0.00515705578996718
"1157","chr1.27045000.27050000","chr1.27100000.27105000",55000,21,0.00838272,27045000,27100000,27050000,27105000,"chr1",31358,1,2,2,5,"chr1",1,0.0123066104078762
"1158","chr1.9840000.9845000","chr1.9860000.9865000",20000,57,1.009568e-10,9840000,9860000,9845000,9865000,"chr1",31374,1,7,4,12,"chr1",1,0.080168776371308
"1159","chr1.151370000.151375000","chr1.151805000.151810000",435000,12,5.973985e-05,151370000,151805000,151375000,151810000,"chr1",31384,1,2,3,6,"chr1",1,0.00843881856540084
"1160","chr1.10070000.10075000","chr1.10150000.10155000",80000,20,0.0006470043,10070000,10150000,10075000,10155000,"chr1",31426,7,11,15,33,"chr1",1,0.0773558368495077
"1161","chr1.9930000.9935000","chr1.10000000.10005000",70000,21,0.0008075999,9930000,1e+07,9935000,10005000,"chr1",31430,5,19,20,44,"chr1",1,0.108298171589311
"1162","chr1.10055000.10060000","chr1.10175000.10180000",120000,15,0.005618157,10055000,10175000,10060000,10180000,"chr1",31473,7,13,22,42,"chr1",1,0.0738396624472574
"1163","chr1.155225000.155230000","chr1.155830000.155835000",605000,8,0.005618348,155225000,155830000,155230000,155835000,"chr1",31475,7,27,10,44,"chr1",1,0.0412564463197375
"1164","chr1.203070000.203075000","chr1.203200000.203205000",130000,22,3.223591e-07,203070000,203200000,203075000,203205000,"chr1",31503,0,3,0,3,"chr1",1,0.00773558368495077
"1165","chr1.28735000.28740000","chr1.28925000.28930000",190000,18,3.385262e-06,28735000,28925000,28740000,28930000,"chr1",31542,1,9,2,12,"chr1",1,0.0253164556962025
"1166","chr1.40280000.40285000","chr1.40380000.40385000",100000,24,3.257567e-07,40280000,40380000,40285000,40385000,"chr1",31553,0,4,1,5,"chr1",1,0.0140646976090014
"1167","chr1.23825000.23830000","chr1.23845000.23850000",20000,37,0.004733079,23825000,23845000,23830000,23850000,"chr1",31568,3,15,14,32,"chr1",1,0.138771683075481
"1168","chr1.161200000.161205000","chr1.161305000.161310000",105000,20,4.589527e-05,161200000,161305000,161205000,161310000,"chr1",31598,1,3,2,6,"chr1",1,0.0140646976090014
"1169","chr1.205180000.205185000","chr1.205225000.205230000",45000,43,9.864893e-13,205180000,205225000,205185000,205230000,"chr1",31654,0,1,1,2,"chr1",1,0.0100796999531177
"1170","chr1.8685000.8690000","chr1.8710000.8715000",25000,61,1.308655e-14,8685000,8710000,8690000,8715000,"chr1",31675,1,15,11,27,"chr1",1,0.193037974683544
"1171","chr1.204410000.204415000","chr1.204465000.204470000",55000,37,6.378105e-11,204410000,204465000,204415000,204470000,"chr1",31680,0,2,2,4,"chr1",1,0.0173464603844351
"1172","chr1.156410000.156415000","chr1.156580000.156585000",170000,14,0.002238629,156410000,156580000,156415000,156585000,"chr1",31685,0,3,2,5,"chr1",1,0.00820440693858415
"1173","chr1.22025000.22030000","chr1.22105000.22110000",80000,34,1.825909e-12,22025000,22105000,22030000,22110000,"chr1",31707,1,2,3,6,"chr1",1,0.0239099859353024
"1174","chr1.45800000.45805000","chr1.45965000.45970000",165000,15,0.0008057805,45800000,45965000,45805000,45970000,"chr1",31780,1,2,3,6,"chr1",1,0.0105485232067511
"1175","chr1.11060000.11065000","chr1.11155000.11160000",95000,16,0.009001332,11060000,11155000,11065000,11160000,"chr1",31791,1,3,3,7,"chr1",1,0.0131270511017346
"1176","chr1.166880000.166885000","chr1.166970000.166975000",90000,20,0.0002098136,166880000,166970000,166885000,166975000,"chr1",31814,1,4,8,13,"chr1",1,0.0304735114861697
"1177","chr1.9290000.9295000","chr1.9345000.9350000",55000,24,0.0005843961,9290000,9345000,9295000,9350000,"chr1",31875,1,7,4,12,"chr1",1,0.0337552742616034
"1178","chr1.168890000.168895000","chr1.169085000.169090000",195000,24,5.954703e-11,168890000,169085000,168895000,169090000,"chr1",31879,0,0,1,1,"chr1",1,0.00281293952180028
"1179","chr1.10045000.10050000","chr1.10160000.10165000",115000,17,0.0008171443,10045000,10160000,10050000,10165000,"chr1",31882,6,6,12,24,"chr1",1,0.0478199718706048
"1180","chr1.183620000.183625000","chr1.184015000.184020000",395000,14,3.377754e-06,183620000,184015000,183625000,184020000,"chr1",31904,0,3,3,6,"chr1",1,0.00984528832630099
"1181","chr1.182110000.182115000","chr1.182235000.182240000",125000,16,0.001500618,182110000,182235000,182115000,182240000,"chr1",31923,2,6,3,11,"chr1",1,0.0206282231598687
"1182","chr1.204400000.204405000","chr1.204475000.204480000",75000,33,3.473301e-11,204400000,204475000,204405000,204480000,"chr1",31958,2,3,2,7,"chr1",1,0.0270745428973277
"1183","chr1.45495000.45500000","chr1.46195000.46200000",700000,11,8.798394e-06,45495000,46195000,45500000,46200000,"chr1",31990,0,4,1,5,"chr1",1,0.00644631973745898
"1184","chr1.32220000.32225000","chr1.32535000.32540000",315000,12,0.0004991842,32220000,32535000,32225000,32540000,"chr1",32014,3,11,6,20,"chr1",1,0.0281293952180028
"1185","chr1.43690000.43695000","chr1.43855000.43860000",165000,29,4.48278e-14,43690000,43855000,43695000,43860000,"chr1",32030,0,8,5,13,"chr1",1,0.0441865916549461
"1186","chr1.109665000.109670000","chr1.109700000.109705000",35000,27,0.00691274,109665000,109700000,109670000,109705000,"chr1",32034,1,0,2,3,"chr1",1,0.00949367088607595
"1187","chr1.10335000.10340000","chr1.10375000.10380000",40000,30,9.14609e-05,10335000,10375000,10340000,10380000,"chr1",32037,0,6,5,11,"chr1",1,0.0386779184247539
"1188","chr1.205195000.205200000","chr1.205225000.205230000",30000,84,8.578208e-35,205195000,205225000,205200000,205230000,"chr1",32039,0,1,1,2,"chr1",1,0.019690576652602
"1189","chr1.44840000.44845000","chr1.45135000.45140000",295000,16,1.074264e-06,44840000,45135000,44845000,45140000,"chr1",32053,9,21,26,56,"chr1",1,0.105016408813877
"1190","chr1.171800000.171805000","chr1.171900000.171905000",100000,26,1.58293e-08,171800000,171900000,171805000,171905000,"chr1",32084,1,1,1,3,"chr1",1,0.00914205344585091
"1191","chr1.1405000.1410000","chr1.1510000.1515000",105000,18,0.0005300991,1405000,1510000,1410000,1515000,"chr1",32104,10,16,30,56,"chr1",1,0.118143459915612
"1192","chr1.165540000.165545000","chr1.165870000.165875000",330000,10,0.00645586,165540000,165870000,165545000,165875000,"chr1",32133,0,3,4,7,"chr1",1,0.00820440693858415
"1193","chr1.31705000.31710000","chr1.31840000.31845000",135000,14,0.008425895,31705000,31840000,31710000,31845000,"chr1",32145,1,4,1,6,"chr1",1,0.00984528832630099
"1194","chr1.223140000.223145000","chr1.223180000.223185000",40000,33,4.350545e-06,223140000,223180000,223145000,223185000,"chr1",32159,1,5,5,11,"chr1",1,0.0425457102672293
"1195","chr1.204130000.204135000","chr1.204370000.204375000",240000,11,0.009597206,204130000,204370000,204135000,204375000,"chr1",32167,1,3,5,9,"chr1",1,0.0116033755274262
"1196","chr1.151295000.151300000","chr1.151365000.151370000",70000,21,0.0008075999,151295000,151365000,151300000,151370000,"chr1",32208,2,7,12,21,"chr1",1,0.0516877637130802
"1197","chr1.234755000.234760000","chr1.235100000.235105000",345000,12,0.0002827585,234755000,235100000,234760000,235105000,"chr1",32247,0,1,2,3,"chr1",1,0.00421940928270042
"1198","chr1.203235000.203240000","chr1.203670000.203675000",435000,10,0.001590574,203235000,203670000,203240000,203675000,"chr1",32250,3,6,7,16,"chr1",1,0.0187529301453352
"1199","chr1.42655000.42660000","chr1.42785000.42790000",130000,26,4.417857e-10,42655000,42785000,42660000,42790000,"chr1",32262,1,3,2,6,"chr1",1,0.0182841068917018
"1200","chr1.203085000.203090000","chr1.203130000.203135000",45000,26,0.0008075999,203085000,203130000,203090000,203135000,"chr1",32273,0,1,0,1,"chr1",1,0.00304735114861697
"1201","chr1.8090000.8095000","chr1.8410000.8415000",320000,14,1.810507e-05,8090000,8410000,8095000,8415000,"chr1",32300,2,6,4,12,"chr1",1,0.019690576652602
"1202","chr1.201530000.201535000","chr1.201720000.201725000",190000,14,0.001061267,201530000,201720000,201535000,201725000,"chr1",32343,0,2,1,3,"chr1",1,0.00492264416315049
"1203","chr1.9980000.9985000","chr1.10130000.10135000",150000,14,0.004757005,9980000,10130000,9985000,10135000,"chr1",32364,9,26,10,45,"chr1",1,0.0738396624472574
"1204","chr1.110335000.110340000","chr1.110410000.110415000",75000,29,1.553864e-08,110335000,110410000,110340000,110415000,"chr1",32372,1,4,5,10,"chr1",1,0.0339896858884201
"1205","chr1.109240000.109245000","chr1.109265000.109270000",25000,35,0.003277108,109240000,109265000,109245000,109270000,"chr1",32434,0,8,6,14,"chr1",1,0.0574308485700891
"1206","chr1.149935000.149940000","chr1.150180000.150185000",245000,15,3.29545e-05,149935000,150180000,149940000,150185000,"chr1",32452,0,6,6,12,"chr1",1,0.0210970464135021
"1207","chr1.205060000.205065000","chr1.205175000.205180000",115000,16,0.002529278,205060000,205175000,205065000,205180000,"chr1",32453,1,5,5,11,"chr1",1,0.0206282231598687
"1208","chr1.230565000.230570000","chr1.230770000.230775000",205000,17,7.652881e-06,230565000,230770000,230570000,230775000,"chr1",32505,3,8,2,13,"chr1",1,0.0259024847632443
"1209","chr1.110390000.110395000","chr1.110460000.110465000",70000,24,3.073313e-05,110390000,110460000,110395000,110465000,"chr1",32554,3,4,6,13,"chr1",1,0.0365682137834037
"1210","chr1.23855000.23860000","chr1.24015000.24020000",160000,13,0.009763887,23855000,24015000,23860000,24020000,"chr1",32581,2,20,10,32,"chr1",1,0.0487576183778715
"1211","chr1.222735000.222740000","chr1.222755000.222760000",20000,50,1.454336e-07,222735000,222755000,222740000,222760000,"chr1",32598,8,1,6,15,"chr1",1,0.0879043600562588
"1212","chr1.232980000.232985000","chr1.233000000.233005000",20000,45,1.330901e-05,232980000,2.33e+08,232985000,233005000,"chr1",32685,0,1,2,3,"chr1",1,0.0158227848101266
"1213","chr1.40370000.40375000","chr1.40435000.40440000",65000,33,6.143777e-10,40370000,40435000,40375000,40440000,"chr1",32729,1,12,3,16,"chr1",1,0.0618846694796062
"1214","chr1.211830000.211835000","chr1.212635000.212640000",805000,7,0.006846469,211830000,212635000,211835000,212640000,"chr1",32739,0,2,0,2,"chr1",1,0.00164088138771683
"1215","chr1.183805000.183810000","chr1.183825000.183830000",20000,38,0.00252151,183805000,183825000,183810000,183830000,"chr1",32868,3,1,5,9,"chr1",1,0.040084388185654
"1216","chr1.233570000.233575000","chr1.234140000.234145000",570000,13,8.461997e-07,233570000,234140000,233575000,234145000,"chr1",32874,0,3,1,4,"chr1",1,0.00609470229723394
"1217","chr1.212230000.212235000","chr1.212545000.212550000",315000,28,1.53082e-18,212230000,212545000,212235000,212550000,"chr1",32878,0,1,0,1,"chr1",1,0.00328176277543366
"1218","chr1.160075000.160080000","chr1.160160000.160165000",85000,24,2.655108e-06,160075000,160160000,160080000,160165000,"chr1",32895,0,2,0,2,"chr1",1,0.00562587904360056
"1219","chr1.21290000.21295000","chr1.21310000.21315000",20000,38,0.00252151,21290000,21310000,21295000,21315000,"chr1",32916,2,4,7,13,"chr1",1,0.0578996718237225
"1220","chr1.167685000.167690000","chr1.167760000.167765000",75000,27,2.61252e-07,167685000,167760000,167690000,167765000,"chr1",32925,0,3,4,7,"chr1",1,0.0221518987341772
"1221","chr1.203130000.203135000","chr1.203235000.203240000",105000,18,0.0005300991,203130000,203235000,203135000,203240000,"chr1",32929,0,6,4,10,"chr1",1,0.0210970464135021
"1222","chr1.204375000.204380000","chr1.204465000.204470000",90000,17,0.005066586,204375000,204465000,204380000,204470000,"chr1",32960,0,2,2,4,"chr1",1,0.00796999531176746
"1223","chr1.228790000.228795000","chr1.229505000.229510000",715000,12,8.368384e-07,228790000,229505000,228795000,229510000,"chr1",32965,0,2,1,3,"chr1",1,0.00421940928270042
"1224","chr1.244085000.244090000","chr1.244430000.244435000",345000,13,5.590942e-05,244085000,244430000,244090000,244435000,"chr1",32967,1,1,2,4,"chr1",1,0.00609470229723394
"1225","chr1.159130000.159135000","chr1.159855000.159860000",725000,9,0.000357604,159130000,159855000,159135000,159860000,"chr1",32990,0,2,2,4,"chr1",1,0.00421940928270042
"1226","chr1.150365000.150370000","chr1.150970000.150975000",605000,8,0.005618348,150365000,150970000,150370000,150975000,"chr1",32996,4,0,3,7,"chr1",1,0.00656352555086732
"1227","chr1.228790000.228795000","chr1.229285000.229290000",495000,11,0.0001330597,228790000,229285000,228795000,229290000,"chr1",33031,0,2,1,3,"chr1",1,0.00386779184247539
"1228","chr1.10110000.10115000","chr1.10210000.10215000",100000,29,1.23774e-10,10110000,10210000,10115000,10215000,"chr1",33159,6,16,13,35,"chr1",1,0.11896390060947
"1229","chr1.221440000.221445000","chr1.221610000.221615000",170000,17,4.411038e-05,221440000,221610000,221445000,221615000,"chr1",33184,2,3,5,10,"chr1",1,0.0199249882794187
"1230","chr1.203005000.203010000","chr1.203100000.203105000",95000,19,0.0003929148,203005000,203100000,203010000,203105000,"chr1",33194,1,2,2,5,"chr1",1,0.0111345522737928
"1231","chr1.244210000.244215000","chr1.244430000.244435000",220000,20,2.03394e-08,244210000,244430000,244215000,244435000,"chr1",33265,1,4,5,10,"chr1",1,0.023441162681669
"1232","chr1.33040000.33045000","chr1.33080000.33085000",40000,26,0.003086748,33040000,33080000,33045000,33085000,"chr1",33354,0,2,7,9,"chr1",1,0.0274261603375527
"1233","chr1.8595000.8600000","chr1.8710000.8715000",115000,19,7.230743e-05,8595000,8710000,8600000,8715000,"chr1",33425,1,4,5,10,"chr1",1,0.0222691045475856
"1234","chr1.214845000.214850000","chr1.215665000.215670000",820000,8,0.001071131,214845000,215665000,214850000,215670000,"chr1",33471,0,3,2,5,"chr1",1,0.0046882325363338
"1235","chr1.174745000.174750000","chr1.174950000.174955000",205000,20,5.009599e-08,174745000,174950000,174750000,174955000,"chr1",33474,3,6,6,15,"chr1",1,0.0351617440225035
"1236","chr1.150145000.150150000","chr1.150180000.150185000",35000,28,0.003304886,150145000,150180000,150150000,150185000,"chr1",33482,1,5,5,11,"chr1",1,0.0360993905297703
"1237","chr1.26870000.26875000","chr1.27045000.27050000",175000,13,0.005981441,26870000,27045000,26875000,27050000,"chr1",33487,5,5,13,23,"chr1",1,0.0350445382090952
"1238","chr1.21310000.21315000","chr1.21395000.21400000",85000,18,0.003006639,21310000,21395000,21315000,21400000,"chr1",33490,0,10,10,20,"chr1",1,0.0421940928270042
"1239","chr1.149915000.149920000","chr1.150145000.150150000",230000,13,0.001007514,149915000,150145000,149920000,150150000,"chr1",33614,1,5,5,11,"chr1",1,0.0167604313173933
"1240","chr1.54310000.54315000","chr1.54495000.54500000",185000,15,0.0003492026,54310000,54495000,54315000,54500000,"chr1",33619,1,3,1,5,"chr1",1,0.00879043600562588
"1241","chr1.171710000.171715000","chr1.171880000.171885000",170000,15,0.0006470043,171710000,171880000,171715000,171885000,"chr1",33691,4,3,3,10,"chr1",1,0.0175808720112518
"1242","chr1.156050000.156055000","chr1.156095000.156100000",45000,27,0.0003258119,156050000,156095000,156055000,156100000,"chr1",33717,0,3,1,4,"chr1",1,0.0126582278481013
"1243","chr1.204245000.204250000","chr1.204325000.204330000",80000,36,5.880117e-14,204245000,204325000,204250000,204330000,"chr1",33740,3,8,14,25,"chr1",1,0.105485232067511
"1244","chr1.16960000.16965000","chr1.17120000.17125000",160000,24,1.021964e-09,16960000,17120000,16965000,17125000,"chr1",33829,0,2,1,3,"chr1",1,0.00843881856540084
"1245","chr1.212230000.212235000","chr1.212635000.212640000",405000,9,0.009597206,212230000,212635000,212235000,212640000,"chr1",33877,0,1,2,3,"chr1",1,0.00316455696202532
"1246","chr1.161235000.161240000","chr1.161285000.161290000",50000,24,0.001605476,161235000,161285000,161240000,161290000,"chr1",33890,7,37,26,70,"chr1",1,0.19690576652602
"1247","chr1.209825000.209830000","chr1.209850000.209855000",25000,34,0.006227396,209825000,209850000,209830000,209855000,"chr1",33891,0,3,1,4,"chr1",1,0.0159399906235349
"1248","chr1.161280000.161285000","chr1.161355000.161360000",75000,24,1.301442e-05,161280000,161355000,161285000,161360000,"chr1",33922,6,14,12,32,"chr1",1,0.090014064697609
"1249","chr1.201970000.201975000","chr1.202085000.202090000",115000,51,5.407809e-32,201970000,202085000,201975000,202090000,"chr1",33945,3,13,12,28,"chr1",1,0.167369901547117
"1250","chr1.155775000.155780000","chr1.156150000.156155000",375000,10,0.003509469,155775000,156150000,155780000,156155000,"chr1",33954,0,1,0,1,"chr1",1,0.00117205813408345
"1251","chr1.153945000.153950000","chr1.154155000.154160000",210000,14,0.0005117364,153945000,154155000,153950000,154160000,"chr1",33958,1,2,1,4,"chr1",1,0.00656352555086732
"1252","chr1.243350000.243355000","chr1.243475000.243480000",125000,22,4.788566e-07,243350000,243475000,243355000,243480000,"chr1",34012,0,1,1,2,"chr1",1,0.00515705578996718
"1253","chr1.228795000.228800000","chr1.229480000.229485000",685000,8,0.002973403,228795000,229480000,228800000,229485000,"chr1",34048,2,6,2,10,"chr1",1,0.00937646507266761
"1254","chr1.203995000.204000000","chr1.204080000.204085000",85000,17,0.007758048,203995000,204080000,2.04e+08,204085000,"chr1",34060,1,4,3,8,"chr1",1,0.0159399906235349
"1255","chr1.9345000.9350000","chr1.9530000.9535000",185000,13,0.004288904,9345000,9530000,9350000,9535000,"chr1",34100,1,7,4,12,"chr1",1,0.0182841068917018
"1256","chr1.201530000.201535000","chr1.201670000.201675000",140000,61,5.41322e-46,201530000,201670000,201535000,201675000,"chr1",34141,0,0,3,3,"chr1",1,0.0214486638537271
"1257","chr1.9555000.9560000","chr1.9625000.9630000",70000,24,3.073313e-05,9555000,9625000,9560000,9630000,"chr1",34148,5,16,13,34,"chr1",1,0.0956399437412096
"1258","chr1.207575000.207580000","chr1.207670000.207675000",95000,26,3.349354e-08,207575000,207670000,207580000,207675000,"chr1",34167,0,2,1,3,"chr1",1,0.00914205344585091
"1259","chr1.205590000.205595000","chr1.205690000.205695000",100000,22,5.499536e-06,205590000,205690000,205595000,205695000,"chr1",34183,1,5,5,11,"chr1",1,0.0283638068448195
"1260","chr1.153725000.153730000","chr1.153960000.153965000",235000,17,1.885725e-06,153725000,153960000,153730000,153965000,"chr1",34199,1,7,6,14,"chr1",1,0.0278949835911861
"1261","chr1.241785000.241790000","chr1.241995000.242000000",210000,14,0.0005117364,241785000,241995000,241790000,2.42e+08,"chr1",34205,0,2,3,5,"chr1",1,0.00820440693858415
"1262","chr1.203475000.203480000","chr1.203650000.203655000",175000,14,0.001856842,203475000,203650000,203480000,203655000,"chr1",34258,1,1,0,2,"chr1",1,0.00328176277543366
"1263","chr1.25165000.25170000","chr1.25520000.25525000",355000,11,0.001102366,25165000,25520000,25170000,25525000,"chr1",34268,0,4,1,5,"chr1",1,0.00644631973745898
"1264","chr1.36625000.36630000","chr1.36650000.36655000",25000,74,1.537106e-22,36625000,36650000,36630000,36655000,"chr1",34281,0,3,3,6,"chr1",1,0.0520393811533052
"1265","chr1.202835000.202840000","chr1.202885000.202890000",50000,22,0.008541777,202835000,202885000,202840000,202890000,"chr1",34289,3,9,11,23,"chr1",1,0.0593061415846226
"1266","chr1.161765000.161770000","chr1.161855000.161860000",90000,18,0.001865958,161765000,161855000,161770000,161860000,"chr1",34310,2,7,2,11,"chr1",1,0.0232067510548523
"1267","chr1.226635000.226640000","chr1.226660000.226665000",25000,37,0.0008057805,226635000,226660000,226640000,226665000,"chr1",34329,1,1,3,5,"chr1",1,0.0216830754805438
"1268","chr1.8510000.8515000","chr1.8670000.8675000",160000,15,0.001000244,8510000,8670000,8515000,8675000,"chr1",34388,2,12,9,23,"chr1",1,0.040436005625879
"1269","chr1.155935000.155940000","chr1.155955000.155960000",20000,53,7.305841e-09,155935000,155955000,155940000,155960000,"chr1",34396,6,34,27,67,"chr1",1,0.416197843413033
"1270","chr1.10140000.10145000","chr1.10175000.10180000",35000,27,0.00691274,10140000,10175000,10145000,10180000,"chr1",34409,1,13,11,25,"chr1",1,0.0791139240506329
"1271","chr1.21320000.21325000","chr1.21435000.21440000",115000,17,0.0008171443,21320000,21435000,21325000,21440000,"chr1",34411,4,19,22,45,"chr1",1,0.089662447257384
"1272","chr1.116710000.116715000","chr1.116930000.116935000",220000,12,0.004800128,116710000,116930000,116715000,116935000,"chr1",34449,0,1,1,2,"chr1",1,0.00281293952180028
"1273","chr1.8525000.8530000","chr1.8625000.8630000",100000,20,7.35421e-05,8525000,8625000,8530000,8630000,"chr1",34474,0,0,3,3,"chr1",1,0.0070323488045007
"1274","chr1.36065000.36070000","chr1.36185000.36190000",120000,15,0.005618157,36065000,36185000,36070000,36190000,"chr1",34481,16,31,29,76,"chr1",1,0.133614627285513
"1275","chr1.77755000.77760000","chr1.77825000.77830000",70000,20,0.002190239,77755000,77825000,77760000,77830000,"chr1",34488,2,11,8,21,"chr1",1,0.0492264416315049
"1276","chr1.229410000.229415000","chr1.229595000.229600000",185000,13,0.004288904,229410000,229595000,229415000,229600000,"chr1",34489,0,6,7,13,"chr1",1,0.0198077824660103
"1277","chr1.21310000.21315000","chr1.21370000.21375000",60000,20,0.00869379,21310000,21370000,21315000,21375000,"chr1",34521,11,22,26,59,"chr1",1,0.138302859821847
"1278","chr1.109980000.109985000","chr1.110010000.110015000",30000,35,0.0001324766,109980000,110010000,109985000,110015000,"chr1",34598,0,1,1,2,"chr1",1,0.00820440693858415
"1279","chr1.43355000.43360000","chr1.43620000.43625000",265000,13,0.0003607747,43355000,43620000,43360000,43625000,"chr1",34645,1,4,5,10,"chr1",1,0.0152367557430849
"1280","chr1.212505000.212510000","chr1.212545000.212550000",40000,33,4.350545e-06,212505000,212545000,212510000,212550000,"chr1",34692,1,4,0,5,"chr1",1,0.0193389592123769
"1281","chr1.9765000.9770000","chr1.9930000.9935000",165000,15,0.0008057805,9765000,9930000,9770000,9935000,"chr1",34700,0,13,9,22,"chr1",1,0.0386779184247539
"1282","chr1.8685000.8690000","chr1.8885000.8890000",200000,12,0.008520915,8685000,8885000,8690000,8890000,"chr1",34736,9,16,15,40,"chr1",1,0.0562587904360056
"1283","chr1.39690000.39695000","chr1.39720000.39725000",30000,34,0.0003080251,39690000,39720000,39695000,39725000,"chr1",34762,1,3,3,7,"chr1",1,0.0278949835911861
"1284","chr1.89685000.89690000","chr1.89705000.89710000",20000,40,0.0006470043,89685000,89705000,89690000,89710000,"chr1",34763,0,3,2,5,"chr1",1,0.023441162681669
"1285","chr1.204405000.204410000","chr1.204475000.204480000",70000,27,7.333486e-07,204405000,204475000,204410000,204480000,"chr1",34768,0,3,2,5,"chr1",1,0.0158227848101266
"1286","chr1.205105000.205110000","chr1.205225000.205230000",120000,16,0.001909676,205105000,205225000,205110000,205230000,"chr1",34782,0,1,1,2,"chr1",1,0.00375058602906704
"1287","chr1.155065000.155070000","chr1.155085000.155090000",20000,45,1.330901e-05,155065000,155085000,155070000,155090000,"chr1",34836,2,2,1,5,"chr1",1,0.0263713080168776
"1288","chr1.150505000.150510000","chr1.150920000.150925000",415000,9,0.008599339,150505000,150920000,150510000,150925000,"chr1",34873,0,1,4,5,"chr1",1,0.00527426160337553
"1289","chr1.32690000.32695000","chr1.32825000.32830000",135000,19,1.883546e-05,32690000,32825000,32695000,32830000,"chr1",34907,4,4,3,11,"chr1",1,0.0244960150023441
"1290","chr1.151165000.151170000","chr1.151255000.151260000",90000,19,0.0006470043,151165000,151255000,151170000,151260000,"chr1",34937,5,17,13,35,"chr1",1,0.0779418659165495
"1291","chr1.54760000.54765000","chr1.54795000.54800000",35000,27,0.00691274,54760000,54795000,54765000,54800000,"chr1",34972,1,3,1,5,"chr1",1,0.0158227848101266
"1292","chr1.243475000.243480000","chr1.243900000.243905000",425000,12,7.069411e-05,243475000,243900000,243480000,243905000,"chr1",34976,0,1,1,2,"chr1",1,0.00281293952180028
"1293","chr1.149895000.149900000","chr1.150180000.150185000",285000,11,0.00367059,149895000,150180000,149900000,150185000,"chr1",34986,2,9,8,19,"chr1",1,0.0244960150023441
"1294","chr1.28580000.28585000","chr1.28885000.28890000",305000,10,0.009342944,28580000,28885000,28585000,28890000,"chr1",34990,0,0,4,4,"chr1",1,0.0046882325363338
"1295","chr1.8025000.8030000","chr1.8710000.8715000",685000,8,0.002973403,8025000,8710000,8030000,8715000,"chr1",35006,0,2,3,5,"chr1",1,0.0046882325363338
"1296","chr1.228795000.228800000","chr1.229410000.229415000",615000,10,0.0001708046,228795000,229410000,228800000,229415000,"chr1",35008,0,13,5,18,"chr1",1,0.0210970464135021
"1297","chr1.235070000.235075000","chr1.235100000.235105000",30000,35,0.0001324766,235070000,235100000,235075000,235105000,"chr1",35068,4,18,14,36,"chr1",1,0.147679324894515
"1298","chr1.26165000.26170000","chr1.26320000.26325000",155000,20,1.202601e-06,26165000,26320000,26170000,26325000,"chr1",35071,4,2,5,11,"chr1",1,0.0257852789498359
"1299","chr1.161175000.161180000","chr1.161285000.161290000",110000,23,4.360387e-07,161175000,161285000,161180000,161290000,"chr1",35077,2,11,13,26,"chr1",1,0.0700890764181903
"1300","chr1.153695000.153700000","chr1.153955000.153960000",260000,16,3.656935e-06,153695000,153955000,153700000,153960000,"chr1",35131,3,5,15,23,"chr1",1,0.043131739334271
"1301","chr1.39730000.39735000","chr1.39795000.39800000",65000,20,0.004296559,39730000,39795000,39735000,39800000,"chr1",35144,4,12,14,30,"chr1",1,0.070323488045007
"1302","chr1.45965000.45970000","chr1.46215000.46220000",250000,12,0.002176934,45965000,46215000,45970000,46220000,"chr1",35149,2,13,3,18,"chr1",1,0.0253164556962025
"1303","chr1.183535000.183540000","chr1.183565000.183570000",30000,33,0.0006782985,183535000,183565000,183540000,183570000,"chr1",35164,0,1,2,3,"chr1",1,0.0116033755274262
"1304","chr1.178085000.178090000","chr1.178235000.178240000",150000,16,0.0004494463,178085000,178235000,178090000,178240000,"chr1",35189,0,1,1,2,"chr1",1,0.00375058602906704
"1305","chr1.54740000.54745000","chr1.54760000.54765000",20000,38,0.00252151,54740000,54760000,54745000,54765000,"chr1",35194,0,4,1,5,"chr1",1,0.0222691045475856
"1306","chr1.29300000.29305000","chr1.29320000.29325000",20000,36,0.008632247,29300000,29320000,29305000,29325000,"chr1",35221,0,0,3,3,"chr1",1,0.0126582278481013
"1307","chr1.204405000.204410000","chr1.204465000.204470000",60000,34,7.451862e-10,204405000,204465000,204410000,204470000,"chr1",35239,0,2,2,4,"chr1",1,0.0159399906235349
"1308","chr1.113040000.113045000","chr1.113225000.113230000",185000,18,4.492586e-06,113040000,113225000,113045000,113230000,"chr1",35248,0,9,6,15,"chr1",1,0.0316455696202532
"1309","chr1.204250000.204255000","chr1.204325000.204330000",75000,21,0.0004093387,204250000,204325000,204255000,204330000,"chr1",35250,1,7,7,15,"chr1",1,0.0369198312236287
"1310","chr1.243850000.243855000","chr1.244430000.244435000",580000,12,5.655326e-06,243850000,244430000,243855000,244435000,"chr1",35279,1,14,9,24,"chr1",1,0.0337552742616034
"1311","chr1.28715000.28720000","chr1.28805000.28810000",90000,20,0.0002098136,28715000,28805000,28720000,28810000,"chr1",35287,2,12,2,16,"chr1",1,0.0375058602906704
"1312","chr1.207750000.207755000","chr1.207795000.207800000",45000,23,0.009597206,207750000,207795000,207755000,207800000,"chr1",35340,1,0,1,2,"chr1",1,0.00539146741678387
"1313","chr1.243710000.243715000","chr1.243850000.243855000",140000,20,3.216314e-06,243710000,243850000,243715000,243855000,"chr1",35341,0,3,1,4,"chr1",1,0.00937646507266761
"1314","chr1.46400000.46405000","chr1.46445000.46450000",45000,32,1.822732e-06,46400000,46445000,46405000,46450000,"chr1",35353,2,1,10,13,"chr1",1,0.0487576183778715
"1315","chr1.39690000.39695000","chr1.39880000.39885000",190000,15,0.000283605,39690000,39880000,39695000,39885000,"chr1",35389,1,3,3,7,"chr1",1,0.0123066104078762
"1316","chr1.204150000.204155000","chr1.204345000.204350000",195000,19,5.046787e-07,204150000,204345000,204155000,204350000,"chr1",35402,0,2,1,3,"chr1",1,0.00668073136427567
"1317","chr1.16960000.16965000","chr1.17105000.17110000",145000,15,0.001879154,16960000,17105000,16965000,17110000,"chr1",35449,5,20,13,38,"chr1",1,0.0668073136427567
"1318","chr1.243505000.243510000","chr1.244430000.244435000",925000,18,3.595501e-15,243505000,244430000,243510000,244435000,"chr1",35486,0,2,1,3,"chr1",1,0.00632911392405063
"1319","chr1.201460000.201465000","chr1.201530000.201535000",70000,24,3.073313e-05,201460000,201530000,201465000,201535000,"chr1",35520,2,2,7,11,"chr1",1,0.0309423347398031
"1320","chr1.39745000.39750000","chr1.39900000.39905000",155000,14,0.00393986,39745000,39900000,39750000,39905000,"chr1",35551,2,18,18,38,"chr1",1,0.0623534927332396
"1321","chr1.14435000.14440000","chr1.15405000.15410000",970000,7,0.002324276,14435000,15405000,14440000,15410000,"chr1",35587,0,2,1,3,"chr1",1,0.00246132208157525
"1322","chr1.40305000.40310000","chr1.40450000.40455000",145000,15,0.001879154,40305000,40450000,40310000,40455000,"chr1",35619,0,4,8,12,"chr1",1,0.0210970464135021
"1323","chr1.243850000.243855000","chr1.243880000.243885000",30000,42,1.563791e-07,243850000,243880000,243855000,243885000,"chr1",35632,2,9,9,20,"chr1",1,0.0984528832630098
"1324","chr1.155250000.155255000","chr1.155270000.155275000",20000,54,2.579949e-09,155250000,155270000,155255000,155275000,"chr1",35634,2,13,8,23,"chr1",1,0.145569620253165
"1325","chr1.155305000.155310000","chr1.155860000.155865000",555000,12,8.330479e-06,155305000,155860000,155310000,155865000,"chr1",35739,1,9,4,14,"chr1",1,0.019690576652602
"1326","chr1.156485000.156490000","chr1.156600000.156605000",115000,15,0.007192145,156485000,156600000,156490000,156605000,"chr1",35798,5,14,16,35,"chr1",1,0.0615330520393812
"1327","chr1.9190000.9195000","chr1.9250000.9255000",60000,23,0.0005784889,9190000,9250000,9195000,9255000,"chr1",35824,4,11,16,31,"chr1",1,0.08356774496015
"1328","chr1.150230000.150235000","chr1.150505000.150510000",275000,13,0.0002791164,150230000,150505000,150235000,150510000,"chr1",35842,0,1,4,5,"chr1",1,0.00761837787154243
"1329","chr1.150365000.150370000","chr1.150805000.150810000",440000,9,0.006488163,150365000,150805000,150370000,150810000,"chr1",35879,1,12,4,17,"chr1",1,0.0179324894514768
"1330","chr1.197180000.197185000","chr1.197200000.197205000",20000,54,2.579949e-09,197180000,197200000,197185000,197205000,"chr1",35905,0,5,1,6,"chr1",1,0.0379746835443038
"1331","chr1.151310000.151315000","chr1.151365000.151370000",55000,23,0.001500618,151310000,151365000,151315000,151370000,"chr1",35954,1,2,1,4,"chr1",1,0.0107829348335677
"1332","chr1.84610000.84615000","chr1.84940000.84945000",330000,19,9.273068e-10,84610000,84940000,84615000,84945000,"chr1",35980,0,3,3,6,"chr1",1,0.0133614627285513
"1333","chr1.204255000.204260000","chr1.204330000.204335000",75000,24,1.301442e-05,204255000,204330000,204260000,204335000,"chr1",35983,2,3,6,11,"chr1",1,0.0309423347398031
"1334","chr1.35705000.35710000","chr1.35805000.35810000",100000,16,0.006415049,35705000,35805000,35710000,35810000,"chr1",36017,0,3,8,11,"chr1",1,0.0206282231598687
"1335","chr1.228860000.228865000","chr1.229660000.229665000",800000,9,0.000187235,228860000,229660000,228865000,229665000,"chr1",36042,2,10,2,14,"chr1",1,0.0147679324894515
"1336","chr1.28205000.28210000","chr1.28235000.28240000",30000,32,0.001500618,28205000,28235000,28210000,28240000,"chr1",36047,5,24,12,41,"chr1",1,0.153774027191749
"1337","chr1.26825000.26830000","chr1.27145000.27150000",320000,10,0.007480566,26825000,27145000,26830000,27150000,"chr1",36056,0,3,1,4,"chr1",1,0.0046882325363338
"1338","chr1.32960000.32965000","chr1.33005000.33010000",45000,28,0.0001254468,32960000,33005000,32965000,33010000,"chr1",36067,0,2,1,3,"chr1",1,0.00984528832630099
"1339","chr1.109380000.109385000","chr1.109575000.109580000",195000,12,0.009750873,109380000,109575000,109385000,109580000,"chr1",36146,1,8,8,17,"chr1",1,0.0239099859353024
"1340","chr1.12295000.12300000","chr1.12315000.12320000",20000,44,3.073313e-05,12295000,12315000,12300000,12320000,"chr1",36232,0,3,2,5,"chr1",1,0.0257852789498359
"1341","chr1.9985000.9990000","chr1.10210000.10215000",225000,14,0.000298595,9985000,10210000,9990000,10215000,"chr1",36234,6,16,13,35,"chr1",1,0.0574308485700891
"1342","chr1.173985000.173990000","chr1.174020000.174025000",35000,39,8.974978e-08,173985000,174020000,173990000,174025000,"chr1",36269,0,7,5,12,"chr1",1,0.0548523206751055
"1343","chr1.235405000.235410000","chr1.235580000.235585000",175000,24,2.942792e-10,235405000,235580000,235410000,235585000,"chr1",36274,0,2,5,7,"chr1",1,0.019690576652602
"1344","chr1.168390000.168395000","chr1.169320000.169325000",930000,8,0.0004622676,168390000,169320000,168395000,169325000,"chr1",36296,0,3,2,5,"chr1",1,0.0046882325363338
"1345","chr1.77975000.77980000","chr1.78135000.78140000",160000,13,0.009763887,77975000,78135000,77980000,78140000,"chr1",36320,0,5,5,10,"chr1",1,0.0152367557430849
"1346","chr1.182050000.182055000","chr1.182560000.182565000",510000,16,4.063147e-09,182050000,182560000,182055000,182565000,"chr1",36321,2,6,9,17,"chr1",1,0.0318799812470699
"1347","chr1.243915000.243920000","chr1.244430000.244435000",515000,11,9.978679e-05,243915000,244430000,243920000,244435000,"chr1",36385,0,3,0,3,"chr1",1,0.00386779184247539
"1348","chr1.26995000.27000000","chr1.27120000.27125000",125000,19,3.530743e-05,26995000,27120000,2.7e+07,27125000,"chr1",36419,3,13,12,28,"chr1",1,0.0623534927332396
"1349","chr1.86845000.86850000","chr1.86965000.86970000",120000,15,0.005618157,86845000,86965000,86850000,86970000,"chr1",36445,0,7,4,11,"chr1",1,0.0193389592123769
"1350","chr1.203425000.203430000","chr1.203445000.203450000",20000,40,0.0006470043,203425000,203445000,203430000,203450000,"chr1",36446,0,1,1,2,"chr1",1,0.00937646507266761
"1351","chr1.201505000.201510000","chr1.201790000.201795000",285000,13,0.0002162115,201505000,201790000,201510000,201795000,"chr1",36474,0,1,0,1,"chr1",1,0.00152367557430849
"1352","chr1.9685000.9690000","chr1.9930000.9935000",245000,13,0.0006470043,9685000,9930000,9690000,9935000,"chr1",36487,8,20,17,45,"chr1",1,0.0685654008438819
"1353","chr1.200640000.200645000","chr1.200705000.200710000",65000,24,7.710059e-05,200640000,200705000,200645000,200710000,"chr1",36498,5,6,9,20,"chr1",1,0.0562587904360056
"1354","chr1.66445000.66450000","chr1.66620000.66625000",175000,26,6.60818e-12,66445000,66620000,66450000,66625000,"chr1",36509,0,4,0,4,"chr1",1,0.0121894045944679
"1355","chr1.25950000.25955000","chr1.25975000.25980000",25000,44,2.434493e-06,25950000,25975000,25955000,25980000,"chr1",36529,4,17,11,32,"chr1",1,0.16502578527895
"1356","chr1.162035000.162040000","chr1.162145000.162150000",110000,17,0.00115434,162035000,162145000,162040000,162150000,"chr1",36546,0,1,2,3,"chr1",1,0.0059774964838256
"1357","chr1.197180000.197185000","chr1.197235000.197240000",55000,22,0.003601062,197180000,197235000,197185000,197240000,"chr1",36560,1,6,6,13,"chr1",1,0.0335208626347867
"1358","chr1.26220000.26225000","chr1.26430000.26435000",210000,14,0.0005117364,26220000,26430000,26225000,26435000,"chr1",36564,3,14,6,23,"chr1",1,0.0377402719174871
"1359","chr1.207020000.207025000","chr1.207050000.207055000",30000,30,0.006218027,207020000,207050000,207025000,207055000,"chr1",36796,1,1,1,3,"chr1",1,0.0105485232067511
"1360","chr1.61560000.61565000","chr1.61720000.61725000",160000,13,0.009763887,61560000,61720000,61565000,61725000,"chr1",36797,0,3,2,5,"chr1",1,0.00761837787154243
"1361","chr1.205345000.205350000","chr1.205430000.205435000",85000,18,0.003006639,205345000,205430000,205350000,205435000,"chr1",36818,4,8,6,18,"chr1",1,0.0379746835443038
"1362","chr1.243505000.243510000","chr1.244335000.244340000",830000,7,0.005861954,243505000,244335000,243510000,244340000,"chr1",36823,0,2,1,3,"chr1",1,0.00246132208157525
"1363","chr1.174715000.174720000","chr1.174950000.174955000",235000,12,0.003229073,174715000,174950000,174720000,174955000,"chr1",36872,3,6,6,15,"chr1",1,0.0210970464135021
"1364","chr1.230250000.230255000","chr1.230365000.230370000",115000,15,0.007192145,230250000,230365000,230255000,230370000,"chr1",36950,0,2,1,3,"chr1",1,0.00527426160337553
"1365","chr1.11270000.11275000","chr1.11700000.11705000",430000,12,6.536086e-05,11270000,11700000,11275000,11705000,"chr1",36963,0,2,1,3,"chr1",1,0.00421940928270042
"1366","chr1.109980000.109985000","chr1.110000000.110005000",20000,58,3.308932e-11,109980000,1.1e+08,109985000,110005000,"chr1",37036,0,1,1,2,"chr1",1,0.013595874355368
"1367","chr1.40380000.40385000","chr1.40435000.40440000",55000,49,1.998346e-19,40380000,40435000,40385000,40440000,"chr1",37089,0,4,1,5,"chr1",1,0.0287154242850445
"1368","chr1.155870000.155875000","chr1.155970000.155975000",100000,17,0.002324276,155870000,155970000,155875000,155975000,"chr1",37103,9,9,10,28,"chr1",1,0.0557899671823722
"1369","chr1.116920000.116925000","chr1.116950000.116955000",30000,39,3.363468e-06,116920000,116950000,116925000,116955000,"chr1",37113,0,1,4,5,"chr1",1,0.0228551336146273
"1370","chr1.11175000.11180000","chr1.11260000.11265000",85000,17,0.007758048,11175000,11260000,11180000,11265000,"chr1",37158,4,4,3,11,"chr1",1,0.0219174871073605
"1371","chr1.174990000.174995000","chr1.175750000.175755000",760000,7,0.008896094,174990000,175750000,174995000,175755000,"chr1",37169,0,3,3,6,"chr1",1,0.00492264416315049
"1372","chr1.228830000.228835000","chr1.229535000.229540000",705000,11,8.258608e-06,228830000,229535000,228835000,229540000,"chr1",37189,3,2,5,10,"chr1",1,0.012892639474918
"1373","chr1.243900000.243905000","chr1.244215000.244220000",315000,13,0.0001051292,243900000,244215000,243905000,244220000,"chr1",37207,0,1,2,3,"chr1",1,0.00457102672292546
"1374","chr1.153475000.153480000","chr1.153535000.153540000",60000,23,0.0005784889,153475000,153535000,153480000,153540000,"chr1",37208,2,4,5,11,"chr1",1,0.0296530707923113
"1375","chr1.153695000.153700000","chr1.153745000.153750000",50000,22,0.008541777,153695000,153745000,153700000,153750000,"chr1",37213,2,8,4,14,"chr1",1,0.0360993905297703
"1376","chr1.40370000.40375000","chr1.40445000.40450000",75000,22,0.0001362782,40370000,40445000,40375000,40450000,"chr1",37244,1,3,3,7,"chr1",1,0.0180496952648851
"1377","chr1.16930000.16935000","chr1.17235000.17240000",305000,10,0.009342944,16930000,17235000,16935000,17240000,"chr1",37279,4,4,8,16,"chr1",1,0.0187529301453352
"1378","chr1.39745000.39750000","chr1.39815000.39820000",70000,27,7.333486e-07,39745000,39815000,39750000,39820000,"chr1",37311,2,8,7,17,"chr1",1,0.0537974683544304
"1379","chr1.182120000.182125000","chr1.182280000.182285000",160000,15,0.001000244,182120000,182280000,182125000,182285000,"chr1",37336,0,7,3,10,"chr1",1,0.0175808720112518
"1380","chr1.77830000.77835000","chr1.78005000.78010000",175000,14,0.001856842,77830000,78005000,77835000,78010000,"chr1",37352,4,4,2,10,"chr1",1,0.0164088138771683
"1381","chr1.201530000.201535000","chr1.201730000.201735000",200000,26,7.286789e-13,201530000,201730000,201535000,201735000,"chr1",37403,4,2,7,13,"chr1",1,0.0396155649320206
"1382","chr1.164640000.164645000","chr1.164750000.164755000",110000,21,7.652881e-06,164640000,164750000,164645000,164755000,"chr1",37419,0,2,1,3,"chr1",1,0.00738396624472574
"1383","chr1.84385000.84390000","chr1.84595000.84600000",210000,14,0.0005117364,84385000,84595000,84390000,84600000,"chr1",37451,3,2,2,7,"chr1",1,0.0114861697140178
"1384","chr1.8835000.8840000","chr1.8885000.8890000",50000,22,0.008541777,8835000,8885000,8840000,8890000,"chr1",37460,9,16,15,40,"chr1",1,0.103141115799344
"1385","chr1.235405000.235410000","chr1.235510000.235515000",105000,17,0.001605476,235405000,235510000,235410000,235515000,"chr1",37463,3,14,9,26,"chr1",1,0.0518049695264885
"1386","chr1.203305000.203310000","chr1.203775000.203780000",470000,9,0.004654588,203305000,203775000,203310000,203780000,"chr1",37465,0,3,2,5,"chr1",1,0.00527426160337553
"1387","chr1.16950000.16955000","chr1.17270000.17275000",320000,60,2.604665e-60,16950000,17270000,16955000,17275000,"chr1",37499,0,11,15,26,"chr1",1,0.182841068917018
"1388","chr1.21195000.21200000","chr1.21395000.21400000",200000,15,0.0001884219,21195000,21395000,21200000,21400000,"chr1",37520,0,10,10,20,"chr1",1,0.0351617440225035
"1389","chr1.203005000.203010000","chr1.203190000.203195000",185000,15,0.0003492026,203005000,203190000,203010000,203195000,"chr1",37605,3,6,9,18,"chr1",1,0.0316455696202532
"1390","chr1.8095000.8100000","chr1.8370000.8375000",275000,30,1.562e-19,8095000,8370000,8100000,8375000,"chr1",37696,0,0,3,3,"chr1",1,0.0105485232067511
"1391","chr1.24500000.24505000","chr1.24700000.24705000",200000,13,0.00261335,24500000,24700000,24505000,24705000,"chr1",37698,5,8,16,29,"chr1",1,0.0441865916549461
"1392","chr1.228830000.228835000","chr1.229575000.229580000",745000,9,0.0003004818,228830000,229575000,228835000,229580000,"chr1",37731,3,2,5,10,"chr1",1,0.0105485232067511
"1393","chr1.109495000.109500000","chr1.109575000.109580000",80000,25,1.566151e-06,109495000,109575000,109500000,109580000,"chr1",37744,0,1,1,2,"chr1",1,0.00586029067041725
"1394","chr1.39750000.39755000","chr1.39850000.39855000",100000,17,0.002324276,39750000,39850000,39755000,39855000,"chr1",37760,6,5,8,19,"chr1",1,0.0378574777308955
"1395","chr1.155260000.155265000","chr1.155685000.155690000",425000,11,0.0003767288,155260000,155685000,155265000,155690000,"chr1",37834,0,7,9,16,"chr1",1,0.0206282231598687
"1396","chr1.205325000.205330000","chr1.205345000.205350000",20000,42,0.0001481797,205325000,205345000,205330000,205350000,"chr1",37840,1,3,6,10,"chr1",1,0.0492264416315049
"1397","chr1.228900000.228905000","chr1.229000000.229005000",100000,16,0.006415049,228900000,2.29e+08,228905000,229005000,"chr1",37857,2,1,2,5,"chr1",1,0.00937646507266761
"1398","chr1.201510000.201515000","chr1.201670000.201675000",160000,21,1.721488e-07,201510000,201670000,201515000,201675000,"chr1",37889,0,0,2,2,"chr1",1,0.00492264416315049
"1399","chr1.182170000.182175000","chr1.182315000.182320000",145000,16,0.0005758375,182170000,182315000,182175000,182320000,"chr1",37894,3,4,7,14,"chr1",1,0.0262541022034693
"1400","chr1.9190000.9195000","chr1.9265000.9270000",75000,21,0.0004093387,9190000,9265000,9195000,9270000,"chr1",37910,6,10,15,31,"chr1",1,0.0763009845288326
"1401","chr1.228830000.228835000","chr1.229225000.229230000",395000,10,0.002714357,228830000,229225000,228835000,229230000,"chr1",37937,3,2,5,10,"chr1",1,0.0117205813408345
"1402","chr1.204245000.204250000","chr1.204355000.204360000",110000,25,2.018769e-08,204245000,204355000,204250000,204360000,"chr1",37954,2,3,6,11,"chr1",1,0.0322315986872949
"1403","chr1.161185000.161190000","chr1.161280000.161285000",95000,29,2.935858e-10,161185000,161280000,161190000,161285000,"chr1",37974,6,9,5,20,"chr1",1,0.0679793717768401
"1404","chr1.10280000.10285000","chr1.10395000.10400000",115000,25,1.144333e-08,10280000,10395000,10285000,10400000,"chr1",37983,8,30,26,64,"chr1",1,0.187529301453352
"1405","chr1.21635000.21640000","chr1.22025000.22030000",390000,10,0.00290255,21635000,22025000,21640000,22030000,"chr1",37991,4,12,6,22,"chr1",1,0.0257852789498359
"1406","chr1.26830000.26835000","chr1.27030000.27035000",200000,12,0.008520915,26830000,27030000,26835000,27035000,"chr1",38015,0,6,1,7,"chr1",1,0.00984528832630099
"1407","chr1.64075000.64080000","chr1.64660000.64665000",585000,9,0.001366185,64075000,64660000,64080000,64665000,"chr1",38042,0,2,3,5,"chr1",1,0.00527426160337553
"1408","chr1.25950000.25955000","chr1.26145000.26150000",195000,14,0.0008677022,25950000,26145000,25955000,26150000,"chr1",38073,4,17,11,32,"chr1",1,0.0525082044069386
"1409","chr1.161150000.161155000","chr1.161305000.161310000",155000,14,0.00393986,161150000,161305000,161155000,161310000,"chr1",38075,2,6,7,15,"chr1",1,0.0246132208157525
"1410","chr1.23635000.23640000","chr1.23725000.23730000",90000,19,0.0006470043,23635000,23725000,23640000,23730000,"chr1",38119,0,7,13,20,"chr1",1,0.0445382090951711
"1411","chr1.8410000.8415000","chr1.8870000.8875000",460000,9,0.005175406,8410000,8870000,8415000,8875000,"chr1",38127,0,5,3,8,"chr1",1,0.00843881856540084
"1412","chr1.22530000.22535000","chr1.23275000.23280000",745000,7,0.009750873,22530000,23275000,22535000,23280000,"chr1",38174,0,3,3,6,"chr1",1,0.00492264416315049
"1413","chr1.27045000.27050000","chr1.27120000.27125000",75000,21,0.0004093387,27045000,27120000,27050000,27125000,"chr1",38184,5,5,13,23,"chr1",1,0.0566104078762307
"1414","chr1.54540000.54545000","chr1.54950000.54955000",410000,9,0.009020058,54540000,54950000,54545000,54955000,"chr1",38225,2,3,1,6,"chr1",1,0.00632911392405063
"1415","chr1.109575000.109580000","chr1.109640000.109645000",65000,23,0.000229001,109575000,109640000,109580000,109645000,"chr1",38236,1,2,8,11,"chr1",1,0.0296530707923113
"1416","chr1.165365000.165370000","chr1.165540000.165545000",175000,17,3.417486e-05,165365000,165540000,165370000,165545000,"chr1",38253,0,3,5,8,"chr1",1,0.0159399906235349
"1417","chr1.61720000.61725000","chr1.61815000.61820000",95000,16,0.009001332,61720000,61815000,61725000,61820000,"chr1",38363,4,4,3,11,"chr1",1,0.0206282231598687
"1418","chr1.26900000.26905000","chr1.27095000.27100000",195000,13,0.003098721,26900000,27095000,26905000,27100000,"chr1",38397,2,8,7,17,"chr1",1,0.0259024847632443
"1419","chr1.212230000.212235000","chr1.212665000.212670000",435000,10,0.001590574,212230000,212665000,212235000,212670000,"chr1",38398,0,0,3,3,"chr1",1,0.00351617440225035
"1420","chr1.8625000.8630000","chr1.8710000.8715000",85000,20,0.0003590682,8625000,8710000,8630000,8715000,"chr1",38404,1,10,11,22,"chr1",1,0.0515705578996718
"1421","chr1.26220000.26225000","chr1.26305000.26310000",85000,19,0.001070775,26220000,26305000,26225000,26310000,"chr1",38418,8,25,18,51,"chr1",1,0.113572433192686
"1422","chr1.40305000.40310000","chr1.40435000.40440000",130000,27,7.582737e-11,40305000,40435000,40310000,40440000,"chr1",38421,0,4,3,7,"chr1",1,0.0221518987341772
"1423","chr1.26920000.26925000","chr1.27145000.27150000",225000,13,0.0011796,26920000,27145000,26925000,27150000,"chr1",38448,3,18,5,26,"chr1",1,0.0396155649320206
"1424","chr1.46445000.46450000","chr1.46465000.46470000",20000,40,0.0006470043,46445000,46465000,46450000,46470000,"chr1",38453,2,1,10,13,"chr1",1,0.0609470229723394
"1425","chr1.8410000.8415000","chr1.8465000.8470000",55000,21,0.00838272,8410000,8465000,8415000,8470000,"chr1",38515,6,22,23,51,"chr1",1,0.125527426160338
"1426","chr1.151590000.151595000","chr1.151760000.151765000",170000,15,0.0006470043,151590000,151760000,151595000,151765000,"chr1",38541,1,7,8,16,"chr1",1,0.0281293952180028
"1427","chr1.27030000.27035000","chr1.27075000.27080000",45000,24,0.004449684,27030000,27075000,27035000,27080000,"chr1",38553,10,31,34,75,"chr1",1,0.210970464135021
"1428","chr1.29210000.29215000","chr1.29350000.29355000",140000,18,5.556461e-05,29210000,29350000,29215000,29355000,"chr1",38564,1,1,1,3,"chr1",1,0.00632911392405063
"1429","chr1.168670000.168675000","chr1.169160000.169165000",490000,9,0.003722807,168670000,169160000,168675000,169165000,"chr1",38588,0,1,3,4,"chr1",1,0.00421940928270042
"1430","chr1.14435000.14440000","chr1.15425000.15430000",990000,9,3.150563e-05,14435000,15425000,14440000,15430000,"chr1",38615,0,7,1,8,"chr1",1,0.00843881856540084
"1431","chr1.23825000.23830000","chr1.23855000.23860000",30000,37,2.278292e-05,23825000,23855000,23830000,23860000,"chr1",38644,6,24,17,47,"chr1",1,0.203820909517112
"1432","chr1.203590000.203595000","chr1.203650000.203655000",60000,22,0.001506977,203590000,203650000,203595000,203655000,"chr1",38669,5,13,8,26,"chr1",1,0.0670417252695734
"1433","chr1.87175000.87180000","chr1.87375000.87380000",200000,12,0.008520915,87175000,87375000,87180000,87380000,"chr1",38685,0,0,1,1,"chr1",1,0.00140646976090014
"1434","chr1.36200000.36205000","chr1.36220000.36225000",20000,38,0.00252151,36200000,36220000,36205000,36225000,"chr1",38714,4,19,21,44,"chr1",1,0.195968120018753
"1435","chr1.31715000.31720000","chr1.31820000.31825000",105000,21,1.247901e-05,31715000,31820000,31720000,31825000,"chr1",38715,1,1,3,5,"chr1",1,0.0123066104078762
"1436","chr1.21195000.21200000","chr1.21215000.21220000",20000,40,0.0006470043,21195000,21215000,21200000,21220000,"chr1",38720,0,9,13,22,"chr1",1,0.103141115799344
"1437","chr1.161190000.161195000","chr1.161355000.161360000",165000,18,1.347837e-05,161190000,161355000,161195000,161360000,"chr1",38725,6,16,13,35,"chr1",1,0.0738396624472574
"1438","chr1.8630000.8635000","chr1.8835000.8840000",205000,15,0.0001526155,8630000,8835000,8635000,8840000,"chr1",38739,12,16,23,51,"chr1",1,0.089662447257384
"1439","chr1.203860000.203865000","chr1.203995000.204000000",135000,16,0.0009028165,203860000,203995000,203865000,2.04e+08,"chr1",38827,4,19,16,39,"chr1",1,0.0731364275668073
"1440","chr1.228860000.228865000","chr1.229255000.229260000",395000,10,0.002714357,228860000,229255000,228865000,229260000,"chr1",38915,1,6,3,10,"chr1",1,0.0117205813408345
"1441","chr1.93325000.93330000","chr1.93435000.93440000",110000,15,0.009294725,93325000,93435000,93330000,93440000,"chr1",38920,3,3,0,6,"chr1",1,0.0105485232067511
"1442","chr1.183565000.183570000","chr1.183595000.183600000",30000,31,0.003104399,183565000,183595000,183570000,183600000,"chr1",38945,3,5,4,12,"chr1",1,0.0436005625879044
"1443","chr1.154625000.154630000","chr1.154875000.154880000",250000,17,9.720102e-07,154625000,154875000,154630000,154880000,"chr1",38969,3,11,8,22,"chr1",1,0.0438349742147211
"1444","chr1.204940000.204945000","chr1.205175000.205180000",235000,13,0.0008544039,204940000,205175000,204945000,205180000,"chr1",38985,0,4,0,4,"chr1",1,0.00609470229723394
"1445","chr1.43235000.43240000","chr1.43280000.43285000",45000,30,1.636532e-05,43235000,43280000,43240000,43285000,"chr1",39014,0,0,3,3,"chr1",1,0.0105485232067511
"1446","chr1.150615000.150620000","chr1.150805000.150810000",190000,14,0.001061267,150615000,150805000,150620000,150810000,"chr1",39034,1,12,4,17,"chr1",1,0.0278949835911861
"1447","chr1.19860000.19865000","chr1.19880000.19885000",20000,57,1.009568e-10,19860000,19880000,19865000,19885000,"chr1",39038,4,9,13,26,"chr1",1,0.173699015471167
"1448","chr1.16155000.16160000","chr1.16175000.16180000",20000,50,1.454336e-07,16155000,16175000,16160000,16180000,"chr1",39062,0,12,4,16,"chr1",1,0.093764650726676
"1449","chr1.225650000.225655000","chr1.226110000.226115000",460000,9,0.005175406,225650000,226110000,225655000,226115000,"chr1",39112,0,3,2,5,"chr1",1,0.00527426160337553
"1450","chr1.54310000.54315000","chr1.54420000.54425000",110000,24,9.680725e-08,54310000,54420000,54315000,54425000,"chr1",39120,7,27,18,52,"chr1",1,0.146272855133615
"1451","chr1.155900000.155905000","chr1.155940000.155945000",40000,26,0.003086748,155900000,155940000,155905000,155945000,"chr1",39179,1,5,2,8,"chr1",1,0.0243788091889358
"1452","chr1.182120000.182125000","chr1.182170000.182175000",50000,22,0.008541777,182120000,182170000,182125000,182175000,"chr1",39219,0,4,3,7,"chr1",1,0.0180496952648851
"1453","chr1.153785000.153790000","chr1.153920000.153925000",135000,18,7.328414e-05,153785000,153920000,153790000,153925000,"chr1",39298,6,18,20,44,"chr1",1,0.0928270042194093
"1454","chr1.212010000.212015000","chr1.212545000.212550000",535000,9,0.00230284,212010000,212545000,212015000,212550000,"chr1",39318,1,4,0,5,"chr1",1,0.00527426160337553
"1455","chr1.243355000.243360000","chr1.243430000.243435000",75000,20,0.001171509,243355000,243430000,243360000,243435000,"chr1",39352,4,4,11,19,"chr1",1,0.0445382090951711
"1456","chr1.16175000.16180000","chr1.16215000.16220000",40000,36,1.492376e-07,16175000,16215000,16180000,16220000,"chr1",39370,0,1,1,2,"chr1",1,0.00843881856540084
"1457","chr1.21600000.21605000","chr1.21630000.21635000",30000,36,5.590942e-05,21600000,21630000,21605000,21635000,"chr1",39372,3,4,7,14,"chr1",1,0.0590717299578059
"1458","chr1.10065000.10070000","chr1.10335000.10340000",270000,12,0.001326741,10065000,10335000,10070000,10340000,"chr1",39393,6,14,13,33,"chr1",1,0.0464135021097046
"1459","chr1.9200000.9205000","chr1.9250000.9255000",50000,30,3.553513e-06,9200000,9250000,9205000,9255000,"chr1",39418,0,0,4,4,"chr1",1,0.0140646976090014
"1460","chr1.181030000.181035000","chr1.181115000.181120000",85000,17,0.007758048,181030000,181115000,181035000,181120000,"chr1",39502,1,10,12,23,"chr1",1,0.0458274730426629
"1461","chr1.174875000.174880000","chr1.174950000.174955000",75000,18,0.007861949,174875000,174950000,174880000,174955000,"chr1",39551,2,6,6,14,"chr1",1,0.029535864978903
"1462","chr1.210945000.210950000","chr1.211305000.211310000",360000,10,0.004288904,210945000,211305000,210950000,211310000,"chr1",39562,0,2,5,7,"chr1",1,0.00820440693858415
"1463","chr1.43300000.43305000","chr1.43545000.43550000",245000,15,3.29545e-05,43300000,43545000,43305000,43550000,"chr1",39567,1,1,0,2,"chr1",1,0.00351617440225035
"1464","chr1.84940000.84945000","chr1.85255000.85260000",315000,10,0.008095926,84940000,85255000,84945000,85260000,"chr1",39617,1,3,3,7,"chr1",1,0.00820440693858415
"1465","chr1.46400000.46405000","chr1.46440000.46445000",40000,28,0.0005784227,46400000,46440000,46405000,46445000,"chr1",39625,5,10,11,26,"chr1",1,0.0853258321612752
"1466","chr1.156055000.156060000","chr1.156190000.156195000",135000,27,4.580632e-11,156055000,156190000,156060000,156195000,"chr1",39646,3,8,12,23,"chr1",1,0.0727848101265823
"1467","chr1.230545000.230550000","chr1.230565000.230570000",20000,39,0.00129403,230545000,230565000,230550000,230570000,"chr1",39703,2,4,2,8,"chr1",1,0.0365682137834037
"1468","chr1.10030000.10035000","chr1.10065000.10070000",35000,48,1.090708e-12,10030000,10065000,10035000,10070000,"chr1",39756,0,6,12,18,"chr1",1,0.10126582278481
"1469","chr1.9950000.9955000","chr1.10070000.10075000",120000,18,0.0001811171,9950000,10070000,9955000,10075000,"chr1",39833,10,11,15,36,"chr1",1,0.0759493670886076
"1470","chr1.2160000.2165000","chr1.2190000.2195000",30000,56,4.886374e-15,2160000,2190000,2165000,2195000,"chr1",39858,2,3,0,5,"chr1",1,0.0328176277543366
"1471","chr1.206725000.206730000","chr1.207670000.207675000",945000,7,0.002814613,206725000,207670000,206730000,207675000,"chr1",39886,0,2,1,3,"chr1",1,0.00246132208157525
"1472","chr1.234745000.234750000","chr1.234995000.235000000",250000,15,2.763449e-05,234745000,234995000,234750000,2.35e+08,"chr1",39895,5,7,7,19,"chr1",1,0.0334036568213783
"1473","chr1.40640000.40645000","chr1.40690000.40695000",50000,29,1.101132e-05,40640000,40690000,40645000,40695000,"chr1",39909,3,2,8,13,"chr1",1,0.0441865916549461
"1474","chr1.8460000.8465000","chr1.8630000.8635000",170000,15,0.0006470043,8460000,8630000,8465000,8635000,"chr1",39914,6,11,15,32,"chr1",1,0.0562587904360056
"1475","chr1.151045000.151050000","chr1.151295000.151300000",250000,13,0.000560038,151045000,151295000,151050000,151300000,"chr1",39927,2,5,9,16,"chr1",1,0.0243788091889358
"1476","chr1.109240000.109245000","chr1.109300000.109305000",60000,23,0.0005784889,109240000,109300000,109245000,109305000,"chr1",39962,0,4,1,5,"chr1",1,0.0134786685419597
"1477","chr1.23725000.23730000","chr1.23790000.23795000",65000,20,0.004296559,23725000,23790000,23730000,23795000,"chr1",39991,0,0,5,5,"chr1",1,0.0117205813408345
"1478","chr1.43695000.43700000","chr1.43760000.43765000",65000,20,0.004296559,43695000,43760000,43700000,43765000,"chr1",40025,2,3,5,10,"chr1",1,0.023441162681669
"1479","chr1.153475000.153480000","chr1.153570000.153575000",95000,18,0.001200097,153475000,153570000,153480000,153575000,"chr1",40045,10,16,20,46,"chr1",1,0.0970464135021097
"1480","chr1.61695000.61700000","chr1.61720000.61725000",25000,34,0.006227396,61695000,61720000,61700000,61725000,"chr1",40077,8,21,18,47,"chr1",1,0.187294889826535
"1481","chr1.201550000.201555000","chr1.201790000.201795000",240000,14,0.0001796433,201550000,201790000,201555000,201795000,"chr1",40129,0,2,1,3,"chr1",1,0.00492264416315049
"1482","chr1.10160000.10165000","chr1.10280000.10285000",120000,15,0.005618157,10160000,10280000,10165000,10285000,"chr1",40152,9,30,32,71,"chr1",1,0.124824191279887
"1483","chr1.171455000.171460000","chr1.171740000.171745000",285000,12,0.000930769,171455000,171740000,171460000,171745000,"chr1",40168,4,4,13,21,"chr1",1,0.029535864978903
"1484","chr1.26830000.26835000","chr1.27120000.27125000",290000,14,3.881624e-05,26830000,27120000,26835000,27125000,"chr1",40178,0,6,1,7,"chr1",1,0.0114861697140178
"1485","chr1.64135000.64140000","chr1.64630000.64635000",495000,10,0.0007247824,64135000,64630000,64140000,64635000,"chr1",40184,0,5,3,8,"chr1",1,0.00937646507266761
"1486","chr1.54335000.54340000","chr1.54500000.54505000",165000,13,0.00838272,54335000,54500000,54340000,54505000,"chr1",40203,2,6,1,9,"chr1",1,0.0137130801687764
"1487","chr1.32765000.32770000","chr1.32875000.32880000",110000,17,0.00115434,32765000,32875000,32770000,32880000,"chr1",40218,0,3,6,9,"chr1",1,0.0179324894514768
"1488","chr1.29215000.29220000","chr1.29350000.29355000",135000,15,0.00290255,29215000,29350000,29220000,29355000,"chr1",40250,1,1,1,3,"chr1",1,0.00527426160337553
"1489","chr1.77900000.77905000","chr1.77975000.77980000",75000,22,0.0001362782,77900000,77975000,77905000,77980000,"chr1",40268,0,5,5,10,"chr1",1,0.0257852789498359
"1490","chr1.150320000.150325000","chr1.150920000.150925000",600000,8,0.005890398,150320000,150920000,150325000,150925000,"chr1",40282,0,11,9,20,"chr1",1,0.0187529301453352
"1491","chr1.112935000.112940000","chr1.112980000.112985000",45000,25,0.001925343,112935000,112980000,112940000,112985000,"chr1",40283,1,18,7,26,"chr1",1,0.0761837787154243
"1492","chr1.11330000.11335000","chr1.11700000.11705000",370000,22,2.748878e-13,11330000,11700000,11335000,11705000,"chr1",40284,0,2,1,3,"chr1",1,0.00773558368495077
"1493","chr1.20225000.20230000","chr1.20460000.20465000",235000,14,0.0002134243,20225000,20460000,20230000,20465000,"chr1",40417,0,0,2,2,"chr1",1,0.00328176277543366
"1494","chr1.19240000.19245000","chr1.19285000.19290000",45000,24,0.004449684,19240000,19285000,19245000,19290000,"chr1",40446,3,6,7,16,"chr1",1,0.0450070323488045
"1495","chr1.153750000.153755000","chr1.153945000.153950000",195000,13,0.003098721,153750000,153945000,153755000,153950000,"chr1",40552,2,4,2,8,"chr1",1,0.0121894045944679
"1496","chr1.155745000.155750000","chr1.155790000.155795000",45000,24,0.004449684,155745000,155790000,155750000,155795000,"chr1",40570,2,9,8,19,"chr1",1,0.0534458509142053
"1497","chr1.240215000.240220000","chr1.240850000.240855000",635000,8,0.004403874,240215000,240850000,240220000,240855000,"chr1",40582,0,0,3,3,"chr1",1,0.00281293952180028
"1498","chr1.234755000.234760000","chr1.235075000.235080000",320000,10,0.007480566,234755000,235075000,234760000,235080000,"chr1",40584,0,1,2,3,"chr1",1,0.00351617440225035
"1499","chr1.28435000.28440000","chr1.28515000.28520000",80000,20,0.0006470043,28435000,28515000,28440000,28520000,"chr1",40585,4,15,7,26,"chr1",1,0.0609470229723394
"1500","chr1.8625000.8630000","chr1.8660000.8665000",35000,30,0.0006685884,8625000,8660000,8630000,8665000,"chr1",40600,2,4,2,8,"chr1",1,0.0281293952180028
"1501","chr1.153645000.153650000","chr1.153920000.153925000",275000,11,0.00450062,153645000,153920000,153650000,153925000,"chr1",40699,2,13,7,22,"chr1",1,0.0283638068448195
"1502","chr1.16930000.16935000","chr1.16960000.16965000",30000,92,2.5592e-41,16930000,16960000,16935000,16965000,"chr1",40720,9,24,14,47,"chr1",1,0.506797937177684
"1503","chr1.9950000.9955000","chr1.10425000.10430000",475000,14,6.388354e-07,9950000,10425000,9955000,10430000,"chr1",40751,8,21,23,52,"chr1",1,0.0853258321612752
"1504","chr1.16175000.16180000","chr1.16245000.16250000",70000,21,0.0008075999,16175000,16245000,16180000,16250000,"chr1",40783,0,9,2,11,"chr1",1,0.0270745428973277
"1505","chr1.9980000.9985000","chr1.10470000.10475000",490000,10,0.0007771036,9980000,10470000,9985000,10475000,"chr1",40820,7,17,10,34,"chr1",1,0.0398499765588373
"1506","chr1.40590000.40595000","chr1.40860000.40865000",270000,11,0.004966,40590000,40860000,40595000,40865000,"chr1",40840,3,9,11,23,"chr1",1,0.0296530707923113
"1507","chr1.32970000.32975000","chr1.33005000.33010000",35000,27,0.00691274,32970000,33005000,32975000,33010000,"chr1",40927,0,2,1,3,"chr1",1,0.00949367088607595
"1508","chr1.66475000.66480000","chr1.66690000.66695000",215000,12,0.005556037,66475000,66690000,66480000,66695000,"chr1",40949,0,2,1,3,"chr1",1,0.00421940928270042
"1509","chr1.10065000.10070000","chr1.10475000.10480000",410000,10,0.002213559,10065000,10475000,10070000,10480000,"chr1",40966,7,11,29,47,"chr1",1,0.0550867323019222
"1510","chr1.149935000.149940000","chr1.149960000.149965000",25000,41,3.467397e-05,149935000,149960000,149940000,149965000,"chr1",40979,0,6,6,12,"chr1",1,0.0576652601969058
"1511","chr1.168600000.168605000","chr1.169320000.169325000",720000,9,0.0003728947,168600000,169320000,168605000,169325000,"chr1",41010,0,2,0,2,"chr1",1,0.00210970464135021
"1512","chr1.8095000.8100000","chr1.8405000.8410000",310000,13,0.0001182238,8095000,8405000,8100000,8410000,"chr1",41017,1,4,3,8,"chr1",1,0.0121894045944679
"1513","chr1.25680000.25685000","chr1.26170000.26175000",490000,10,0.0007771036,25680000,26170000,25685000,26175000,"chr1",41071,1,10,6,17,"chr1",1,0.0199249882794187
"1514","chr1.230545000.230550000","chr1.230780000.230785000",235000,12,0.003229073,230545000,230780000,230550000,230785000,"chr1",41091,0,4,3,7,"chr1",1,0.00984528832630099
"1515","chr1.10280000.10285000","chr1.10470000.10475000",190000,14,0.001061267,10280000,10470000,10285000,10475000,"chr1",41100,7,17,24,48,"chr1",1,0.0787623066104079
"1516","chr1.183650000.183655000","chr1.183805000.183810000",155000,15,0.001236846,183650000,183805000,183655000,183810000,"chr1",41102,1,1,1,3,"chr1",1,0.00527426160337553
"1517","chr1.16155000.16160000","chr1.16240000.16245000",85000,18,0.003006639,16155000,16240000,16160000,16245000,"chr1",41147,5,9,10,24,"chr1",1,0.0506329113924051
"1518","chr1.182080000.182085000","chr1.182110000.182115000",30000,54,7.538124e-14,182080000,182110000,182085000,182115000,"chr1",41229,0,3,3,6,"chr1",1,0.0379746835443038
"1519","chr1.32755000.32760000","chr1.32815000.32820000",60000,21,0.003722807,32755000,32815000,32760000,32820000,"chr1",41238,0,4,2,6,"chr1",1,0.0147679324894515
"1520","chr1.8095000.8100000","chr1.8595000.8600000",500000,9,0.003339969,8095000,8595000,8100000,8600000,"chr1",41324,1,4,3,8,"chr1",1,0.00843881856540084
"1521","chr1.38450000.38455000","chr1.39290000.39295000",840000,7,0.005535442,38450000,39290000,38455000,39295000,"chr1",41341,0,5,3,8,"chr1",1,0.00656352555086732
"1522","chr1.64160000.64165000","chr1.64490000.64495000",330000,11,0.001629786,64160000,64490000,64165000,64495000,"chr1",41406,1,2,0,3,"chr1",1,0.00386779184247539
"1523","chr1.205105000.205110000","chr1.205230000.205235000",125000,17,0.0004573819,205105000,205230000,205110000,205235000,"chr1",41435,1,3,4,8,"chr1",1,0.0159399906235349
"1524","chr1.155270000.155275000","chr1.155685000.155690000",415000,12,8.351218e-05,155270000,155685000,155275000,155690000,"chr1",41436,0,7,8,15,"chr1",1,0.0210970464135021
"1525","chr1.150055000.150060000","chr1.150145000.150150000",90000,17,0.005066586,150055000,150145000,150060000,150150000,"chr1",41518,1,5,5,11,"chr1",1,0.0219174871073605
"1526","chr1.16620000.16625000","chr1.16960000.16965000",340000,11,0.001394873,16620000,16960000,16625000,16965000,"chr1",41555,2,11,6,19,"chr1",1,0.0244960150023441
"1527","chr1.117125000.117130000","chr1.117215000.117220000",90000,17,0.005066586,117125000,117215000,117130000,117220000,"chr1",41570,1,3,6,10,"chr1",1,0.0199249882794187
"1528","chr1.210790000.210795000","chr1.211305000.211310000",515000,11,9.978679e-05,210790000,211305000,210795000,211310000,"chr1",41600,0,6,4,10,"chr1",1,0.012892639474918
"1529","chr1.151155000.151160000","chr1.151370000.151375000",215000,12,0.005556037,151155000,151370000,151160000,151375000,"chr1",41713,1,5,5,11,"chr1",1,0.0154711673699015
"1530","chr1.223710000.223715000","chr1.223810000.223815000",100000,26,1.58293e-08,223710000,223810000,223715000,223815000,"chr1",41715,2,5,12,19,"chr1",1,0.0578996718237225
"1531","chr1.212255000.212260000","chr1.212440000.212445000",185000,13,0.004288904,212255000,212440000,212260000,212445000,"chr1",41725,1,4,5,10,"chr1",1,0.0152367557430849
"1532","chr1.8025000.8030000","chr1.8410000.8415000",385000,12,0.0001394881,8025000,8410000,8030000,8415000,"chr1",41778,0,2,3,5,"chr1",1,0.0070323488045007
"1533","chr1.155500000.155505000","chr1.155915000.155920000",415000,9,0.008599339,155500000,155915000,155505000,155920000,"chr1",41798,6,21,24,51,"chr1",1,0.0537974683544304
"1534","chr1.204415000.204420000","chr1.204465000.204470000",50000,89,7.995008e-54,204415000,204465000,204420000,204470000,"chr1",41802,0,2,2,4,"chr1",1,0.0417252695733708
"1535","chr1.109630000.109635000","chr1.109655000.109660000",25000,37,0.0008057805,109630000,109655000,109635000,109660000,"chr1",41808,0,3,3,6,"chr1",1,0.0260196905766526
"1536","chr1.51905000.51910000","chr1.51950000.51955000",45000,34,1.721488e-07,51905000,51950000,51910000,51955000,"chr1",41813,0,2,0,2,"chr1",1,0.00796999531176746
"1537","chr1.8595000.8600000","chr1.8885000.8890000",290000,12,0.0008248102,8595000,8885000,8600000,8890000,"chr1",41827,6,4,5,15,"chr1",1,0.0210970464135021
"1538","chr1.153490000.153495000","chr1.153535000.153540000",45000,26,0.0008075999,153490000,153535000,153495000,153540000,"chr1",41858,1,4,3,8,"chr1",1,0.0243788091889358
"1539","chr1.155910000.155915000","chr1.155955000.155960000",45000,24,0.004449684,155910000,155955000,155915000,155960000,"chr1",41914,1,4,8,13,"chr1",1,0.0365682137834037
"1540","chr1.8630000.8635000","chr1.8875000.8880000",245000,15,3.29545e-05,8630000,8875000,8635000,8880000,"chr1",41973,5,16,18,39,"chr1",1,0.0685654008438819
"1541","chr1.46400000.46405000","chr1.46450000.46455000",50000,22,0.008541777,46400000,46450000,46405000,46455000,"chr1",42003,3,2,2,7,"chr1",1,0.0180496952648851
"1542","chr1.153785000.153790000","chr1.153945000.153950000",160000,14,0.003280797,153785000,153945000,153790000,153950000,"chr1",42011,2,4,2,8,"chr1",1,0.0131270511017346
"1543","chr1.168600000.168605000","chr1.169070000.169075000",470000,11,0.0001941265,168600000,169070000,168605000,169075000,"chr1",42035,0,2,0,2,"chr1",1,0.00257852789498359
"1544","chr1.178000000.178005000","chr1.178240000.178245000",240000,21,9.62174e-10,1.78e+08,178240000,178005000,178245000,"chr1",42063,0,2,1,3,"chr1",1,0.00738396624472574
"1545","chr1.111765000.111770000","chr1.111790000.111795000",25000,59,1.675795e-13,111765000,111790000,111770000,111795000,"chr1",42071,1,3,5,9,"chr1",1,0.0622362869198312
"1546","chr1.66275000.66280000","chr1.66295000.66300000",20000,44,3.073313e-05,66275000,66295000,66280000,66300000,"chr1",42077,0,2,2,4,"chr1",1,0.0206282231598687
"1547","chr1.28735000.28740000","chr1.28830000.28835000",95000,24,6.346975e-07,28735000,28830000,28740000,28835000,"chr1",42137,1,9,2,12,"chr1",1,0.0337552742616034
"1548","chr1.44320000.44325000","chr1.44505000.44510000",185000,13,0.004288904,44320000,44505000,44325000,44510000,"chr1",42138,0,0,2,2,"chr1",1,0.00304735114861697
"1549","chr1.174745000.174750000","chr1.174940000.174945000",195000,17,1.253798e-05,174745000,174940000,174750000,174945000,"chr1",42168,3,6,14,23,"chr1",1,0.0458274730426629
"1550","chr1.229505000.229510000","chr1.229625000.229630000",120000,17,0.0006133453,229505000,229625000,229510000,229630000,"chr1",42179,5,1,5,11,"chr1",1,0.0219174871073605
"1551","chr1.243505000.243510000","chr1.244410000.244415000",905000,7,0.00365728,243505000,244410000,243510000,244415000,"chr1",42235,0,2,1,3,"chr1",1,0.00246132208157525
"1552","chr1.155960000.155965000","chr1.156020000.156025000",60000,20,0.00869379,155960000,156020000,155965000,156025000,"chr1",42248,6,10,17,33,"chr1",1,0.0773558368495077
"1553","chr1.202900000.202905000","chr1.202965000.202970000",65000,35,2.964485e-11,202900000,202965000,202905000,202970000,"chr1",42265,2,14,11,27,"chr1",1,0.110759493670886
"1554","chr1.204415000.204420000","chr1.204475000.204480000",60000,36,3.940093e-11,204415000,204475000,204420000,204480000,"chr1",42272,2,3,2,7,"chr1",1,0.029535864978903
"1555","chr1.204245000.204250000","chr1.204300000.204305000",55000,25,0.0002173261,204245000,204300000,204250000,204305000,"chr1",42281,1,2,3,6,"chr1",1,0.0175808720112518
"1556","chr1.25175000.25180000","chr1.25525000.25530000",350000,11,0.00119049,25175000,25525000,25180000,25530000,"chr1",42287,4,8,9,21,"chr1",1,0.0270745428973277
"1557","chr1.156570000.156575000","chr1.156625000.156630000",55000,21,0.00838272,156570000,156625000,156575000,156630000,"chr1",42316,2,10,7,19,"chr1",1,0.0467651195499297
"1558","chr1.234975000.234980000","chr1.235070000.235075000",95000,19,0.0003929148,234975000,235070000,234980000,235075000,"chr1",42328,0,4,1,5,"chr1",1,0.0111345522737928
"1559","chr1.210585000.210590000","chr1.211545000.211550000",960000,8,0.0003573867,210585000,211545000,210590000,211550000,"chr1",42349,1,4,2,7,"chr1",1,0.00656352555086732
"1560","chr1.21220000.21225000","chr1.21330000.21335000",110000,16,0.00338394,21220000,21330000,21225000,21335000,"chr1",42360,4,11,10,25,"chr1",1,0.046882325363338
"1561","chr1.43950000.43955000","chr1.44545000.44550000",595000,9,0.001235866,43950000,44545000,43955000,44550000,"chr1",42401,0,3,1,4,"chr1",1,0.00421940928270042
"1562","chr1.7720000.7725000","chr1.7960000.7965000",240000,11,0.009597206,7720000,7960000,7725000,7965000,"chr1",42436,4,10,11,25,"chr1",1,0.0322315986872949
"1563","chr1.203235000.203240000","chr1.203275000.203280000",40000,29,0.0002333342,203235000,203275000,203240000,203280000,"chr1",42439,2,6,7,15,"chr1",1,0.0509845288326301
"1564","chr1.150055000.150060000","chr1.150185000.150190000",130000,17,0.0003492026,150055000,150185000,150060000,150190000,"chr1",42476,3,8,13,24,"chr1",1,0.0478199718706048
"1565","chr1.205515000.205520000","chr1.205590000.205595000",75000,19,0.003125299,205515000,205590000,205520000,205595000,"chr1",42507,0,2,1,3,"chr1",1,0.00668073136427567
"1566","chr1.54885000.54890000","chr1.54940000.54945000",55000,24,0.0005843961,54885000,54940000,54890000,54945000,"chr1",42516,1,0,1,2,"chr1",1,0.00562587904360056
"1567","chr1.9950000.9955000","chr1.10470000.10475000",520000,11,9.322159e-05,9950000,10470000,9955000,10475000,"chr1",42518,7,17,24,48,"chr1",1,0.0618846694796062
"1568","chr1.156390000.156395000","chr1.156570000.156575000",180000,15,0.0004279485,156390000,156570000,156395000,156575000,"chr1",42537,0,3,3,6,"chr1",1,0.0105485232067511
"1569","chr1.89585000.89590000","chr1.89720000.89725000",135000,14,0.008425895,89585000,89720000,89590000,89725000,"chr1",42548,0,0,3,3,"chr1",1,0.00492264416315049
"1570","chr1.11095000.11100000","chr1.11700000.11705000",605000,12,3.879487e-06,11095000,11700000,11100000,11705000,"chr1",42613,0,2,1,3,"chr1",1,0.00421940928270042
"1571","chr1.39395000.39400000","chr1.39490000.39495000",95000,18,0.001200097,39395000,39490000,39400000,39495000,"chr1",42662,1,1,0,2,"chr1",1,0.00421940928270042
"1572","chr1.168670000.168675000","chr1.169080000.169085000",410000,11,0.0004758657,168670000,169080000,168675000,169085000,"chr1",42694,0,1,3,4,"chr1",1,0.00515705578996718
"1573","chr1.8095000.8100000","chr1.8380000.8385000",285000,12,0.000930769,8095000,8380000,8100000,8385000,"chr1",42698,1,3,2,6,"chr1",1,0.00843881856540084
"1574","chr1.39405000.39410000","chr1.39455000.39460000",50000,30,3.553513e-06,39405000,39455000,39410000,39460000,"chr1",42714,0,2,0,2,"chr1",1,0.0070323488045007
"1575","chr1.27030000.27035000","chr1.27070000.27075000",40000,27,0.001354847,27030000,27070000,27035000,27075000,"chr1",42717,2,7,2,11,"chr1",1,0.0348101265822785
"1576","chr1.155985000.155990000","chr1.156020000.156025000",35000,43,7.540224e-10,155985000,156020000,155990000,156025000,"chr1",42745,1,13,14,28,"chr1",1,0.141115799343647
"1577","chr1.243745000.243750000","chr1.243850000.243855000",105000,18,0.0005300991,243745000,243850000,243750000,243855000,"chr1",42802,1,1,1,3,"chr1",1,0.00632911392405063
"1578","chr1.155685000.155690000","chr1.155895000.155900000",210000,14,0.0005117364,155685000,155895000,155690000,155900000,"chr1",42838,0,7,9,16,"chr1",1,0.0262541022034693
"1579","chr1.23440000.23445000","chr1.23480000.23485000",40000,41,2.935858e-10,23440000,23480000,23445000,23485000,"chr1",42907,0,5,3,8,"chr1",1,0.0384435067979372
"1580","chr1.212475000.212480000","chr1.212545000.212550000",70000,24,3.073313e-05,212475000,212545000,212480000,212550000,"chr1",42965,1,4,0,5,"chr1",1,0.0140646976090014
"1581","chr1.31265000.31270000","chr1.31380000.31385000",115000,27,4.132448e-10,31265000,31380000,31270000,31385000,"chr1",43023,1,4,3,8,"chr1",1,0.0253164556962025
"1582","chr1.168615000.168620000","chr1.169080000.169085000",465000,10,0.001076799,168615000,169080000,168620000,169085000,"chr1",43030,1,2,0,3,"chr1",1,0.00351617440225035
"1583","chr1.44815000.44820000","chr1.44945000.44950000",130000,17,0.0003492026,44815000,44945000,44820000,44950000,"chr1",43072,5,7,14,26,"chr1",1,0.0518049695264885
"1584","chr1.84620000.84625000","chr1.84945000.84950000",325000,13,8.43013e-05,84620000,84945000,84625000,84950000,"chr1",43097,0,5,5,10,"chr1",1,0.0152367557430849
"1585","chr1.201540000.201545000","chr1.201600000.201605000",60000,29,6.563593e-07,201540000,201600000,201545000,201605000,"chr1",43167,1,2,2,5,"chr1",1,0.01699484294421
"1586","chr1.150530000.150535000","chr1.150970000.150975000",440000,11,0.0003021836,150530000,150970000,150535000,150975000,"chr1",43172,1,0,3,4,"chr1",1,0.00515705578996718
"1587","chr1.28580000.28585000","chr1.28925000.28930000",345000,15,1.646982e-06,28580000,28925000,28585000,28930000,"chr1",43203,6,12,14,32,"chr1",1,0.0562587904360056
"1588","chr1.204185000.204190000","chr1.204365000.204370000",180000,13,0.005018612,204185000,204365000,204190000,204370000,"chr1",43254,0,1,2,3,"chr1",1,0.00457102672292546
"1589","chr1.202885000.202890000","chr1.202965000.202970000",80000,21,0.0002162115,202885000,202965000,202890000,202970000,"chr1",43267,2,12,11,25,"chr1",1,0.0615330520393812
"1590","chr1.8095000.8100000","chr1.8410000.8415000",315000,20,1.965576e-10,8095000,8410000,8100000,8415000,"chr1",43272,1,4,3,8,"chr1",1,0.0187529301453352
"1591","chr1.116345000.116350000","chr1.116530000.116535000",185000,15,0.0003492026,116345000,116530000,116350000,116535000,"chr1",43275,0,0,3,3,"chr1",1,0.00527426160337553
"1592","chr1.144545000.144550000","chr1.144995000.145000000",450000,19,2.08306e-11,144545000,144995000,144550000,1.45e+08,"chr1",43280,0,0,3,3,"chr1",1,0.00668073136427567
"1593","chr1.26430000.26435000","chr1.26470000.26475000",40000,56,4.758867e-20,26430000,26470000,26435000,26475000,"chr1",43284,0,5,3,8,"chr1",1,0.0525082044069386
"1594","chr1.66445000.66450000","chr1.66600000.66605000",155000,16,0.0003558736,66445000,66600000,66450000,66605000,"chr1",43413,1,1,0,2,"chr1",1,0.00375058602906704
"1595","chr1.156050000.156055000","chr1.156160000.156165000",110000,15,0.009294725,156050000,156160000,156055000,156165000,"chr1",43414,0,3,1,4,"chr1",1,0.0070323488045007
"1596","chr1.10030000.10035000","chr1.10495000.10500000",465000,11,0.0002098796,10030000,10495000,10035000,10500000,"chr1",43442,0,2,2,4,"chr1",1,0.00515705578996718
"1597","chr1.16960000.16965000","chr1.17270000.17275000",310000,11,0.002313048,16960000,17270000,16965000,17275000,"chr1",43455,7,12,18,37,"chr1",1,0.0477027660571964
"1598","chr1.11155000.11160000","chr1.11260000.11265000",105000,20,4.589527e-05,11155000,11260000,11160000,11265000,"chr1",43489,1,3,3,7,"chr1",1,0.0164088138771683
"1599","chr1.23365000.23370000","chr1.23790000.23795000",425000,10,0.001810359,23365000,23790000,23370000,23795000,"chr1",43495,0,0,5,5,"chr1",1,0.00586029067041725
"1600","chr1.8510000.8515000","chr1.8685000.8690000",175000,15,0.0005339167,8510000,8685000,8515000,8690000,"chr1",43500,2,12,13,27,"chr1",1,0.0474683544303797
"1601","chr1.27340000.27345000","chr1.28125000.28130000",785000,7,0.007719712,27340000,28125000,27345000,28130000,"chr1",43533,0,11,6,17,"chr1",1,0.0139474917955931
"1602","chr1.155270000.155275000","chr1.155560000.155565000",290000,14,3.881624e-05,155270000,155560000,155275000,155565000,"chr1",43563,0,2,0,2,"chr1",1,0.00328176277543366
"1603","chr1.155895000.155900000","chr1.156020000.156025000",125000,16,0.001500618,155895000,156020000,155900000,156025000,"chr1",43580,7,21,17,45,"chr1",1,0.0843881856540084
"1604","chr1.161190000.161195000","chr1.161285000.161290000",95000,26,3.349354e-08,161190000,161285000,161195000,161290000,"chr1",43613,6,16,13,35,"chr1",1,0.106657290201594
"1605","chr1.33385000.33390000","chr1.33470000.33475000",85000,17,0.007758048,33385000,33470000,33390000,33475000,"chr1",43632,2,1,2,5,"chr1",1,0.00996249413970933
"1606","chr1.149915000.149920000","chr1.150010000.150015000",95000,18,0.001200097,149915000,150010000,149920000,150015000,"chr1",43670,1,1,7,9,"chr1",1,0.0189873417721519
"1607","chr1.8625000.8630000","chr1.8725000.8730000",100000,16,0.006415049,8625000,8725000,8630000,8730000,"chr1",43671,1,10,17,28,"chr1",1,0.0525082044069386
"1608","chr1.204185000.204190000","chr1.204345000.204350000",160000,14,0.003280797,204185000,204345000,204190000,204350000,"chr1",43684,0,2,1,3,"chr1",1,0.00492264416315049
"1609","chr1.153795000.153800000","chr1.153960000.153965000",165000,15,0.0008057805,153795000,153960000,153800000,153965000,"chr1",43686,0,2,2,4,"chr1",1,0.0070323488045007
"1610","chr1.230205000.230210000","chr1.230345000.230350000",140000,17,0.000209311,230205000,230345000,230210000,230350000,"chr1",43698,3,4,4,11,"chr1",1,0.0219174871073605
"1611","chr1.10110000.10115000","chr1.10175000.10180000",65000,24,7.710059e-05,10110000,10175000,10115000,10180000,"chr1",43699,7,13,16,36,"chr1",1,0.10126582278481
"1612","chr1.54320000.54325000","chr1.54885000.54890000",565000,11,4.955416e-05,54320000,54885000,54325000,54890000,"chr1",43712,0,1,1,2,"chr1",1,0.00257852789498359
"1613","chr1.9875000.9880000","chr1.10335000.10340000",460000,9,0.005175406,9875000,10335000,9880000,10340000,"chr1",43796,0,3,3,6,"chr1",1,0.00632911392405063
"1614","chr1.155250000.155255000","chr1.155830000.155835000",580000,10,0.0002561047,155250000,155830000,155255000,155835000,"chr1",43913,2,21,12,35,"chr1",1,0.0410220346929208
"1615","chr1.161165000.161170000","chr1.161365000.161370000",200000,15,0.0001884219,161165000,161365000,161170000,161370000,"chr1",43964,0,5,2,7,"chr1",1,0.0123066104078762
"1616","chr1.42035000.42040000","chr1.42255000.42260000",220000,13,0.00137653,42035000,42255000,42040000,42260000,"chr1",44006,0,0,2,2,"chr1",1,0.00304735114861697
"1617","chr1.84620000.84625000","chr1.85150000.85155000",530000,9,0.0024319,84620000,85150000,84625000,85155000,"chr1",44032,1,11,6,18,"chr1",1,0.0189873417721519
"1618","chr1.10160000.10165000","chr1.10210000.10215000",50000,24,0.001605476,10160000,10210000,10165000,10215000,"chr1",44047,6,16,13,35,"chr1",1,0.0984528832630098
"1619","chr1.183805000.183810000","chr1.183830000.183835000",25000,36,0.001641975,183805000,183830000,183810000,183835000,"chr1",44053,2,1,0,3,"chr1",1,0.0126582278481013
"1620","chr1.210850000.210855000","chr1.211305000.211310000",455000,10,0.001229674,210850000,211305000,210855000,211310000,"chr1",44077,0,6,5,11,"chr1",1,0.012892639474918
"1621","chr1.8465000.8470000","chr1.8855000.8860000",390000,10,0.00290255,8465000,8855000,8470000,8860000,"chr1",44081,6,22,23,51,"chr1",1,0.059774964838256
"1622","chr1.8525000.8530000","chr1.8590000.8595000",65000,22,0.0006470043,8525000,8590000,8530000,8595000,"chr1",44162,0,0,3,3,"chr1",1,0.00773558368495077
"1623","chr1.19680000.19685000","chr1.19880000.19885000",200000,13,0.00261335,19680000,19880000,19685000,19885000,"chr1",44179,5,5,3,13,"chr1",1,0.0198077824660103
"1624","chr1.43690000.43695000","chr1.44500000.44505000",810000,8,0.0011613,43690000,44500000,43695000,44505000,"chr1",44215,0,6,5,11,"chr1",1,0.0103141115799344
"1625","chr1.224435000.224440000","chr1.224455000.224460000",20000,37,0.004733079,224435000,224455000,224440000,224460000,"chr1",44293,3,3,3,9,"chr1",1,0.0390295358649789
"1626","chr1.156055000.156060000","chr1.156095000.156100000",40000,42,7.744207e-11,156055000,156095000,156060000,156100000,"chr1",44304,3,8,8,19,"chr1",1,0.0935302390998594
"1627","chr1.23690000.23695000","chr1.23810000.23815000",120000,15,0.005618157,23690000,23810000,23695000,23815000,"chr1",44433,2,13,13,28,"chr1",1,0.0492264416315049
"1628","chr1.171710000.171715000","chr1.171950000.171955000",240000,25,2.526053e-13,171710000,171950000,171715000,171955000,"chr1",44437,1,3,2,6,"chr1",1,0.0175808720112518
"1629","chr1.9765000.9770000","chr1.9875000.9880000",110000,16,0.00338394,9765000,9875000,9770000,9880000,"chr1",44446,0,3,3,6,"chr1",1,0.0112517580872011
"1630","chr1.11785000.11790000","chr1.11860000.11865000",75000,19,0.003125299,11785000,11860000,11790000,11865000,"chr1",44448,3,2,4,9,"chr1",1,0.020042194092827
"1631","chr1.153785000.153790000","chr1.153960000.153965000",175000,21,6.15242e-08,153785000,153960000,153790000,153965000,"chr1",44496,1,7,6,14,"chr1",1,0.0344585091420534
"1632","chr1.155860000.155865000","chr1.155900000.155905000",40000,27,0.001354847,155860000,155900000,155865000,155905000,"chr1",44514,9,39,35,83,"chr1",1,0.262658227848101
"1633","chr1.26240000.26245000","chr1.26305000.26310000",65000,21,0.001695142,26240000,26305000,26245000,26310000,"chr1",44542,5,13,9,27,"chr1",1,0.0664556962025316
"1634","chr1.29110000.29115000","chr1.29200000.29205000",90000,67,4.997782e-45,29110000,29200000,29115000,29205000,"chr1",44560,2,3,6,11,"chr1",1,0.0863806844819503
"1635","chr1.205655000.205660000","chr1.205675000.205680000",20000,50,1.454336e-07,205655000,205675000,205660000,205680000,"chr1",44589,0,5,1,6,"chr1",1,0.0351617440225035
"1636","chr1.19685000.19690000","chr1.19880000.19885000",195000,15,0.0002307636,19685000,19880000,19690000,19885000,"chr1",44592,2,5,7,14,"chr1",1,0.0246132208157525
"1637","chr1.182120000.182125000","chr1.182300000.182305000",180000,14,0.001527903,182120000,182300000,182125000,182305000,"chr1",44614,0,4,2,6,"chr1",1,0.00984528832630099
"1638","chr1.23775000.23780000","chr1.23790000.23795000",15000,39,0.00129403,23775000,23790000,23780000,23795000,"chr1",44625,0,0,5,5,"chr1",1,0.0228551336146273
"1639","chr1.150060000.150065000","chr1.150145000.150150000",85000,22,3.458094e-05,150060000,150145000,150065000,150150000,"chr1",44637,1,5,5,11,"chr1",1,0.0283638068448195
"1640","chr1.204500000.204505000","chr1.205070000.205075000",570000,8,0.007642337,204500000,205070000,204505000,205075000,"chr1",44642,0,2,0,2,"chr1",1,0.00187529301453352
"1641","chr1.40380000.40385000","chr1.40505000.40510000",125000,15,0.004449684,40380000,40505000,40385000,40510000,"chr1",44650,0,4,1,5,"chr1",1,0.00879043600562588
"1642","chr1.11155000.11160000","chr1.11330000.11335000",175000,13,0.005981441,11155000,11330000,11160000,11335000,"chr1",44670,1,3,3,7,"chr1",1,0.0106657290201594
"1643","chr1.201710000.201715000","chr1.201730000.201735000",20000,45,1.330901e-05,201710000,201730000,201715000,201735000,"chr1",44681,2,6,13,21,"chr1",1,0.110759493670886
"1644","chr1.29245000.29250000","chr1.29350000.29355000",105000,19,0.0001598251,29245000,29350000,29250000,29355000,"chr1",44688,0,1,0,1,"chr1",1,0.00222691045475856
"1645","chr1.234745000.234750000","chr1.235100000.235105000",355000,10,0.004583869,234745000,235100000,234750000,235105000,"chr1",44712,4,7,7,18,"chr1",1,0.0210970464135021
"1646","chr1.8460000.8465000","chr1.8710000.8715000",250000,16,5.434421e-06,8460000,8710000,8465000,8715000,"chr1",44720,1,11,11,23,"chr1",1,0.043131739334271
"1647","chr1.43945000.43950000","chr1.44270000.44275000",325000,12,0.0004079793,43945000,44270000,43950000,44275000,"chr1",44754,0,2,1,3,"chr1",1,0.00421940928270042
"1648","chr1.182560000.182565000","chr1.182780000.182785000",220000,19,1.24854e-07,182560000,182780000,182565000,182785000,"chr1",44849,1,3,0,4,"chr1",1,0.00890764181903422
"1649","chr1.234560000.234565000","chr1.235510000.235515000",950000,7,0.002714357,234560000,235510000,234565000,235515000,"chr1",44861,3,15,14,32,"chr1",1,0.0262541022034693
"1650","chr1.153510000.153515000","chr1.153545000.153550000",35000,31,0.0002882227,153510000,153545000,153515000,153550000,"chr1",44902,3,4,5,12,"chr1",1,0.0436005625879044
"1651","chr1.116920000.116925000","chr1.117030000.117035000",110000,27,7.83432e-10,116920000,117030000,116925000,117035000,"chr1",44909,0,2,2,4,"chr1",1,0.0126582278481013
"1652","chr1.54885000.54890000","chr1.54950000.54955000",65000,22,0.0006470043,54885000,54950000,54890000,54955000,"chr1",44910,2,1,1,4,"chr1",1,0.0103141115799344
"1653","chr1.156065000.156070000","chr1.156240000.156245000",175000,13,0.005981441,156065000,156240000,156070000,156245000,"chr1",44918,1,10,4,15,"chr1",1,0.0228551336146273
"1654","chr1.8470000.8475000","chr1.8700000.8705000",230000,12,0.003666933,8470000,8700000,8475000,8705000,"chr1",44930,0,2,1,3,"chr1",1,0.00421940928270042
"1655","chr1.201790000.201795000","chr1.202085000.202090000",295000,14,3.412721e-05,201790000,202085000,201795000,202090000,"chr1",44939,0,2,1,3,"chr1",1,0.00492264416315049
"1656","chr1.110335000.110340000","chr1.110475000.110480000",140000,24,5.535288e-09,110335000,110475000,110340000,110480000,"chr1",44961,1,0,2,3,"chr1",1,0.00843881856540084
"1657","chr1.203305000.203310000","chr1.203670000.203675000",365000,22,3.303959e-13,203305000,203670000,203310000,203675000,"chr1",44964,0,3,2,5,"chr1",1,0.012892639474918
"1658","chr1.156590000.156595000","chr1.156685000.156690000",95000,18,0.001200097,156590000,156685000,156595000,156690000,"chr1",44975,2,11,2,15,"chr1",1,0.0316455696202532
"1659","chr1.156385000.156390000","chr1.156405000.156410000",20000,44,3.073313e-05,156385000,156405000,156390000,156410000,"chr1",45042,0,1,1,2,"chr1",1,0.0103141115799344
"1660","chr1.161285000.161290000","chr1.161330000.161335000",45000,23,0.009597206,161285000,161330000,161290000,161335000,"chr1",45045,7,17,20,44,"chr1",1,0.118612283169245
"1661","chr1.233565000.233570000","chr1.234220000.234225000",655000,10,0.0001086939,233565000,234220000,233570000,234225000,"chr1",45049,0,2,1,3,"chr1",1,0.00351617440225035
"1662","chr1.168615000.168620000","chr1.169345000.169350000",730000,8,0.002075175,168615000,169345000,168620000,169350000,"chr1",45109,1,2,0,3,"chr1",1,0.00281293952180028
"1663","chr1.54795000.54800000","chr1.54950000.54955000",155000,23,8.821627e-09,54795000,54950000,54800000,54955000,"chr1",45112,1,3,1,5,"chr1",1,0.0134786685419597
"1664","chr1.160160000.160165000","chr1.160260000.160265000",100000,19,0.0002491261,160160000,160260000,160165000,160265000,"chr1",45113,0,2,0,2,"chr1",1,0.00445382090951711
"1665","chr1.84620000.84625000","chr1.84940000.84945000",320000,14,1.810507e-05,84620000,84940000,84625000,84945000,"chr1",45153,1,3,3,7,"chr1",1,0.0114861697140178
"1666","chr1.211740000.211745000","chr1.211830000.211835000",90000,19,0.0006470043,211740000,211830000,211745000,211835000,"chr1",45176,0,2,0,2,"chr1",1,0.00445382090951711
"1667","chr1.9685000.9690000","chr1.9925000.9930000",240000,16,8.00102e-06,9685000,9925000,9690000,9930000,"chr1",45190,2,20,17,39,"chr1",1,0.0731364275668073
"1668","chr1.21220000.21225000","chr1.21340000.21345000",120000,16,0.001909676,21220000,21340000,21225000,21345000,"chr1",45191,3,9,6,18,"chr1",1,0.0337552742616034
"1669","chr1.230245000.230250000","chr1.230265000.230270000",20000,37,0.004733079,230245000,230265000,230250000,230270000,"chr1",45221,3,7,2,12,"chr1",1,0.0520393811533052
"1670","chr1.201505000.201510000","chr1.201530000.201535000",25000,66,1.600473e-17,201505000,201530000,201510000,201535000,"chr1",45250,1,1,0,2,"chr1",1,0.0154711673699015
"1671","chr1.9980000.9985000","chr1.10065000.10070000",85000,19,0.001070775,9980000,10065000,9985000,10070000,"chr1",45283,8,26,10,44,"chr1",1,0.0979840600093765
"1672","chr1.161205000.161210000","chr1.161365000.161370000",160000,16,0.0002827585,161205000,161365000,161210000,161370000,"chr1",45285,3,5,2,10,"chr1",1,0.0187529301453352
"1673","chr1.204240000.204245000","chr1.204300000.204305000",60000,21,0.003722807,204240000,204300000,204245000,204305000,"chr1",45371,0,2,3,5,"chr1",1,0.0123066104078762
"1674","chr1.228900000.228905000","chr1.229275000.229280000",375000,15,7.993393e-07,228900000,229275000,228905000,229280000,"chr1",45415,1,1,2,4,"chr1",1,0.0070323488045007
"1675","chr1.229000000.229005000","chr1.229270000.229275000",270000,11,0.004966,2.29e+08,229270000,229005000,229275000,"chr1",45466,2,2,2,6,"chr1",1,0.00773558368495077
"1676","chr1.26880000.26885000","chr1.27115000.27120000",235000,14,0.0002134243,26880000,27115000,26885000,27120000,"chr1",45503,1,4,8,13,"chr1",1,0.0213314580403188
"1677","chr1.244755000.244760000","chr1.244965000.244970000",210000,15,0.0001254468,244755000,244965000,244760000,244970000,"chr1",45512,1,11,9,21,"chr1",1,0.0369198312236287
"1678","chr1.156080000.156085000","chr1.156160000.156165000",80000,18,0.004760983,156080000,156160000,156085000,156165000,"chr1",45560,0,4,0,4,"chr1",1,0.00843881856540084
"1679","chr1.110280000.110285000","chr1.110490000.110495000",210000,14,0.0005117364,110280000,110490000,110285000,110495000,"chr1",45577,0,1,0,1,"chr1",1,0.00164088138771683
"1680","chr1.110335000.110340000","chr1.110390000.110395000",55000,30,7.990362e-07,110335000,110390000,110340000,110395000,"chr1",45583,1,4,5,10,"chr1",1,0.0351617440225035
"1681","chr1.202715000.202720000","chr1.202965000.202970000",250000,11,0.007719712,202715000,202965000,202720000,202970000,"chr1",45615,2,10,11,23,"chr1",1,0.0296530707923113
"1682","chr1.11380000.11385000","chr1.11700000.11705000",320000,10,0.007480566,11380000,11700000,11385000,11705000,"chr1",45659,0,2,1,3,"chr1",1,0.00351617440225035
"1683","chr1.167685000.167690000","chr1.167715000.167720000",30000,36,5.590942e-05,167685000,167715000,167690000,167720000,"chr1",45689,0,3,5,8,"chr1",1,0.0337552742616034
"1684","chr1.9835000.9840000","chr1.9860000.9865000",25000,38,0.0003847014,9835000,9860000,9840000,9865000,"chr1",45732,3,7,10,20,"chr1",1,0.0890764181903422
"1685","chr1.151145000.151150000","chr1.151365000.151370000",220000,12,0.004800128,151145000,151365000,151150000,151370000,"chr1",45845,0,5,3,8,"chr1",1,0.0112517580872011
"1686","chr1.11175000.11180000","chr1.11195000.11200000",20000,38,0.00252151,11175000,11195000,11180000,11200000,"chr1",45933,0,4,3,7,"chr1",1,0.0311767463666198
"1687","chr1.54335000.54340000","chr1.54365000.54370000",30000,31,0.003104399,54335000,54365000,54340000,54370000,"chr1",45947,0,2,0,2,"chr1",1,0.00726676043131739
"1688","chr1.203590000.203595000","chr1.203640000.203645000",50000,30,3.553513e-06,203590000,203640000,203595000,203645000,"chr1",45993,3,8,4,15,"chr1",1,0.0527426160337553
"1689","chr1.229480000.229485000","chr1.229555000.229560000",75000,19,0.003125299,229480000,229555000,229485000,229560000,"chr1",46004,2,6,2,10,"chr1",1,0.0222691045475856
"1690","chr1.36620000.36625000","chr1.36650000.36655000",30000,45,5.709864e-09,36620000,36650000,36625000,36655000,"chr1",46032,0,3,3,6,"chr1",1,0.0316455696202532
"1691","chr1.150610000.150615000","chr1.150920000.150925000",310000,13,0.0001182238,150610000,150920000,150615000,150925000,"chr1",46102,4,34,24,62,"chr1",1,0.0944678856071261
"1692","chr1.28210000.28215000","chr1.28235000.28240000",25000,37,0.0008057805,28210000,28235000,28215000,28240000,"chr1",46107,5,16,10,31,"chr1",1,0.134435067979372
"1693","chr1.225975000.225980000","chr1.226120000.226125000",145000,20,2.347232e-06,225975000,226120000,225980000,226125000,"chr1",46138,0,9,3,12,"chr1",1,0.0281293952180028
"1694","chr1.16175000.16180000","chr1.16300000.16305000",125000,19,3.530743e-05,16175000,16300000,16180000,16305000,"chr1",46221,0,12,4,16,"chr1",1,0.0356305672761369
"1695","chr1.26985000.26990000","chr1.27120000.27125000",135000,14,0.008425895,26985000,27120000,26990000,27125000,"chr1",46260,5,22,15,42,"chr1",1,0.0689170182841069
"1696","chr1.167695000.167700000","chr1.167715000.167720000",20000,58,3.308932e-11,167695000,167715000,167700000,167720000,"chr1",46261,3,4,3,10,"chr1",1,0.0679793717768401
"1697","chr1.169130000.169135000","chr1.169160000.169165000",30000,41,4.470562e-07,169130000,169160000,169135000,169165000,"chr1",46277,0,2,2,4,"chr1",1,0.0192217533989686
"1698","chr1.243350000.243355000","chr1.243405000.243410000",55000,24,0.0005843961,243350000,243405000,243355000,243410000,"chr1",46304,1,2,2,5,"chr1",1,0.0140646976090014
"1699","chr1.26165000.26170000","chr1.26335000.26340000",170000,13,0.00702836,26165000,26335000,26170000,26340000,"chr1",46319,1,5,5,11,"chr1",1,0.0167604313173933
"1700","chr1.165600000.165605000","chr1.165655000.165660000",55000,28,8.565836e-06,165600000,165655000,165605000,165660000,"chr1",46321,3,3,9,15,"chr1",1,0.0492264416315049
"1701","chr1.11735000.11740000","chr1.11790000.11795000",55000,30,7.990362e-07,11735000,11790000,11740000,11795000,"chr1",46421,0,3,2,5,"chr1",1,0.0175808720112518
"1702","chr1.24400000.24405000","chr1.24715000.24720000",315000,10,0.008095926,24400000,24715000,24405000,24720000,"chr1",46430,3,11,13,27,"chr1",1,0.0316455696202532
"1703","chr1.8095000.8100000","chr1.8315000.8320000",220000,14,0.0003558736,8095000,8315000,8100000,8320000,"chr1",46492,1,4,3,8,"chr1",1,0.0131270511017346
"1704","chr1.10130000.10135000","chr1.10210000.10215000",80000,24,5.773374e-06,10130000,10210000,10135000,10215000,"chr1",46493,6,16,13,35,"chr1",1,0.0984528832630098
"1705","chr1.26285000.26290000","chr1.26305000.26310000",20000,44,3.073313e-05,26285000,26305000,26290000,26310000,"chr1",46497,1,6,3,10,"chr1",1,0.0515705578996718
"1706","chr1.155830000.155835000","chr1.155915000.155920000",85000,22,3.458094e-05,155830000,155915000,155835000,155920000,"chr1",46537,6,21,24,51,"chr1",1,0.131504922644163
"1707","chr1.150505000.150510000","chr1.150925000.150930000",420000,9,0.008177867,150505000,150925000,150510000,150930000,"chr1",46553,0,1,4,5,"chr1",1,0.00527426160337553
"1708","chr1.32215000.32220000","chr1.32400000.32405000",185000,15,0.0003492026,32215000,32400000,32220000,32405000,"chr1",46627,3,28,17,48,"chr1",1,0.0843881856540084
"1709","chr1.182050000.182055000","chr1.182345000.182350000",295000,16,1.074264e-06,182050000,182345000,182055000,182350000,"chr1",46674,5,11,9,25,"chr1",1,0.046882325363338
"1710","chr1.36065000.36070000","chr1.36175000.36180000",110000,17,0.00115434,36065000,36175000,36070000,36180000,"chr1",46691,7,17,9,33,"chr1",1,0.0657524613220816
"1711","chr1.8055000.8060000","chr1.8460000.8465000",405000,10,0.002358895,8055000,8460000,8060000,8465000,"chr1",46693,6,11,15,32,"chr1",1,0.0375058602906704
"1712","chr1.112955000.112960000","chr1.112995000.113000000",40000,28,0.0005784227,112955000,112995000,112960000,1.13e+08,"chr1",46696,1,16,8,25,"chr1",1,0.0820440693858415
"1713","chr1.151005000.151010000","chr1.151045000.151050000",40000,30,9.14609e-05,151005000,151045000,151010000,151050000,"chr1",46702,1,3,3,7,"chr1",1,0.0246132208157525
"1714","chr1.27070000.27075000","chr1.27095000.27100000",25000,37,0.0008057805,27070000,27095000,27075000,27100000,"chr1",46724,2,7,2,11,"chr1",1,0.0477027660571964
"1715","chr1.54495000.54500000","chr1.54950000.54955000",455000,9,0.005526424,54495000,54950000,54500000,54955000,"chr1",46738,1,3,1,5,"chr1",1,0.00527426160337553
"1716","chr1.64160000.64165000","chr1.64675000.64680000",515000,11,9.978679e-05,64160000,64675000,64165000,64680000,"chr1",46745,1,2,0,3,"chr1",1,0.00386779184247539
"1717","chr1.234745000.234750000","chr1.235125000.235130000",380000,16,1.001275e-07,234745000,235125000,234750000,235130000,"chr1",46831,1,7,7,15,"chr1",1,0.0281293952180028
"1718","chr1.11105000.11110000","chr1.11700000.11705000",595000,9,0.001235866,11105000,11700000,11110000,11705000,"chr1",46835,0,2,1,3,"chr1",1,0.00316455696202532
"1719","chr1.26825000.26830000","chr1.26920000.26925000",95000,19,0.0003929148,26825000,26920000,26830000,26925000,"chr1",46844,0,3,1,4,"chr1",1,0.00890764181903422
"1720","chr1.162055000.162060000","chr1.162090000.162095000",35000,30,0.0006685884,162055000,162090000,162060000,162095000,"chr1",46878,0,1,1,2,"chr1",1,0.0070323488045007
"1721","chr1.236280000.236285000","chr1.236685000.236690000",405000,11,0.0005159089,236280000,236685000,236285000,236690000,"chr1",46881,1,2,2,5,"chr1",1,0.00644631973745898
"1722","chr1.84615000.84620000","chr1.84940000.84945000",325000,11,0.001778335,84615000,84940000,84620000,84945000,"chr1",46889,1,3,3,7,"chr1",1,0.00902484763244257
"1723","chr1.228865000.228870000","chr1.229625000.229630000",760000,7,0.008896094,228865000,229625000,228870000,229630000,"chr1",46897,5,1,5,11,"chr1",1,0.00902484763244257
"1724","chr1.21290000.21295000","chr1.21505000.21510000",215000,13,0.001605476,21290000,21505000,21295000,21510000,"chr1",46899,2,4,7,13,"chr1",1,0.0198077824660103
"1725","chr1.156675000.156680000","chr1.156725000.156730000",50000,22,0.008541777,156675000,156725000,156680000,156730000,"chr1",46953,0,2,3,5,"chr1",1,0.012892639474918
"1726","chr1.150905000.150910000","chr1.150925000.150930000",20000,51,5.431705e-08,150905000,150925000,150910000,150930000,"chr1",47031,5,7,13,25,"chr1",1,0.14943741209564
"1727","chr1.203305000.203310000","chr1.203405000.203410000",100000,46,3.83868e-25,203305000,203405000,203310000,203410000,"chr1",47087,0,2,2,4,"chr1",1,0.0215658696671355
"1728","chr1.160980000.160985000","chr1.161035000.161040000",55000,35,1.113553e-09,160980000,161035000,160985000,161040000,"chr1",47089,2,17,12,31,"chr1",1,0.127168307548054
"1729","chr1.20530000.20535000","chr1.20815000.20820000",285000,11,0.00367059,20530000,20815000,20535000,20820000,"chr1",47173,12,27,34,73,"chr1",1,0.0941162681669011
"1730","chr1.151175000.151180000","chr1.151255000.151260000",80000,20,0.0006470043,151175000,151255000,151180000,151260000,"chr1",47239,8,21,23,52,"chr1",1,0.121894045944679
"1731","chr1.241690000.241695000","chr1.241995000.242000000",305000,16,7.829034e-07,241690000,241995000,241695000,2.42e+08,"chr1",47253,1,6,2,9,"chr1",1,0.0168776371308017
"1732","chr1.161165000.161170000","chr1.161280000.161285000",115000,18,0.0002518963,161165000,161280000,161170000,161285000,"chr1",47266,0,6,3,9,"chr1",1,0.0189873417721519
"1733","chr1.100265000.100270000","chr1.100700000.100705000",435000,9,0.00691274,100265000,100700000,100270000,100705000,"chr1",47275,1,6,4,11,"chr1",1,0.0116033755274262
"1734","chr1.205395000.205400000","chr1.205540000.205545000",145000,15,0.001879154,205395000,205540000,205400000,205545000,"chr1",47388,5,13,15,33,"chr1",1,0.0580168776371308
"1735","chr1.183920000.183925000","chr1.184670000.184675000",750000,8,0.001789712,183920000,184670000,183925000,184675000,"chr1",47390,0,7,0,7,"chr1",1,0.00656352555086732
"1736","chr1.27075000.27080000","chr1.27095000.27100000",20000,38,0.00252151,27075000,27095000,27080000,27100000,"chr1",47426,2,8,7,17,"chr1",1,0.0757149554617909
"1737","chr1.16960000.16965000","chr1.17020000.17025000",60000,20,0.00869379,16960000,17020000,16965000,17025000,"chr1",47433,2,2,1,5,"chr1",1,0.0117205813408345
"1738","chr1.155225000.155230000","chr1.155270000.155275000",45000,34,1.721488e-07,155225000,155270000,155230000,155275000,"chr1",47469,5,13,8,26,"chr1",1,0.103609939052977
"1739","chr1.155900000.155905000","chr1.155955000.155960000",55000,61,2.419625e-29,155900000,155955000,155905000,155960000,"chr1",47480,6,34,27,67,"chr1",1,0.479020159399906
"1740","chr1.150255000.150260000","chr1.150905000.150910000",650000,8,0.003870098,150255000,150905000,150260000,150910000,"chr1",47504,0,5,1,6,"chr1",1,0.00562587904360056
"1741","chr1.54330000.54335000","chr1.54415000.54420000",85000,19,0.001070775,54330000,54415000,54335000,54420000,"chr1",47512,4,10,13,27,"chr1",1,0.060126582278481
"1742","chr1.182085000.182090000","chr1.182110000.182115000",25000,42,1.476136e-05,182085000,182110000,182090000,182115000,"chr1",47516,0,1,1,2,"chr1",1,0.00984528832630099
"1743","chr1.33005000.33010000","chr1.33035000.33040000",30000,35,0.0001324766,33005000,33035000,33010000,33040000,"chr1",47545,0,2,1,3,"chr1",1,0.0123066104078762
"1744","chr1.182140000.182145000","chr1.182345000.182350000",205000,13,0.002217414,182140000,182345000,182145000,182350000,"chr1",47555,2,18,10,30,"chr1",1,0.0457102672292546
"1745","chr1.26870000.26875000","chr1.27280000.27285000",410000,9,0.009020058,26870000,27280000,26875000,27285000,"chr1",47598,1,10,9,20,"chr1",1,0.0210970464135021
"1746","chr1.21585000.21590000","chr1.21690000.21695000",105000,26,7.857051e-09,21585000,21690000,21590000,21695000,"chr1",47629,1,9,1,11,"chr1",1,0.0335208626347867
"1747","chr1.154935000.154940000","chr1.155030000.155035000",95000,18,0.001200097,154935000,155030000,154940000,155035000,"chr1",47658,1,4,0,5,"chr1",1,0.0105485232067511
"1748","chr1.26240000.26245000","chr1.26320000.26325000",80000,25,1.566151e-06,26240000,26320000,26245000,26325000,"chr1",47677,4,2,5,11,"chr1",1,0.0322315986872949
"1749","chr1.153645000.153650000","chr1.153695000.153700000",50000,48,2.150035e-17,153645000,153695000,153650000,153700000,"chr1",47707,2,13,7,22,"chr1",1,0.123769338959212
"1750","chr1.12315000.12320000","chr1.12340000.12345000",25000,42,1.476136e-05,12315000,12340000,12320000,12345000,"chr1",47713,3,6,5,14,"chr1",1,0.0689170182841069
"1751","chr1.156440000.156445000","chr1.156570000.156575000",130000,21,1.463599e-06,156440000,156570000,156445000,156575000,"chr1",47729,2,4,7,13,"chr1",1,0.0319971870604782
"1752","chr1.33390000.33395000","chr1.33470000.33475000",80000,19,0.00180801,33390000,33470000,33395000,33475000,"chr1",47780,1,1,0,2,"chr1",1,0.00445382090951711
"1753","chr1.228795000.228800000","chr1.229625000.229630000",830000,8,0.0009978666,228795000,229625000,228800000,229630000,"chr1",47792,5,1,5,11,"chr1",1,0.0103141115799344
"1754","chr1.153605000.153610000","chr1.153625000.153630000",20000,61,1.037412e-12,153605000,153625000,153610000,153630000,"chr1",47812,0,7,5,12,"chr1",1,0.0857946554149086
"1755","chr1.153530000.153535000","chr1.153955000.153960000",425000,9,0.007719712,153530000,153955000,153535000,153960000,"chr1",47872,3,5,6,14,"chr1",1,0.0147679324894515
"1756","chr1.233570000.233575000","chr1.233940000.233945000",370000,10,0.003722807,233570000,233940000,233575000,233945000,"chr1",47886,3,2,3,8,"chr1",1,0.00937646507266761
"1757","chr1.33470000.33475000","chr1.33535000.33540000",65000,21,0.001695142,33470000,33535000,33475000,33540000,"chr1",47890,0,1,2,3,"chr1",1,0.00738396624472574
"1758","chr1.21235000.21240000","chr1.21310000.21315000",75000,23,4.328812e-05,21235000,21310000,21240000,21315000,"chr1",47939,3,9,13,25,"chr1",1,0.0673933427097984
"1759","chr1.201465000.201470000","chr1.201550000.201555000",85000,19,0.001070775,201465000,201550000,201470000,201555000,"chr1",47956,4,4,5,13,"chr1",1,0.0289498359118612
"1760","chr1.66620000.66625000","chr1.66690000.66695000",70000,26,2.649753e-06,66620000,66690000,66625000,66695000,"chr1",48011,0,5,3,8,"chr1",1,0.0243788091889358
"1761","chr1.161150000.161155000","chr1.161280000.161285000",130000,24,1.312788e-08,161150000,161280000,161155000,161285000,"chr1",48025,6,14,12,32,"chr1",1,0.090014064697609
"1762","chr1.23790000.23795000","chr1.23825000.23830000",35000,27,0.00691274,23790000,23825000,23795000,23830000,"chr1",48039,0,0,5,5,"chr1",1,0.0158227848101266
"1763","chr1.182110000.182115000","chr1.182135000.182140000",25000,46,3.642497e-07,182110000,182135000,182115000,182140000,"chr1",48086,3,6,3,12,"chr1",1,0.0646976090014065
"1764","chr1.8435000.8440000","chr1.8875000.8880000",440000,9,0.006488163,8435000,8875000,8440000,8880000,"chr1",48140,1,4,3,8,"chr1",1,0.00843881856540084
"1765","chr1.150050000.150055000","chr1.150360000.150365000",310000,12,0.0005547613,150050000,150360000,150055000,150365000,"chr1",48282,1,8,3,12,"chr1",1,0.0168776371308017
"1766","chr1.155305000.155310000","chr1.155605000.155610000",300000,13,0.0001481797,155305000,155605000,155310000,155610000,"chr1",48294,1,9,4,14,"chr1",1,0.0213314580403188
"1767","chr1.182085000.182090000","chr1.182260000.182265000",175000,13,0.005981441,182085000,182260000,182090000,182265000,"chr1",48340,0,1,1,2,"chr1",1,0.00304735114861697
"1768","chr1.8525000.8530000","chr1.8885000.8890000",360000,15,1.143006e-06,8525000,8885000,8530000,8890000,"chr1",48368,0,0,3,3,"chr1",1,0.00527426160337553
"1769","chr1.10110000.10115000","chr1.10150000.10155000",40000,32,1.249066e-05,10110000,10150000,10115000,10155000,"chr1",48377,7,17,16,40,"chr1",1,0.150023441162682
"1770","chr1.234860000.234865000","chr1.234995000.235000000",135000,21,1.011018e-06,234860000,234995000,234865000,2.35e+08,"chr1",48393,4,7,11,22,"chr1",1,0.0541490857946554
"1771","chr1.26960000.26965000","chr1.26990000.26995000",30000,31,0.003104399,26960000,26990000,26965000,26995000,"chr1",48448,2,15,11,28,"chr1",1,0.101734646038444
"1772","chr1.155255000.155260000","chr1.155685000.155690000",430000,10,0.001690346,155255000,155685000,155260000,155690000,"chr1",48457,0,7,9,16,"chr1",1,0.0187529301453352
"1773","chr1.183620000.183625000","chr1.183875000.183880000",255000,31,6.883172e-20,183620000,183875000,183625000,183880000,"chr1",48517,0,2,3,5,"chr1",1,0.0181669010782935
"1774","chr1.44815000.44820000","chr1.44835000.44840000",20000,36,0.008632247,44815000,44835000,44820000,44840000,"chr1",48528,8,37,28,73,"chr1",1,0.308016877637131
"1775","chr1.100265000.100270000","chr1.100895000.100900000",630000,13,3.162365e-07,100265000,100895000,100270000,100900000,"chr1",48564,2,9,4,15,"chr1",1,0.0228551336146273
"1776","chr1.28735000.28740000","chr1.28755000.28760000",20000,42,0.0001481797,28735000,28755000,28740000,28760000,"chr1",48572,1,8,1,10,"chr1",1,0.0492264416315049
"1777","chr1.210505000.210510000","chr1.211305000.211310000",800000,8,0.00124165,210505000,211305000,210510000,211310000,"chr1",48574,0,5,2,7,"chr1",1,0.00656352555086732
"1778","chr1.225745000.225750000","chr1.225855000.225860000",110000,15,0.009294725,225745000,225855000,225750000,225860000,"chr1",48612,5,9,18,32,"chr1",1,0.0562587904360056
"1779","chr1.153780000.153785000","chr1.153920000.153925000",140000,17,0.000209311,153780000,153920000,153785000,153925000,"chr1",48646,5,23,16,44,"chr1",1,0.0876699484294421
"1780","chr1.11910000.11915000","chr1.11930000.11935000",20000,51,5.431705e-08,11910000,11930000,11915000,11935000,"chr1",48679,5,6,7,18,"chr1",1,0.107594936708861
"1781","chr1.44670000.44675000","chr1.44840000.44845000",170000,18,1.020071e-05,44670000,44840000,44675000,44845000,"chr1",48709,2,9,16,27,"chr1",1,0.0569620253164557
"1782","chr1.9950000.9955000","chr1.9980000.9985000",30000,38,8.886415e-06,9950000,9980000,9955000,9985000,"chr1",48812,9,26,10,45,"chr1",1,0.20042194092827
"1783","chr1.203305000.203310000","chr1.203445000.203450000",140000,43,5.13981e-26,203305000,203445000,203310000,203450000,"chr1",48830,0,2,1,3,"chr1",1,0.0151195499296765
"1784","chr1.151575000.151580000","chr1.151725000.151730000",150000,14,0.004757005,151575000,151725000,151580000,151730000,"chr1",48835,4,7,9,20,"chr1",1,0.0328176277543366
"1785","chr1.207750000.207755000","chr1.207835000.207840000",85000,19,0.001070775,207750000,207835000,207755000,207840000,"chr1",48838,1,0,1,2,"chr1",1,0.00445382090951711
"1786","chr1.153785000.153790000","chr1.153965000.153970000",180000,15,0.0004279485,153785000,153965000,153790000,153970000,"chr1",48841,7,18,16,41,"chr1",1,0.0720815752461322
"1787","chr1.9925000.9930000","chr1.10105000.10110000",180000,14,0.001527903,9925000,10105000,9930000,10110000,"chr1",48858,0,7,5,12,"chr1",1,0.019690576652602
"1788","chr1.210630000.210635000","chr1.211305000.211310000",675000,12,1.439678e-06,210630000,211305000,210635000,211310000,"chr1",48874,0,2,2,4,"chr1",1,0.00562587904360056
"1789","chr1.46165000.46170000","chr1.46340000.46345000",175000,15,0.0005339167,46165000,46340000,46170000,46345000,"chr1",48880,0,0,2,2,"chr1",1,0.00351617440225035
"1790","chr1.26430000.26435000","chr1.26460000.26465000",30000,35,0.0001324766,26430000,26460000,26435000,26465000,"chr1",48885,3,11,6,20,"chr1",1,0.0820440693858415
"1791","chr1.54540000.54545000","chr1.55155000.55160000",615000,8,0.005163365,54540000,55155000,54545000,55160000,"chr1",48898,0,2,0,2,"chr1",1,0.00187529301453352
"1792","chr1.84610000.84615000","chr1.85150000.85155000",540000,10,0.0004153543,84610000,85150000,84615000,85155000,"chr1",48913,0,5,3,8,"chr1",1,0.00937646507266761
"1793","chr1.228865000.228870000","chr1.229275000.229280000",410000,9,0.009020058,228865000,229275000,228870000,229280000,"chr1",48948,1,5,5,11,"chr1",1,0.0116033755274262
"1794","chr1.109290000.109295000","chr1.109425000.109430000",135000,14,0.008425895,109290000,109425000,109295000,109430000,"chr1",48975,2,3,5,10,"chr1",1,0.0164088138771683
"1795","chr1.161235000.161240000","chr1.161260000.161265000",25000,34,0.006227396,161235000,161260000,161240000,161265000,"chr1",48980,3,18,16,37,"chr1",1,0.147444913267698
"1796","chr1.212475000.212480000","chr1.212495000.212500000",20000,37,0.004733079,212475000,212495000,212480000,212500000,"chr1",49009,7,4,11,22,"chr1",1,0.0954055321143929
"1797","chr1.243790000.243795000","chr1.243850000.243855000",60000,21,0.003722807,243790000,243850000,243795000,243855000,"chr1",49029,2,12,7,21,"chr1",1,0.0516877637130802
"1798","chr1.203475000.203480000","chr1.203590000.203595000",115000,15,0.007192145,203475000,203590000,203480000,203595000,"chr1",49034,1,1,0,2,"chr1",1,0.00351617440225035
"1799","chr1.15680000.15685000","chr1.15700000.15705000",20000,41,0.0003129283,15680000,15700000,15685000,15705000,"chr1",49039,4,9,12,25,"chr1",1,0.120135958743554
"1800","chr1.12175000.12180000","chr1.12270000.12275000",95000,24,6.346975e-07,12175000,12270000,12180000,12275000,"chr1",49087,0,10,6,16,"chr1",1,0.0450070323488045
"1801","chr1.171780000.171785000","chr1.171950000.171955000",170000,37,5.989734e-22,171780000,171950000,171785000,171955000,"chr1",49123,1,2,2,5,"chr1",1,0.0216830754805438
"1802","chr1.205590000.205595000","chr1.205700000.205705000",110000,20,2.963273e-05,205590000,205700000,205595000,205705000,"chr1",49128,1,5,6,12,"chr1",1,0.0281293952180028
"1803","chr1.204505000.204510000","chr1.204705000.204710000",200000,12,0.008520915,204505000,204705000,204510000,204710000,"chr1",49130,0,0,2,2,"chr1",1,0.00281293952180028
"1804","chr1.203485000.203490000","chr1.203670000.203675000",185000,17,2.06366e-05,203485000,203670000,203490000,203675000,"chr1",49175,0,4,4,8,"chr1",1,0.0159399906235349
"1805","chr1.26770000.26775000","chr1.27145000.27150000",375000,10,0.003509469,26770000,27145000,26775000,27150000,"chr1",49235,0,3,1,4,"chr1",1,0.0046882325363338
"1806","chr1.243490000.243495000","chr1.244110000.244115000",620000,10,0.0001603957,243490000,244110000,243495000,244115000,"chr1",49285,0,3,4,7,"chr1",1,0.00820440693858415
"1807","chr1.87175000.87180000","chr1.87435000.87440000",260000,13,0.0004157809,87175000,87435000,87180000,87440000,"chr1",49305,0,0,6,6,"chr1",1,0.00914205344585091
"1808","chr1.204350000.204355000","chr1.204370000.204375000",20000,39,0.00129403,204350000,204370000,204355000,204375000,"chr1",49344,5,7,5,17,"chr1",1,0.0777074542897328
"1809","chr1.229410000.229415000","chr1.229625000.229630000",215000,21,4.365532e-09,229410000,229625000,229415000,229630000,"chr1",49358,0,1,5,6,"chr1",1,0.0147679324894515
"1810","chr1.225975000.225980000","chr1.226060000.226065000",85000,17,0.007758048,225975000,226060000,225980000,226065000,"chr1",49359,0,2,4,6,"chr1",1,0.0119549929676512
"1811","chr1.161150000.161155000","chr1.161260000.161265000",110000,16,0.00338394,161150000,161260000,161155000,161265000,"chr1",49445,3,18,16,37,"chr1",1,0.0693858415377403
"1812","chr1.110425000.110430000","chr1.110460000.110465000",35000,32,0.0001186414,110425000,110460000,110430000,110465000,"chr1",49566,3,4,6,13,"chr1",1,0.0487576183778715
"1813","chr1.64075000.64080000","chr1.64675000.64680000",600000,10,0.0002051524,64075000,64675000,64080000,64680000,"chr1",49599,1,2,3,6,"chr1",1,0.0070323488045007
"1814","chr1.153795000.153800000","chr1.153925000.153930000",130000,16,0.001164783,153795000,153925000,153800000,153930000,"chr1",49623,0,2,2,4,"chr1",1,0.00750117205813408
"1815","chr1.153695000.153700000","chr1.153960000.153965000",265000,36,7.213714e-26,153695000,153960000,153700000,153965000,"chr1",49638,1,7,6,14,"chr1",1,0.0590717299578059
"1816","chr1.40305000.40310000","chr1.40420000.40425000",115000,16,0.002529278,40305000,40420000,40310000,40425000,"chr1",49666,0,1,3,4,"chr1",1,0.00750117205813408
"1817","chr1.10210000.10215000","chr1.10395000.10400000",185000,13,0.004288904,10210000,10395000,10215000,10400000,"chr1",49711,6,16,13,35,"chr1",1,0.053328645100797
"1818","chr1.153605000.153610000","chr1.153955000.153960000",350000,14,8.946938e-06,153605000,153955000,153610000,153960000,"chr1",49723,0,5,5,10,"chr1",1,0.0164088138771683
"1819","chr1.94525000.94530000","chr1.94855000.94860000",330000,15,2.388556e-06,94525000,94855000,94530000,94860000,"chr1",49724,0,3,0,3,"chr1",1,0.00527426160337553
"1820","chr1.10130000.10135000","chr1.10150000.10155000",20000,63,9.213933e-14,10130000,10150000,10135000,10155000,"chr1",49753,7,38,32,77,"chr1",1,0.568565400843882
"1821","chr1.10125000.10130000","chr1.10175000.10180000",50000,27,9.219509e-05,10125000,10175000,10130000,10180000,"chr1",49762,2,7,3,12,"chr1",1,0.0379746835443038
"1822","chr1.44810000.44815000","chr1.44840000.44845000",30000,37,2.278292e-05,44810000,44840000,44815000,44845000,"chr1",49763,0,7,8,15,"chr1",1,0.0650492264416315
"1823","chr1.161190000.161195000","chr1.161290000.161295000",100000,23,1.363974e-06,161190000,161290000,161195000,161295000,"chr1",49782,6,16,13,35,"chr1",1,0.0943506797937178
"1824","chr1.155595000.155600000","chr1.155790000.155795000",195000,12,0.009750873,155595000,155790000,155600000,155795000,"chr1",49788,10,26,29,65,"chr1",1,0.0914205344585091
"1825","chr1.161205000.161210000","chr1.161280000.161285000",75000,21,0.0004093387,161205000,161280000,161210000,161285000,"chr1",49802,4,14,12,30,"chr1",1,0.0738396624472574
"1826","chr1.155830000.155835000","chr1.155870000.155875000",40000,27,0.001354847,155830000,155870000,155835000,155875000,"chr1",49813,10,29,23,62,"chr1",1,0.19620253164557
"1827","chr1.54335000.54340000","chr1.54950000.54955000",615000,8,0.005163365,54335000,54950000,54340000,54955000,"chr1",49837,2,3,1,6,"chr1",1,0.00562587904360056
"1828","chr1.150805000.150810000","chr1.150905000.150910000",100000,22,5.499536e-06,150805000,150905000,150810000,150910000,"chr1",49850,1,10,4,15,"chr1",1,0.0386779184247539
"1829","chr1.225675000.225680000","chr1.226080000.226085000",405000,9,0.009597206,225675000,226080000,225680000,226085000,"chr1",49926,7,26,26,59,"chr1",1,0.0622362869198312
"1830","chr1.155915000.155920000","chr1.155955000.155960000",40000,52,3.155193e-17,155915000,155955000,155920000,155960000,"chr1",49949,6,21,24,51,"chr1",1,0.310829817158931
"1831","chr1.162070000.162075000","chr1.162215000.162220000",145000,20,2.347232e-06,162070000,162215000,162075000,162220000,"chr1",49955,2,5,6,13,"chr1",1,0.0304735114861697
"1832","chr1.21310000.21315000","chr1.21435000.21440000",125000,17,0.0004573819,21310000,21435000,21315000,21440000,"chr1",49961,4,20,22,46,"chr1",1,0.0916549460853258
"1833","chr1.23070000.23075000","chr1.23165000.23170000",95000,17,0.003397074,23070000,23165000,23075000,23170000,"chr1",50034,2,2,1,5,"chr1",1,0.00996249413970933
"1834","chr1.204255000.204260000","chr1.204325000.204330000",70000,20,0.002190239,204255000,204325000,204260000,204330000,"chr1",50068,2,3,6,11,"chr1",1,0.0257852789498359
"1835","chr1.10105000.10110000","chr1.10160000.10165000",55000,25,0.0002173261,10105000,10160000,10110000,10165000,"chr1",50098,0,7,5,12,"chr1",1,0.0351617440225035
"1836","chr1.116360000.116365000","chr1.116510000.116515000",150000,15,0.001520338,116360000,116510000,116365000,116515000,"chr1",50175,2,3,0,5,"chr1",1,0.00879043600562588
"1837","chr1.228900000.228905000","chr1.229380000.229385000",480000,9,0.004178511,228900000,229380000,228905000,229385000,"chr1",50227,2,1,2,5,"chr1",1,0.00527426160337553
"1838","chr1.16960000.16965000","chr1.17010000.17015000",50000,22,0.008541777,16960000,17010000,16965000,17015000,"chr1",50253,5,18,15,38,"chr1",1,0.0979840600093765
"1839","chr1.225735000.225740000","chr1.225985000.225990000",250000,11,0.007719712,225735000,225985000,225740000,225990000,"chr1",50296,3,10,6,19,"chr1",1,0.0244960150023441
"1840","chr1.23015000.23020000","chr1.23225000.23230000",210000,17,5.986221e-06,23015000,23225000,23020000,23230000,"chr1",50306,11,21,18,50,"chr1",1,0.0996249413970933
"1841","chr1.11380000.11385000","chr1.11680000.11685000",300000,13,0.0001481797,11380000,11680000,11385000,11685000,"chr1",50312,3,4,4,11,"chr1",1,0.0167604313173933
"1842","chr1.161205000.161210000","chr1.161285000.161290000",80000,25,1.566151e-06,161205000,161285000,161210000,161290000,"chr1",50345,4,28,18,50,"chr1",1,0.146507266760431
"1843","chr1.23810000.23815000","chr1.23865000.23870000",55000,37,6.378105e-11,23810000,23865000,23815000,23870000,"chr1",50369,5,17,13,35,"chr1",1,0.151781528363807
"1844","chr1.168650000.168655000","chr1.168890000.168895000",240000,11,0.009597206,168650000,168890000,168655000,168895000,"chr1",50439,0,0,1,1,"chr1",1,0.0012892639474918
"1845","chr1.204240000.204245000","chr1.204295000.204300000",55000,29,2.655108e-06,204240000,204295000,204245000,204300000,"chr1",50448,0,1,1,2,"chr1",1,0.00679793717768401
"1846","chr1.21340000.21345000","chr1.21395000.21400000",55000,21,0.00838272,21340000,21395000,21345000,21400000,"chr1",50458,0,9,6,15,"chr1",1,0.0369198312236287
"1847","chr1.17435000.17440000","chr1.17560000.17565000",125000,19,3.530743e-05,17435000,17560000,17440000,17565000,"chr1",50465,0,6,1,7,"chr1",1,0.0155883731833099
"1848","chr1.156020000.156025000","chr1.156050000.156055000",30000,40,1.244322e-06,156020000,156050000,156025000,156055000,"chr1",50536,0,3,1,4,"chr1",1,0.0187529301453352
"1849","chr1.32215000.32220000","chr1.32395000.32400000",180000,13,0.005018612,32215000,32395000,32220000,32400000,"chr1",50541,3,28,17,48,"chr1",1,0.0731364275668073
"1850","chr1.27770000.27775000","chr1.27805000.27810000",35000,33,4.662643e-05,27770000,27805000,27775000,27810000,"chr1",50565,0,8,1,9,"chr1",1,0.0348101265822785
"1851","chr1.6285000.6290000","chr1.6430000.6435000",145000,15,0.001879154,6285000,6430000,6290000,6435000,"chr1",50591,2,11,9,22,"chr1",1,0.0386779184247539
"1852","chr1.52030000.52035000","chr1.52345000.52350000",315000,10,0.008095926,52030000,52345000,52035000,52350000,"chr1",50612,3,19,19,41,"chr1",1,0.0480543834974215
"1853","chr1.228790000.228795000","chr1.229410000.229415000",620000,8,0.004946176,228790000,229410000,228795000,229415000,"chr1",50625,0,2,1,3,"chr1",1,0.00281293952180028
"1854","chr1.150410000.150415000","chr1.150970000.150975000",560000,9,0.001761985,150410000,150970000,150415000,150975000,"chr1",50647,4,0,3,7,"chr1",1,0.00738396624472574
"1855","chr1.162135000.162140000","chr1.162215000.162220000",80000,18,0.004760983,162135000,162215000,162140000,162220000,"chr1",50767,0,2,1,3,"chr1",1,0.00632911392405063
"1856","chr1.10000000.10005000","chr1.10140000.10145000",140000,15,0.002324276,1e+07,10140000,10005000,10145000,"chr1",50869,1,14,11,26,"chr1",1,0.0457102672292546
"1857","chr1.160075000.160080000","chr1.160325000.160330000",250000,14,0.0001287456,160075000,160325000,160080000,160330000,"chr1",50877,3,2,1,6,"chr1",1,0.00984528832630099
"1858","chr1.11715000.11720000","chr1.11800000.11805000",85000,22,3.458094e-05,11715000,11800000,11720000,11805000,"chr1",50919,2,10,3,15,"chr1",1,0.0386779184247539
"1859","chr1.54330000.54335000","chr1.54420000.54425000",90000,22,1.823634e-05,54330000,54420000,54335000,54425000,"chr1",50928,6,10,13,29,"chr1",1,0.0747773089545241
"1860","chr1.165655000.165660000","chr1.165870000.165875000",215000,17,4.73899e-06,165655000,165870000,165660000,165875000,"chr1",50976,1,6,4,11,"chr1",1,0.0219174871073605
"1861","chr1.21600000.21605000","chr1.21635000.21640000",35000,35,6.593574e-06,21600000,21635000,21605000,21640000,"chr1",51016,3,4,6,13,"chr1",1,0.053328645100797
"1862","chr1.54670000.54675000","chr1.54950000.54955000",280000,16,1.791283e-06,54670000,54950000,54675000,54955000,"chr1",51025,2,3,1,6,"chr1",1,0.0112517580872011
"1863","chr1.28580000.28585000","chr1.28680000.28685000",100000,18,0.0007807092,28580000,28680000,28585000,28685000,"chr1",51027,8,31,22,61,"chr1",1,0.128691983122363
"1864","chr1.95130000.95135000","chr1.95225000.95230000",95000,16,0.009001332,95130000,95225000,95135000,95230000,"chr1",51090,0,2,1,3,"chr1",1,0.00562587904360056
"1865","chr1.180980000.180985000","chr1.181125000.181130000",145000,18,4.166729e-05,180980000,181125000,180985000,181130000,"chr1",51103,3,10,9,22,"chr1",1,0.0464135021097046
"1866","chr1.154735000.154740000","chr1.154760000.154765000",25000,34,0.006227396,154735000,154760000,154740000,154765000,"chr1",51105,4,12,13,29,"chr1",1,0.115564932020628
"1867","chr1.155830000.155835000","chr1.155960000.155965000",130000,16,0.001164783,155830000,155960000,155835000,155965000,"chr1",51106,6,10,23,39,"chr1",1,0.0731364275668073
"1868","chr1.204935000.204940000","chr1.205060000.205065000",125000,15,0.004449684,204935000,205060000,204940000,205065000,"chr1",51117,1,1,2,4,"chr1",1,0.0070323488045007
"1869","chr1.150180000.150185000","chr1.151045000.151050000",865000,7,0.004733079,150180000,151045000,150185000,151050000,"chr1",51207,5,5,9,19,"chr1",1,0.0155883731833099
"1870","chr1.180480000.180485000","chr1.180880000.180885000",400000,10,0.002527826,180480000,180880000,180485000,180885000,"chr1",51218,0,2,1,3,"chr1",1,0.00351617440225035
"1871","chr1.203235000.203240000","chr1.203305000.203310000",70000,80,1.520016e-53,203235000,203305000,203240000,203310000,"chr1",51220,0,3,2,5,"chr1",1,0.046882325363338
"1872","chr1.151250000.151255000","chr1.151365000.151370000",115000,17,0.0008171443,151250000,151365000,151255000,151370000,"chr1",51266,2,7,12,21,"chr1",1,0.0418424753867792
"1873","chr1.204245000.204250000","chr1.204475000.204480000",230000,14,0.0002509734,204245000,204475000,204250000,204480000,"chr1",51293,2,3,2,7,"chr1",1,0.0114861697140178
"1874","chr1.54885000.54890000","chr1.54925000.54930000",40000,26,0.003086748,54885000,54925000,54890000,54930000,"chr1",51362,1,1,1,3,"chr1",1,0.00914205344585091
"1875","chr1.59965000.59970000","chr1.60030000.60035000",65000,22,0.0006470043,59965000,60030000,59970000,60035000,"chr1",51374,0,2,1,3,"chr1",1,0.00773558368495077
"1876","chr1.160290000.160295000","chr1.160310000.160315000",20000,43,6.896909e-05,160290000,160310000,160295000,160315000,"chr1",51390,2,6,4,12,"chr1",1,0.060478199718706
"1877","chr1.171800000.171805000","chr1.171950000.171955000",150000,21,3.534255e-07,171800000,171950000,171805000,171955000,"chr1",51397,1,1,1,3,"chr1",1,0.00738396624472574
"1878","chr1.54315000.54320000","chr1.54335000.54340000",20000,46,5.655326e-06,54315000,54335000,54320000,54340000,"chr1",51421,2,6,1,9,"chr1",1,0.0485232067510548
"1879","chr1.54895000.54900000","chr1.54940000.54945000",45000,29,4.600653e-05,54895000,54940000,54900000,54945000,"chr1",51445,0,0,1,1,"chr1",1,0.00339896858884201
"1880","chr1.11195000.11200000","chr1.11285000.11290000",90000,18,0.001865958,11195000,11285000,11200000,11290000,"chr1",51468,0,11,6,17,"chr1",1,0.0358649789029536
"1881","chr1.153760000.153765000","chr1.153945000.153950000",185000,30,6.640355e-16,153760000,153945000,153765000,153950000,"chr1",51560,1,4,2,7,"chr1",1,0.0246132208157525
"1882","chr1.182110000.182115000","chr1.182260000.182265000",150000,19,7.518871e-06,182110000,182260000,182115000,182265000,"chr1",51584,2,10,3,15,"chr1",1,0.0334036568213783
"1883","chr1.156125000.156130000","chr1.156290000.156295000",165000,16,0.0002232684,156125000,156290000,156130000,156295000,"chr1",51670,1,12,8,21,"chr1",1,0.0393811533052039
"1884","chr1.77680000.77685000","chr1.77900000.77905000",220000,14,0.0003558736,77680000,77900000,77685000,77905000,"chr1",51672,1,5,4,10,"chr1",1,0.0164088138771683
"1885","chr1.184035000.184040000","chr1.184190000.184195000",155000,16,0.0003558736,184035000,184190000,184040000,184195000,"chr1",51676,2,1,1,4,"chr1",1,0.00750117205813408
"1886","chr1.174160000.174165000","chr1.174745000.174750000",585000,8,0.006690763,174160000,174745000,174165000,174750000,"chr1",51685,1,3,2,6,"chr1",1,0.00562587904360056
"1887","chr1.184035000.184040000","chr1.184665000.184670000",630000,10,0.0001435392,184035000,184665000,184040000,184670000,"chr1",51694,2,1,1,4,"chr1",1,0.0046882325363338
"1888","chr1.40305000.40310000","chr1.40380000.40385000",75000,30,3.557209e-09,40305000,40380000,40310000,40385000,"chr1",51720,0,4,1,5,"chr1",1,0.0175808720112518
"1889","chr1.161200000.161205000","chr1.161355000.161360000",155000,17,9.494008e-05,161200000,161355000,161205000,161360000,"chr1",51793,1,3,2,6,"chr1",1,0.0119549929676512
"1890","chr1.17415000.17420000","chr1.17440000.17445000",25000,44,2.434493e-06,17415000,17440000,17420000,17445000,"chr1",51807,3,16,10,29,"chr1",1,0.149554617909048
"1891","chr1.32480000.32485000","chr1.32500000.32505000",20000,37,0.004733079,32480000,32500000,32485000,32505000,"chr1",51869,5,12,28,45,"chr1",1,0.195147679324895
"1892","chr1.150050000.150055000","chr1.150160000.150165000",110000,17,0.00115434,150050000,150160000,150055000,150165000,"chr1",51937,1,2,3,6,"chr1",1,0.0119549929676512
"1893","chr1.43390000.43395000","chr1.43525000.43530000",135000,15,0.00290255,43390000,43525000,43395000,43530000,"chr1",51945,1,7,6,14,"chr1",1,0.0246132208157525
"1894","chr1.201845000.201850000","chr1.201945000.201950000",100000,23,1.363974e-06,201845000,201945000,201850000,201950000,"chr1",51975,1,3,4,8,"chr1",1,0.0215658696671355
"1895","chr1.67460000.67465000","chr1.67610000.67615000",150000,20,1.674205e-06,67460000,67610000,67465000,67615000,"chr1",51978,1,4,1,6,"chr1",1,0.0140646976090014
"1896","chr1.184385000.184390000","chr1.184405000.184410000",20000,47,2.356529e-06,184385000,184405000,184390000,184410000,"chr1",51994,5,5,2,12,"chr1",1,0.0661040787623066
"1897","chr1.153760000.153765000","chr1.153955000.153960000",195000,21,1.593197e-08,153760000,153955000,153765000,153960000,"chr1",52020,1,5,8,14,"chr1",1,0.0344585091420534
"1898","chr1.9310000.9315000","chr1.9345000.9350000",35000,30,0.0006685884,9310000,9345000,9315000,9350000,"chr1",52033,1,7,4,12,"chr1",1,0.0421940928270042
"1899","chr1.203235000.203240000","chr1.203290000.203295000",55000,27,2.643362e-05,203235000,203290000,203240000,203295000,"chr1",52034,1,6,6,13,"chr1",1,0.0411392405063291
"1900","chr1.84615000.84620000","chr1.84760000.84765000",145000,23,1.965001e-08,84615000,84760000,84620000,84765000,"chr1",52089,1,5,4,10,"chr1",1,0.0269573370839194
"1901","chr1.22035000.22040000","chr1.22105000.22110000",70000,19,0.00555421,22035000,22105000,22040000,22110000,"chr1",52093,1,2,3,6,"chr1",1,0.0133614627285513
"1902","chr1.204185000.204190000","chr1.204300000.204305000",115000,17,0.0008171443,204185000,204300000,204190000,204305000,"chr1",52121,1,2,3,6,"chr1",1,0.0119549929676512
"1903","chr1.226815000.226820000","chr1.226935000.226940000",120000,16,0.001909676,226815000,226935000,226820000,226940000,"chr1",52124,0,0,4,4,"chr1",1,0.00750117205813408
"1904","chr1.39390000.39395000","chr1.39455000.39460000",65000,32,2.617181e-09,39390000,39455000,39395000,39460000,"chr1",52145,0,2,1,3,"chr1",1,0.0112517580872011
"1905","chr1.84595000.84600000","chr1.84940000.84945000",345000,12,0.0002827585,84595000,84940000,84600000,84945000,"chr1",52240,1,2,2,5,"chr1",1,0.0070323488045007
"1906","chr1.42035000.42040000","chr1.42125000.42130000",90000,21,6.373704e-05,42035000,42125000,42040000,42130000,"chr1",52291,0,0,1,1,"chr1",1,0.00246132208157525
"1907","chr1.184035000.184040000","chr1.184660000.184665000",625000,8,0.004757005,184035000,184660000,184040000,184665000,"chr1",52314,2,1,1,4,"chr1",1,0.00375058602906704
"1908","chr1.149960000.149965000","chr1.150180000.150185000",220000,15,8.43013e-05,149960000,150180000,149965000,150185000,"chr1",52342,4,25,14,43,"chr1",1,0.0755977496483826
"1909","chr1.225675000.225680000","chr1.226135000.226140000",460000,15,1.129855e-07,225675000,226135000,225680000,226140000,"chr1",52383,7,17,23,47,"chr1",1,0.0826300984528833
"1910","chr1.24460000.24465000","chr1.24700000.24705000",240000,13,0.0007368324,24460000,24700000,24465000,24705000,"chr1",52384,0,18,16,34,"chr1",1,0.0518049695264885
"1911","chr1.11035000.11040000","chr1.11065000.11070000",30000,35,0.0001324766,11035000,11065000,11040000,11070000,"chr1",52410,4,12,14,30,"chr1",1,0.123066104078762
"1912","chr1.243495000.243500000","chr1.244430000.244435000",935000,7,0.00302809,243495000,244430000,243500000,244435000,"chr1",52524,1,0,1,2,"chr1",1,0.00164088138771683
"1913","chr1.243900000.243905000","chr1.244010000.244015000",110000,18,0.0003587972,243900000,244010000,243905000,244015000,"chr1",52582,0,1,2,3,"chr1",1,0.00632911392405063
"1914","chr1.16930000.16935000","chr1.16950000.16955000",20000,44,3.073313e-05,16930000,16950000,16935000,16955000,"chr1",52603,0,11,14,25,"chr1",1,0.12892639474918
"1915","chr1.226530000.226535000","chr1.226560000.226565000",30000,30,0.006218027,226530000,226560000,226535000,226565000,"chr1",52647,0,2,1,3,"chr1",1,0.0105485232067511
"1916","chr1.155305000.155310000","chr1.155725000.155730000",420000,9,0.008177867,155305000,155725000,155310000,155730000,"chr1",52657,1,9,4,14,"chr1",1,0.0147679324894515
"1917","chr1.8460000.8465000","chr1.8875000.8880000",415000,9,0.008599339,8460000,8875000,8465000,8880000,"chr1",52662,5,11,15,31,"chr1",1,0.0327004219409283
"1918","chr1.183620000.183625000","chr1.184000000.184005000",380000,12,0.0001522485,183620000,1.84e+08,183625000,184005000,"chr1",52709,0,0,3,3,"chr1",1,0.00421940928270042
"1919","chr1.36595000.36600000","chr1.36650000.36655000",55000,26,7.710059e-05,36595000,36650000,36600000,36655000,"chr1",52714,0,2,0,2,"chr1",1,0.00609470229723394
"1920","chr1.45205000.45210000","chr1.45965000.45970000",760000,7,0.008896094,45205000,45965000,45210000,45970000,"chr1",52737,2,11,3,16,"chr1",1,0.0131270511017346
"1921","chr1.151165000.151170000","chr1.151310000.151315000",145000,14,0.005764312,151165000,151310000,151170000,151315000,"chr1",52777,1,2,1,4,"chr1",1,0.00656352555086732
"1922","chr1.35705000.35710000","chr1.36220000.36225000",515000,9,0.002872008,35705000,36220000,35710000,36225000,"chr1",52795,1,9,8,18,"chr1",1,0.0189873417721519
"1923","chr1.155270000.155275000","chr1.156190000.156195000",920000,8,0.0005053148,155270000,156190000,155275000,156195000,"chr1",52802,3,11,8,22,"chr1",1,0.0206282231598687
"1924","chr1.34165000.34170000","chr1.35075000.35080000",910000,8,0.0005495994,34165000,35075000,34170000,35080000,"chr1",52816,2,4,5,11,"chr1",1,0.0103141115799344
"1925","chr1.44835000.44840000","chr1.45135000.45140000",300000,15,5.489877e-06,44835000,45135000,44840000,45140000,"chr1",52832,12,33,28,73,"chr1",1,0.128340365682138
"1926","chr1.244770000.244775000","chr1.245195000.245200000",425000,9,0.007719712,244770000,245195000,244775000,245200000,"chr1",52887,0,4,3,7,"chr1",1,0.00738396624472574
"1927","chr1.89555000.89560000","chr1.89685000.89690000",130000,15,0.003565021,89555000,89685000,89560000,89690000,"chr1",52915,0,0,4,4,"chr1",1,0.0070323488045007
"1928","chr1.54330000.54335000","chr1.55170000.55175000",840000,7,0.005535442,54330000,55170000,54335000,55175000,"chr1",52944,2,1,1,4,"chr1",1,0.00328176277543366
"1929","chr1.40380000.40385000","chr1.40450000.40455000",70000,19,0.00555421,40380000,40450000,40385000,40455000,"chr1",52989,0,4,1,5,"chr1",1,0.0111345522737928
"1930","chr1.153785000.153790000","chr1.153880000.153885000",95000,17,0.003397074,153785000,153880000,153790000,153885000,"chr1",53004,2,12,14,28,"chr1",1,0.0557899671823722
"1931","chr1.151175000.151180000","chr1.151370000.151375000",195000,14,0.0008677022,151175000,151370000,151180000,151375000,"chr1",53017,1,9,5,15,"chr1",1,0.0246132208157525
"1932","chr1.203325000.203330000","chr1.203380000.203385000",55000,22,0.003601062,203325000,203380000,203330000,203385000,"chr1",53059,0,0,1,1,"chr1",1,0.00257852789498359
"1933","chr1.77795000.77800000","chr1.78000000.78005000",205000,14,0.0006128938,77795000,7.8e+07,77800000,78005000,"chr1",53081,5,11,10,26,"chr1",1,0.0426629160806376
"1934","chr1.154270000.154275000","chr1.154335000.154340000",65000,22,0.0006470043,154270000,154335000,154275000,154340000,"chr1",53138,0,7,6,13,"chr1",1,0.0335208626347867
"1935","chr1.168760000.168765000","chr1.169085000.169090000",325000,10,0.006950379,168760000,169085000,168765000,169090000,"chr1",53150,0,1,2,3,"chr1",1,0.00351617440225035
"1936","chr1.204430000.204435000","chr1.204475000.204480000",45000,24,0.004449684,204430000,204475000,204435000,204480000,"chr1",53166,0,3,2,5,"chr1",1,0.0140646976090014
"1937","chr1.223355000.223360000","chr1.223800000.223805000",445000,9,0.006175879,223355000,223800000,223360000,223805000,"chr1",53167,5,9,19,33,"chr1",1,0.0348101265822785
"1938","chr1.28205000.28210000","chr1.28365000.28370000",160000,14,0.003280797,28205000,28365000,28210000,28370000,"chr1",53203,10,34,22,66,"chr1",1,0.108298171589311
"1939","chr1.110335000.110340000","chr1.110425000.110430000",90000,32,5.139875e-12,110335000,110425000,110340000,110430000,"chr1",53248,1,4,5,10,"chr1",1,0.0375058602906704
"1940","chr1.204130000.204135000","chr1.204325000.204330000",195000,15,0.0002307636,204130000,204325000,204135000,204330000,"chr1",53252,1,3,5,9,"chr1",1,0.0158227848101266
"1941","chr1.201445000.201450000","chr1.201480000.201485000",35000,49,2.748878e-13,201445000,201480000,201450000,201485000,"chr1",53267,1,5,0,6,"chr1",1,0.0344585091420534
"1942","chr1.20550000.20555000","chr1.20815000.20820000",265000,12,0.001500618,20550000,20815000,20555000,20820000,"chr1",53278,4,10,4,18,"chr1",1,0.0253164556962025
"1943","chr1.21310000.21315000","chr1.21360000.21365000",50000,24,0.001605476,21310000,21360000,21315000,21365000,"chr1",53283,1,7,6,14,"chr1",1,0.0393811533052039
"1944","chr1.153695000.153700000","chr1.153725000.153730000",30000,31,0.003104399,153695000,153725000,153700000,153730000,"chr1",53317,9,26,34,69,"chr1",1,0.25070323488045
"1945","chr1.201850000.201855000","chr1.201945000.201950000",95000,16,0.009001332,201850000,201945000,201855000,201950000,"chr1",53336,2,3,4,9,"chr1",1,0.0168776371308017
"1946","chr1.229000000.229005000","chr1.229090000.229095000",90000,19,0.0006470043,2.29e+08,229090000,229005000,229095000,"chr1",53349,2,2,2,6,"chr1",1,0.0133614627285513
"1947","chr1.174955000.174960000","chr1.174990000.174995000",35000,27,0.00691274,174955000,174990000,174960000,174995000,"chr1",53367,0,3,3,6,"chr1",1,0.0189873417721519
"1948","chr1.178055000.178060000","chr1.178240000.178245000",185000,14,0.001282156,178055000,178240000,178060000,178245000,"chr1",53372,2,4,2,8,"chr1",1,0.0131270511017346
"1949","chr1.8460000.8465000","chr1.8525000.8530000",65000,35,2.964485e-11,8460000,8525000,8465000,8530000,"chr1",53423,0,0,3,3,"chr1",1,0.0123066104078762
"1950","chr1.16120000.16125000","chr1.16930000.16935000",810000,7,0.006608083,16120000,16930000,16125000,16935000,"chr1",53441,1,3,2,6,"chr1",1,0.00492264416315049
"1951","chr1.25725000.25730000","chr1.26145000.26150000",420000,9,0.008177867,25725000,26145000,25730000,26150000,"chr1",53448,4,9,12,25,"chr1",1,0.0263713080168776
"1952","chr1.46155000.46160000","chr1.46215000.46220000",60000,42,2.688267e-15,46155000,46215000,46160000,46220000,"chr1",53479,6,13,6,25,"chr1",1,0.123066104078762
"1953","chr1.43945000.43950000","chr1.43965000.43970000",20000,49,3.736063e-07,43945000,43965000,43950000,43970000,"chr1",53482,0,2,2,4,"chr1",1,0.0229723394280356
"1954","chr1.201450000.201455000","chr1.201480000.201485000",30000,91,1.734615e-40,201450000,201480000,201455000,201485000,"chr1",53498,1,5,0,6,"chr1",1,0.0639943741209564
"1955","chr1.151760000.151765000","chr1.151805000.151810000",45000,26,0.0008075999,151760000,151805000,151765000,151810000,"chr1",53517,1,2,3,6,"chr1",1,0.0182841068917018
"1956","chr1.203260000.203265000","chr1.203305000.203310000",45000,37,4.01439e-09,203260000,203305000,203265000,203310000,"chr1",53520,0,3,2,5,"chr1",1,0.0216830754805438
"1957","chr1.61640000.61645000","chr1.61740000.61745000",100000,25,7.297488e-08,61640000,61740000,61645000,61745000,"chr1",53541,0,3,0,3,"chr1",1,0.00879043600562588
"1958","chr1.10105000.10110000","chr1.10210000.10215000",105000,20,4.589527e-05,10105000,10210000,10110000,10215000,"chr1",53552,0,7,5,12,"chr1",1,0.0281293952180028
"1959","chr1.8055000.8060000","chr1.8345000.8350000",290000,12,0.0008248102,8055000,8345000,8060000,8350000,"chr1",53560,0,2,1,3,"chr1",1,0.00421940928270042
"1960","chr1.12355000.12360000","chr1.12375000.12380000",20000,39,0.00129403,12355000,12375000,12360000,12380000,"chr1",53598,0,6,4,10,"chr1",1,0.0457102672292546
"1961","chr1.43620000.43625000","chr1.43660000.43665000",40000,25,0.006608083,43620000,43660000,43625000,43665000,"chr1",53602,1,4,5,10,"chr1",1,0.0293014533520863
"1962","chr1.225675000.225680000","chr1.225855000.225860000",180000,15,0.0004279485,225675000,225855000,225680000,225860000,"chr1",53624,5,11,20,36,"chr1",1,0.0632911392405063
"1963","chr1.201540000.201545000","chr1.201945000.201950000",405000,9,0.009597206,201540000,201945000,201545000,201950000,"chr1",53629,1,2,2,5,"chr1",1,0.00527426160337553
"1964","chr1.204430000.204435000","chr1.204465000.204470000",35000,33,4.662643e-05,204430000,204465000,204435000,204470000,"chr1",53635,0,2,2,4,"chr1",1,0.0154711673699015
"1965","chr1.173960000.173965000","chr1.173985000.173990000",25000,38,0.0003847014,173960000,173985000,173965000,173990000,"chr1",53712,2,8,5,15,"chr1",1,0.0668073136427567
"1966","chr1.19730000.19735000","chr1.19760000.19765000",30000,31,0.003104399,19730000,19760000,19735000,19765000,"chr1",53802,3,14,11,28,"chr1",1,0.101734646038444
"1967","chr1.204125000.204130000","chr1.204345000.204350000",220000,13,0.00137653,204125000,204345000,204130000,204350000,"chr1",53822,0,1,1,2,"chr1",1,0.00304735114861697
"1968","chr1.243430000.243435000","chr1.243475000.243480000",45000,45,4.863745e-14,243430000,243475000,243435000,243480000,"chr1",53828,0,1,1,2,"chr1",1,0.0105485232067511
"1969","chr1.171950000.171955000","chr1.172370000.172375000",420000,19,5.213987e-11,171950000,172370000,171955000,172375000,"chr1",53843,1,0,2,3,"chr1",1,0.00668073136427567
"1970","chr1.38445000.38450000","chr1.39290000.39295000",845000,10,1.563338e-05,38445000,39290000,38450000,39295000,"chr1",53858,1,1,2,4,"chr1",1,0.0046882325363338
"1971","chr1.203275000.203280000","chr1.203290000.203295000",15000,41,0.0003129283,203275000,203290000,203280000,203295000,"chr1",53945,1,6,6,13,"chr1",1,0.0624706985466479
"1972","chr1.212410000.212415000","chr1.212450000.212455000",40000,25,0.006608083,212410000,212450000,212415000,212455000,"chr1",53951,0,2,1,3,"chr1",1,0.00879043600562588
"1973","chr1.201540000.201545000","chr1.201790000.201795000",250000,17,9.720102e-07,201540000,201790000,201545000,201795000,"chr1",53952,0,2,1,3,"chr1",1,0.0059774964838256
"1974","chr1.155830000.155835000","chr1.155895000.155900000",65000,26,7.652881e-06,155830000,155895000,155835000,155900000,"chr1",53983,7,25,40,72,"chr1",1,0.219409282700422
"1975","chr1.94880000.94885000","chr1.95535000.95540000",655000,8,0.003722807,94880000,95535000,94885000,95540000,"chr1",54026,0,6,1,7,"chr1",1,0.00656352555086732
"1976","chr1.8095000.8100000","chr1.8395000.8400000",300000,14,2.998648e-05,8095000,8395000,8100000,8400000,"chr1",54033,1,4,3,8,"chr1",1,0.0131270511017346
"1977","chr1.168600000.168605000","chr1.169130000.169135000",530000,15,2.417017e-08,168600000,169130000,168605000,169135000,"chr1",54034,0,2,0,2,"chr1",1,0.00351617440225035
"1978","chr1.160170000.160175000","chr1.160310000.160315000",140000,18,5.556461e-05,160170000,160310000,160175000,160315000,"chr1",54035,1,6,10,17,"chr1",1,0.0358649789029536
"1979","chr1.32980000.32985000","chr1.33080000.33085000",100000,19,0.0002491261,32980000,33080000,32985000,33085000,"chr1",54036,0,2,7,9,"chr1",1,0.020042194092827
"1980","chr1.36575000.36580000","chr1.36760000.36765000",185000,15,0.0003492026,36575000,36760000,36580000,36765000,"chr1",54040,0,2,4,6,"chr1",1,0.0105485232067511
"1981","chr1.51725000.51730000","chr1.51990000.51995000",265000,13,0.0003607747,51725000,51990000,51730000,51995000,"chr1",54067,1,14,10,25,"chr1",1,0.0380918893577121
"1982","chr1.205175000.205180000","chr1.205230000.205235000",55000,21,0.00838272,205175000,205230000,205180000,205235000,"chr1",54097,4,3,4,11,"chr1",1,0.0270745428973277
"1983","chr1.54545000.54550000","chr1.54940000.54945000",395000,10,0.002714357,54545000,54940000,54550000,54945000,"chr1",54116,1,0,1,2,"chr1",1,0.0023441162681669
"1984","chr1.205320000.205325000","chr1.205430000.205435000",110000,18,0.0003587972,205320000,205430000,205325000,205435000,"chr1",54217,0,8,6,14,"chr1",1,0.029535864978903
"1985","chr1.28830000.28835000","chr1.28925000.28930000",95000,19,0.0003929148,28830000,28925000,28835000,28930000,"chr1",54245,6,12,14,32,"chr1",1,0.0712611345522738
"1986","chr1.228865000.228870000","chr1.229405000.229410000",540000,8,0.009838485,228865000,229405000,228870000,229410000,"chr1",54254,4,10,7,21,"chr1",1,0.019690576652602
"1987","chr1.201435000.201440000","chr1.201480000.201485000",45000,25,0.001925343,201435000,201480000,201440000,201485000,"chr1",54275,1,5,0,6,"chr1",1,0.0175808720112518
"1988","chr1.43690000.43695000","chr1.43945000.43950000",255000,12,0.001902037,43690000,43945000,43695000,43950000,"chr1",54300,0,2,2,4,"chr1",1,0.00562587904360056
"1989","chr1.116665000.116670000","chr1.117030000.117035000",365000,11,0.0009363332,116665000,117030000,116670000,117035000,"chr1",54382,2,2,2,6,"chr1",1,0.00773558368495077
"1990","chr1.161205000.161210000","chr1.161725000.161730000",520000,9,0.002714357,161205000,161725000,161210000,161730000,"chr1",54383,0,10,2,12,"chr1",1,0.0126582278481013
"1991","chr1.54770000.54775000","chr1.54950000.54955000",180000,17,2.655523e-05,54770000,54950000,54775000,54955000,"chr1",54389,2,3,1,6,"chr1",1,0.0119549929676512
"1992","chr1.23070000.23075000","chr1.23175000.23180000",105000,21,1.247901e-05,23070000,23175000,23075000,23180000,"chr1",54402,3,5,2,10,"chr1",1,0.0246132208157525
"1993","chr1.243490000.243495000","chr1.244430000.244435000",940000,9,5.343485e-05,243490000,244430000,243495000,244435000,"chr1",54406,0,3,4,7,"chr1",1,0.00738396624472574
"1994","chr1.36420000.36425000","chr1.36460000.36465000",40000,28,0.0005784227,36420000,36460000,36425000,36465000,"chr1",54459,1,4,4,9,"chr1",1,0.029535864978903
"1995","chr1.40435000.40440000","chr1.40475000.40480000",40000,25,0.006608083,40435000,40475000,40440000,40480000,"chr1",54471,1,12,3,16,"chr1",1,0.046882325363338
"1996","chr1.24150000.24155000","chr1.24195000.24200000",45000,28,0.0001254468,24150000,24195000,24155000,24200000,"chr1",54490,10,8,4,22,"chr1",1,0.0721987810595406
"1997","chr1.54235000.54240000","chr1.54265000.54270000",30000,31,0.003104399,54235000,54265000,54240000,54270000,"chr1",54501,4,3,6,13,"chr1",1,0.0472339428035631
"1998","chr1.156095000.156100000","chr1.156160000.156165000",65000,22,0.0006470043,156095000,156160000,156100000,156165000,"chr1",54524,3,6,4,13,"chr1",1,0.0335208626347867
"1999","chr1.8465000.8470000","chr1.8710000.8715000",245000,12,0.002484868,8465000,8710000,8470000,8715000,"chr1",54559,1,15,11,27,"chr1",1,0.0379746835443038
"2000","chr1.23400000.23405000","chr1.23560000.23565000",160000,15,0.001000244,23400000,23560000,23405000,23565000,"chr1",54562,0,7,0,7,"chr1",1,0.0123066104078762
"2001","chr1.234860000.234865000","chr1.235100000.235105000",240000,15,3.931393e-05,234860000,235100000,234865000,235105000,"chr1",54590,4,9,14,27,"chr1",1,0.0474683544303797
"2002","chr1.180480000.180485000","chr1.181115000.181120000",635000,12,2.508337e-06,180480000,181115000,180485000,181120000,"chr1",54592,0,2,1,3,"chr1",1,0.00421940928270042
"2003","chr1.180480000.180485000","chr1.181090000.181095000",610000,9,0.001061997,180480000,181090000,180485000,181095000,"chr1",54604,0,2,1,3,"chr1",1,0.00316455696202532
"2004","chr1.234280000.234285000","chr1.234485000.234490000",205000,15,0.0001526155,234280000,234485000,234285000,234490000,"chr1",54671,1,3,5,9,"chr1",1,0.0158227848101266
"2005","chr1.9195000.9200000","chr1.9625000.9630000",430000,12,6.536086e-05,9195000,9625000,9200000,9630000,"chr1",54700,2,1,7,10,"chr1",1,0.0140646976090014
"2006","chr1.93550000.93555000","chr1.93635000.93640000",85000,25,6.912566e-07,93550000,93635000,93555000,93640000,"chr1",54704,2,6,6,14,"chr1",1,0.0410220346929208
"2007","chr1.233570000.233575000","chr1.234325000.234330000",755000,7,0.009184,233570000,234325000,233575000,234330000,"chr1",54755,6,10,8,24,"chr1",1,0.019690576652602
"2008","chr1.201545000.201550000","chr1.201845000.201850000",300000,14,2.998648e-05,201545000,201845000,201550000,201850000,"chr1",54778,1,9,7,17,"chr1",1,0.0278949835911861
"2009","chr1.24830000.24835000","chr1.25520000.25525000",690000,8,0.002851334,24830000,25520000,24835000,25525000,"chr1",54790,1,4,1,6,"chr1",1,0.00562587904360056
"2010","chr1.27030000.27035000","chr1.27100000.27105000",70000,36,1.146154e-12,27030000,27100000,27035000,27105000,"chr1",54791,1,2,2,5,"chr1",1,0.0210970464135021
"2011","chr1.15125000.15130000","chr1.15340000.15345000",215000,13,0.001605476,15125000,15340000,15130000,15345000,"chr1",54874,0,3,2,5,"chr1",1,0.00761837787154243
"2012","chr1.10105000.10110000","chr1.10125000.10130000",20000,50,1.454336e-07,10105000,10125000,10110000,10130000,"chr1",54937,0,7,3,10,"chr1",1,0.0586029067041725
"2013","chr1.156380000.156385000","chr1.156410000.156415000",30000,33,0.0006782985,156380000,156410000,156385000,156415000,"chr1",55095,0,3,7,10,"chr1",1,0.0386779184247539
"2014","chr1.15175000.15180000","chr1.15340000.15345000",165000,14,0.002719567,15175000,15340000,15180000,15345000,"chr1",55105,4,5,5,14,"chr1",1,0.0229723394280356
"2015","chr1.212975000.212980000","chr1.213170000.213175000",195000,12,0.009750873,212975000,213170000,212980000,213175000,"chr1",55107,2,0,0,2,"chr1",1,0.00281293952180028
"2016","chr1.150365000.150370000","chr1.150410000.150415000",45000,25,0.001925343,150365000,150410000,150370000,150415000,"chr1",55146,6,27,18,51,"chr1",1,0.14943741209564
"2017","chr1.201580000.201585000","chr1.201790000.201795000",210000,15,0.0001254468,201580000,201790000,201585000,201795000,"chr1",55167,0,2,1,3,"chr1",1,0.00527426160337553
"2018","chr1.9345000.9350000","chr1.9455000.9460000",110000,22,1.885275e-06,9345000,9455000,9350000,9460000,"chr1",55210,1,7,4,12,"chr1",1,0.0309423347398031
"2019","chr1.23740000.23745000","chr1.23770000.23775000",30000,30,0.006218027,23740000,23770000,23745000,23775000,"chr1",55223,5,12,14,31,"chr1",1,0.109001406469761
"2020","chr1.151045000.151050000","chr1.151095000.151100000",50000,24,0.001605476,151045000,151095000,151050000,151100000,"chr1",55266,4,5,9,18,"chr1",1,0.0506329113924051
"2021","chr1.31715000.31720000","chr1.31810000.31815000",95000,17,0.003397074,31715000,31810000,31720000,31815000,"chr1",55319,1,1,3,5,"chr1",1,0.00996249413970933
"2022","chr1.201545000.201550000","chr1.201790000.201795000",245000,14,0.0001513543,201545000,201790000,201550000,201795000,"chr1",55322,0,2,1,3,"chr1",1,0.00492264416315049
"2023","chr1.151735000.151740000","chr1.151760000.151765000",25000,44,2.434493e-06,151735000,151760000,151740000,151765000,"chr1",55359,0,11,5,16,"chr1",1,0.0825128926394749
"2024","chr1.116710000.116715000","chr1.116905000.116910000",195000,12,0.009750873,116710000,116905000,116715000,116910000,"chr1",55368,0,1,1,2,"chr1",1,0.00281293952180028
"2025","chr1.211745000.211750000","chr1.211825000.211830000",80000,29,5.361149e-09,211745000,211825000,211750000,211830000,"chr1",55381,0,1,2,3,"chr1",1,0.010196905766526
"2026","chr1.169925000.169930000","chr1.170695000.170700000",770000,7,0.008446393,169925000,170695000,169930000,170700000,"chr1",55421,0,3,0,3,"chr1",1,0.00246132208157525
"2027","chr1.201845000.201850000","chr1.202115000.202120000",270000,11,0.004966,201845000,202115000,201850000,202120000,"chr1",55435,1,9,7,17,"chr1",1,0.0219174871073605
"2028","chr1.150965000.150970000","chr1.151045000.151050000",80000,19,0.00180801,150965000,151045000,150970000,151050000,"chr1",55442,0,5,9,14,"chr1",1,0.0311767463666198
"2029","chr1.110300000.110305000","chr1.110475000.110480000",175000,13,0.005981441,110300000,110475000,110305000,110480000,"chr1",55482,3,0,2,5,"chr1",1,0.00761837787154243
"2030","chr1.54335000.54340000","chr1.54420000.54425000",85000,30,4.040152e-10,54335000,54420000,54340000,54425000,"chr1",55518,2,6,1,9,"chr1",1,0.0316455696202532
"2031","chr1.167695000.167700000","chr1.167760000.167765000",65000,32,2.617181e-09,167695000,167760000,167700000,167765000,"chr1",55634,0,3,3,6,"chr1",1,0.0225035161744023
"2032","chr1.32480000.32485000","chr1.32540000.32545000",60000,22,0.001506977,32480000,32540000,32485000,32545000,"chr1",55667,4,12,13,29,"chr1",1,0.0747773089545241
"2033","chr1.202085000.202090000","chr1.202115000.202120000",30000,35,0.0001324766,202085000,202115000,202090000,202120000,"chr1",55671,3,13,12,28,"chr1",1,0.114861697140178
"2034","chr1.40770000.40775000","chr1.40915000.40920000",145000,14,0.005764312,40770000,40915000,40775000,40920000,"chr1",55692,1,2,6,9,"chr1",1,0.0147679324894515
"2035","chr1.204380000.204385000","chr1.204400000.204405000",20000,37,0.004733079,204380000,204400000,204385000,204405000,"chr1",55708,3,16,12,31,"chr1",1,0.134435067979372
"2036","chr1.243475000.243480000","chr1.244430000.244435000",955000,9,4.589527e-05,243475000,244430000,243480000,244435000,"chr1",55762,0,1,1,2,"chr1",1,0.00210970464135021
"2037","chr1.243945000.243950000","chr1.244335000.244340000",390000,10,0.00290255,243945000,244335000,243950000,244340000,"chr1",55767,2,9,7,18,"chr1",1,0.0210970464135021
"2038","chr1.42035000.42040000","chr1.42390000.42395000",355000,11,0.001102366,42035000,42390000,42040000,42395000,"chr1",55800,0,0,5,5,"chr1",1,0.00644631973745898
"2039","chr1.201530000.201535000","chr1.201705000.201710000",175000,16,0.0001391493,201530000,201705000,201535000,201710000,"chr1",55817,4,2,7,13,"chr1",1,0.0243788091889358
"2040","chr1.54340000.54345000","chr1.54420000.54425000",80000,21,0.0002162115,54340000,54420000,54345000,54425000,"chr1",55836,1,1,9,11,"chr1",1,0.0270745428973277
"2041","chr1.113660000.113665000","chr1.114230000.114235000",570000,11,4.602629e-05,113660000,114230000,113665000,114235000,"chr1",55845,2,2,2,6,"chr1",1,0.00773558368495077
"2042","chr1.45490000.45495000","chr1.45685000.45690000",195000,13,0.003098721,45490000,45685000,45495000,45690000,"chr1",55848,1,7,5,13,"chr1",1,0.0198077824660103
"2043","chr1.211550000.211555000","chr1.211745000.211750000",195000,12,0.009750873,211550000,211745000,211555000,211750000,"chr1",55913,0,1,2,3,"chr1",1,0.00421940928270042
"2044","chr1.156055000.156060000","chr1.156290000.156295000",235000,17,1.885725e-06,156055000,156290000,156060000,156295000,"chr1",55930,7,8,12,27,"chr1",1,0.0537974683544304
"2045","chr1.229405000.229410000","chr1.229595000.229600000",190000,15,0.000283605,229405000,229595000,229410000,229600000,"chr1",55962,2,6,7,15,"chr1",1,0.0263713080168776
"2046","chr1.204490000.204495000","chr1.204905000.204910000",415000,11,0.0004396956,204490000,204905000,204495000,204910000,"chr1",55967,4,9,3,16,"chr1",1,0.0206282231598687
"2047","chr1.11060000.11065000","chr1.11700000.11705000",640000,9,0.00078456,11060000,11700000,11065000,11705000,"chr1",55968,0,2,1,3,"chr1",1,0.00316455696202532
"2048","chr1.150185000.150190000","chr1.150255000.150260000",70000,20,0.002190239,150185000,150255000,150190000,150260000,"chr1",56016,0,5,1,6,"chr1",1,0.0140646976090014
"2049","chr1.54315000.54320000","chr1.54415000.54420000",100000,17,0.002324276,54315000,54415000,54320000,54420000,"chr1",56045,4,15,16,35,"chr1",1,0.0697374589779653
"2050","chr1.40625000.40630000","chr1.40770000.40775000",145000,21,5.00289e-07,40625000,40770000,40630000,40775000,"chr1",56051,1,1,4,6,"chr1",1,0.0147679324894515
"2051","chr1.244270000.244275000","chr1.244295000.244300000",25000,46,3.642497e-07,244270000,244295000,244275000,244300000,"chr1",56110,0,2,2,4,"chr1",1,0.0215658696671355
"2052","chr1.182120000.182125000","chr1.182235000.182240000",115000,25,1.144333e-08,182120000,182235000,182125000,182240000,"chr1",56124,0,6,3,9,"chr1",1,0.0263713080168776
"2053","chr1.23020000.23025000","chr1.23165000.23170000",145000,14,0.005764312,23020000,23165000,23025000,23170000,"chr1",56135,2,2,1,5,"chr1",1,0.00820440693858415
"2054","chr1.64490000.64495000","chr1.64535000.64540000",45000,24,0.004449684,64490000,64535000,64495000,64540000,"chr1",56154,0,2,0,2,"chr1",1,0.00562587904360056
"2055","chr1.156355000.156360000","chr1.156405000.156410000",50000,24,0.001605476,156355000,156405000,156360000,156410000,"chr1",56198,0,6,4,10,"chr1",1,0.0281293952180028
"2056","chr1.11800000.11805000","chr1.11860000.11865000",60000,21,0.003722807,11800000,11860000,11805000,11865000,"chr1",56239,2,10,3,15,"chr1",1,0.0369198312236287
"2057","chr1.150875000.150880000","chr1.150920000.150925000",45000,26,0.0008075999,150875000,150920000,150880000,150925000,"chr1",56269,1,14,11,26,"chr1",1,0.0792311298640413
"2058","chr1.10030000.10035000","chr1.10055000.10060000",25000,40,7.966121e-05,10030000,10055000,10035000,10060000,"chr1",56332,0,6,12,18,"chr1",1,0.0843881856540084
"2059","chr1.9950000.9955000","chr1.10075000.10080000",125000,19,3.530743e-05,9950000,10075000,9955000,10080000,"chr1",56338,3,14,14,31,"chr1",1,0.0690342240975152
"2060","chr1.26415000.26420000","chr1.26745000.26750000",330000,11,0.001629786,26415000,26745000,26420000,26750000,"chr1",56444,1,5,12,18,"chr1",1,0.0232067510548523
"2061","chr1.201530000.201535000","chr1.201790000.201795000",260000,24,5.756092e-13,201530000,201790000,201535000,201795000,"chr1",56464,0,2,1,3,"chr1",1,0.00843881856540084
"2062","chr1.54320000.54325000","chr1.54420000.54425000",100000,24,3.257567e-07,54320000,54420000,54325000,54425000,"chr1",56472,0,1,5,6,"chr1",1,0.0168776371308017
"2063","chr1.117610000.117615000","chr1.117670000.117675000",60000,31,4.890619e-08,117610000,117670000,117615000,117675000,"chr1",56488,0,3,3,6,"chr1",1,0.0218002812939522
"2064","chr1.66630000.66635000","chr1.66690000.66695000",60000,26,2.391654e-05,66630000,66690000,66635000,66695000,"chr1",56494,3,7,15,25,"chr1",1,0.0761837787154243
"2065","chr1.21570000.21575000","chr1.21690000.21695000",120000,15,0.005618157,21570000,21690000,21575000,21695000,"chr1",56568,1,10,12,23,"chr1",1,0.040436005625879
"2066","chr1.151195000.151200000","chr1.151365000.151370000",170000,13,0.00702836,151195000,151365000,151200000,151370000,"chr1",56617,2,7,12,21,"chr1",1,0.0319971870604782
"2067","chr1.203590000.203595000","chr1.203670000.203675000",80000,51,1.024665e-26,203590000,203670000,203595000,203675000,"chr1",56623,4,13,8,25,"chr1",1,0.14943741209564
"2068","chr1.46175000.46180000","chr1.46195000.46200000",20000,36,0.008632247,46175000,46195000,46180000,46200000,"chr1",56755,0,4,1,5,"chr1",1,0.0210970464135021
"2069","chr1.39690000.39695000","chr1.39795000.39800000",105000,16,0.004620068,39690000,39795000,39695000,39800000,"chr1",56757,1,3,3,7,"chr1",1,0.0131270511017346
"2070","chr1.24110000.24115000","chr1.24185000.24190000",75000,19,0.003125299,24110000,24185000,24115000,24190000,"chr1",56804,0,5,2,7,"chr1",1,0.0155883731833099
"2071","chr1.228860000.228865000","chr1.229275000.229280000",415000,9,0.008599339,228860000,229275000,228865000,229280000,"chr1",56809,1,5,5,11,"chr1",1,0.0116033755274262
"2072","chr1.183805000.183810000","chr1.183875000.183880000",70000,21,0.0008075999,183805000,183875000,183810000,183880000,"chr1",56864,2,1,5,8,"chr1",1,0.019690576652602
"2073","chr1.201540000.201545000","chr1.201740000.201745000",200000,15,0.0001884219,201540000,201740000,201545000,201745000,"chr1",56917,1,2,2,5,"chr1",1,0.00879043600562588
"2074","chr1.8435000.8440000","chr1.8510000.8515000",75000,20,0.001171509,8435000,8510000,8440000,8515000,"chr1",56954,1,4,3,8,"chr1",1,0.0187529301453352
"2075","chr1.27355000.27360000","chr1.27415000.27420000",60000,21,0.003722807,27355000,27415000,27360000,27420000,"chr1",57004,0,0,1,1,"chr1",1,0.00246132208157525
"2076","chr1.167055000.167060000","chr1.167150000.167155000",95000,17,0.003397074,167055000,167150000,167060000,167155000,"chr1",57011,0,2,1,3,"chr1",1,0.0059774964838256
"2077","chr1.16950000.16955000","chr1.17050000.17055000",100000,29,1.23774e-10,16950000,17050000,16955000,17055000,"chr1",57014,0,11,15,26,"chr1",1,0.0883731833098922
"2078","chr1.161165000.161170000","chr1.161290000.161295000",125000,18,0.000131934,161165000,161290000,161170000,161295000,"chr1",57026,0,6,3,9,"chr1",1,0.0189873417721519
"2079","chr1.31265000.31270000","chr1.31370000.31375000",105000,18,0.0005300991,31265000,31370000,31270000,31375000,"chr1",57043,2,6,3,11,"chr1",1,0.0232067510548523
"2080","chr1.204345000.204350000","chr1.204360000.204365000",15000,39,0.00129403,204345000,204360000,204350000,204365000,"chr1",57114,0,2,1,3,"chr1",1,0.0137130801687764
"2081","chr1.21215000.21220000","chr1.21310000.21315000",95000,17,0.003397074,21215000,21310000,21220000,21315000,"chr1",57156,0,9,13,22,"chr1",1,0.0438349742147211
"2082","chr1.9360000.9365000","chr1.9455000.9460000",95000,16,0.009001332,9360000,9455000,9365000,9460000,"chr1",57193,3,9,10,22,"chr1",1,0.0412564463197375
"2083","chr1.44835000.44840000","chr1.44945000.44950000",110000,22,1.885275e-06,44835000,44945000,44840000,44950000,"chr1",57199,5,7,14,26,"chr1",1,0.0670417252695734
"2084","chr1.161155000.161160000","chr1.161355000.161360000",200000,18,2.006467e-06,161155000,161355000,161160000,161360000,"chr1",57215,0,2,3,5,"chr1",1,0.0105485232067511
"2085","chr1.210630000.210635000","chr1.211330000.211335000",700000,11,8.798394e-06,210630000,211330000,210635000,211335000,"chr1",57272,0,2,2,4,"chr1",1,0.00515705578996718
"2086","chr1.8055000.8060000","chr1.8405000.8410000",350000,10,0.00486492,8055000,8405000,8060000,8410000,"chr1",57275,1,4,5,10,"chr1",1,0.0117205813408345
"2087","chr1.155190000.155195000","chr1.156020000.156025000",830000,8,0.0009978666,155190000,156020000,155195000,156025000,"chr1",57286,0,1,1,2,"chr1",1,0.00187529301453352
"2088","chr1.208190000.208195000","chr1.208265000.208270000",75000,19,0.003125299,208190000,208265000,208195000,208270000,"chr1",57325,0,3,2,5,"chr1",1,0.0111345522737928
"2089","chr1.172745000.172750000","chr1.173715000.173720000",970000,8,0.0003258558,172745000,173715000,172750000,173720000,"chr1",57330,2,5,5,12,"chr1",1,0.0112517580872011
"2090","chr1.169080000.169085000","chr1.169320000.169325000",240000,21,9.62174e-10,169080000,169320000,169085000,169325000,"chr1",57345,2,3,3,8,"chr1",1,0.019690576652602
"2091","chr1.204990000.204995000","chr1.205140000.205145000",150000,17,0.0001234709,204990000,205140000,204995000,205145000,"chr1",57352,1,6,6,13,"chr1",1,0.0259024847632443
"2092","chr1.21320000.21325000","chr1.22115000.22120000",795000,8,0.001293222,21320000,22115000,21325000,22120000,"chr1",57370,3,9,8,20,"chr1",1,0.0187529301453352
"2093","chr1.54865000.54870000","chr1.54950000.54955000",85000,22,3.458094e-05,54865000,54950000,54870000,54955000,"chr1",57379,2,3,1,6,"chr1",1,0.0154711673699015
"2094","chr1.155085000.155090000","chr1.155140000.155145000",55000,28,8.565836e-06,155085000,155140000,155090000,155145000,"chr1",57408,2,2,1,5,"chr1",1,0.0164088138771683
"2095","chr1.8465000.8470000","chr1.8525000.8530000",60000,21,0.003722807,8465000,8525000,8470000,8530000,"chr1",57465,0,0,3,3,"chr1",1,0.00738396624472574
"2096","chr1.39455000.39460000","chr1.40035000.40040000",580000,8,0.006962679,39455000,40035000,39460000,40040000,"chr1",57480,0,2,1,3,"chr1",1,0.00281293952180028
"2097","chr1.40660000.40665000","chr1.40690000.40695000",30000,33,0.0006782985,40660000,40690000,40665000,40695000,"chr1",57531,1,0,0,1,"chr1",1,0.00386779184247539
"2098","chr1.201700000.201705000","chr1.201740000.201745000",40000,42,7.744207e-11,201700000,201740000,201705000,201745000,"chr1",57541,1,3,3,7,"chr1",1,0.0344585091420534
"2099","chr1.160075000.160080000","chr1.160175000.160180000",100000,16,0.006415049,160075000,160175000,160080000,160180000,"chr1",57558,1,2,1,4,"chr1",1,0.00750117205813408
"2100","chr1.54855000.54860000","chr1.54950000.54955000",95000,21,3.530743e-05,54855000,54950000,54860000,54955000,"chr1",57567,0,3,1,4,"chr1",1,0.00984528832630099
"2101","chr1.182280000.182285000","chr1.182300000.182305000",20000,43,6.896909e-05,182280000,182300000,182285000,182305000,"chr1",57569,1,4,2,7,"chr1",1,0.0352789498359119
"2102","chr1.10045000.10050000","chr1.10065000.10070000",20000,46,5.655326e-06,10045000,10065000,10050000,10070000,"chr1",57583,6,6,12,24,"chr1",1,0.129395218002813
"2103","chr1.161190000.161195000","chr1.161260000.161265000",70000,21,0.0008075999,161190000,161260000,161195000,161265000,"chr1",57603,3,16,13,32,"chr1",1,0.0787623066104079
"2104","chr1.21215000.21220000","chr1.21235000.21240000",20000,40,0.0006470043,21215000,21235000,21220000,21240000,"chr1",57700,0,9,13,22,"chr1",1,0.103141115799344
"2105","chr1.212485000.212490000","chr1.212545000.212550000",60000,22,0.001506977,212485000,212545000,212490000,212550000,"chr1",57711,1,4,0,5,"chr1",1,0.012892639474918
"2106","chr1.149935000.149940000","chr1.150010000.150015000",75000,33,3.473301e-11,149935000,150010000,149940000,150015000,"chr1",57764,0,1,6,7,"chr1",1,0.0270745428973277
"2107","chr1.43355000.43360000","chr1.43545000.43550000",190000,16,7.024127e-05,43355000,43545000,43360000,43550000,"chr1",57809,1,1,0,2,"chr1",1,0.00375058602906704
"2108","chr1.154605000.154610000","chr1.155070000.155075000",465000,9,0.004886133,154605000,155070000,154610000,155075000,"chr1",57814,4,5,4,13,"chr1",1,0.0137130801687764
"2109","chr1.161175000.161180000","chr1.161355000.161360000",180000,14,0.001527903,161175000,161355000,161180000,161360000,"chr1",57847,2,11,13,26,"chr1",1,0.0426629160806376
"2110","chr1.19230000.19235000","chr1.19285000.19290000",55000,21,0.00838272,19230000,19285000,19235000,19290000,"chr1",57848,1,6,9,16,"chr1",1,0.0393811533052039
"2111","chr1.8590000.8595000","chr1.8915000.8920000",325000,12,0.0004079793,8590000,8915000,8595000,8920000,"chr1",57855,5,11,10,26,"chr1",1,0.0365682137834037
"2112","chr1.149895000.149900000","chr1.150185000.150190000",290000,13,0.0001899761,149895000,150185000,149900000,150190000,"chr1",57856,2,9,8,19,"chr1",1,0.0289498359118612
"2113","chr1.212230000.212235000","chr1.212505000.212510000",275000,18,5.515998e-08,212230000,212505000,212235000,212510000,"chr1",57887,0,1,3,4,"chr1",1,0.00843881856540084
"2114","chr1.54870000.54875000","chr1.54950000.54955000",80000,71,6.776118e-47,54870000,54950000,54875000,54955000,"chr1",57910,2,3,1,6,"chr1",1,0.049929676511955
"2115","chr1.26530000.26535000","chr1.26720000.26725000",190000,13,0.003611391,26530000,26720000,26535000,26725000,"chr1",57946,0,4,3,7,"chr1",1,0.0106657290201594
"2116","chr1.16215000.16220000","chr1.16300000.16305000",85000,21,0.0001156532,16215000,16300000,16220000,16305000,"chr1",57965,0,1,1,2,"chr1",1,0.00492264416315049
"2117","chr1.39575000.39580000","chr1.39650000.39655000",75000,44,1.194542e-19,39575000,39650000,39580000,39655000,"chr1",57971,0,3,4,7,"chr1",1,0.0360993905297703
"2118","chr1.228790000.228795000","chr1.229545000.229550000",755000,7,0.009184,228790000,229545000,228795000,229550000,"chr1",57973,0,2,1,3,"chr1",1,0.00246132208157525
"2119","chr1.162070000.162075000","chr1.162090000.162095000",20000,48,9.466554e-07,162070000,162090000,162075000,162095000,"chr1",57991,1,1,1,3,"chr1",1,0.0168776371308017
"2120","chr1.28245000.28250000","chr1.28515000.28520000",270000,12,0.001326741,28245000,28515000,28250000,28520000,"chr1",58039,5,19,21,45,"chr1",1,0.0632911392405063
"2121","chr1.168615000.168620000","chr1.168760000.168765000",145000,14,0.005764312,168615000,168760000,168620000,168765000,"chr1",58051,0,2,0,2,"chr1",1,0.00328176277543366
"2122","chr1.207670000.207675000","chr1.207845000.207850000",175000,14,0.001856842,207670000,207845000,207675000,207850000,"chr1",58063,0,2,1,3,"chr1",1,0.00492264416315049
"2123","chr1.8590000.8595000","chr1.8815000.8820000",225000,12,0.004222767,8590000,8815000,8595000,8820000,"chr1",58087,0,7,5,12,"chr1",1,0.0168776371308017
"2124","chr1.8085000.8090000","chr1.8410000.8415000",325000,10,0.006950379,8085000,8410000,8090000,8415000,"chr1",58100,9,23,19,51,"chr1",1,0.059774964838256
"2125","chr1.31705000.31710000","chr1.31820000.31825000",115000,15,0.007192145,31705000,31820000,31710000,31825000,"chr1",58234,1,4,1,6,"chr1",1,0.0105485232067511
"2126","chr1.244295000.244300000","chr1.244430000.244435000",135000,15,0.00290255,244295000,244430000,244300000,244435000,"chr1",58241,1,14,9,24,"chr1",1,0.0421940928270042
"2127","chr1.40610000.40615000","chr1.40710000.40715000",100000,19,0.0002491261,40610000,40710000,40615000,40715000,"chr1",58253,2,3,4,9,"chr1",1,0.020042194092827
"2128","chr1.202835000.202840000","chr1.202940000.202945000",105000,16,0.004620068,202835000,202940000,202840000,202945000,"chr1",58257,0,9,5,14,"chr1",1,0.0262541022034693
"2129","chr1.171880000.171885000","chr1.171950000.171955000",70000,31,2.760412e-09,171880000,171950000,171885000,171955000,"chr1",58281,1,4,2,7,"chr1",1,0.0254336615096109
"2130","chr1.171780000.171785000","chr1.171900000.171905000",120000,15,0.005618157,171780000,171900000,171785000,171905000,"chr1",58364,3,2,5,10,"chr1",1,0.0175808720112518
"2131","chr1.54740000.54745000","chr1.54950000.54955000",210000,12,0.00640887,54740000,54950000,54745000,54955000,"chr1",58410,0,3,1,4,"chr1",1,0.00562587904360056
"2132","chr1.9690000.9695000","chr1.10475000.10480000",785000,8,0.001386725,9690000,10475000,9695000,10480000,"chr1",58442,4,11,26,41,"chr1",1,0.0384435067979372
"2133","chr1.204845000.204850000","chr1.204900000.204905000",55000,30,7.990362e-07,204845000,204900000,204850000,204905000,"chr1",58444,7,8,12,27,"chr1",1,0.0949367088607595
"2134","chr1.205105000.205110000","chr1.205175000.205180000",70000,26,2.649753e-06,205105000,205175000,205110000,205180000,"chr1",58453,1,6,5,12,"chr1",1,0.0365682137834037
"2135","chr1.178500000.178505000","chr1.178710000.178715000",210000,22,9.219505e-10,178500000,178710000,178505000,178715000,"chr1",58539,1,6,5,12,"chr1",1,0.0309423347398031
"2136","chr1.156160000.156165000","chr1.156580000.156585000",420000,10,0.001921749,156160000,156580000,156165000,156585000,"chr1",58557,0,4,2,6,"chr1",1,0.0070323488045007
"2137","chr1.8435000.8440000","chr1.8710000.8715000",275000,13,0.0002791164,8435000,8710000,8440000,8715000,"chr1",58668,1,4,3,8,"chr1",1,0.0121894045944679
"2138","chr1.162020000.162025000","chr1.162215000.162220000",195000,15,0.0002307636,162020000,162215000,162025000,162220000,"chr1",58674,0,5,4,9,"chr1",1,0.0158227848101266
"2139","chr1.46165000.46170000","chr1.46195000.46200000",30000,36,5.590942e-05,46165000,46195000,46170000,46200000,"chr1",58697,0,4,1,5,"chr1",1,0.0210970464135021
"2140","chr1.10130000.10135000","chr1.10175000.10180000",45000,29,4.600653e-05,10130000,10175000,10135000,10180000,"chr1",58739,7,13,22,42,"chr1",1,0.142756680731364
"2141","chr1.153790000.153795000","chr1.153955000.153960000",165000,15,0.0008057805,153790000,153955000,153795000,153960000,"chr1",58753,3,5,4,12,"chr1",1,0.0210970464135021
"2142","chr1.39390000.39395000","chr1.39490000.39495000",100000,31,3.98457e-12,39390000,39490000,39395000,39495000,"chr1",58782,2,1,0,3,"chr1",1,0.0109001406469761
"2143","chr1.20150000.20155000","chr1.20445000.20450000",295000,11,0.00307826,20150000,20445000,20155000,20450000,"chr1",58802,1,2,2,5,"chr1",1,0.00644631973745898
"2144","chr1.171740000.171745000","chr1.171950000.171955000",210000,12,0.00640887,171740000,171950000,171745000,171955000,"chr1",58822,1,4,2,7,"chr1",1,0.00984528832630099
"2145","chr1.155830000.155835000","chr1.155855000.155860000",25000,37,0.0008057805,155830000,155855000,155835000,155860000,"chr1",58826,7,20,21,48,"chr1",1,0.208157524613221
"2146","chr1.145425000.145430000","chr1.145465000.145470000",40000,55,2.466633e-19,145425000,145465000,145430000,145470000,"chr1",58844,0,6,5,11,"chr1",1,0.0709095171120488
"2147","chr1.25175000.25180000","chr1.25520000.25525000",345000,10,0.005218466,25175000,25520000,25180000,25525000,"chr1",58872,1,4,1,6,"chr1",1,0.0070323488045007
"2148","chr1.23365000.23370000","chr1.23575000.23580000",210000,13,0.001879154,23365000,23575000,23370000,23580000,"chr1",58876,2,3,7,12,"chr1",1,0.0182841068917018
"2149","chr1.228795000.228800000","chr1.229435000.229440000",640000,10,0.0001283145,228795000,229435000,228800000,229440000,"chr1",58905,4,12,5,21,"chr1",1,0.0246132208157525
"2150","chr1.51235000.51240000","chr1.51730000.51735000",495000,10,0.0007247824,51235000,51730000,51240000,51735000,"chr1",58956,1,5,6,12,"chr1",1,0.0140646976090014
"2151","chr1.21235000.21240000","chr1.21280000.21285000",45000,23,0.009597206,21235000,21280000,21240000,21285000,"chr1",58967,1,9,9,19,"chr1",1,0.0512189404594468
"2152","chr1.243505000.243510000","chr1.244215000.244220000",710000,8,0.0024319,243505000,244215000,243510000,244220000,"chr1",58983,0,2,1,3,"chr1",1,0.00281293952180028
"2153","chr1.183635000.183640000","chr1.183875000.183880000",240000,15,3.931393e-05,183635000,183875000,183640000,183880000,"chr1",58992,1,2,2,5,"chr1",1,0.00879043600562588
"2154","chr1.93330000.93335000","chr1.93445000.93450000",115000,23,2.61252e-07,93330000,93445000,93335000,93450000,"chr1",59026,3,4,1,8,"chr1",1,0.0215658696671355
"2155","chr1.9860000.9865000","chr1.9910000.9915000",50000,26,0.0002506014,9860000,9910000,9865000,9915000,"chr1",59039,3,7,10,20,"chr1",1,0.0609470229723394
"2156","chr1.155860000.155865000","chr1.155960000.155965000",100000,16,0.006415049,155860000,155960000,155865000,155965000,"chr1",59048,6,10,23,39,"chr1",1,0.0731364275668073
"2157","chr1.8525000.8530000","chr1.8710000.8715000",185000,13,0.004288904,8525000,8710000,8530000,8715000,"chr1",59073,0,0,3,3,"chr1",1,0.00457102672292546
"2158","chr1.229535000.229540000","chr1.229555000.229560000",20000,40,0.0006470043,229535000,229555000,229540000,229560000,"chr1",59094,4,6,9,19,"chr1",1,0.0890764181903422
"2159","chr1.204245000.204250000","chr1.204330000.204335000",85000,27,3.999233e-08,204245000,204330000,204250000,204335000,"chr1",59113,2,8,9,19,"chr1",1,0.060126582278481
"2160","chr1.39570000.39575000","chr1.39700000.39705000",130000,17,0.0003492026,39570000,39700000,39575000,39705000,"chr1",59129,0,4,2,6,"chr1",1,0.0119549929676512
"2161","chr1.169085000.169090000","chr1.169320000.169325000",235000,14,0.0002134243,169085000,169320000,169090000,169325000,"chr1",59163,0,1,2,3,"chr1",1,0.00492264416315049
"2162","chr1.27030000.27035000","chr1.27095000.27100000",65000,29,1.688833e-07,27030000,27095000,27035000,27100000,"chr1",59352,2,8,7,17,"chr1",1,0.0577824660103141
"2163","chr1.113070000.113075000","chr1.113225000.113230000",155000,14,0.00393986,113070000,113225000,113075000,113230000,"chr1",59355,1,4,4,9,"chr1",1,0.0147679324894515
"2164","chr1.150565000.150570000","chr1.150875000.150880000",310000,10,0.008632247,150565000,150875000,150570000,150880000,"chr1",59361,1,14,11,26,"chr1",1,0.0304735114861697
"2165","chr1.11350000.11355000","chr1.11700000.11705000",350000,10,0.00486492,11350000,11700000,11355000,11705000,"chr1",59389,0,2,1,3,"chr1",1,0.00351617440225035
"2166","chr1.225730000.225735000","chr1.225825000.225830000",95000,16,0.009001332,225730000,225825000,225735000,225830000,"chr1",59423,1,5,7,13,"chr1",1,0.0243788091889358
"2167","chr1.168735000.168740000","chr1.169130000.169135000",395000,11,0.0006001318,168735000,169130000,168740000,169135000,"chr1",59434,0,2,2,4,"chr1",1,0.00515705578996718
"2168","chr1.116380000.116385000","chr1.116510000.116515000",130000,22,3.223591e-07,116380000,116510000,116385000,116515000,"chr1",59471,1,2,1,4,"chr1",1,0.0103141115799344
"2169","chr1.150550000.150555000","chr1.150965000.150970000",415000,10,0.00206337,150550000,150965000,150555000,150970000,"chr1",59474,0,1,0,1,"chr1",1,0.00117205813408345
"2170","chr1.168600000.168605000","chr1.169170000.169175000",570000,10,0.0002882227,168600000,169170000,168605000,169175000,"chr1",59480,0,2,0,2,"chr1",1,0.0023441162681669
"2171","chr1.155250000.155255000","chr1.155470000.155475000",220000,17,3.717423e-06,155250000,155470000,155255000,155475000,"chr1",59485,2,21,12,35,"chr1",1,0.0697374589779653
"2172","chr1.9310000.9315000","chr1.9560000.9565000",250000,11,0.007719712,9310000,9560000,9315000,9565000,"chr1",59486,8,22,22,52,"chr1",1,0.0670417252695734
"2173","chr1.204245000.204250000","chr1.204270000.204275000",25000,39,0.0001793477,204245000,204270000,204250000,204275000,"chr1",59493,3,1,4,8,"chr1",1,0.0365682137834037
"2174","chr1.29255000.29260000","chr1.29350000.29355000",95000,17,0.003397074,29255000,29350000,29260000,29355000,"chr1",59501,0,1,1,2,"chr1",1,0.00398499765588373
"2175","chr1.223715000.223720000","chr1.223810000.223815000",95000,18,0.001200097,223715000,223810000,223720000,223815000,"chr1",59507,1,6,7,14,"chr1",1,0.029535864978903
"2176","chr1.211740000.211745000","chr1.211825000.211830000",85000,17,0.007758048,211740000,211825000,211745000,211830000,"chr1",59527,4,6,9,19,"chr1",1,0.0378574777308955
"2177","chr1.201495000.201500000","chr1.201540000.201545000",45000,26,0.0008075999,201495000,201540000,201500000,201545000,"chr1",59534,1,2,1,4,"chr1",1,0.0121894045944679
"2178","chr1.39650000.39655000","chr1.39690000.39695000",40000,25,0.006608083,39650000,39690000,39655000,39695000,"chr1",59539,0,3,3,6,"chr1",1,0.0175808720112518
"2179","chr1.164690000.164695000","chr1.164750000.164755000",60000,21,0.003722807,164690000,164750000,164695000,164755000,"chr1",59550,0,4,1,5,"chr1",1,0.0123066104078762
"2180","chr1.161200000.161205000","chr1.161285000.161290000",85000,29,1.939221e-09,161200000,161285000,161205000,161290000,"chr1",59601,1,3,2,6,"chr1",1,0.020393811533052
"2181","chr1.77680000.77685000","chr1.77990000.77995000",310000,17,1.017851e-07,77680000,77990000,77685000,77995000,"chr1",59617,1,5,4,10,"chr1",1,0.0199249882794187
"2182","chr1.39650000.39655000","chr1.39730000.39735000",80000,21,0.0002162115,39650000,39730000,39655000,39735000,"chr1",59675,0,3,4,7,"chr1",1,0.0172292545710267
"2183","chr1.228790000.228795000","chr1.229625000.229630000",835000,8,0.0009552771,228790000,229625000,228795000,229630000,"chr1",59698,0,1,1,2,"chr1",1,0.00187529301453352
"2184","chr1.43705000.43710000","chr1.44505000.44510000",800000,8,0.00124165,43705000,44505000,43710000,44510000,"chr1",59733,0,5,3,8,"chr1",1,0.00750117205813408
"2185","chr1.8685000.8690000","chr1.8725000.8730000",40000,25,0.006608083,8685000,8725000,8690000,8730000,"chr1",59752,1,23,17,41,"chr1",1,0.120135958743554
"2186","chr1.84385000.84390000","chr1.84945000.84950000",560000,9,0.001761985,84385000,84945000,84390000,84950000,"chr1",59776,0,5,5,10,"chr1",1,0.0105485232067511
"2187","chr1.155915000.155920000","chr1.155985000.155990000",70000,20,0.002190239,155915000,155985000,155920000,155990000,"chr1",59777,1,13,14,28,"chr1",1,0.0656352555086732
"2188","chr1.205245000.205250000","chr1.205285000.205290000",40000,43,2.011148e-11,205245000,205285000,205250000,205290000,"chr1",59800,1,2,2,5,"chr1",1,0.0251992498827942
"2189","chr1.201540000.201545000","chr1.201770000.201775000",230000,13,0.001007514,201540000,201770000,201545000,201775000,"chr1",59832,1,2,2,5,"chr1",1,0.00761837787154243
"2190","chr1.183650000.183655000","chr1.183875000.183880000",225000,26,9.07198e-14,183650000,183875000,183655000,183880000,"chr1",59857,1,2,1,4,"chr1",1,0.0121894045944679
"2191","chr1.161280000.161285000","chr1.161365000.161370000",85000,20,0.0003590682,161280000,161365000,161285000,161370000,"chr1",59870,3,5,2,10,"chr1",1,0.023441162681669
"2192","chr1.16215000.16220000","chr1.16235000.16240000",20000,39,0.00129403,16215000,16235000,16220000,16240000,"chr1",59959,0,1,1,2,"chr1",1,0.00914205344585091
"2193","chr1.24745000.24750000","chr1.24830000.24835000",85000,18,0.003006639,24745000,24830000,24750000,24835000,"chr1",60022,6,19,19,44,"chr1",1,0.0928270042194093
"2194","chr1.230215000.230220000","chr1.230365000.230370000",150000,15,0.001520338,230215000,230365000,230220000,230370000,"chr1",60064,2,2,2,6,"chr1",1,0.0105485232067511
"2195","chr1.8410000.8415000","chr1.8510000.8515000",100000,17,0.002324276,8410000,8510000,8415000,8515000,"chr1",60118,2,12,13,27,"chr1",1,0.0537974683544304
"2196","chr1.39455000.39460000","chr1.39490000.39495000",35000,54,1.927977e-16,39455000,39490000,39460000,39495000,"chr1",60131,0,1,0,1,"chr1",1,0.00632911392405063
"2197","chr1.19715000.19720000","chr1.19760000.19765000",45000,24,0.004449684,19715000,19760000,19720000,19765000,"chr1",60165,6,15,16,37,"chr1",1,0.10407876230661
"2198","chr1.204245000.204250000","chr1.204305000.204310000",60000,28,2.282334e-06,204245000,204305000,204250000,204310000,"chr1",60168,3,8,14,25,"chr1",1,0.0820440693858415
"2199","chr1.203085000.203090000","chr1.203235000.203240000",150000,25,4.047421e-10,203085000,203235000,203090000,203240000,"chr1",60207,1,1,0,2,"chr1",1,0.00586029067041725
"2200","chr1.182110000.182115000","chr1.182345000.182350000",235000,38,9.882959e-27,182110000,182345000,182115000,182350000,"chr1",60224,3,10,3,16,"chr1",1,0.0712611345522738
"2201","chr1.36450000.36455000","chr1.36520000.36525000",70000,19,0.00555421,36450000,36520000,36455000,36525000,"chr1",60276,0,3,1,4,"chr1",1,0.00890764181903422
"2202","chr1.39650000.39655000","chr1.39745000.39750000",95000,18,0.001200097,39650000,39745000,39655000,39750000,"chr1",60354,0,3,4,7,"chr1",1,0.0147679324894515
"2203","chr1.10000000.10005000","chr1.10375000.10380000",375000,10,0.003509469,1e+07,10375000,10005000,10380000,"chr1",60360,0,6,5,11,"chr1",1,0.012892639474918
"2204","chr1.66600000.66605000","chr1.66630000.66635000",30000,36,5.590942e-05,66600000,66630000,66605000,66635000,"chr1",60367,1,1,4,6,"chr1",1,0.0253164556962025
"2205","chr1.153745000.153750000","chr1.153960000.153965000",215000,18,9.103338e-07,153745000,153960000,153750000,153965000,"chr1",60382,1,7,4,12,"chr1",1,0.0253164556962025
"2206","chr1.156390000.156395000","chr1.156600000.156605000",210000,14,0.0005117364,156390000,156600000,156395000,156605000,"chr1",60383,0,3,3,6,"chr1",1,0.00984528832630099
"2207","chr1.32480000.32485000","chr1.32650000.32655000",170000,15,0.0006470043,32480000,32650000,32485000,32655000,"chr1",60422,5,8,10,23,"chr1",1,0.040436005625879
"2208","chr1.240340000.240345000","chr1.240865000.240870000",525000,9,0.002554003,240340000,240865000,240345000,240870000,"chr1",60434,0,1,0,1,"chr1",1,0.00105485232067511
"2209","chr1.161155000.161160000","chr1.161280000.161285000",125000,21,2.157778e-06,161155000,161280000,161160000,161285000,"chr1",60442,0,2,3,5,"chr1",1,0.0123066104078762
"2210","chr1.27010000.27015000","chr1.27100000.27105000",90000,17,0.005066586,27010000,27100000,27015000,27105000,"chr1",60451,1,2,2,5,"chr1",1,0.00996249413970933
"2211","chr1.151165000.151170000","chr1.151370000.151375000",205000,21,8.30117e-09,151165000,151370000,151170000,151375000,"chr1",60472,1,9,5,15,"chr1",1,0.0369198312236287
"2212","chr1.201710000.201715000","chr1.201740000.201745000",30000,43,5.31851e-08,201710000,201740000,201715000,201745000,"chr1",60493,1,3,3,7,"chr1",1,0.0352789498359119
"2213","chr1.212985000.212990000","chr1.213170000.213175000",185000,30,6.640355e-16,212985000,213170000,212990000,213175000,"chr1",60525,2,5,2,9,"chr1",1,0.0316455696202532
"2214","chr1.153545000.153550000","chr1.153625000.153630000",80000,20,0.0006470043,153545000,153625000,153550000,153630000,"chr1",60548,2,6,5,13,"chr1",1,0.0304735114861697
"2215","chr1.205300000.205305000","chr1.205490000.205495000",190000,17,1.606819e-05,205300000,205490000,205305000,205495000,"chr1",60637,1,7,8,16,"chr1",1,0.0318799812470699
"2216","chr1.16155000.16160000","chr1.16235000.16240000",80000,20,0.0006470043,16155000,16235000,16160000,16240000,"chr1",60645,5,13,10,28,"chr1",1,0.0656352555086732
"2217","chr1.16960000.16965000","chr1.17235000.17240000",275000,17,3.562761e-07,16960000,17235000,16965000,17240000,"chr1",60691,4,4,8,16,"chr1",1,0.0318799812470699
"2218","chr1.149915000.149920000","chr1.150180000.150185000",265000,14,8.003931e-05,149915000,150180000,149920000,150185000,"chr1",60692,1,7,13,21,"chr1",1,0.0344585091420534
"2219","chr1.244075000.244080000","chr1.244110000.244115000",35000,29,0.001520338,244075000,244110000,244080000,244115000,"chr1",60809,0,9,7,16,"chr1",1,0.0543834974214721
"2220","chr1.180980000.180985000","chr1.181020000.181025000",40000,30,9.14609e-05,180980000,181020000,180985000,181025000,"chr1",60825,3,9,6,18,"chr1",1,0.0632911392405063
"2221","chr1.235010000.235015000","chr1.235075000.235080000",65000,21,0.001695142,235010000,235075000,235015000,235080000,"chr1",60838,0,3,2,5,"chr1",1,0.0123066104078762
"2222","chr1.78030000.78035000","chr1.78095000.78100000",65000,24,7.710059e-05,78030000,78095000,78035000,78100000,"chr1",60851,0,1,3,4,"chr1",1,0.0112517580872011
"2223","chr1.151250000.151255000","chr1.151310000.151315000",60000,24,0.0002105081,151250000,151310000,151255000,151315000,"chr1",60854,1,2,1,4,"chr1",1,0.0112517580872011
"2224","chr1.165590000.165595000","chr1.165655000.165660000",65000,21,0.001695142,165590000,165655000,165595000,165660000,"chr1",60861,4,19,14,37,"chr1",1,0.0910689170182841
"2225","chr1.149935000.149940000","chr1.150055000.150060000",120000,16,0.001909676,149935000,150055000,149940000,150060000,"chr1",60873,0,6,6,12,"chr1",1,0.0225035161744023
"2226","chr1.77830000.77835000","chr1.78000000.78005000",170000,16,0.0001774802,77830000,7.8e+07,77835000,78005000,"chr1",60883,5,4,2,11,"chr1",1,0.0206282231598687
"2227","chr1.8670000.8675000","chr1.8710000.8715000",40000,32,1.249066e-05,8670000,8710000,8675000,8715000,"chr1",60922,1,12,9,22,"chr1",1,0.0825128926394749
"2228","chr1.229450000.229455000","chr1.229555000.229560000",105000,17,0.001605476,229450000,229555000,229455000,229560000,"chr1",60941,4,15,10,29,"chr1",1,0.0577824660103141
"2229","chr1.153645000.153650000","chr1.153945000.153950000",300000,13,0.0001481797,153645000,153945000,153650000,153950000,"chr1",60955,2,4,2,8,"chr1",1,0.0121894045944679
"2230","chr1.203005000.203010000","chr1.203235000.203240000",230000,15,5.74267e-05,203005000,203235000,203010000,203240000,"chr1",61010,3,6,7,16,"chr1",1,0.0281293952180028
"2231","chr1.39735000.39740000","chr1.39880000.39885000",145000,16,0.0005758375,39735000,39880000,39740000,39885000,"chr1",61012,1,10,9,20,"chr1",1,0.0375058602906704
"2232","chr1.21255000.21260000","chr1.21280000.21285000",25000,34,0.006227396,21255000,21280000,21260000,21285000,"chr1",61057,1,8,6,15,"chr1",1,0.059774964838256
"2233","chr1.150050000.150055000","chr1.150145000.150150000",95000,21,3.530743e-05,150050000,150145000,150055000,150150000,"chr1",61130,1,5,3,9,"chr1",1,0.0221518987341772
"2234","chr1.155900000.155905000","chr1.155945000.155950000",45000,40,7.095345e-11,155900000,155945000,155905000,155950000,"chr1",61132,17,41,28,86,"chr1",1,0.403187998124707
"2235","chr1.153645000.153650000","chr1.153750000.153755000",105000,16,0.004620068,153645000,153750000,153650000,153755000,"chr1",61183,2,10,7,19,"chr1",1,0.0356305672761369
"2236","chr1.243490000.243495000","chr1.244460000.244465000",970000,8,0.0003258558,243490000,244460000,243495000,244465000,"chr1",61195,0,3,4,7,"chr1",1,0.00656352555086732
"2237","chr1.201550000.201555000","chr1.201720000.201725000",170000,15,0.0006470043,201550000,201720000,201555000,201725000,"chr1",61201,0,2,1,3,"chr1",1,0.00527426160337553
"2238","chr1.150180000.150185000","chr1.150230000.150235000",50000,22,0.008541777,150180000,150230000,150185000,150235000,"chr1",61212,5,16,14,35,"chr1",1,0.0902484763244257
"2239","chr1.33005000.33010000","chr1.33125000.33130000",120000,17,0.0006133453,33005000,33125000,33010000,33130000,"chr1",61245,0,2,1,3,"chr1",1,0.0059774964838256
"2240","chr1.8460000.8465000","chr1.8595000.8600000",135000,18,7.328414e-05,8460000,8595000,8465000,8600000,"chr1",61275,6,4,5,15,"chr1",1,0.0316455696202532
"2241","chr1.67460000.67465000","chr1.67615000.67620000",155000,16,0.0003558736,67460000,67615000,67465000,67620000,"chr1",61280,1,6,1,8,"chr1",1,0.0150023441162682
"2242","chr1.45495000.45500000","chr1.45730000.45735000",235000,12,0.003229073,45495000,45730000,45500000,45735000,"chr1",61285,4,21,18,43,"chr1",1,0.060478199718706
"2243","chr1.212230000.212235000","chr1.212540000.212545000",310000,19,1.93502e-09,212230000,212540000,212235000,212545000,"chr1",61308,0,1,2,3,"chr1",1,0.00668073136427567
"2244","chr1.156120000.156125000","chr1.156160000.156165000",40000,27,0.001354847,156120000,156160000,156125000,156165000,"chr1",61310,5,6,4,15,"chr1",1,0.0474683544303797
"2245","chr1.21345000.21350000","chr1.21395000.21400000",50000,28,3.2625e-05,21345000,21395000,21350000,21400000,"chr1",61313,0,4,2,6,"chr1",1,0.019690576652602
"2246","chr1.161185000.161190000","chr1.161285000.161290000",100000,16,0.006415049,161185000,161285000,161190000,161290000,"chr1",61362,7,9,5,21,"chr1",1,0.0393811533052039
"2247","chr1.39625000.39630000","chr1.39650000.39655000",25000,40,7.966121e-05,39625000,39650000,39630000,39655000,"chr1",61433,0,3,4,7,"chr1",1,0.0328176277543366
"2248","chr1.156055000.156060000","chr1.156090000.156095000",35000,34,1.810507e-05,156055000,156090000,156060000,156095000,"chr1",61501,7,8,12,27,"chr1",1,0.107594936708861
"2249","chr1.23365000.23370000","chr1.23440000.23445000",75000,23,4.328812e-05,23365000,23440000,23370000,23445000,"chr1",61517,3,5,7,15,"chr1",1,0.040436005625879
"2250","chr1.247095000.247100000","chr1.247370000.247375000",275000,12,0.001179873,247095000,247370000,247100000,247375000,"chr1",61521,6,19,6,31,"chr1",1,0.0436005625879044
"2251","chr1.183610000.183615000","chr1.183650000.183655000",40000,26,0.003086748,183610000,183650000,183615000,183655000,"chr1",61601,1,2,1,4,"chr1",1,0.0121894045944679
"2252","chr1.144545000.144550000","chr1.145285000.145290000",740000,8,0.001914257,144545000,145285000,144550000,145290000,"chr1",61604,5,8,8,21,"chr1",1,0.019690576652602
"2253","chr1.54420000.54425000","chr1.54495000.54500000",75000,26,9.9939e-07,54420000,54495000,54425000,54500000,"chr1",61633,1,3,1,5,"chr1",1,0.0152367557430849
"2254","chr1.15665000.15670000","chr1.15685000.15690000",20000,38,0.00252151,15665000,15685000,15670000,15690000,"chr1",61657,2,6,4,12,"chr1",1,0.0534458509142053
"2255","chr1.204240000.204245000","chr1.204325000.204330000",85000,28,8.894404e-09,204240000,204325000,204245000,204330000,"chr1",61678,0,9,12,21,"chr1",1,0.0689170182841069
"2256","chr1.32965000.32970000","chr1.33085000.33090000",120000,15,0.005618157,32965000,33085000,32970000,33090000,"chr1",61682,3,6,10,19,"chr1",1,0.0334036568213783
"2257","chr1.192435000.192440000","chr1.193120000.193125000",685000,8,0.002973403,192435000,193120000,192440000,193125000,"chr1",61698,0,3,1,4,"chr1",1,0.00375058602906704
"2258","chr1.26600000.26605000","chr1.26690000.26695000",90000,18,0.001865958,26600000,26690000,26605000,26695000,"chr1",61726,2,9,2,13,"chr1",1,0.0274261603375527
"2259","chr1.178295000.178300000","chr1.178710000.178715000",415000,13,1.42709e-05,178295000,178710000,178300000,178715000,"chr1",61737,4,10,8,22,"chr1",1,0.0335208626347867
"2260","chr1.211745000.211750000","chr1.211830000.211835000",85000,32,1.568001e-11,211745000,211830000,211750000,211835000,"chr1",61760,0,1,0,1,"chr1",1,0.00375058602906704
"2261","chr1.183930000.183935000","chr1.184015000.184020000",85000,17,0.007758048,183930000,184015000,183935000,184020000,"chr1",61792,2,1,5,8,"chr1",1,0.0159399906235349
"2262","chr1.212255000.212260000","chr1.212515000.212520000",260000,13,0.0004157809,212255000,212515000,212260000,212520000,"chr1",61801,4,4,5,13,"chr1",1,0.0198077824660103
"2263","chr1.11155000.11160000","chr1.11285000.11290000",130000,18,9.727861e-05,11155000,11285000,11160000,11290000,"chr1",61829,1,3,3,7,"chr1",1,0.0147679324894515
"2264","chr1.210795000.210800000","chr1.211305000.211310000",510000,15,3.741012e-08,210795000,211305000,210800000,211310000,"chr1",61857,0,3,5,8,"chr1",1,0.0140646976090014
"2265","chr1.165520000.165525000","chr1.165540000.165545000",20000,48,9.466554e-07,165520000,165540000,165525000,165545000,"chr1",61866,0,3,5,8,"chr1",1,0.0450070323488045
"2266","chr1.27030000.27035000","chr1.27120000.27125000",90000,21,6.373704e-05,27030000,27120000,27035000,27125000,"chr1",61890,5,22,15,42,"chr1",1,0.10337552742616
"2267","chr1.234755000.234760000","chr1.235010000.235015000",255000,11,0.00691274,234755000,235010000,234760000,235015000,"chr1",61978,0,1,2,3,"chr1",1,0.00386779184247539
"2268","chr1.10130000.10135000","chr1.10395000.10400000",265000,12,0.001500618,10130000,10395000,10135000,10400000,"chr1",61989,8,41,26,75,"chr1",1,0.105485232067511
"2269","chr1.171985000.171990000","chr1.172420000.172425000",435000,9,0.00691274,171985000,172420000,171990000,172425000,"chr1",61995,0,1,1,2,"chr1",1,0.00210970464135021
"2270","chr1.203595000.203600000","chr1.203670000.203675000",75000,56,2.171803e-30,203595000,203670000,203600000,203675000,"chr1",62041,4,13,8,25,"chr1",1,0.164088138771683
"2271","chr1.155855000.155860000","chr1.155870000.155875000",15000,37,0.004733079,155855000,155870000,155860000,155875000,"chr1",62065,7,20,21,48,"chr1",1,0.208157524613221
"2272","chr1.40625000.40630000","chr1.40710000.40715000",85000,17,0.007758048,40625000,40710000,40630000,40715000,"chr1",62222,2,1,4,7,"chr1",1,0.0139474917955931
"2273","chr1.201500000.201505000","chr1.201670000.201675000",170000,17,4.411038e-05,201500000,201670000,201505000,201675000,"chr1",62262,0,0,3,3,"chr1",1,0.0059774964838256
"2274","chr1.223355000.223360000","chr1.223830000.223835000",475000,11,0.0001798882,223355000,223830000,223360000,223835000,"chr1",62269,1,1,5,7,"chr1",1,0.00902484763244257
"2275","chr1.113615000.113620000","chr1.113930000.113935000",315000,10,0.008095926,113615000,113930000,113620000,113935000,"chr1",62287,1,6,4,11,"chr1",1,0.012892639474918
"2276","chr1.89700000.89705000","chr1.89720000.89725000",20000,36,0.008632247,89700000,89720000,89705000,89725000,"chr1",62316,0,0,3,3,"chr1",1,0.0126582278481013
"2277","chr1.39605000.39610000","chr1.40035000.40040000",430000,9,0.007266285,39605000,40035000,39610000,40040000,"chr1",62342,4,5,9,18,"chr1",1,0.0189873417721519
"2278","chr1.167525000.167530000","chr1.167660000.167665000",135000,19,1.883546e-05,167525000,167660000,167530000,167665000,"chr1",62408,2,4,3,9,"chr1",1,0.020042194092827
"2279","chr1.16960000.16965000","chr1.17055000.17060000",95000,45,1.565979e-23,16960000,17055000,16965000,17060000,"chr1",62415,4,14,22,40,"chr1",1,0.210970464135021
"2280","chr1.243845000.243850000","chr1.244430000.244435000",585000,8,0.006690763,243845000,244430000,243850000,244435000,"chr1",62428,1,2,5,8,"chr1",1,0.00750117205813408
"2281","chr1.10295000.10300000","chr1.10385000.10390000",90000,17,0.005066586,10295000,10385000,10300000,10390000,"chr1",62431,1,3,5,9,"chr1",1,0.0179324894514768
"2282","chr1.155895000.155900000","chr1.155960000.155965000",65000,32,2.617181e-09,155895000,155960000,155900000,155965000,"chr1",62442,6,10,23,39,"chr1",1,0.146272855133615
"2283","chr1.51725000.51730000","chr1.52000000.52005000",275000,19,8.102799e-09,51725000,5.2e+07,51730000,52005000,"chr1",62461,7,15,17,39,"chr1",1,0.0868495077355837
"2284","chr1.233595000.233600000","chr1.234070000.234075000",475000,10,0.000940042,233595000,234070000,233600000,234075000,"chr1",62514,2,2,0,4,"chr1",1,0.0046882325363338
"2285","chr1.54760000.54765000","chr1.54895000.54900000",135000,14,0.008425895,54760000,54895000,54765000,54900000,"chr1",62519,0,5,9,14,"chr1",1,0.0229723394280356
"2286","chr1.78030000.78035000","chr1.78050000.78055000",20000,42,0.0001481797,78030000,78050000,78035000,78055000,"chr1",62528,1,4,10,15,"chr1",1,0.0738396624472574
"2287","chr1.156410000.156415000","chr1.156600000.156605000",190000,15,0.000283605,156410000,156600000,156415000,156605000,"chr1",62553,0,3,7,10,"chr1",1,0.0175808720112518
"2288","chr1.224435000.224440000","chr1.224510000.224515000",75000,18,0.007861949,224435000,224510000,224440000,224515000,"chr1",62565,6,15,8,29,"chr1",1,0.0611814345991561
"2289","chr1.228790000.228795000","chr1.229450000.229455000",660000,9,0.0006470043,228790000,229450000,228795000,229455000,"chr1",62607,0,2,1,3,"chr1",1,0.00316455696202532
"2290","chr1.156130000.156135000","chr1.156190000.156195000",60000,20,0.00869379,156130000,156190000,156135000,156195000,"chr1",62609,3,11,12,26,"chr1",1,0.0609470229723394
"2291","chr1.43695000.43700000","chr1.43855000.43860000",160000,20,8.686063e-07,43695000,43855000,43700000,43860000,"chr1",62630,3,3,6,12,"chr1",1,0.0281293952180028
"2292","chr1.8460000.8465000","chr1.8590000.8595000",130000,17,0.0003492026,8460000,8590000,8465000,8595000,"chr1",62652,5,11,10,26,"chr1",1,0.0518049695264885
"2293","chr1.40370000.40375000","chr1.40450000.40455000",80000,23,2.046838e-05,40370000,40450000,40375000,40455000,"chr1",62671,2,8,9,19,"chr1",1,0.0512189404594468
"2294","chr1.26430000.26435000","chr1.26555000.26560000",125000,16,0.001500618,26430000,26555000,26435000,26560000,"chr1",62686,1,5,4,10,"chr1",1,0.0187529301453352
"2295","chr1.27625000.27630000","chr1.27980000.27985000",355000,14,8.00102e-06,27625000,27980000,27630000,27985000,"chr1",62730,7,12,12,31,"chr1",1,0.0508673230192218
"2296","chr1.19240000.19245000","chr1.19430000.19435000",190000,15,0.000283605,19240000,19430000,19245000,19435000,"chr1",62776,3,6,7,16,"chr1",1,0.0281293952180028
"2297","chr1.19675000.19680000","chr1.19710000.19715000",35000,27,0.00691274,19675000,19710000,19680000,19715000,"chr1",62786,2,4,3,9,"chr1",1,0.0284810126582278
"2298","chr1.186370000.186375000","chr1.186855000.186860000",485000,9,0.00393986,186370000,186855000,186375000,186860000,"chr1",62826,1,4,2,7,"chr1",1,0.00738396624472574
"2299","chr1.23015000.23020000","chr1.23165000.23170000",150000,15,0.001520338,23015000,23165000,23020000,23170000,"chr1",62875,2,2,1,5,"chr1",1,0.00879043600562588
"2300","chr1.66600000.66605000","chr1.66640000.66645000",40000,28,0.0005784227,66600000,66640000,66605000,66645000,"chr1",62893,1,1,2,4,"chr1",1,0.0131270511017346
"2301","chr1.234740000.234745000","chr1.235100000.235105000",360000,10,0.004288904,234740000,235100000,234745000,235105000,"chr1",62939,1,7,10,18,"chr1",1,0.0210970464135021
"2302","chr1.183605000.183610000","chr1.184015000.184020000",410000,9,0.009020058,183605000,184015000,183610000,184020000,"chr1",62962,4,5,12,21,"chr1",1,0.0221518987341772
"2303","chr1.28580000.28585000","chr1.28880000.28885000",300000,13,0.0001481797,28580000,28880000,28585000,28885000,"chr1",63096,6,21,30,57,"chr1",1,0.0868495077355837
"2304","chr1.24500000.24505000","chr1.24715000.24720000",215000,14,0.0004233859,24500000,24715000,24505000,24720000,"chr1",63111,3,8,16,27,"chr1",1,0.0443037974683544
"2305","chr1.26230000.26235000","chr1.26320000.26325000",90000,38,9.678367e-17,26230000,26320000,26235000,26325000,"chr1",63120,4,2,5,11,"chr1",1,0.0489920300046882
"2306","chr1.210795000.210800000","chr1.211050000.211055000",255000,11,0.00691274,210795000,211050000,210800000,211055000,"chr1",63156,1,3,2,6,"chr1",1,0.00773558368495077
"2307","chr1.204245000.204250000","chr1.204360000.204365000",115000,18,0.0002518963,204245000,204360000,204250000,204365000,"chr1",63171,2,3,9,14,"chr1",1,0.029535864978903
"2308","chr1.43945000.43950000","chr1.44355000.44360000",410000,14,2.461171e-06,43945000,44355000,43950000,44360000,"chr1",63190,0,2,2,4,"chr1",1,0.00656352555086732
"2309","chr1.54885000.54890000","chr1.54935000.54940000",50000,23,0.003767084,54885000,54935000,54890000,54940000,"chr1",63197,2,1,1,4,"chr1",1,0.0107829348335677
"2310","chr1.17440000.17445000","chr1.17560000.17565000",120000,18,0.0001811171,17440000,17560000,17445000,17565000,"chr1",63198,3,6,1,10,"chr1",1,0.0210970464135021
"2311","chr1.212495000.212500000","chr1.212515000.212520000",20000,36,0.008632247,212495000,212515000,212500000,212520000,"chr1",63207,7,4,11,22,"chr1",1,0.0928270042194093
"2312","chr1.151295000.151300000","chr1.151575000.151580000",280000,14,5.156444e-05,151295000,151575000,151300000,151580000,"chr1",63226,2,12,17,31,"chr1",1,0.0508673230192218
"2313","chr1.234740000.234745000","chr1.234860000.234865000",120000,23,1.605831e-07,234740000,234860000,234745000,234865000,"chr1",63278,1,7,10,18,"chr1",1,0.0485232067510548
"2314","chr1.228830000.228835000","chr1.229555000.229560000",725000,9,0.000357604,228830000,229555000,228835000,229560000,"chr1",63300,3,2,5,10,"chr1",1,0.0105485232067511
"2315","chr1.6780000.6785000","chr1.7720000.7725000",940000,7,0.002913391,6780000,7720000,6785000,7725000,"chr1",63314,2,10,11,23,"chr1",1,0.0188701359587436
"2316","chr1.204900000.204905000","chr1.205175000.205180000",275000,12,0.001179873,204900000,205175000,204905000,205180000,"chr1",63331,6,8,12,26,"chr1",1,0.0365682137834037
"2317","chr1.204515000.204520000","chr1.204720000.204725000",205000,14,0.0006128938,204515000,204720000,204520000,204725000,"chr1",63380,5,6,10,21,"chr1",1,0.0344585091420534
"2318","chr1.235415000.235420000","chr1.235585000.235590000",170000,13,0.00702836,235415000,235585000,235420000,235590000,"chr1",63412,3,4,11,18,"chr1",1,0.0274261603375527
"2319","chr1.228830000.228835000","chr1.228860000.228865000",30000,36,5.590942e-05,228830000,228860000,228835000,228865000,"chr1",63451,2,2,5,9,"chr1",1,0.0379746835443038
"2320","chr1.33390000.33395000","chr1.33535000.33540000",145000,17,0.0001595167,33390000,33535000,33395000,33540000,"chr1",63499,0,1,0,1,"chr1",1,0.00199249882794187
"2321","chr1.169140000.169145000","chr1.169160000.169165000",20000,43,6.896909e-05,169140000,169160000,169145000,169165000,"chr1",63500,2,4,4,10,"chr1",1,0.0503984997655884
"2322","chr1.95130000.95135000","chr1.95245000.95250000",115000,15,0.007192145,95130000,95245000,95135000,95250000,"chr1",63514,0,2,1,3,"chr1",1,0.00527426160337553
"2323","chr1.10160000.10165000","chr1.10375000.10380000",215000,12,0.005556037,10160000,10375000,10165000,10380000,"chr1",63515,0,6,5,11,"chr1",1,0.0154711673699015
"2324","chr1.21340000.21345000","chr1.21360000.21365000",20000,39,0.00129403,21340000,21360000,21345000,21365000,"chr1",63518,1,7,6,14,"chr1",1,0.0639943741209564
"2325","chr1.116370000.116375000","chr1.116510000.116515000",140000,18,5.556461e-05,116370000,116510000,116375000,116515000,"chr1",63608,0,2,1,3,"chr1",1,0.00632911392405063
"2326","chr1.32960000.32965000","chr1.33070000.33075000",110000,15,0.009294725,32960000,33070000,32965000,33075000,"chr1",63615,3,7,9,19,"chr1",1,0.0334036568213783
"2327","chr1.203275000.203280000","chr1.203305000.203310000",30000,46,1.804555e-09,203275000,203305000,203280000,203310000,"chr1",63623,0,3,2,5,"chr1",1,0.0269573370839194
"2328","chr1.225650000.225655000","chr1.226185000.226190000",535000,10,0.0004424707,225650000,226185000,225655000,226190000,"chr1",63649,0,1,2,3,"chr1",1,0.00351617440225035
"2329","chr1.16075000.16080000","chr1.16960000.16965000",885000,7,0.004178511,16075000,16960000,16080000,16965000,"chr1",63691,1,11,9,21,"chr1",1,0.0172292545710267
"2330","chr1.202340000.202345000","chr1.202410000.202415000",70000,19,0.00555421,202340000,202410000,202345000,202415000,"chr1",63799,3,10,4,17,"chr1",1,0.0378574777308955
"2331","chr1.181020000.181025000","chr1.181115000.181120000",95000,23,2.544721e-06,181020000,181115000,181025000,181120000,"chr1",63801,4,9,6,19,"chr1",1,0.0512189404594468
"2332","chr1.155090000.155095000","chr1.155135000.155140000",45000,27,0.0003258119,155090000,155135000,155095000,155140000,"chr1",63815,1,4,9,14,"chr1",1,0.0443037974683544
"2333","chr1.9840000.9845000","chr1.9925000.9930000",85000,21,0.0001156532,9840000,9925000,9845000,9930000,"chr1",63882,1,9,4,14,"chr1",1,0.0344585091420534
"2334","chr1.205300000.205305000","chr1.205325000.205330000",25000,42,1.476136e-05,205300000,205325000,205305000,205330000,"chr1",63900,1,3,6,10,"chr1",1,0.0492264416315049
"2335","chr1.228790000.228795000","chr1.229595000.229600000",805000,7,0.006846469,228790000,229595000,228795000,229600000,"chr1",63906,0,2,1,3,"chr1",1,0.00246132208157525
"2336","chr1.182140000.182145000","chr1.182170000.182175000",30000,30,0.006218027,182140000,182170000,182145000,182175000,"chr1",63931,2,4,7,13,"chr1",1,0.0457102672292546
"2337","chr1.26825000.26830000","chr1.27010000.27015000",185000,14,0.001282156,26825000,27010000,26830000,27015000,"chr1",63941,0,3,1,4,"chr1",1,0.00656352555086732
"2338","chr1.54670000.54675000","chr1.54885000.54890000",215000,13,0.001605476,54670000,54885000,54675000,54890000,"chr1",63967,2,1,1,4,"chr1",1,0.00609470229723394
"2339","chr1.203670000.203675000","chr1.204505000.204510000",835000,7,0.005667308,203670000,204505000,203675000,204510000,"chr1",63970,4,13,8,25,"chr1",1,0.0205110173464604
"2340","chr1.32480000.32485000","chr1.32535000.32540000",55000,37,6.378105e-11,32480000,32535000,32485000,32540000,"chr1",63972,5,11,10,26,"chr1",1,0.112751992498828
"2341","chr1.171955000.171960000","chr1.172370000.172375000",415000,15,3.173502e-07,171955000,172370000,171960000,172375000,"chr1",64017,0,0,2,2,"chr1",1,0.00351617440225035
"2342","chr1.27775000.27780000","chr1.27810000.27815000",35000,32,0.0001186414,27775000,27810000,27780000,27815000,"chr1",64032,5,26,18,49,"chr1",1,0.183778715424285
"2343","chr1.225675000.225680000","chr1.226120000.226125000",445000,10,0.00139887,225675000,226120000,225680000,226125000,"chr1",64036,0,9,3,12,"chr1",1,0.0140646976090014
"2344","chr1.168600000.168605000","chr1.168760000.168765000",160000,15,0.001000244,168600000,168760000,168605000,168765000,"chr1",64045,0,2,0,2,"chr1",1,0.00351617440225035
"2345","chr1.28435000.28440000","chr1.28505000.28510000",70000,26,2.649753e-06,28435000,28505000,28440000,28510000,"chr1",64049,4,15,7,26,"chr1",1,0.0792311298640413
"2346","chr1.64135000.64140000","chr1.64660000.64665000",525000,9,0.002554003,64135000,64660000,64140000,64665000,"chr1",64067,0,2,3,5,"chr1",1,0.00527426160337553
"2347","chr1.205590000.205595000","chr1.205655000.205660000",65000,22,0.0006470043,205590000,205655000,205595000,205660000,"chr1",64097,1,5,9,15,"chr1",1,0.0386779184247539
"2348","chr1.155900000.155905000","chr1.156160000.156165000",260000,13,0.0004157809,155900000,156160000,155905000,156165000,"chr1",64143,5,6,4,15,"chr1",1,0.0228551336146273
"2349","chr1.110335000.110340000","chr1.110460000.110465000",125000,21,2.157778e-06,110335000,110460000,110340000,110465000,"chr1",64176,1,4,5,10,"chr1",1,0.0246132208157525
"2350","chr1.19715000.19720000","chr1.19915000.19920000",200000,15,0.0001884219,19715000,19915000,19720000,19920000,"chr1",64180,4,5,12,21,"chr1",1,0.0369198312236287
"2351","chr1.8315000.8320000","chr1.8345000.8350000",30000,30,0.006218027,8315000,8345000,8320000,8350000,"chr1",64234,0,2,1,3,"chr1",1,0.0105485232067511
"2352","chr1.54300000.54305000","chr1.54500000.54505000",200000,12,0.008520915,54300000,54500000,54305000,54505000,"chr1",64282,0,2,1,3,"chr1",1,0.00421940928270042
"2353","chr1.19740000.19745000","chr1.19765000.19770000",25000,44,2.434493e-06,19740000,19765000,19745000,19770000,"chr1",64328,0,2,2,4,"chr1",1,0.0206282231598687
"2354","chr1.39690000.39695000","chr1.39850000.39855000",160000,14,0.003280797,39690000,39850000,39695000,39855000,"chr1",64361,1,3,3,7,"chr1",1,0.0114861697140178
"2355","chr1.227450000.227455000","chr1.227480000.227485000",30000,34,0.0003080251,227450000,227480000,227455000,227485000,"chr1",64387,0,3,3,6,"chr1",1,0.0239099859353024
"2356","chr1.9950000.9955000","chr1.10295000.10300000",345000,11,0.001293222,9950000,10295000,9955000,10300000,"chr1",64467,1,3,5,9,"chr1",1,0.0116033755274262
"2357","chr1.24015000.24020000","chr1.24070000.24075000",55000,23,0.001500618,24015000,24070000,24020000,24075000,"chr1",64485,2,7,5,14,"chr1",1,0.0377402719174871
"2358","chr1.150320000.150325000","chr1.150515000.150520000",195000,12,0.009750873,150320000,150515000,150325000,150520000,"chr1",64491,0,11,9,20,"chr1",1,0.0281293952180028
"2359","chr1.16960000.16965000","chr1.17050000.17055000",90000,65,7.304872e-43,16960000,17050000,16965000,17055000,"chr1",64512,2,14,16,32,"chr1",1,0.243788091889358
"2360","chr1.182300000.182305000","chr1.182345000.182350000",45000,32,1.822732e-06,182300000,182345000,182305000,182350000,"chr1",64586,1,4,2,7,"chr1",1,0.0262541022034693
"2361","chr1.39390000.39395000","chr1.39450000.39455000",60000,25,7.2355e-05,39390000,39450000,39395000,39455000,"chr1",64680,2,3,7,12,"chr1",1,0.0351617440225035
"2362","chr1.33430000.33435000","chr1.33455000.33460000",25000,34,0.006227396,33430000,33455000,33435000,33460000,"chr1",64689,1,4,6,11,"chr1",1,0.0438349742147211
"2363","chr1.155305000.155310000","chr1.155470000.155475000",165000,20,6.329146e-07,155305000,155470000,155310000,155475000,"chr1",64750,1,9,4,14,"chr1",1,0.0328176277543366
"2364","chr1.205320000.205325000","chr1.205490000.205495000",170000,13,0.00702836,205320000,205490000,205325000,205495000,"chr1",64751,0,10,15,25,"chr1",1,0.0380918893577121
"2365","chr1.153670000.153675000","chr1.153975000.153980000",305000,11,0.002527826,153670000,153975000,153675000,153980000,"chr1",64770,6,28,22,56,"chr1",1,0.0721987810595406
"2366","chr1.182050000.182055000","chr1.182315000.182320000",265000,11,0.005556037,182050000,182315000,182055000,182320000,"chr1",64804,5,9,9,23,"chr1",1,0.0296530707923113
"2367","chr1.156080000.156085000","chr1.156225000.156230000",145000,14,0.005764312,156080000,156225000,156085000,156230000,"chr1",64880,0,4,0,4,"chr1",1,0.00656352555086732
"2368","chr1.112335000.112340000","chr1.112875000.112880000",540000,8,0.009838485,112335000,112875000,112340000,112880000,"chr1",64884,1,6,4,11,"chr1",1,0.0103141115799344
"2369","chr1.1500000.1505000","chr1.1615000.1620000",115000,15,0.007192145,1500000,1615000,1505000,1620000,"chr1",64914,0,0,2,2,"chr1",1,0.00351617440225035
"2370","chr1.9165000.9170000","chr1.9540000.9545000",375000,10,0.003509469,9165000,9540000,9170000,9545000,"chr1",64928,5,16,17,38,"chr1",1,0.0445382090951711
"2371","chr1.36625000.36630000","chr1.36760000.36765000",135000,15,0.00290255,36625000,36760000,36630000,36765000,"chr1",64933,0,4,3,7,"chr1",1,0.0123066104078762
"2372","chr1.171740000.171745000","chr1.172395000.172400000",655000,9,0.0006752415,171740000,172395000,171745000,172400000,"chr1",64934,0,2,1,3,"chr1",1,0.00316455696202532
"2373","chr1.11330000.11335000","chr1.11800000.11805000",470000,9,0.004654588,11330000,11800000,11335000,11805000,"chr1",64946,2,5,3,10,"chr1",1,0.0105485232067511
"2374","chr1.205590000.205595000","chr1.205710000.205715000",120000,16,0.001909676,205590000,205710000,205595000,205715000,"chr1",65006,1,5,9,15,"chr1",1,0.0281293952180028
"2375","chr1.39795000.39800000","chr1.39880000.39885000",85000,17,0.007758048,39795000,39880000,39800000,39885000,"chr1",65043,4,14,14,32,"chr1",1,0.0637599624941397
"2376","chr1.9275000.9280000","chr1.9625000.9630000",350000,14,8.946938e-06,9275000,9625000,9280000,9630000,"chr1",65055,1,16,13,30,"chr1",1,0.0492264416315049
"2377","chr1.116920000.116925000","chr1.117020000.117025000",100000,20,7.35421e-05,116920000,117020000,116925000,117025000,"chr1",65059,0,7,6,13,"chr1",1,0.0304735114861697
"2378","chr1.8455000.8460000","chr1.8710000.8715000",255000,11,0.00691274,8455000,8710000,8460000,8715000,"chr1",65068,1,3,6,10,"chr1",1,0.012892639474918
"2379","chr1.243880000.243885000","chr1.243900000.243905000",20000,81,1.891413e-24,243880000,243900000,243885000,243905000,"chr1",65081,0,1,2,3,"chr1",1,0.0284810126582278
"2380","chr1.193190000.193195000","chr1.194045000.194050000",855000,7,0.004999422,193190000,194045000,193195000,194050000,"chr1",65088,0,6,5,11,"chr1",1,0.00902484763244257
"2381","chr1.228790000.228795000","chr1.229480000.229485000",690000,9,0.0004952264,228790000,229480000,228795000,229485000,"chr1",65140,0,2,1,3,"chr1",1,0.00316455696202532
"2382","chr1.230205000.230210000","chr1.230240000.230245000",35000,27,0.00691274,230205000,230240000,230210000,230245000,"chr1",65142,3,4,4,11,"chr1",1,0.0348101265822785
"2383","chr1.10030000.10035000","chr1.10395000.10400000",365000,12,0.0001996786,10030000,10395000,10035000,10400000,"chr1",65147,0,6,12,18,"chr1",1,0.0253164556962025
"2384","chr1.243930000.243935000","chr1.244110000.244115000",180000,14,0.001527903,243930000,244110000,243935000,244115000,"chr1",65150,0,10,7,17,"chr1",1,0.0278949835911861
"2385","chr1.32290000.32295000","chr1.32390000.32395000",100000,16,0.006415049,32290000,32390000,32295000,32395000,"chr1",65178,2,6,3,11,"chr1",1,0.0206282231598687
"2386","chr1.223715000.223720000","chr1.223800000.223805000",85000,30,4.040152e-10,223715000,223800000,223720000,223805000,"chr1",65210,1,6,7,14,"chr1",1,0.0492264416315049
"2387","chr1.54315000.54320000","chr1.54495000.54500000",180000,16,0.000110791,54315000,54495000,54320000,54500000,"chr1",65216,1,3,1,5,"chr1",1,0.00937646507266761
"2388","chr1.174745000.174750000","chr1.174975000.174980000",230000,15,5.74267e-05,174745000,174975000,174750000,174980000,"chr1",65265,2,6,5,13,"chr1",1,0.0228551336146273
"2389","chr1.229405000.229410000","chr1.229480000.229485000",75000,23,4.328812e-05,229405000,229480000,229410000,229485000,"chr1",65334,2,6,2,10,"chr1",1,0.0269573370839194
"2390","chr1.15045000.15050000","chr1.15100000.15105000",55000,21,0.00838272,15045000,15100000,15050000,15105000,"chr1",65411,0,3,2,5,"chr1",1,0.0123066104078762
"2391","chr1.155830000.155835000","chr1.155955000.155960000",125000,23,1.017851e-07,155830000,155955000,155835000,155960000,"chr1",65423,6,34,27,67,"chr1",1,0.18061415846226
"2392","chr1.61720000.61725000","chr1.62100000.62105000",380000,11,0.0007423417,61720000,62100000,61725000,62105000,"chr1",65459,4,14,7,25,"chr1",1,0.0322315986872949
"2393","chr1.8630000.8635000","chr1.8710000.8715000",80000,23,2.046838e-05,8630000,8710000,8635000,8715000,"chr1",65467,1,15,11,27,"chr1",1,0.0727848101265823
"2394","chr1.161175000.161180000","chr1.161365000.161370000",190000,18,3.385262e-06,161175000,161365000,161180000,161370000,"chr1",65515,2,5,2,9,"chr1",1,0.0189873417721519
"2395","chr1.8460000.8465000","chr1.8510000.8515000",50000,28,3.2625e-05,8460000,8510000,8465000,8515000,"chr1",65518,2,11,13,26,"chr1",1,0.0853258321612752
"2396","chr1.16960000.16965000","chr1.17085000.17090000",125000,15,0.004449684,16960000,17085000,16965000,17090000,"chr1",65537,0,6,2,8,"chr1",1,0.0140646976090014
"2397","chr1.201980000.201985000","chr1.202085000.202090000",105000,35,9.49644e-16,201980000,202085000,201985000,202090000,"chr1",65556,3,13,12,28,"chr1",1,0.114861697140178
"2398","chr1.201480000.201485000","chr1.201530000.201535000",50000,24,0.001605476,201480000,201530000,201485000,201535000,"chr1",65700,1,2,0,3,"chr1",1,0.00843881856540084
"2399","chr1.31190000.31195000","chr1.31380000.31385000",190000,19,6.796629e-07,31190000,31380000,31195000,31385000,"chr1",65718,1,4,3,8,"chr1",1,0.0178152836380684
"2400","chr1.39575000.39580000","chr1.39745000.39750000",170000,21,8.720146e-08,39575000,39745000,39580000,39750000,"chr1",65727,2,20,18,40,"chr1",1,0.0984528832630098
"2401","chr1.243880000.243885000","chr1.244460000.244465000",580000,8,0.006962679,243880000,244460000,243885000,244465000,"chr1",65782,3,9,16,28,"chr1",1,0.0262541022034693
"2402","chr1.151250000.151255000","chr1.151370000.151375000",120000,26,1.254736e-09,151250000,151370000,151255000,151375000,"chr1",65804,1,9,5,15,"chr1",1,0.0457102672292546
"2403","chr1.210750000.210755000","chr1.211135000.211140000",385000,10,0.003098721,210750000,211135000,210755000,211140000,"chr1",65852,0,2,3,5,"chr1",1,0.00586029067041725
"2404","chr1.160260000.160265000","chr1.160285000.160290000",25000,39,0.0001793477,160260000,160285000,160265000,160290000,"chr1",65857,0,2,2,4,"chr1",1,0.0182841068917018
"2405","chr1.35705000.35710000","chr1.35770000.35775000",65000,22,0.0006470043,35705000,35770000,35710000,35775000,"chr1",65873,1,9,8,18,"chr1",1,0.0464135021097046
"2406","chr1.155900000.155905000","chr1.155960000.155965000",60000,54,7.600538e-25,155900000,155960000,155905000,155965000,"chr1",65893,6,10,23,39,"chr1",1,0.246835443037975
"2407","chr1.8455000.8460000","chr1.8885000.8890000",430000,10,0.001690346,8455000,8885000,8460000,8890000,"chr1",65903,2,3,6,11,"chr1",1,0.012892639474918
"2408","chr1.43235000.43240000","chr1.43315000.43320000",80000,18,0.004760983,43235000,43315000,43240000,43320000,"chr1",65914,0,0,3,3,"chr1",1,0.00632911392405063
"2409","chr1.165640000.165645000","chr1.165870000.165875000",230000,13,0.001007514,165640000,165870000,165645000,165875000,"chr1",65925,1,6,4,11,"chr1",1,0.0167604313173933
"2410","chr1.41090000.41095000","chr1.41400000.41405000",310000,10,0.008632247,41090000,41400000,41095000,41405000,"chr1",65990,1,4,5,10,"chr1",1,0.0117205813408345
"2411","chr1.151495000.151500000","chr1.151575000.151580000",80000,19,0.00180801,151495000,151575000,151500000,151580000,"chr1",66053,1,9,17,27,"chr1",1,0.060126582278481
"2412","chr1.182080000.182085000","chr1.182345000.182350000",265000,12,0.001500618,182080000,182345000,182085000,182350000,"chr1",66058,0,3,5,8,"chr1",1,0.0112517580872011
"2413","chr1.184160000.184165000","chr1.184575000.184580000",415000,9,0.008599339,184160000,184575000,184165000,184580000,"chr1",66094,2,3,3,8,"chr1",1,0.00843881856540084
"2414","chr1.161205000.161210000","chr1.161355000.161360000",150000,20,1.674205e-06,161205000,161355000,161210000,161360000,"chr1",66097,4,28,18,50,"chr1",1,0.117205813408345
"2415","chr1.182140000.182145000","chr1.182160000.182165000",20000,49,3.736063e-07,182140000,182160000,182145000,182165000,"chr1",66184,0,4,2,6,"chr1",1,0.0344585091420534
"2416","chr1.203510000.203515000","chr1.203650000.203655000",140000,14,0.006950379,203510000,203650000,203515000,203655000,"chr1",66210,0,2,0,2,"chr1",1,0.00328176277543366
"2417","chr1.9950000.9955000","chr1.10475000.10480000",525000,11,8.686228e-05,9950000,10475000,9955000,10480000,"chr1",66225,7,11,29,47,"chr1",1,0.0605954055321144
"2418","chr1.156125000.156130000","chr1.156240000.156245000",115000,18,0.0002518963,156125000,156240000,156130000,156245000,"chr1",66438,1,10,4,15,"chr1",1,0.0316455696202532
"2419","chr1.161155000.161160000","chr1.161365000.161370000",210000,16,2.874768e-05,161155000,161365000,161160000,161370000,"chr1",66439,0,2,2,4,"chr1",1,0.00750117205813408
"2420","chr1.185320000.185325000","chr1.185475000.185480000",155000,14,0.00393986,185320000,185475000,185325000,185480000,"chr1",66442,2,1,1,4,"chr1",1,0.00656352555086732
"2421","chr1.10030000.10035000","chr1.10430000.10435000",400000,10,0.002527826,10030000,10430000,10035000,10435000,"chr1",66449,0,6,10,16,"chr1",1,0.0187529301453352
"2422","chr1.165465000.165470000","chr1.165540000.165545000",75000,20,0.001171509,165465000,165540000,165470000,165545000,"chr1",66454,0,2,2,4,"chr1",1,0.00937646507266761
"2423","chr1.164910000.164915000","chr1.164995000.165000000",85000,17,0.007758048,164910000,164995000,164915000,1.65e+08,"chr1",66466,1,1,2,4,"chr1",1,0.00796999531176746
"2424","chr1.26220000.26225000","chr1.26320000.26325000",100000,70,1.419778e-50,26220000,26320000,26225000,26325000,"chr1",66495,4,2,5,11,"chr1",1,0.0902484763244257
"2425","chr1.111765000.111770000","chr1.111945000.111950000",180000,25,2.946941e-11,111765000,111945000,111770000,111950000,"chr1",66523,0,1,2,3,"chr1",1,0.00879043600562588
"2426","chr1.39650000.39655000","chr1.39890000.39895000",240000,11,0.009597206,39650000,39890000,39655000,39895000,"chr1",66529,0,3,4,7,"chr1",1,0.00902484763244257
"2427","chr1.77780000.77785000","chr1.77975000.77980000",195000,12,0.009750873,77780000,77975000,77785000,77980000,"chr1",66546,0,3,5,8,"chr1",1,0.0112517580872011
"2428","chr1.28580000.28585000","chr1.28830000.28835000",250000,17,9.720102e-07,28580000,28830000,28585000,28835000,"chr1",66548,8,17,19,44,"chr1",1,0.0876699484294421
"2429","chr1.153510000.153515000","chr1.153535000.153540000",25000,49,1.727148e-08,153510000,153535000,153515000,153540000,"chr1",66594,2,4,5,11,"chr1",1,0.063173933427098
"2430","chr1.11720000.11725000","chr1.11790000.11795000",70000,23,9.590695e-05,11720000,11790000,11725000,11795000,"chr1",66639,1,3,2,6,"chr1",1,0.0161744022503516
"2431","chr1.26995000.27000000","chr1.27030000.27035000",35000,27,0.00691274,26995000,27030000,2.7e+07,27035000,"chr1",66654,3,13,12,28,"chr1",1,0.0886075949367089
"2432","chr1.40280000.40285000","chr1.40435000.40440000",155000,46,2.437166e-30,40280000,40435000,40285000,40440000,"chr1",66666,1,12,3,16,"chr1",1,0.086263478668542
"2433","chr1.203650000.203655000","chr1.203670000.203675000",20000,41,0.0003129283,203650000,203670000,203655000,203675000,"chr1",66702,4,13,8,25,"chr1",1,0.120135958743554
"2434","chr1.203305000.203310000","chr1.203595000.203600000",290000,13,0.0001899761,203305000,203595000,203310000,203600000,"chr1",66707,0,3,2,5,"chr1",1,0.00761837787154243
"2435","chr1.201545000.201550000","chr1.201655000.201660000",110000,15,0.009294725,201545000,201655000,201550000,201660000,"chr1",66715,3,4,5,12,"chr1",1,0.0210970464135021
"2436","chr1.161190000.161195000","chr1.161280000.161285000",90000,28,3.557209e-09,161190000,161280000,161195000,161285000,"chr1",66738,6,14,12,32,"chr1",1,0.105016408813877
"2437","chr1.26990000.26995000","chr1.27100000.27105000",110000,17,0.00115434,26990000,27100000,26995000,27105000,"chr1",66773,1,2,2,5,"chr1",1,0.00996249413970933
"2438","chr1.39575000.39580000","chr1.39730000.39735000",155000,18,2.385478e-05,39575000,39730000,39580000,39735000,"chr1",66817,5,12,14,31,"chr1",1,0.0654008438818565
"2439","chr1.204185000.204190000","chr1.204360000.204365000",175000,13,0.005981441,204185000,204360000,204190000,204365000,"chr1",66818,2,3,9,14,"chr1",1,0.0213314580403188
"2440","chr1.9860000.9865000","chr1.10615000.10620000",755000,8,0.00171529,9860000,10615000,9865000,10620000,"chr1",66841,3,7,10,20,"chr1",1,0.0187529301453352
"2441","chr1.212485000.212490000","chr1.212540000.212545000",55000,24,0.0005843961,212485000,212540000,212490000,212545000,"chr1",66898,2,5,2,9,"chr1",1,0.0253164556962025
"2442","chr1.202860000.202865000","chr1.202965000.202970000",105000,21,1.247901e-05,202860000,202965000,202865000,202970000,"chr1",66913,2,11,10,23,"chr1",1,0.0566104078762307
"2443","chr1.212285000.212290000","chr1.212415000.212420000",130000,16,0.001164783,212285000,212415000,212290000,212420000,"chr1",66925,0,2,1,3,"chr1",1,0.00562587904360056
"2444","chr1.25950000.25955000","chr1.26125000.26130000",175000,14,0.001856842,25950000,26125000,25955000,26130000,"chr1",66929,2,4,6,12,"chr1",1,0.019690576652602
"2445","chr1.116710000.116715000","chr1.116910000.116915000",200000,19,3.776511e-07,116710000,116910000,116715000,116915000,"chr1",66954,0,1,1,2,"chr1",1,0.00445382090951711
"2446","chr1.6865000.6870000","chr1.6945000.6950000",80000,18,0.004760983,6865000,6945000,6870000,6950000,"chr1",66966,7,10,9,26,"chr1",1,0.0548523206751055
"2447","chr1.52000000.52005000","chr1.52030000.52035000",30000,42,1.563791e-07,5.2e+07,52030000,52005000,52035000,"chr1",66978,7,16,19,42,"chr1",1,0.206751054852321
"2448","chr1.153605000.153610000","chr1.153630000.153635000",25000,55,2.199034e-11,153605000,153630000,153610000,153635000,"chr1",67038,0,7,5,12,"chr1",1,0.0773558368495077
"2449","chr1.9860000.9865000","chr1.10105000.10110000",245000,15,3.29545e-05,9860000,10105000,9865000,10110000,"chr1",67058,0,7,5,12,"chr1",1,0.0210970464135021
"2450","chr1.20695000.20700000","chr1.20815000.20820000",120000,23,1.605831e-07,20695000,20815000,20700000,20820000,"chr1",67071,3,9,4,16,"chr1",1,0.043131739334271
"2451","chr1.212515000.212520000","chr1.212540000.212545000",25000,44,2.434493e-06,212515000,212540000,212520000,212545000,"chr1",67073,2,5,2,9,"chr1",1,0.0464135021097046
"2452","chr1.183620000.183625000","chr1.183650000.183655000",30000,42,1.563791e-07,183620000,183650000,183625000,183655000,"chr1",67076,0,3,1,4,"chr1",1,0.019690576652602
"2453","chr1.184035000.184040000","chr1.184670000.184675000",635000,12,2.508337e-06,184035000,184670000,184040000,184675000,"chr1",67083,0,1,0,1,"chr1",1,0.00140646976090014
"2454","chr1.161150000.161155000","chr1.161190000.161195000",40000,35,4.73934e-07,161150000,161190000,161155000,161195000,"chr1",67122,6,16,13,35,"chr1",1,0.143577121425223
"2455","chr1.162145000.162150000","chr1.162215000.162220000",70000,20,0.002190239,162145000,162215000,162150000,162220000,"chr1",67166,0,1,2,3,"chr1",1,0.0070323488045007
"2456","chr1.156115000.156120000","chr1.156190000.156195000",75000,31,7.83432e-10,156115000,156190000,156120000,156195000,"chr1",67168,3,11,12,26,"chr1",1,0.0944678856071261
"2457","chr1.66445000.66450000","chr1.66690000.66695000",245000,19,3.349354e-08,66445000,66690000,66450000,66695000,"chr1",67226,3,4,0,7,"chr1",1,0.0155883731833099
"2458","chr1.155895000.155900000","chr1.155985000.155990000",90000,19,0.0006470043,155895000,155985000,155900000,155990000,"chr1",67232,1,13,14,28,"chr1",1,0.0623534927332396
"2459","chr1.84600000.84605000","chr1.84940000.84945000",340000,10,0.005618157,84600000,84940000,84605000,84945000,"chr1",67273,1,3,3,7,"chr1",1,0.00820440693858415
"2460","chr1.33005000.33010000","chr1.33080000.33085000",75000,20,0.001171509,33005000,33080000,33010000,33085000,"chr1",67311,0,2,1,3,"chr1",1,0.0070323488045007
"2461","chr1.10140000.10145000","chr1.10160000.10165000",20000,57,1.009568e-10,10140000,10160000,10145000,10165000,"chr1",67326,1,14,11,26,"chr1",1,0.173699015471167
"2462","chr1.27010000.27015000","chr1.27115000.27120000",105000,21,1.247901e-05,27010000,27115000,27015000,27120000,"chr1",67345,1,3,5,9,"chr1",1,0.0221518987341772
"2463","chr1.201700000.201705000","chr1.201730000.201735000",30000,52,1.07875e-12,201700000,201730000,201705000,201735000,"chr1",67348,4,7,13,24,"chr1",1,0.146272855133615
"2464","chr1.182050000.182055000","chr1.182300000.182305000",250000,14,0.0001287456,182050000,182300000,182055000,182305000,"chr1",67353,1,4,2,7,"chr1",1,0.0114861697140178
"2465","chr1.153545000.153550000","chr1.153645000.153650000",100000,21,2.069424e-05,153545000,153645000,153550000,153650000,"chr1",67395,2,6,5,13,"chr1",1,0.0319971870604782
"2466","chr1.150320000.150325000","chr1.150925000.150930000",605000,9,0.001119103,150320000,150925000,150325000,150930000,"chr1",67448,0,7,9,16,"chr1",1,0.0168776371308017
"2467","chr1.203475000.203480000","chr1.203640000.203645000",165000,20,6.329146e-07,203475000,203640000,203480000,203645000,"chr1",67469,1,1,0,2,"chr1",1,0.0046882325363338
"2468","chr1.202460000.202465000","chr1.202500000.202505000",40000,27,0.001354847,202460000,202500000,202465000,202505000,"chr1",67499,0,2,0,2,"chr1",1,0.00632911392405063
"2469","chr1.40390000.40395000","chr1.40435000.40440000",45000,33,5.735131e-07,40390000,40435000,40395000,40440000,"chr1",67515,1,6,3,10,"chr1",1,0.0386779184247539
"2470","chr1.154745000.154750000","chr1.154785000.154790000",40000,28,0.0005784227,154745000,154785000,154750000,154790000,"chr1",67592,0,0,2,2,"chr1",1,0.00656352555086732
"2471","chr1.181465000.181470000","chr1.182050000.182055000",585000,9,0.001366185,181465000,182050000,181470000,182055000,"chr1",67598,2,3,0,5,"chr1",1,0.00527426160337553
"2472","chr1.153545000.153550000","chr1.153960000.153965000",415000,15,3.173502e-07,153545000,153960000,153550000,153965000,"chr1",67628,1,6,5,12,"chr1",1,0.0210970464135021
"2473","chr1.230770000.230775000","chr1.231335000.231340000",565000,11,4.955416e-05,230770000,231335000,230775000,231340000,"chr1",67629,2,2,2,6,"chr1",1,0.00773558368495077
"2474","chr1.113615000.113620000","chr1.114230000.114235000",615000,8,0.005163365,113615000,114230000,113620000,114235000,"chr1",67671,1,2,2,5,"chr1",1,0.0046882325363338
"2475","chr1.182160000.182165000","chr1.182235000.182240000",75000,21,0.0004093387,182160000,182235000,182165000,182240000,"chr1",67698,0,4,2,6,"chr1",1,0.0147679324894515
"2476","chr1.174875000.174880000","chr1.174955000.174960000",80000,18,0.004760983,174875000,174955000,174880000,174960000,"chr1",67782,2,10,7,19,"chr1",1,0.040084388185654
"2477","chr1.156355000.156360000","chr1.156410000.156415000",55000,55,3.05275e-24,156355000,156410000,156360000,156415000,"chr1",67814,0,3,7,10,"chr1",1,0.0644631973745898
"2478","chr1.93325000.93330000","chr1.93445000.93450000",120000,22,7.343546e-07,93325000,93445000,93330000,93450000,"chr1",67828,3,4,1,8,"chr1",1,0.0206282231598687
"2479","chr1.205070000.205075000","chr1.205175000.205180000",105000,19,0.0001598251,205070000,205175000,205075000,205180000,"chr1",67884,0,2,0,2,"chr1",1,0.00445382090951711
"2480","chr1.228795000.228800000","chr1.229595000.229600000",800000,8,0.00124165,228795000,229595000,228800000,229600000,"chr1",67964,2,6,5,13,"chr1",1,0.0121894045944679
"2481","chr1.8510000.8515000","chr1.8625000.8630000",115000,16,0.002529278,8510000,8625000,8515000,8630000,"chr1",67998,2,10,13,25,"chr1",1,0.046882325363338
"2482","chr1.150060000.150065000","chr1.150180000.150185000",120000,17,0.0006133453,150060000,150180000,150065000,150185000,"chr1",68014,5,13,14,32,"chr1",1,0.0637599624941397
"2483","chr1.156485000.156490000","chr1.156675000.156680000",190000,13,0.003611391,156485000,156675000,156490000,156680000,"chr1",68032,0,2,3,5,"chr1",1,0.00761837787154243
"2484","chr1.193105000.193110000","chr1.193120000.193125000",15000,39,0.00129403,193105000,193120000,193110000,193125000,"chr1",68068,2,7,1,10,"chr1",1,0.0457102672292546
"2485","chr1.153670000.153675000","chr1.153780000.153785000",110000,17,0.00115434,153670000,153780000,153675000,153785000,"chr1",68072,5,23,16,44,"chr1",1,0.0876699484294421
"2486","chr1.201530000.201535000","chr1.201600000.201605000",70000,22,0.0002882227,201530000,201600000,201535000,201605000,"chr1",68092,3,2,7,12,"chr1",1,0.0309423347398031
"2487","chr1.39745000.39750000","chr1.40040000.40045000",295000,11,0.00307826,39745000,40040000,39750000,40045000,"chr1",68100,2,16,8,26,"chr1",1,0.0335208626347867
"2488","chr1.212475000.212480000","chr1.212540000.212545000",65000,25,2.508188e-05,212475000,212540000,212480000,212545000,"chr1",68102,2,5,2,9,"chr1",1,0.0263713080168776
"2489","chr1.228860000.228865000","chr1.229625000.229630000",765000,10,3.432711e-05,228860000,229625000,228865000,229630000,"chr1",68106,2,1,5,8,"chr1",1,0.00937646507266761
"2490","chr1.66445000.66450000","chr1.66630000.66635000",185000,20,1.721488e-07,66445000,66630000,66450000,66635000,"chr1",68121,3,4,0,7,"chr1",1,0.0164088138771683
"2491","chr1.15975000.15980000","chr1.16005000.16010000",30000,33,0.0006782985,15975000,16005000,15980000,16010000,"chr1",68123,2,5,7,14,"chr1",1,0.0541490857946554
"2492","chr1.223085000.223090000","chr1.223120000.223125000",35000,43,7.540224e-10,223085000,223120000,223090000,223125000,"chr1",68129,4,8,7,19,"chr1",1,0.0957571495546179
"2493","chr1.156355000.156360000","chr1.156380000.156385000",25000,48,4.908096e-08,156355000,156380000,156360000,156385000,"chr1",68143,2,10,8,20,"chr1",1,0.112517580872011
"2494","chr1.178500000.178505000","chr1.178720000.178725000",220000,29,1.838573e-16,178500000,178720000,178505000,178725000,"chr1",68151,1,6,5,12,"chr1",1,0.0407876230661041
"2495","chr1.235010000.235015000","chr1.235125000.235130000",115000,15,0.007192145,235010000,235125000,235015000,235130000,"chr1",68160,1,7,8,16,"chr1",1,0.0281293952180028
"2496","chr1.150695000.150700000","chr1.150805000.150810000",110000,16,0.00338394,150695000,150805000,150700000,150810000,"chr1",68162,0,6,4,10,"chr1",1,0.0187529301453352
"2497","chr1.212510000.212515000","chr1.212545000.212550000",35000,31,0.0002882227,212510000,212545000,212515000,212550000,"chr1",68163,1,1,0,2,"chr1",1,0.00726676043131739
"2498","chr1.173430000.173435000","chr1.173670000.173675000",240000,12,0.002839254,173430000,173670000,173435000,173675000,"chr1",68166,1,1,1,3,"chr1",1,0.00421940928270042
"2499","chr1.205675000.205680000","chr1.205710000.205715000",35000,34,1.810507e-05,205675000,205710000,205680000,205715000,"chr1",68216,0,5,1,6,"chr1",1,0.0239099859353024
"2500","chr1.212255000.212260000","chr1.212495000.212500000",240000,13,0.0007368324,212255000,212495000,212260000,212500000,"chr1",68271,4,4,5,13,"chr1",1,0.0198077824660103
"2501","chr1.156120000.156125000","chr1.156245000.156250000",125000,15,0.004449684,156120000,156245000,156125000,156250000,"chr1",68308,0,0,2,2,"chr1",1,0.00351617440225035
"2502","chr1.182110000.182115000","chr1.182160000.182165000",50000,24,0.001605476,182110000,182160000,182115000,182165000,"chr1",68393,0,4,2,6,"chr1",1,0.0168776371308017
"2503","chr1.112935000.112940000","chr1.113225000.113230000",290000,12,0.0008248102,112935000,113225000,112940000,113230000,"chr1",68396,1,18,7,26,"chr1",1,0.0365682137834037
"2504","chr1.156125000.156130000","chr1.156190000.156195000",65000,34,1.364219e-10,156125000,156190000,156130000,156195000,"chr1",68408,1,11,8,20,"chr1",1,0.0796999531176746
"2505","chr1.150410000.150415000","chr1.150905000.150910000",495000,9,0.003538675,150410000,150905000,150415000,150910000,"chr1",68414,8,10,20,38,"chr1",1,0.040084388185654
"2506","chr1.201550000.201555000","chr1.201670000.201675000",120000,16,0.001909676,201550000,201670000,201555000,201675000,"chr1",68419,0,0,3,3,"chr1",1,0.00562587904360056
"2507","chr1.10030000.10035000","chr1.10140000.10145000",110000,18,0.0003587972,10030000,10140000,10035000,10145000,"chr1",68475,0,6,11,17,"chr1",1,0.0358649789029536
"2508","chr1.156445000.156450000","chr1.156580000.156585000",135000,18,7.328414e-05,156445000,156580000,156450000,156585000,"chr1",68495,0,4,2,6,"chr1",1,0.0126582278481013
"2509","chr1.202165000.202170000","chr1.202685000.202690000",520000,11,9.322159e-05,202165000,202685000,202170000,202690000,"chr1",68557,0,3,11,14,"chr1",1,0.0180496952648851
"2510","chr1.169890000.169895000","chr1.170765000.170770000",875000,8,0.0007056015,169890000,170765000,169895000,170770000,"chr1",68599,1,4,1,6,"chr1",1,0.00562587904360056
"2511","chr1.201845000.201850000","chr1.201955000.201960000",110000,15,0.009294725,201845000,201955000,201850000,201960000,"chr1",68607,1,9,7,17,"chr1",1,0.029887482419128
"2512","chr1.204805000.204810000","chr1.204935000.204940000",130000,22,3.223591e-07,204805000,204935000,204810000,204940000,"chr1",68657,1,1,2,4,"chr1",1,0.0103141115799344
"2513","chr1.243880000.243885000","chr1.244430000.244435000",550000,18,1.374068e-11,243880000,244430000,243885000,244435000,"chr1",68667,1,9,9,19,"chr1",1,0.040084388185654
"2514","chr1.182560000.182565000","chr1.182730000.182735000",170000,16,0.0001774802,182560000,182730000,182565000,182735000,"chr1",68668,0,6,3,9,"chr1",1,0.0168776371308017
"2515","chr1.205180000.205185000","chr1.205210000.205215000",30000,31,0.003104399,205180000,205210000,205185000,205215000,"chr1",68673,0,11,6,17,"chr1",1,0.0617674636661978
"2516","chr1.32235000.32240000","chr1.32535000.32540000",300000,11,0.002789144,32235000,32535000,32240000,32540000,"chr1",68715,6,11,10,27,"chr1",1,0.0348101265822785
"2517","chr1.153745000.153750000","chr1.153955000.153960000",210000,14,0.0005117364,153745000,153955000,153750000,153960000,"chr1",68723,2,5,4,11,"chr1",1,0.0180496952648851
"2518","chr1.180480000.180485000","chr1.181125000.181130000",645000,9,0.0007434584,180480000,181125000,180485000,181130000,"chr1",68849,0,2,1,3,"chr1",1,0.00316455696202532
"2519","chr1.11315000.11320000","chr1.11790000.11795000",475000,9,0.004416941,11315000,11790000,11320000,11795000,"chr1",68865,1,3,2,6,"chr1",1,0.00632911392405063
"2520","chr1.204345000.204350000","chr1.204370000.204375000",25000,56,6.651266e-12,204345000,204370000,204350000,204375000,"chr1",68880,0,2,1,3,"chr1",1,0.019690576652602
"2521","chr1.26145000.26150000","chr1.26220000.26225000",75000,18,0.007861949,26145000,26220000,26150000,26225000,"chr1",68898,8,23,14,45,"chr1",1,0.0949367088607595
"2522","chr1.203595000.203600000","chr1.203650000.203655000",55000,30,7.990362e-07,203595000,203650000,203600000,203655000,"chr1",68912,4,24,20,48,"chr1",1,0.168776371308017
"2523","chr1.54420000.54425000","chr1.54500000.54505000",80000,23,2.046838e-05,54420000,54500000,54425000,54505000,"chr1",68931,6,23,8,37,"chr1",1,0.0997421472105016
"2524","chr1.43695000.43700000","chr1.43950000.43955000",255000,12,0.001902037,43695000,43950000,43700000,43955000,"chr1",68997,0,3,1,4,"chr1",1,0.00562587904360056
"2525","chr1.151395000.151400000","chr1.151495000.151500000",100000,17,0.002324276,151395000,151495000,151400000,151500000,"chr1",69022,1,9,18,28,"chr1",1,0.0557899671823722
"2526","chr1.234290000.234295000","chr1.234545000.234550000",255000,12,0.001902037,234290000,234545000,234295000,234550000,"chr1",69034,1,2,4,7,"chr1",1,0.00984528832630099
"2527","chr1.25240000.25245000","chr1.25525000.25530000",285000,12,0.000930769,25240000,25525000,25245000,25530000,"chr1",69043,3,13,19,35,"chr1",1,0.0492264416315049
"2528","chr1.36550000.36555000","chr1.36760000.36765000",210000,12,0.00640887,36550000,36760000,36555000,36765000,"chr1",69052,0,3,2,5,"chr1",1,0.0070323488045007
"2529","chr1.9860000.9865000","chr1.9880000.9885000",20000,56,3.002802e-10,9860000,9880000,9865000,9885000,"chr1",69054,2,4,5,11,"chr1",1,0.0721987810595406
"2530","chr1.28450000.28455000","chr1.28515000.28520000",65000,26,7.652881e-06,28450000,28515000,28455000,28520000,"chr1",69064,6,39,21,66,"chr1",1,0.20112517580872
"2531","chr2.64820000.64825000","chr2.64855000.64860000",35000,26,0.009419337,64820000,64855000,64825000,64860000,"chr2",69128,7,7,9,23,"chr2",1,0.0700890764181903
"2532","chr2.25295000.25300000","chr2.25340000.25345000",45000,25,0.001208006,25295000,25340000,25300000,25345000,"chr2",69147,1,4,1,6,"chr2",1,0.0175808720112518
"2533","chr2.42100000.42105000","chr2.42315000.42320000",215000,14,0.0003090645,42100000,42315000,42105000,42320000,"chr2",69233,2,3,4,9,"chr2",1,0.0147679324894515
"2534","chr2.46695000.46700000","chr2.46915000.46920000",220000,12,0.003776479,46695000,46915000,46700000,46920000,"chr2",69370,2,2,4,8,"chr2",1,0.0112517580872011
"2535","chr2.54330000.54335000","chr2.54925000.54930000",595000,14,8.284764e-08,54330000,54925000,54335000,54930000,"chr2",69390,0,1,2,3,"chr2",1,0.00492264416315049
"2536","chr2.178110000.178115000","chr2.178190000.178195000",80000,19,0.001084925,178110000,178190000,178115000,178195000,"chr2",69395,2,0,5,7,"chr2",1,0.0155883731833099
"2537","chr2.230930000.230935000","chr2.231015000.231020000",85000,21,6.0953e-05,230930000,231015000,230935000,231020000,"chr2",69415,1,3,0,4,"chr2",1,0.00984528832630099
"2538","chr2.70070000.70075000","chr2.70505000.70510000",435000,9,0.006907378,70070000,70505000,70075000,70510000,"chr2",69430,0,3,0,3,"chr2",1,0.00316455696202532
"2539","chr2.25225000.25230000","chr2.25315000.25320000",90000,16,0.008624295,25225000,25315000,25230000,25320000,"chr2",69459,0,7,9,16,"chr2",1,0.0300046882325363
"2540","chr2.224910000.224915000","chr2.225110000.225115000",200000,13,0.001954724,224910000,225110000,224915000,225115000,"chr2",69510,1,0,3,4,"chr2",1,0.00609470229723394
"2541","chr2.101305000.101310000","chr2.101580000.101585000",275000,12,0.0009559797,101305000,101580000,101310000,101585000,"chr2",69522,0,6,3,9,"chr2",1,0.0126582278481013
"2542","chr2.47265000.47270000","chr2.47370000.47375000",105000,15,0.008351178,47265000,47370000,47270000,47375000,"chr2",69675,6,9,11,26,"chr2",1,0.0457102672292546
"2543","chr2.159885000.159890000","chr2.159920000.159925000",35000,26,0.009419337,159885000,159920000,159890000,159925000,"chr2",69696,0,2,1,3,"chr2",1,0.00914205344585091
"2544","chr2.232665000.232670000","chr2.233205000.233210000",540000,9,0.002487796,232665000,233205000,232670000,233210000,"chr2",69717,5,14,8,27,"chr2",1,0.0284810126582278
"2545","chr2.9355000.9360000","chr2.9430000.9435000",75000,21,0.0002292038,9355000,9430000,9360000,9435000,"chr2",69762,2,4,0,6,"chr2",1,0.0147679324894515
"2546","chr2.45890000.45895000","chr2.45935000.45940000",45000,29,2.462297e-05,45890000,45935000,45895000,45940000,"chr2",69809,1,6,9,16,"chr2",1,0.0543834974214721
"2547","chr2.230985000.230990000","chr2.231330000.231335000",345000,10,0.004694997,230985000,231330000,230990000,231335000,"chr2",69898,1,6,4,11,"chr2",1,0.012892639474918
"2548","chr2.230940000.230945000","chr2.231015000.231020000",75000,33,1.023474e-11,230940000,231015000,230945000,231020000,"chr2",69924,1,2,2,5,"chr2",1,0.0193389592123769
"2549","chr2.47335000.47340000","chr2.47370000.47375000",35000,31,0.0001682114,47335000,47370000,47340000,47375000,"chr2",70040,8,17,26,51,"chr2",1,0.185302390998594
"2550","chr2.79995000.80000000","chr2.80060000.80065000",65000,23,0.0001271874,79995000,80060000,8e+07,80065000,"chr2",70078,0,0,1,1,"chr2",1,0.00269573370839194
"2551","chr2.70530000.70535000","chr2.71000000.71005000",470000,9,0.004903942,70530000,7.1e+07,70535000,71005000,"chr2",70109,3,1,0,4,"chr2",1,0.00421940928270042
"2552","chr2.54330000.54335000","chr2.54955000.54960000",625000,8,0.005803355,54330000,54955000,54335000,54960000,"chr2",70114,0,1,2,3,"chr2",1,0.00281293952180028
"2553","chr2.160965000.160970000","chr2.161120000.161125000",155000,14,0.002774387,160965000,161120000,160970000,161125000,"chr2",70126,1,1,5,7,"chr2",1,0.0114861697140178
"2554","chr2.152540000.152545000","chr2.152570000.152575000",30000,34,0.0001901193,152540000,152570000,152545000,152575000,"chr2",70127,4,7,8,19,"chr2",1,0.0757149554617909
"2555","chr2.172695000.172700000","chr2.172805000.172810000",110000,15,0.006252332,172695000,172805000,172700000,172810000,"chr2",70162,0,0,2,2,"chr2",1,0.00351617440225035
"2556","chr2.42085000.42090000","chr2.42315000.42320000",230000,26,2.623777e-14,42085000,42315000,42090000,42320000,"chr2",70178,4,6,4,14,"chr2",1,0.0426629160806376
"2557","chr2.54385000.54390000","chr2.54925000.54930000",540000,11,8.2444e-05,54385000,54925000,54390000,54930000,"chr2",70214,0,3,2,5,"chr2",1,0.00644631973745898
"2558","chr2.207855000.207860000","chr2.208040000.208045000",185000,13,0.003174651,207855000,208040000,207860000,208045000,"chr2",70225,0,21,12,33,"chr2",1,0.05028129395218
"2559","chr2.65230000.65235000","chr2.65265000.65270000",35000,34,9.473445e-06,65230000,65265000,65235000,65270000,"chr2",70240,0,0,4,4,"chr2",1,0.0159399906235349
"2560","chr2.230940000.230945000","chr2.231005000.231010000",65000,21,0.001034425,230940000,231005000,230945000,231010000,"chr2",70296,1,2,2,5,"chr2",1,0.0123066104078762
"2561","chr2.70105000.70110000","chr2.70290000.70295000",185000,13,0.003174651,70105000,70290000,70110000,70295000,"chr2",70405,4,15,30,49,"chr2",1,0.0746601031411158
"2562","chr2.128060000.128065000","chr2.128235000.128240000",175000,20,1.744436e-07,128060000,128235000,128065000,128240000,"chr2",70435,5,18,12,35,"chr2",1,0.0820440693858415
"2563","chr2.85650000.85655000","chr2.85750000.85755000",100000,16,0.00419449,85650000,85750000,85655000,85755000,"chr2",70439,0,0,2,2,"chr2",1,0.00375058602906704
"2564","chr2.64815000.64820000","chr2.65065000.65070000",250000,13,0.0004295622,64815000,65065000,64820000,65070000,"chr2",70498,5,14,15,34,"chr2",1,0.0518049695264885
"2565","chr2.235050000.235055000","chr2.235170000.235175000",120000,17,0.0003709646,235050000,235170000,235055000,235175000,"chr2",70521,0,0,3,3,"chr2",1,0.0059774964838256
"2566","chr2.85580000.85585000","chr2.85745000.85750000",165000,15,0.0005404616,85580000,85745000,85585000,85750000,"chr2",70619,2,3,2,7,"chr2",1,0.0123066104078762
"2567","chr2.80015000.80020000","chr2.80060000.80065000",45000,26,0.0004875882,80015000,80060000,80020000,80065000,"chr2",70661,0,0,1,1,"chr2",1,0.00304735114861697
"2568","chr2.20625000.20630000","chr2.20840000.20845000",215000,12,0.004349821,20625000,20840000,20630000,20845000,"chr2",70662,1,2,1,4,"chr2",1,0.00562587904360056
"2569","chr2.42115000.42120000","chr2.42315000.42320000",200000,14,0.000522239,42115000,42315000,42120000,42320000,"chr2",70722,3,3,2,8,"chr2",1,0.0131270511017346
"2570","chr2.26220000.26225000","chr2.26380000.26385000",160000,16,0.0001810214,26220000,26380000,26225000,26385000,"chr2",70732,0,2,1,3,"chr2",1,0.00562587904360056
"2571","chr2.85725000.85730000","chr2.85745000.85750000",20000,48,5.303157e-07,85725000,85745000,85730000,85750000,"chr2",70765,2,3,2,7,"chr2",1,0.0393811533052039
"2572","chr2.201780000.201785000","chr2.202055000.202060000",275000,13,0.0002166617,201780000,202055000,201785000,202060000,"chr2",70875,2,11,5,18,"chr2",1,0.0274261603375527
"2573","chr2.54560000.54565000","chr2.54880000.54885000",320000,10,0.006519483,54560000,54880000,54565000,54885000,"chr2",70973,0,5,2,7,"chr2",1,0.00820440693858415
"2574","chr2.86135000.86140000","chr2.86245000.86250000",110000,15,0.006252332,86135000,86245000,86140000,86250000,"chr2",70987,4,2,5,11,"chr2",1,0.0193389592123769
"2575","chr2.70070000.70075000","chr2.70105000.70110000",35000,28,0.002159006,70070000,70105000,70075000,70110000,"chr2",71027,9,18,13,40,"chr2",1,0.131270511017346
"2576","chr2.33290000.33295000","chr2.33555000.33560000",265000,11,0.004599226,33290000,33555000,33295000,33560000,"chr2",71039,0,0,7,7,"chr2",1,0.00902484763244257
"2577","chr2.38515000.38520000","chr2.38960000.38965000",445000,11,0.0002864327,38515000,38960000,38520000,38965000,"chr2",71075,0,0,2,2,"chr2",1,0.00257852789498359
"2578","chr2.70540000.70545000","chr2.70860000.70865000",320000,19,8.840349e-10,70540000,70860000,70545000,70865000,"chr2",71091,0,7,4,11,"chr2",1,0.0244960150023441
"2579","chr2.70130000.70135000","chr2.70300000.70305000",170000,24,1.905768e-10,70130000,70300000,70135000,70305000,"chr2",71128,7,21,15,43,"chr2",1,0.120956399437412
"2580","chr2.96740000.96745000","chr2.96760000.96765000",20000,39,0.0009045029,96740000,96760000,96745000,96765000,"chr2",71252,0,2,2,4,"chr2",1,0.0182841068917018
"2581","chr2.231015000.231020000","chr2.231465000.231470000",450000,10,0.001341526,231015000,231465000,231020000,231470000,"chr2",71303,1,15,19,35,"chr2",1,0.0410220346929208
"2582","chr2.54430000.54435000","chr2.54925000.54930000",495000,12,2.404403e-05,54430000,54925000,54435000,54930000,"chr2",71311,0,3,2,5,"chr2",1,0.0070323488045007
"2583","chr2.201970000.201975000","chr2.202015000.202020000",45000,31,2.722742e-06,201970000,202015000,201975000,202020000,"chr2",71344,0,0,3,3,"chr2",1,0.0109001406469761
"2584","chr2.74050000.74055000","chr2.74575000.74580000",525000,9,0.002886765,74050000,74575000,74055000,74580000,"chr2",71354,4,6,2,12,"chr2",1,0.0126582278481013
"2585","chr2.230690000.230695000","chr2.230710000.230715000",20000,74,1.414989e-20,230690000,230710000,230695000,230715000,"chr2",71361,0,12,4,16,"chr2",1,0.138771683075481
"2586","chr2.26160000.26165000","chr2.26250000.26255000",90000,18,0.001121902,26160000,26250000,26165000,26255000,"chr2",71377,2,8,8,18,"chr2",1,0.0379746835443038
"2587","chr2.62075000.62080000","chr2.62115000.62120000",40000,30,4.964184e-05,62075000,62115000,62080000,62120000,"chr2",71397,2,7,5,14,"chr2",1,0.0492264416315049
"2588","chr2.232760000.232765000","chr2.232950000.232955000",190000,12,0.008687146,232760000,232950000,232765000,232955000,"chr2",71409,1,4,3,8,"chr2",1,0.0112517580872011
"2589","chr2.54175000.54180000","chr2.54755000.54760000",580000,8,0.008190711,54175000,54755000,54180000,54760000,"chr2",71467,1,4,4,9,"chr2",1,0.00843881856540084
"2590","chr2.24640000.24645000","chr2.25050000.25055000",410000,16,4.177668e-08,24640000,25050000,24645000,25055000,"chr2",71480,1,1,0,2,"chr2",1,0.00375058602906704
"2591","chr2.207925000.207930000","chr2.208025000.208030000",100000,22,2.584498e-06,207925000,208025000,207930000,208030000,"chr2",71514,2,8,4,14,"chr2",1,0.0360993905297703
"2592","chr2.219160000.219165000","chr2.219260000.219265000",100000,26,5.973249e-09,219160000,219260000,219165000,219265000,"chr2",71561,0,4,3,7,"chr2",1,0.0213314580403188
"2593","chr2.232815000.232820000","chr2.233145000.233150000",330000,13,6.226865e-05,232815000,233145000,232820000,233150000,"chr2",71579,0,1,0,1,"chr2",1,0.00152367557430849
"2594","chr2.55265000.55270000","chr2.55400000.55405000",135000,18,4.227874e-05,55265000,55400000,55270000,55405000,"chr2",71593,1,9,7,17,"chr2",1,0.0358649789029536
"2595","chr2.219520000.219525000","chr2.219575000.219580000",55000,24,0.0003526635,219520000,219575000,219525000,219580000,"chr2",71625,1,1,0,2,"chr2",1,0.00562587904360056
"2596","chr2.230925000.230930000","chr2.231015000.231020000",90000,22,8.931313e-06,230925000,231015000,230930000,231020000,"chr2",71674,1,7,8,16,"chr2",1,0.0412564463197375
"2597","chr2.55455000.55460000","chr2.55590000.55595000",135000,14,0.005846758,55455000,55590000,55460000,55595000,"chr2",71788,1,12,2,15,"chr2",1,0.0246132208157525
"2598","chr2.70140000.70145000","chr2.70300000.70305000",160000,21,8.623577e-08,70140000,70300000,70145000,70305000,"chr2",71829,0,14,11,25,"chr2",1,0.0615330520393812
"2599","chr2.97865000.97870000","chr2.98170000.98175000",305000,20,1.834237e-10,97865000,98170000,97870000,98175000,"chr2",71857,0,0,2,2,"chr2",1,0.0046882325363338
"2600","chr2.27190000.27195000","chr2.27255000.27260000",65000,30,1.749122e-08,27190000,27255000,27195000,27260000,"chr2",71889,4,9,6,19,"chr2",1,0.0668073136427567
"2601","chr2.32875000.32880000","chr2.33290000.33295000",415000,9,0.00850255,32875000,33290000,32880000,33295000,"chr2",71944,0,2,2,4,"chr2",1,0.00421940928270042
"2602","chr2.69790000.69795000","chr2.69830000.69835000",40000,27,0.0008355202,69790000,69830000,69795000,69835000,"chr2",71946,3,6,12,21,"chr2",1,0.0664556962025316
"2603","chr2.74050000.74055000","chr2.74335000.74340000",285000,16,1.076805e-06,74050000,74335000,74055000,74340000,"chr2",71995,2,5,2,9,"chr2",1,0.0168776371308017
"2604","chr2.24050000.24055000","chr2.24360000.24365000",310000,11,0.001972111,24050000,24360000,24055000,24365000,"chr2",72027,1,7,3,11,"chr2",1,0.0141819034224098
"2605","chr2.231700000.231705000","chr2.231850000.231855000",150000,17,7.441819e-05,231700000,231850000,231705000,231855000,"chr2",72111,6,12,11,29,"chr2",1,0.0577824660103141
"2606","chr2.178200000.178205000","chr2.178265000.178270000",65000,25,1.265954e-05,178200000,178265000,178205000,178270000,"chr2",72171,5,7,8,20,"chr2",1,0.0586029067041725
"2607","chr2.64875000.64880000","chr2.64940000.64945000",65000,28,2.746856e-07,64875000,64940000,64880000,64945000,"chr2",72224,4,5,7,16,"chr2",1,0.0525082044069386
"2608","chr2.24970000.24975000","chr2.24995000.25000000",25000,50,2.829263e-09,24970000,24995000,24975000,2.5e+07,"chr2",72248,2,5,4,11,"chr2",1,0.0644631973745898
"2609","chr2.24045000.24050000","chr2.24075000.24080000",30000,30,0.004323057,24045000,24075000,24050000,24080000,"chr2",72289,6,18,16,40,"chr2",1,0.140646976090014
"2610","chr2.235465000.235470000","chr2.235855000.235860000",390000,10,0.002740393,235465000,235855000,235470000,235860000,"chr2",72363,0,5,1,6,"chr2",1,0.0070323488045007
"2611","chr2.43155000.43160000","chr2.43710000.43715000",555000,8,0.00984918,43155000,43710000,43160000,43715000,"chr2",72375,0,1,3,4,"chr2",1,0.00375058602906704
"2612","chr2.196460000.196465000","chr2.196485000.196490000",25000,43,3.460641e-06,196460000,196485000,196465000,196490000,"chr2",72397,2,1,4,7,"chr2",1,0.0352789498359119
"2613","chr2.54880000.54885000","chr2.54930000.54935000",50000,32,1.507461e-07,54880000,54930000,54885000,54935000,"chr2",72538,0,5,2,7,"chr2",1,0.0262541022034693
"2614","chr2.64820000.64825000","chr2.65030000.65035000",210000,14,0.0003709646,64820000,65030000,64825000,65035000,"chr2",72568,0,7,4,11,"chr2",1,0.0180496952648851
"2615","chr2.201860000.201865000","chr2.201970000.201975000",110000,18,0.0002073649,201860000,201970000,201865000,201975000,"chr2",72610,0,0,3,3,"chr2",1,0.00632911392405063
"2616","chr2.64450000.64455000","chr2.65265000.65270000",815000,8,0.001519918,64450000,65265000,64455000,65270000,"chr2",72687,0,0,4,4,"chr2",1,0.00375058602906704
"2617","chr2.47260000.47265000","chr2.47310000.47315000",50000,24,0.001005454,47260000,47310000,47265000,47315000,"chr2",72762,1,10,4,15,"chr2",1,0.0421940928270042
"2618","chr2.96925000.96930000","chr2.96965000.96970000",40000,28,0.0003417937,96925000,96965000,96930000,96970000,"chr2",72826,1,3,1,5,"chr2",1,0.0164088138771683
"2619","chr2.26250000.26255000","chr2.26380000.26385000",130000,16,0.0007348989,26250000,26380000,26255000,26385000,"chr2",72976,2,8,8,18,"chr2",1,0.0337552742616034
"2620","chr2.47225000.47230000","chr2.47530000.47535000",305000,11,0.002159006,47225000,47530000,47230000,47535000,"chr2",73060,0,3,2,5,"chr2",1,0.00644631973745898
"2621","chr2.198090000.198095000","chr2.198135000.198140000",45000,23,0.006426477,198090000,198135000,198095000,198140000,"chr2",73108,0,2,7,9,"chr2",1,0.0242616033755274
"2622","chr2.3395000.3400000","chr2.3515000.3520000",120000,16,0.001208006,3395000,3515000,3400000,3520000,"chr2",73165,4,10,10,24,"chr2",1,0.0450070323488045
"2623","chr2.159060000.159065000","chr2.159515000.159520000",455000,11,0.000248511,159060000,159515000,159065000,159520000,"chr2",73181,0,1,4,5,"chr2",1,0.00644631973745898
"2624","chr2.54405000.54410000","chr2.54755000.54760000",350000,12,0.0002216703,54405000,54755000,54410000,54760000,"chr2",73209,1,4,4,9,"chr2",1,0.0126582278481013
"2625","chr2.20580000.20585000","chr2.20625000.20630000",45000,25,0.001208006,20580000,20625000,20585000,20630000,"chr2",73219,1,2,1,4,"chr2",1,0.0117205813408345
"2626","chr2.72110000.72115000","chr2.72800000.72805000",690000,10,0.000102131,72110000,72800000,72115000,72805000,"chr2",73234,0,7,5,12,"chr2",1,0.0140646976090014
"2627","chr2.48130000.48135000","chr2.48325000.48330000",195000,13,0.002290301,48130000,48325000,48135000,48330000,"chr2",73250,0,4,2,6,"chr2",1,0.00914205344585091
"2628","chr2.235050000.235055000","chr2.235385000.235390000",335000,11,0.001310839,235050000,235385000,235055000,235390000,"chr2",73271,0,0,4,4,"chr2",1,0.00515705578996718
"2629","chr2.24880000.24885000","chr2.24970000.24975000",90000,18,0.001121902,24880000,24970000,24885000,24975000,"chr2",73301,0,5,2,7,"chr2",1,0.0147679324894515
"2630","chr2.190695000.190700000","chr2.191050000.191055000",355000,10,0.004187627,190695000,191050000,190700000,191055000,"chr2",73310,2,0,1,3,"chr2",1,0.00351617440225035
"2631","chr2.55135000.55140000","chr2.55415000.55420000",280000,19,4.102549e-09,55135000,55415000,55140000,55420000,"chr2",73344,0,2,2,4,"chr2",1,0.00890764181903422
"2632","chr2.105545000.105550000","chr2.105650000.105655000",105000,16,0.002972259,105545000,105650000,105550000,105655000,"chr2",73363,2,4,3,9,"chr2",1,0.0168776371308017
"2633","chr2.128060000.128065000","chr2.128250000.128255000",190000,16,4.571848e-05,128060000,128250000,128065000,128255000,"chr2",73388,2,12,6,20,"chr2",1,0.0375058602906704
"2634","chr2.46875000.46880000","chr2.46940000.46945000",65000,20,0.002745608,46875000,46940000,46880000,46945000,"chr2",73411,0,1,1,2,"chr2",1,0.0046882325363338
"2635","chr2.39380000.39385000","chr2.39410000.39415000",30000,32,0.0009703642,39380000,39410000,39385000,39415000,"chr2",73434,0,3,3,6,"chr2",1,0.0225035161744023
"2636","chr2.232085000.232090000","chr2.232310000.232315000",225000,15,4.892506e-05,232085000,232310000,232090000,232315000,"chr2",73437,3,2,6,11,"chr2",1,0.0193389592123769
"2637","chr2.54405000.54410000","chr2.54930000.54935000",525000,13,2.176488e-06,54405000,54930000,54410000,54935000,"chr2",73446,3,7,6,16,"chr2",1,0.0243788091889358
"2638","chr2.65140000.65145000","chr2.65230000.65235000",90000,16,0.008624295,65140000,65230000,65145000,65235000,"chr2",73463,6,14,8,28,"chr2",1,0.0525082044069386
"2639","chr2.84865000.84870000","chr2.85455000.85460000",590000,8,0.00756228,84865000,85455000,84870000,85460000,"chr2",73493,1,3,3,7,"chr2",1,0.00656352555086732
"2640","chr2.223545000.223550000","chr2.223725000.223730000",180000,13,0.003742372,223545000,223725000,223550000,223730000,"chr2",73595,0,3,2,5,"chr2",1,0.00761837787154243
"2641","chr2.54755000.54760000","chr2.54925000.54930000",170000,23,1.23166e-09,54755000,54925000,54760000,54930000,"chr2",73622,0,3,2,5,"chr2",1,0.0134786685419597
"2642","chr2.46875000.46880000","chr2.46915000.46920000",40000,31,1.803561e-05,46875000,46915000,46880000,46920000,"chr2",73671,0,1,1,2,"chr2",1,0.00726676043131739
"2643","chr2.47285000.47290000","chr2.47400000.47405000",115000,26,8.057649e-10,47285000,47400000,47290000,47405000,"chr2",73677,2,9,10,21,"chr2",1,0.0639943741209564
"2644","chr2.101730000.101735000","chr2.101750000.101755000",20000,46,3.358359e-06,101730000,101750000,101735000,101755000,"chr2",73755,2,5,7,14,"chr2",1,0.0754805438349742
"2645","chr2.86065000.86070000","chr2.86315000.86320000",250000,15,1.949445e-05,86065000,86315000,86070000,86320000,"chr2",73821,1,6,6,13,"chr2",1,0.0228551336146273
"2646","chr2.153025000.153030000","chr2.153540000.153545000",515000,10,0.0006414317,153025000,153540000,153030000,153545000,"chr2",73880,0,4,1,5,"chr2",1,0.00586029067041725
"2647","chr2.191230000.191235000","chr2.191690000.191695000",460000,10,0.001195928,191230000,191690000,191235000,191695000,"chr2",73960,1,3,3,7,"chr2",1,0.00820440693858415
"2648","chr2.61690000.61695000","chr2.61915000.61920000",225000,15,4.892506e-05,61690000,61915000,61695000,61920000,"chr2",73978,6,17,13,36,"chr2",1,0.0632911392405063
"2649","chr2.26265000.26270000","chr2.26295000.26300000",30000,36,3.282478e-05,26265000,26295000,26270000,26300000,"chr2",74047,5,15,12,32,"chr2",1,0.135021097046413
"2650","chr2.177260000.177265000","chr2.177280000.177285000",20000,40,0.0004387141,177260000,177280000,177265000,177285000,"chr2",74200,0,2,0,2,"chr2",1,0.00937646507266761
"2651","chr2.28145000.28150000","chr2.28175000.28180000",30000,31,0.002093764,28145000,28175000,28150000,28180000,"chr2",74341,0,1,0,1,"chr2",1,0.0036333802156587
"2652","chr2.54755000.54760000","chr2.54930000.54935000",175000,24,1.275151e-10,54755000,54930000,54760000,54935000,"chr2",74357,1,4,4,9,"chr2",1,0.0253164556962025
"2653","chr2.171195000.171200000","chr2.171665000.171670000",470000,9,0.004903942,171195000,171665000,171200000,171670000,"chr2",74400,0,3,0,3,"chr2",1,0.00316455696202532
"2654","chr2.54530000.54535000","chr2.54955000.54960000",425000,9,0.007654353,54530000,54955000,54535000,54960000,"chr2",74449,0,6,2,8,"chr2",1,0.00843881856540084
"2655","chr2.128090000.128095000","chr2.128245000.128250000",155000,15,0.0008356975,128090000,128245000,128095000,128250000,"chr2",74465,4,22,18,44,"chr2",1,0.0773558368495077
"2656","chr2.102805000.102810000","chr2.102845000.102850000",40000,32,6.286924e-06,102805000,102845000,102810000,102850000,"chr2",74495,0,1,0,1,"chr2",1,0.00375058602906704
"2657","chr2.43035000.43040000","chr2.43710000.43715000",675000,9,0.0007453237,43035000,43710000,43040000,43715000,"chr2",74607,0,1,2,3,"chr2",1,0.00316455696202532
"2658","chr2.58130000.58135000","chr2.58330000.58335000",200000,13,0.001954724,58130000,58330000,58135000,58335000,"chr2",74653,0,0,3,3,"chr2",1,0.00457102672292546
"2659","chr2.69600000.69605000","chr2.69915000.69920000",315000,10,0.007022645,69600000,69915000,69605000,69920000,"chr2",74671,1,1,2,4,"chr2",1,0.0046882325363338
"2660","chr2.201780000.201785000","chr2.201925000.201930000",145000,15,0.001250277,201780000,201925000,201785000,201930000,"chr2",74675,1,8,4,13,"chr2",1,0.0228551336146273
"2661","chr2.223620000.223625000","chr2.223725000.223730000",105000,19,8.815808e-05,223620000,223725000,223625000,223730000,"chr2",74748,0,4,2,6,"chr2",1,0.0133614627285513
"2662","chr2.64820000.64825000","chr2.65055000.65060000",235000,14,0.0001555264,64820000,65055000,64825000,65060000,"chr2",74754,7,7,9,23,"chr2",1,0.0377402719174871
"2663","chr2.198050000.198055000","chr2.198090000.198095000",40000,26,0.001945659,198050000,198090000,198055000,198095000,"chr2",74810,0,2,7,9,"chr2",1,0.0274261603375527
"2664","chr2.97645000.97650000","chr2.97675000.97680000",30000,29,0.008519007,97645000,97675000,97650000,97680000,"chr2",74822,2,5,10,17,"chr2",1,0.0577824660103141
"2665","chr2.217850000.217855000","chr2.218385000.218390000",535000,15,2.630617e-08,217850000,218385000,217855000,218390000,"chr2",74882,0,3,1,4,"chr2",1,0.0070323488045007
"2666","chr2.237435000.237440000","chr2.237980000.237985000",545000,12,1.180283e-05,237435000,237980000,237440000,237985000,"chr2",74893,5,4,8,17,"chr2",1,0.0239099859353024
"2667","chr2.233030000.233035000","chr2.233145000.233150000",115000,18,0.0001443878,233030000,233145000,233035000,233150000,"chr2",74913,0,1,0,1,"chr2",1,0.00210970464135021
"2668","chr2.73995000.74000000","chr2.74575000.74580000",580000,9,0.001738884,73995000,74575000,7.4e+07,74580000,"chr2",74925,0,5,2,7,"chr2",1,0.00738396624472574
"2669","chr2.232900000.232905000","chr2.232955000.232960000",55000,22,0.002337964,232900000,232955000,232905000,232960000,"chr2",74953,2,7,6,15,"chr2",1,0.0386779184247539
"2670","chr2.47225000.47230000","chr2.47520000.47525000",295000,17,1.17709e-07,47225000,47520000,47230000,47525000,"chr2",74971,0,3,2,5,"chr2",1,0.00996249413970933
"2671","chr2.219430000.219435000","chr2.219570000.219575000",140000,14,0.004846327,219430000,219570000,219435000,219575000,"chr2",75019,0,2,2,4,"chr2",1,0.00656352555086732
"2672","chr2.219325000.219330000","chr2.219385000.219390000",60000,20,0.00585082,219325000,219385000,219330000,219390000,"chr2",75064,0,7,3,10,"chr2",1,0.023441162681669
"2673","chr2.54590000.54595000","chr2.54705000.54710000",115000,17,0.0004957577,54590000,54705000,54595000,54710000,"chr2",75069,0,7,3,10,"chr2",1,0.0199249882794187
"2674","chr2.198295000.198300000","chr2.198375000.198380000",80000,27,3.934651e-08,198295000,198375000,198300000,198380000,"chr2",75088,8,11,9,28,"chr2",1,0.0886075949367089
"2675","chr2.25650000.25655000","chr2.25680000.25685000",30000,32,0.0009703642,25650000,25680000,25655000,25685000,"chr2",75099,0,5,0,5,"chr2",1,0.0187529301453352
"2676","chr2.48560000.48565000","chr2.48600000.48605000",40000,38,5.346684e-09,48560000,48600000,48565000,48605000,"chr2",75124,0,2,3,5,"chr2",1,0.0222691045475856
"2677","chr2.201985000.201990000","chr2.202015000.202020000",30000,40,6.393175e-07,201985000,202015000,201990000,202020000,"chr2",75142,1,5,4,10,"chr2",1,0.046882325363338
"2678","chr2.47225000.47230000","chr2.47510000.47515000",285000,11,0.00308603,47225000,47510000,47230000,47515000,"chr2",75157,0,1,2,3,"chr2",1,0.00386779184247539
"2679","chr2.28190000.28195000","chr2.28725000.28730000",535000,9,0.002616274,28190000,28725000,28195000,28730000,"chr2",75187,1,12,9,22,"chr2",1,0.0232067510548523
"2680","chr2.231050000.231055000","chr2.231365000.231370000",315000,11,0.001825096,231050000,231365000,231055000,231370000,"chr2",75205,2,7,6,15,"chr2",1,0.0193389592123769
"2681","chr2.144365000.144370000","chr2.145200000.145205000",835000,7,0.007360737,144365000,145200000,144370000,145205000,"chr2",75229,0,2,0,2,"chr2",1,0.00164088138771683
"2682","chr2.72970000.72975000","chr2.73050000.73055000",80000,17,0.007887179,72970000,73050000,72975000,73055000,"chr2",75240,0,2,0,2,"chr2",1,0.00398499765588373
"2683","chr2.208185000.208190000","chr2.208320000.208325000",135000,15,0.001935147,208185000,208320000,208190000,208325000,"chr2",75276,0,3,0,3,"chr2",1,0.00527426160337553
"2684","chr2.61690000.61695000","chr2.61885000.61890000",195000,12,0.007583919,61690000,61885000,61695000,61890000,"chr2",75347,6,17,12,35,"chr2",1,0.0492264416315049
"2685","chr2.15940000.15945000","chr2.15965000.15970000",25000,34,0.004425962,15940000,15965000,15945000,15970000,"chr2",75412,0,1,1,2,"chr2",1,0.00796999531176746
"2686","chr2.47270000.47275000","chr2.47530000.47535000",260000,11,0.005083305,47270000,47530000,47275000,47535000,"chr2",75428,6,16,26,48,"chr2",1,0.0618846694796062
"2687","chr2.11650000.11655000","chr2.11685000.11690000",35000,33,2.555721e-05,11650000,11685000,11655000,11690000,"chr2",75516,1,0,1,2,"chr2",1,0.00773558368495077
"2688","chr2.46940000.46945000","chr2.47095000.47100000",155000,16,0.000226149,46940000,47095000,46945000,47100000,"chr2",75524,0,8,0,8,"chr2",1,0.0150023441162682
"2689","chr2.26250000.26255000","chr2.26345000.26350000",95000,16,0.005948559,26250000,26345000,26255000,26350000,"chr2",75528,1,7,0,8,"chr2",1,0.0150023441162682
"2690","chr2.48430000.48435000","chr2.48600000.48605000",170000,16,0.0001135799,48430000,48600000,48435000,48605000,"chr2",75531,0,2,0,2,"chr2",1,0.00375058602906704
"2691","chr2.25290000.25295000","chr2.25340000.25345000",50000,28,1.75251e-05,25290000,25340000,25295000,25345000,"chr2",75626,3,5,1,9,"chr2",1,0.029535864978903
"2692","chr2.27320000.27325000","chr2.27500000.27505000",180000,43,9.911104e-30,27320000,27500000,27325000,27505000,"chr2",75663,1,1,1,3,"chr2",1,0.0151195499296765
"2693","chr2.240285000.240290000","chr2.240820000.240825000",535000,11,8.815808e-05,240285000,240820000,240290000,240825000,"chr2",75665,0,1,1,2,"chr2",1,0.00257852789498359
"2694","chr2.104575000.104580000","chr2.105410000.105415000",835000,7,0.007360737,104575000,105410000,104580000,105415000,"chr2",75720,0,5,5,10,"chr2",1,0.00820440693858415
"2695","chr2.39605000.39610000","chr2.39670000.39675000",65000,23,0.0001271874,39605000,39670000,39610000,39675000,"chr2",75750,1,1,0,2,"chr2",1,0.00539146741678387
"2696","chr2.54405000.54410000","chr2.54955000.54960000",550000,11,7.279752e-05,54405000,54955000,54410000,54960000,"chr2",75804,0,6,2,8,"chr2",1,0.0103141115799344
"2697","chr2.25605000.25610000","chr2.25700000.25705000",95000,19,0.0002219465,25605000,25700000,25610000,25705000,"chr2",75814,4,1,4,9,"chr2",1,0.020042194092827
"2698","chr2.61670000.61675000","chr2.61690000.61695000",20000,51,2.831597e-08,61670000,61690000,61675000,61695000,"chr2",75823,3,12,3,18,"chr2",1,0.107594936708861
"2699","chr2.232900000.232905000","chr2.232940000.232945000",40000,25,0.004349821,232900000,232940000,232905000,232945000,"chr2",75868,1,7,6,14,"chr2",1,0.0410220346929208
"2700","chr2.47345000.47350000","chr2.47510000.47515000",165000,18,7.986263e-06,47345000,47510000,47350000,47515000,"chr2",75874,1,1,2,4,"chr2",1,0.00843881856540084
"2701","chr2.43080000.43085000","chr2.43710000.43715000",630000,9,0.001086022,43080000,43710000,43085000,43715000,"chr2",75901,0,0,2,2,"chr2",1,0.00210970464135021
"2702","chr2.85725000.85730000","chr2.85750000.85755000",25000,45,5.158248e-07,85725000,85750000,85730000,85755000,"chr2",75949,0,0,2,2,"chr2",1,0.0105485232067511
"2703","chr2.47270000.47275000","chr2.47400000.47405000",130000,28,4.085315e-12,47270000,47400000,47275000,47405000,"chr2",75964,6,16,20,42,"chr2",1,0.137834036568214
"2704","chr2.11375000.11380000","chr2.11530000.11535000",155000,15,0.0008356975,11375000,11530000,11380000,11535000,"chr2",75973,3,12,10,25,"chr2",1,0.0439521800281294
"2705","chr2.230910000.230915000","chr2.231465000.231470000",555000,8,0.00984918,230910000,231465000,230915000,231470000,"chr2",75979,0,2,5,7,"chr2",1,0.00656352555086732
"2706","chr2.70125000.70130000","chr2.70290000.70295000",165000,19,1.666187e-06,70125000,70290000,70130000,70295000,"chr2",76002,4,15,30,49,"chr2",1,0.109118612283169
"2707","chr2.68075000.68080000","chr2.68255000.68260000",180000,13,0.003742372,68075000,68255000,68080000,68260000,"chr2",76069,0,4,1,5,"chr2",1,0.00761837787154243
"2708","chr2.102635000.102640000","chr2.102750000.102755000",115000,16,0.001617402,102635000,102750000,102640000,102755000,"chr2",76082,3,3,6,12,"chr2",1,0.0225035161744023
"2709","chr2.11365000.11370000","chr2.11540000.11545000",175000,13,0.004403514,11365000,11540000,11370000,11545000,"chr2",76101,0,3,3,6,"chr2",1,0.00914205344585091
"2710","chr2.191230000.191235000","chr2.191375000.191380000",145000,17,9.587926e-05,191230000,191375000,191235000,191380000,"chr2",76182,0,3,11,14,"chr2",1,0.0278949835911861
"2711","chr2.46915000.46920000","chr2.46940000.46945000",25000,35,0.002278734,46915000,46940000,46920000,46945000,"chr2",76184,2,6,4,12,"chr2",1,0.0492264416315049
"2712","chr2.20580000.20585000","chr2.20605000.20610000",25000,50,2.829263e-09,20580000,20605000,20585000,20610000,"chr2",76211,0,5,2,7,"chr2",1,0.0410220346929208
"2713","chr2.42095000.42100000","chr2.42315000.42320000",220000,53,9.006116e-45,42095000,42315000,42100000,42320000,"chr2",76289,3,6,4,13,"chr2",1,0.0807548054383497
"2714","chr2.55110000.55115000","chr2.55520000.55525000",410000,10,0.002159006,55110000,55520000,55115000,55525000,"chr2",76307,2,5,2,9,"chr2",1,0.0105485232067511
"2715","chr2.55520000.55525000","chr2.55645000.55650000",125000,19,1.908347e-05,55520000,55645000,55525000,55650000,"chr2",76421,5,11,9,25,"chr2",1,0.0556727613689639
"2716","chr2.25250000.25255000","chr2.25330000.25335000",80000,21,0.0001173801,25250000,25330000,25255000,25335000,"chr2",76423,0,1,1,2,"chr2",1,0.00492264416315049
"2717","chr2.86045000.86050000","chr2.86290000.86295000",245000,17,7.969776e-07,86045000,86290000,86050000,86295000,"chr2",76448,2,7,8,17,"chr2",1,0.0338724800750117
"2718","chr2.219160000.219165000","chr2.219325000.219330000",165000,15,0.0005404616,219160000,219325000,219165000,219330000,"chr2",76494,0,4,3,7,"chr2",1,0.0123066104078762
"2719","chr2.1880000.1885000","chr2.2300000.2305000",420000,9,0.008091968,1880000,2300000,1885000,2305000,"chr2",76536,0,2,0,2,"chr2",1,0.00210970464135021
"2720","chr2.54980000.54985000","chr2.55045000.55050000",65000,21,0.001034425,54980000,55045000,54985000,55050000,"chr2",76580,0,2,1,3,"chr2",1,0.00738396624472574
"2721","chr2.62175000.62180000","chr2.62475000.62480000",300000,14,2.302313e-05,62175000,62475000,62180000,62480000,"chr2",76620,0,3,1,4,"chr2",1,0.00656352555086732
"2722","chr2.37005000.37010000","chr2.37230000.37235000",225000,30,4.154655e-18,37005000,37230000,37010000,37235000,"chr2",76653,0,4,1,5,"chr2",1,0.0175808720112518
"2723","chr2.10975000.10980000","chr2.11240000.11245000",265000,23,1.910932e-12,10975000,11240000,10980000,11245000,"chr2",76674,1,1,1,3,"chr2",1,0.00808720112517581
"2724","chr2.54225000.54230000","chr2.54270000.54275000",45000,23,0.006426477,54225000,54270000,54230000,54275000,"chr2",76710,0,2,7,9,"chr2",1,0.0242616033755274
"2725","chr2.85675000.85680000","chr2.85745000.85750000",70000,53,1.880908e-27,85675000,85745000,85680000,85750000,"chr2",76737,2,3,2,7,"chr2",1,0.043483356774496
"2726","chr2.55265000.55270000","chr2.55415000.55420000",150000,18,1.812485e-05,55265000,55415000,55270000,55420000,"chr2",76771,1,4,6,11,"chr2",1,0.0232067510548523
"2727","chr2.64820000.64825000","chr2.65065000.65070000",245000,17,7.969776e-07,64820000,65065000,64825000,65070000,"chr2",76856,5,7,9,21,"chr2",1,0.0418424753867792
"2728","chr2.131105000.131110000","chr2.131125000.131130000",20000,37,0.003413209,131105000,131125000,131110000,131130000,"chr2",76920,4,9,5,18,"chr2",1,0.0780590717299578
"2729","chr2.55455000.55460000","chr2.55645000.55650000",190000,18,2.031727e-06,55455000,55645000,55460000,55650000,"chr2",76941,1,14,2,17,"chr2",1,0.0358649789029536
"2730","chr2.26120000.26125000","chr2.26345000.26350000",225000,12,0.003316906,26120000,26345000,26125000,26350000,"chr2",77032,1,7,0,8,"chr2",1,0.0112517580872011
"2731","chr2.74000000.74005000","chr2.74365000.74370000",365000,10,0.003679247,7.4e+07,74365000,74005000,74370000,"chr2",77036,0,0,1,1,"chr2",1,0.00117205813408345
"2732","chr2.171345000.171350000","chr2.171665000.171670000",320000,21,1.154485e-11,171345000,171665000,171350000,171670000,"chr2",77126,0,1,0,1,"chr2",1,0.00246132208157525
"2733","chr2.69740000.69745000","chr2.69785000.69790000",45000,23,0.006426477,69740000,69785000,69745000,69790000,"chr2",77128,1,5,3,9,"chr2",1,0.0242616033755274
"2734","chr2.216130000.216135000","chr2.216835000.216840000",705000,8,0.003259365,216130000,216835000,216135000,216840000,"chr2",77235,3,9,8,20,"chr2",1,0.0187529301453352
"2735","chr2.24050000.24055000","chr2.24300000.24305000",250000,13,0.0004295622,24050000,24300000,24055000,24305000,"chr2",77321,3,8,5,16,"chr2",1,0.0243788091889358
"2736","chr2.69790000.69795000","chr2.69930000.69935000",140000,15,0.001560022,69790000,69930000,69795000,69935000,"chr2",77327,1,2,3,6,"chr2",1,0.0105485232067511
"2737","chr2.26245000.26250000","chr2.26355000.26360000",110000,16,0.002167945,26245000,26355000,26250000,26360000,"chr2",77355,0,12,15,27,"chr2",1,0.0506329113924051
"2738","chr2.101615000.101620000","chr2.101770000.101775000",155000,14,0.002774387,101615000,101770000,101620000,101775000,"chr2",77363,0,5,3,8,"chr2",1,0.0131270511017346
"2739","chr2.64875000.64880000","chr2.64995000.65000000",120000,16,0.001208006,64875000,64995000,64880000,6.5e+07,"chr2",77365,4,8,13,25,"chr2",1,0.046882325363338
"2740","chr2.201795000.201800000","chr2.202060000.202065000",265000,13,0.0002839226,201795000,202060000,201800000,202065000,"chr2",77395,0,7,7,14,"chr2",1,0.0213314580403188
"2741","chr2.64820000.64825000","chr2.65175000.65180000",355000,10,0.004187627,64820000,65175000,64825000,65180000,"chr2",77456,7,7,9,23,"chr2",1,0.0269573370839194
"2742","chr2.85850000.85855000","chr2.86045000.86050000",195000,12,0.007583919,85850000,86045000,85855000,86050000,"chr2",77569,0,4,0,4,"chr2",1,0.00562587904360056
"2743","chr2.24045000.24050000","chr2.24355000.24360000",310000,10,0.007583919,24045000,24355000,24050000,24360000,"chr2",77604,5,18,12,35,"chr2",1,0.0410220346929208
"2744","chr2.86045000.86050000","chr2.86315000.86320000",270000,12,0.001060841,86045000,86315000,86050000,86320000,"chr2",77640,1,7,8,16,"chr2",1,0.0225035161744023
"2745","chr2.20560000.20565000","chr2.20835000.20840000",275000,11,0.003745171,20560000,20835000,20565000,20840000,"chr2",77673,2,6,3,11,"chr2",1,0.0141819034224098
"2746","chr2.151355000.151360000","chr2.152095000.152100000",740000,8,0.002534857,151355000,152095000,151360000,152100000,"chr2",77687,0,1,5,6,"chr2",1,0.00562587904360056
"2747","chr2.47400000.47405000","chr2.47505000.47510000",105000,20,2.398148e-05,47400000,47505000,47405000,47510000,"chr2",77784,2,7,10,19,"chr2",1,0.0445382090951711
"2748","chr2.177145000.177150000","chr2.177330000.177335000",185000,17,1.276248e-05,177145000,177330000,177150000,177335000,"chr2",77840,0,3,1,4,"chr2",1,0.00796999531176746
"2749","chr2.25530000.25535000","chr2.25555000.25560000",25000,47,6.926165e-08,25530000,25555000,25535000,25560000,"chr2",77857,0,5,5,10,"chr2",1,0.0550867323019222
"2750","chr2.70565000.70570000","chr2.70860000.70865000",295000,17,1.17709e-07,70565000,70860000,70570000,70865000,"chr2",77993,1,1,2,4,"chr2",1,0.00796999531176746
"2751","chr2.159760000.159765000","chr2.159885000.159890000",125000,17,0.0002760066,159760000,159885000,159765000,159890000,"chr2",78101,1,4,4,9,"chr2",1,0.0179324894514768
"2752","chr2.86675000.86680000","chr2.86765000.86770000",90000,16,0.008624295,86675000,86765000,86680000,86770000,"chr2",78107,2,10,12,24,"chr2",1,0.0450070323488045
"2753","chr2.27315000.27320000","chr2.27500000.27505000",185000,14,0.0009143288,27315000,27500000,27320000,27505000,"chr2",78156,1,6,6,13,"chr2",1,0.0213314580403188
"2754","chr2.11375000.11380000","chr2.11540000.11545000",165000,16,0.0001431418,11375000,11540000,11380000,11545000,"chr2",78213,0,3,4,7,"chr2",1,0.0131270511017346
"2755","chr2.47650000.47655000","chr2.48325000.48330000",675000,8,0.004052619,47650000,48325000,47655000,48330000,"chr2",78291,0,3,2,5,"chr2",1,0.0046882325363338
"2756","chr2.43555000.43560000","chr2.43710000.43715000",155000,15,0.0008356975,43555000,43710000,43560000,43715000,"chr2",78363,0,1,3,4,"chr2",1,0.0070323488045007
"2757","chr2.64125000.64130000","chr2.64205000.64210000",80000,18,0.003026855,64125000,64205000,64130000,64210000,"chr2",78380,0,4,5,9,"chr2",1,0.0189873417721519
"2758","chr2.48340000.48345000","chr2.48605000.48610000",265000,11,0.004599226,48340000,48605000,48345000,48610000,"chr2",78448,1,0,2,3,"chr2",1,0.00386779184247539
"2759","chr2.161270000.161275000","chr2.161825000.161830000",555000,10,0.0004124094,161270000,161825000,161275000,161830000,"chr2",78512,0,0,5,5,"chr2",1,0.00586029067041725
"2760","chr2.65130000.65135000","chr2.65265000.65270000",135000,19,1.016791e-05,65130000,65265000,65135000,65270000,"chr2",78564,0,0,4,4,"chr2",1,0.00890764181903422
"2761","chr2.128695000.128700000","chr2.128750000.128755000",55000,21,0.005634437,128695000,128750000,128700000,128755000,"chr2",78582,0,3,1,4,"chr2",1,0.00984528832630099
"2762","chr2.24775000.24780000","chr2.24995000.25000000",220000,12,0.003776479,24775000,24995000,24780000,2.5e+07,"chr2",78592,2,13,7,22,"chr2",1,0.0309423347398031
"2763","chr2.42340000.42345000","chr2.42360000.42365000",20000,41,0.0002073649,42340000,42360000,42345000,42365000,"chr2",78703,0,0,4,4,"chr2",1,0.0192217533989686
"2764","chr2.218745000.218750000","chr2.218845000.218850000",100000,16,0.00419449,218745000,218845000,218750000,218850000,"chr2",78715,0,3,3,6,"chr2",1,0.0112517580872011
"2765","chr2.65185000.65190000","chr2.65265000.65270000",80000,20,0.0003709646,65185000,65265000,65190000,65270000,"chr2",78733,0,0,4,4,"chr2",1,0.00937646507266761
"2766","chr2.25680000.25685000","chr2.25700000.25705000",20000,38,0.001797953,25680000,25700000,25685000,25705000,"chr2",78759,6,14,15,35,"chr2",1,0.155883731833099
"2767","chr2.54705000.54710000","chr2.54880000.54885000",175000,13,0.004403514,54705000,54880000,54710000,54885000,"chr2",78785,0,5,2,7,"chr2",1,0.0106657290201594
"2768","chr2.11475000.11480000","chr2.11540000.11545000",65000,19,0.006728756,11475000,11540000,11480000,11545000,"chr2",78900,0,3,4,7,"chr2",1,0.0155883731833099
"2769","chr2.121350000.121355000","chr2.121415000.121420000",65000,24,4.147305e-05,121350000,121415000,121355000,121420000,"chr2",78928,2,0,1,3,"chr2",1,0.00843881856540084
"2770","chr2.70130000.70135000","chr2.70290000.70295000",160000,14,0.002294501,70130000,70290000,70135000,70295000,"chr2",78934,4,15,15,34,"chr2",1,0.0557899671823722
"2771","chr2.102635000.102640000","chr2.102785000.102790000",150000,14,0.003346259,102635000,102785000,102640000,102790000,"chr2",78936,3,3,5,11,"chr2",1,0.0180496952648851
"2772","chr2.85925000.85930000","chr2.86035000.86040000",110000,20,1.52246e-05,85925000,86035000,85930000,86040000,"chr2",78952,0,5,1,6,"chr2",1,0.0140646976090014
"2773","chr2.173455000.173460000","chr2.173570000.173575000",115000,20,9.984152e-06,173455000,173570000,173460000,173575000,"chr2",78953,2,0,3,5,"chr2",1,0.0117205813408345
"2774","chr2.233030000.233035000","chr2.233115000.233120000",85000,17,0.005024145,233030000,233115000,233035000,233120000,"chr2",78977,3,3,3,9,"chr2",1,0.0179324894514768
"2775","chr2.27095000.27100000","chr2.27150000.27155000",55000,21,0.005634437,27095000,27150000,27100000,27155000,"chr2",78989,5,6,8,19,"chr2",1,0.0467651195499297
"2776","chr2.9705000.9710000","chr2.9810000.9815000",105000,15,0.008351178,9705000,9810000,9710000,9815000,"chr2",78991,0,6,4,10,"chr2",1,0.0175808720112518
"2777","chr2.135125000.135130000","chr2.135165000.135170000",40000,30,4.964184e-05,135125000,135165000,135130000,135170000,"chr2",78993,2,3,6,11,"chr2",1,0.0386779184247539
"2778","chr2.46695000.46700000","chr2.46835000.46840000",140000,18,3.207531e-05,46695000,46835000,46700000,46840000,"chr2",79001,2,2,4,8,"chr2",1,0.0168776371308017
"2779","chr2.219160000.219165000","chr2.219575000.219580000",415000,10,0.002039678,219160000,219575000,219165000,219580000,"chr2",79017,0,4,3,7,"chr2",1,0.00820440693858415
"2780","chr2.70110000.70115000","chr2.70455000.70460000",345000,10,0.004694997,70110000,70455000,70115000,70460000,"chr2",79185,0,2,0,2,"chr2",1,0.0023441162681669
"2781","chr2.74000000.74005000","chr2.74420000.74425000",420000,9,0.008091968,7.4e+07,74420000,74005000,74425000,"chr2",79291,0,0,1,1,"chr2",1,0.00105485232067511
"2782","chr2.54980000.54985000","chr2.55130000.55135000",150000,15,0.001014892,54980000,55130000,54985000,55135000,"chr2",79342,6,19,13,38,"chr2",1,0.0668073136427567
"2783","chr2.24080000.24085000","chr2.24100000.24105000",20000,38,0.001797953,24080000,24100000,24085000,24105000,"chr2",79372,1,2,3,6,"chr2",1,0.0267229254571027
"2784","chr2.48545000.48550000","chr2.48600000.48605000",55000,27,1.391913e-05,48545000,48600000,48550000,48605000,"chr2",79385,0,2,3,5,"chr2",1,0.0158227848101266
"2785","chr2.69600000.69605000","chr2.69710000.69715000",110000,15,0.006252332,69600000,69710000,69605000,69715000,"chr2",79400,1,1,1,3,"chr2",1,0.00527426160337553
"2786","chr2.159110000.159115000","chr2.159145000.159150000",35000,26,0.009419337,159110000,159145000,159115000,159150000,"chr2",79472,1,3,2,6,"chr2",1,0.0182841068917018
"2787","chr2.219575000.219580000","chr2.219640000.219645000",65000,22,0.0003732923,219575000,219640000,219580000,219645000,"chr2",79478,1,3,13,17,"chr2",1,0.0438349742147211
"2788","chr2.204145000.204150000","chr2.204325000.204330000",180000,13,0.003742372,204145000,204325000,204150000,204330000,"chr2",79561,0,0,1,1,"chr2",1,0.00152367557430849
"2789","chr2.54410000.54415000","chr2.54590000.54595000",180000,14,0.001084925,54410000,54590000,54415000,54595000,"chr2",79665,1,7,5,13,"chr2",1,0.0213314580403188
"2790","chr2.200470000.200475000","chr2.200695000.200700000",225000,13,0.0009045029,200470000,200695000,200475000,200700000,"chr2",79671,1,7,5,13,"chr2",1,0.0198077824660103
"2791","chr2.25295000.25300000","chr2.25315000.25320000",20000,60,1.395056e-12,25295000,25315000,25300000,25320000,"chr2",79719,1,4,3,8,"chr2",1,0.0562587904360056
"2792","chr2.61470000.61475000","chr2.62115000.62120000",645000,9,0.0009602413,61470000,62115000,61475000,62120000,"chr2",79750,5,7,5,17,"chr2",1,0.0179324894514768
"2793","chr2.219570000.219575000","chr2.219660000.219665000",90000,23,2.304042e-06,219570000,219660000,219575000,219665000,"chr2",79753,2,2,2,6,"chr2",1,0.0161744022503516
"2794","chr2.219160000.219165000","chr2.219430000.219435000",270000,18,4.399229e-08,219160000,219430000,219165000,219435000,"chr2",79931,0,4,3,7,"chr2",1,0.0147679324894515
"2795","chr2.25225000.25230000","chr2.25340000.25345000",115000,15,0.004802086,25225000,25340000,25230000,25345000,"chr2",80046,0,5,1,6,"chr2",1,0.0105485232067511
"2796","chr2.105810000.105815000","chr2.105845000.105850000",35000,26,0.009419337,105810000,105845000,105815000,105850000,"chr2",80049,0,3,1,4,"chr2",1,0.0121894045944679
"2797","chr2.54115000.54120000","chr2.54290000.54295000",175000,13,0.004403514,54115000,54290000,54120000,54295000,"chr2",80084,4,7,7,18,"chr2",1,0.0274261603375527
"2798","chr2.61990000.61995000","chr2.62075000.62080000",85000,31,2.447579e-11,61990000,62075000,61995000,62080000,"chr2",80136,2,10,8,20,"chr2",1,0.0726676043131739
"2799","chr2.47210000.47215000","chr2.47505000.47510000",295000,12,0.0006175335,47210000,47505000,47215000,47510000,"chr2",80141,2,7,10,19,"chr2",1,0.0267229254571027
"2800","chr2.55120000.55125000","chr2.55400000.55405000",280000,22,7.616952e-12,55120000,55400000,55125000,55405000,"chr2",80294,2,0,1,3,"chr2",1,0.00773558368495077
"2801","chr2.86105000.86110000","chr2.86245000.86250000",140000,20,1.666187e-06,86105000,86245000,86110000,86250000,"chr2",80375,2,3,5,10,"chr2",1,0.023441162681669
"2802","chr2.178195000.178200000","chr2.178475000.178480000",280000,12,0.0008587206,178195000,178475000,178200000,178480000,"chr2",80386,2,3,2,7,"chr2",1,0.00984528832630099
"2803","chr2.171345000.171350000","chr2.171430000.171435000",85000,26,6.926165e-08,171345000,171430000,171350000,171435000,"chr2",80393,0,1,0,1,"chr2",1,0.00304735114861697
"2804","chr2.25225000.25230000","chr2.25360000.25365000",135000,15,0.001935147,25225000,25360000,25230000,25365000,"chr2",80402,0,7,8,15,"chr2",1,0.0263713080168776
"2805","chr2.33520000.33525000","chr2.33595000.33600000",75000,19,0.001945659,33520000,33595000,33525000,33600000,"chr2",80423,1,4,5,10,"chr2",1,0.0222691045475856
"2806","chr2.58135000.58140000","chr2.58550000.58555000",415000,9,0.00850255,58135000,58550000,58140000,58555000,"chr2",80428,0,4,4,8,"chr2",1,0.00843881856540084
"2807","chr2.177210000.177215000","chr2.177260000.177265000",50000,29,5.65568e-06,177210000,177260000,177215000,177265000,"chr2",80638,0,4,2,6,"chr2",1,0.020393811533052
"2808","chr2.21395000.21400000","chr2.21500000.21505000",105000,15,0.008351178,21395000,21500000,21400000,21505000,"chr2",80666,1,1,3,5,"chr2",1,0.00879043600562588
"2809","chr2.26245000.26250000","chr2.26350000.26355000",105000,22,1.463276e-06,26245000,26350000,26250000,26355000,"chr2",80705,0,12,15,27,"chr2",1,0.069620253164557
"2810","chr2.177145000.177150000","chr2.177260000.177265000",115000,15,0.004802086,177145000,177260000,177150000,177265000,"chr2",80709,0,3,1,4,"chr2",1,0.0070323488045007
"2811","chr2.47370000.47375000","chr2.47505000.47510000",135000,15,0.001935147,47370000,47505000,47375000,47510000,"chr2",80740,2,7,10,19,"chr2",1,0.0334036568213783
"2812","chr2.25200000.25205000","chr2.25305000.25310000",105000,15,0.008351178,25200000,25305000,25205000,25310000,"chr2",80822,2,12,6,20,"chr2",1,0.0351617440225035
"2813","chr2.231680000.231685000","chr2.231850000.231855000",170000,24,1.905768e-10,231680000,231850000,231685000,231855000,"chr2",80829,3,12,6,21,"chr2",1,0.0590717299578059
"2814","chr2.24860000.24865000","chr2.24880000.24885000",20000,42,9.587926e-05,24860000,24880000,24865000,24885000,"chr2",80850,0,6,2,8,"chr2",1,0.0393811533052039
"2815","chr2.69720000.69725000","chr2.69740000.69745000",20000,48,5.303157e-07,69720000,69740000,69725000,69745000,"chr2",80852,7,13,17,37,"chr2",1,0.208157524613221
"2816","chr2.200470000.200475000","chr2.200710000.200715000",240000,11,0.007887179,200470000,200710000,200475000,200715000,"chr2",80863,0,2,0,2,"chr2",1,0.00257852789498359
"2817","chr2.231295000.231300000","chr2.231330000.231335000",35000,27,0.004599226,231295000,231330000,231300000,231335000,"chr2",80892,0,1,1,2,"chr2",1,0.00632911392405063
"2818","chr2.177210000.177215000","chr2.177235000.177240000",25000,37,0.0005349065,177210000,177235000,177215000,177240000,"chr2",80909,0,8,6,14,"chr2",1,0.0607126113455227
"2819","chr2.218655000.218660000","chr2.218860000.218865000",205000,16,2.35545e-05,218655000,218860000,218660000,218865000,"chr2",80991,2,11,2,15,"chr2",1,0.0281293952180028
"2820","chr2.69830000.69835000","chr2.69915000.69920000",85000,22,1.756224e-05,69830000,69915000,69835000,69920000,"chr2",81033,1,6,10,17,"chr2",1,0.0438349742147211
"2821","chr2.58135000.58140000","chr2.58330000.58335000",195000,14,0.0006307952,58135000,58330000,58140000,58335000,"chr2",81048,0,2,3,5,"chr2",1,0.00820440693858415
"2822","chr2.47335000.47340000","chr2.47365000.47370000",30000,29,0.008519007,47335000,47365000,47340000,47370000,"chr2",81082,2,12,11,25,"chr2",1,0.0849742147210502
"2823","chr2.54360000.54365000","chr2.54530000.54535000",170000,13,0.005171789,54360000,54530000,54365000,54535000,"chr2",81113,1,5,7,13,"chr2",1,0.0198077824660103
"2824","chr2.135795000.135800000","chr2.136375000.136380000",580000,8,0.008190711,135795000,136375000,135800000,136380000,"chr2",81114,2,0,1,3,"chr2",1,0.00281293952180028
"2825","chr2.198375000.198380000","chr2.198495000.198500000",120000,19,2.719959e-05,198375000,198495000,198380000,198500000,"chr2",81176,3,5,3,11,"chr2",1,0.0244960150023441
"2826","chr2.26160000.26165000","chr2.26295000.26300000",135000,14,0.005846758,26160000,26295000,26165000,26300000,"chr2",81210,5,18,12,35,"chr2",1,0.0574308485700891
"2827","chr2.27070000.27075000","chr2.27150000.27155000",80000,22,3.555263e-05,27070000,27150000,27075000,27155000,"chr2",81262,0,4,0,4,"chr2",1,0.0103141115799344
"2828","chr2.65125000.65130000","chr2.65265000.65270000",140000,15,0.001560022,65125000,65265000,65130000,65270000,"chr2",81291,0,0,4,4,"chr2",1,0.0070323488045007
"2829","chr2.69600000.69605000","chr2.69720000.69725000",120000,18,0.0001031128,69600000,69720000,69605000,69725000,"chr2",81295,2,1,2,5,"chr2",1,0.0105485232067511
"2830","chr2.48125000.48130000","chr2.48600000.48605000",475000,10,0.001005454,48125000,48600000,48130000,48605000,"chr2",81380,0,2,3,5,"chr2",1,0.00586029067041725
"2831","chr2.64325000.64330000","chr2.64820000.64825000",495000,9,0.003838505,64325000,64820000,64330000,64825000,"chr2",81392,0,3,7,10,"chr2",1,0.0105485232067511
"2832","chr2.54270000.54275000","chr2.54925000.54930000",655000,8,0.004640583,54270000,54925000,54275000,54930000,"chr2",81479,0,3,2,5,"chr2",1,0.0046882325363338
"2833","chr2.235790000.235795000","chr2.235855000.235860000",65000,26,3.701924e-06,235790000,235855000,235795000,235860000,"chr2",81566,0,4,1,5,"chr2",1,0.0152367557430849
"2834","chr2.38580000.38585000","chr2.38945000.38950000",365000,10,0.003679247,38580000,38945000,38585000,38950000,"chr2",81607,1,9,6,16,"chr2",1,0.0187529301453352
"2835","chr2.48340000.48345000","chr2.48430000.48435000",90000,60,9.215628e-39,48340000,48430000,48345000,48435000,"chr2",81658,1,0,0,1,"chr2",1,0.0070323488045007
"2836","chr2.233470000.233475000","chr2.234200000.234205000",730000,9,0.0004639581,233470000,234200000,233475000,234205000,"chr2",81734,2,1,3,6,"chr2",1,0.00632911392405063
"2837","chr2.54440000.54445000","chr2.54495000.54500000",55000,22,0.002337964,54440000,54495000,54445000,54500000,"chr2",81756,0,4,1,5,"chr2",1,0.012892639474918
"2838","chr2.64325000.64330000","chr2.64520000.64525000",195000,15,0.0001580014,64325000,64520000,64330000,64525000,"chr2",81786,0,3,7,10,"chr2",1,0.0175808720112518
"2839","chr2.65140000.65145000","chr2.65265000.65270000",125000,109,3.275818e-109,65140000,65265000,65145000,65270000,"chr2",81799,0,0,4,4,"chr2",1,0.0511017346460384
"2840","chr2.98540000.98545000","chr2.98905000.98910000",365000,10,0.003679247,98540000,98905000,98545000,98910000,"chr2",81817,0,6,3,9,"chr2",1,0.0105485232067511
"2841","chr2.42750000.42755000","chr2.42770000.42775000",20000,38,0.001797953,42750000,42770000,42755000,42775000,"chr2",81892,1,2,3,6,"chr2",1,0.0267229254571027
"2842","chr2.55120000.55125000","chr2.55405000.55410000",285000,16,1.076805e-06,55120000,55405000,55125000,55410000,"chr2",81945,2,0,1,3,"chr2",1,0.00562587904360056
"2843","chr2.105095000.105100000","chr2.105110000.105115000",15000,37,0.003413209,105095000,105110000,105100000,105115000,"chr2",81959,3,4,3,10,"chr2",1,0.0433661509610877
"2844","chr2.230940000.230945000","chr2.230985000.230990000",45000,25,0.001208006,230940000,230985000,230945000,230990000,"chr2",81966,1,2,2,5,"chr2",1,0.0146507266760431
"2845","chr2.201870000.201875000","chr2.201970000.201975000",100000,16,0.00419449,201870000,201970000,201875000,201975000,"chr2",82041,0,0,3,3,"chr2",1,0.00562587904360056
"2846","chr2.55120000.55125000","chr2.55355000.55360000",235000,12,0.002534677,55120000,55355000,55125000,55360000,"chr2",82137,0,0,1,1,"chr2",1,0.00140646976090014
"2847","chr2.68390000.68395000","chr2.68465000.68470000",75000,23,2.192649e-05,68390000,68465000,68395000,68470000,"chr2",82152,1,4,7,12,"chr2",1,0.0323488045007032
"2848","chr2.134985000.134990000","chr2.135050000.135055000",65000,19,0.006728756,134985000,135050000,134990000,135055000,"chr2",82168,1,1,1,3,"chr2",1,0.00668073136427567
"2849","chr2.30800000.30805000","chr2.30820000.30825000",20000,41,0.0002073649,30800000,30820000,30805000,30825000,"chr2",82189,0,2,0,2,"chr2",1,0.00961087669948429
"2850","chr2.27085000.27090000","chr2.27115000.27120000",30000,31,0.002093764,27085000,27115000,27090000,27120000,"chr2",82221,3,6,2,11,"chr2",1,0.0399671823722457
"2851","chr2.55130000.55135000","chr2.55455000.55460000",325000,10,0.006122944,55130000,55455000,55135000,55460000,"chr2",82250,1,17,2,20,"chr2",1,0.023441162681669
"2852","chr2.235790000.235795000","chr2.235825000.235830000",35000,37,3.844298e-07,235790000,235825000,235795000,235830000,"chr2",82312,0,4,1,5,"chr2",1,0.0216830754805438
"2853","chr2.26175000.26180000","chr2.26350000.26355000",175000,16,9.021355e-05,26175000,26350000,26180000,26355000,"chr2",82339,2,7,18,27,"chr2",1,0.0506329113924051
"2854","chr2.138705000.138710000","chr2.138845000.138850000",140000,21,3.479897e-07,138705000,138845000,138710000,138850000,"chr2",82401,4,6,3,13,"chr2",1,0.0319971870604782
"2855","chr2.147840000.147845000","chr2.148615000.148620000",775000,8,0.001996781,147840000,148615000,147845000,148620000,"chr2",82436,0,1,0,1,"chr2",1,0.00093764650726676
"2856","chr2.70565000.70570000","chr2.70745000.70750000",180000,16,7.164951e-05,70565000,70745000,70570000,70750000,"chr2",82470,0,1,2,3,"chr2",1,0.00562587904360056
"2857","chr2.55265000.55270000","chr2.55355000.55360000",90000,18,0.001121902,55265000,55355000,55270000,55360000,"chr2",82487,0,2,1,3,"chr2",1,0.00632911392405063
"2858","chr2.30445000.30450000","chr2.30675000.30680000",230000,12,0.002895462,30445000,30675000,30450000,30680000,"chr2",82522,1,4,4,9,"chr2",1,0.0126582278481013
"2859","chr2.54955000.54960000","chr2.55405000.55410000",450000,9,0.00595415,54955000,55405000,54960000,55410000,"chr2",82540,0,6,2,8,"chr2",1,0.00843881856540084
"2860","chr2.20605000.20610000","chr2.20840000.20845000",235000,16,6.686679e-06,20605000,20840000,20610000,20845000,"chr2",82586,0,2,2,4,"chr2",1,0.00750117205813408
"2861","chr2.20640000.20645000","chr2.20840000.20845000",200000,57,2.828731e-48,20640000,20840000,20645000,20845000,"chr2",82614,1,1,1,3,"chr2",1,0.020042194092827
"2862","chr2.61470000.61475000","chr2.61915000.61920000",445000,10,0.001427765,61470000,61915000,61475000,61920000,"chr2",82654,6,25,20,51,"chr2",1,0.059774964838256
"2863","chr2.69740000.69745000","chr2.69770000.69775000",30000,37,1.273575e-05,69740000,69770000,69745000,69775000,"chr2",82662,6,8,8,22,"chr2",1,0.0954055321143929
"2864","chr2.236045000.236050000","chr2.236510000.236515000",465000,15,1.03936e-07,236045000,236510000,236050000,236515000,"chr2",82837,2,7,4,13,"chr2",1,0.0228551336146273
"2865","chr2.10830000.10835000","chr2.10950000.10955000",120000,15,0.003742989,10830000,10950000,10835000,10955000,"chr2",82891,0,2,6,8,"chr2",1,0.0140646976090014
"2866","chr2.178210000.178215000","chr2.178265000.178270000",55000,31,1.022664e-07,178210000,178265000,178215000,178270000,"chr2",82893,2,7,8,17,"chr2",1,0.0617674636661978
"2867","chr2.223835000.223840000","chr2.224585000.224590000",750000,9,0.0003975131,223835000,224585000,223840000,224590000,"chr2",82929,0,2,0,2,"chr2",1,0.00210970464135021
"2868","chr2.9325000.9330000","chr2.9475000.9480000",150000,21,1.735379e-07,9325000,9475000,9330000,9480000,"chr2",82935,2,0,0,2,"chr2",1,0.00492264416315049
"2869","chr2.219275000.219280000","chr2.219325000.219330000",50000,23,0.002462653,219275000,219325000,219280000,219330000,"chr2",82946,2,22,6,30,"chr2",1,0.0808720112517581
"2870","chr2.100380000.100385000","chr2.100865000.100870000",485000,9,0.004261853,100380000,100865000,100385000,100870000,"chr2",82965,1,6,4,11,"chr2",1,0.0116033755274262
"2871","chr2.20585000.20590000","chr2.20605000.20610000",20000,43,4.321287e-05,20585000,20605000,20590000,20610000,"chr2",82968,0,4,3,7,"chr2",1,0.0352789498359119
"2872","chr2.232585000.232590000","chr2.232625000.232630000",40000,35,2.102784e-07,232585000,232625000,232590000,232630000,"chr2",83022,8,9,7,24,"chr2",1,0.0984528832630098
"2873","chr2.26015000.26020000","chr2.26065000.26070000",50000,26,0.0001443878,26015000,26065000,26020000,26070000,"chr2",83042,2,9,8,19,"chr2",1,0.0578996718237225
"2874","chr2.65140000.65145000","chr2.65360000.65365000",220000,12,0.003776479,65140000,65360000,65145000,65365000,"chr2",83127,6,14,20,40,"chr2",1,0.0562587904360056
"2875","chr2.43155000.43160000","chr2.43715000.43720000",560000,9,0.002084529,43155000,43715000,43160000,43720000,"chr2",83170,0,7,3,10,"chr2",1,0.0105485232067511
"2876","chr2.10270000.10275000","chr2.10435000.10440000",165000,13,0.006114697,10270000,10435000,10275000,10440000,"chr2",83189,0,2,0,2,"chr2",1,0.00304735114861697
"2877","chr2.216130000.216135000","chr2.216795000.216800000",665000,16,2.231898e-10,216130000,216795000,216135000,216800000,"chr2",83218,2,13,8,23,"chr2",1,0.043131739334271
"2878","chr2.159760000.159765000","chr2.160105000.160110000",345000,10,0.004694997,159760000,160105000,159765000,160110000,"chr2",83219,1,1,2,4,"chr2",1,0.0046882325363338
"2879","chr2.69785000.69790000","chr2.69930000.69935000",145000,34,3.500762e-18,69785000,69930000,69790000,69935000,"chr2",83232,1,2,3,6,"chr2",1,0.0239099859353024
"2880","chr2.20580000.20585000","chr2.20840000.20845000",260000,16,2.551883e-06,20580000,20840000,20585000,20845000,"chr2",83233,1,2,2,5,"chr2",1,0.00937646507266761
"2881","chr2.183055000.183060000","chr2.183490000.183495000",435000,14,1.417398e-06,183055000,183490000,183060000,183495000,"chr2",83242,0,4,2,6,"chr2",1,0.00984528832630099
"2882","chr2.101275000.101280000","chr2.101580000.101585000",305000,11,0.002159006,101275000,101580000,101280000,101585000,"chr2",83336,0,6,5,11,"chr2",1,0.0141819034224098
"2883","chr2.219625000.219630000","chr2.219645000.219650000",20000,57,4.472715e-11,219625000,219645000,219630000,219650000,"chr2",83344,0,4,2,6,"chr2",1,0.040084388185654
"2884","chr2.42420000.42425000","chr2.42460000.42465000",40000,28,0.0003417937,42420000,42460000,42425000,42465000,"chr2",83362,0,2,1,3,"chr2",1,0.00984528832630099
"2885","chr2.9300000.9305000","chr2.9800000.9805000",500000,9,0.003667546,9300000,9800000,9305000,9805000,"chr2",83435,2,6,7,15,"chr2",1,0.0158227848101266
"2886","chr2.47260000.47265000","chr2.47400000.47405000",140000,38,9.429466e-22,47260000,47400000,47265000,47405000,"chr2",83464,1,10,4,15,"chr2",1,0.0668073136427567
"2887","chr2.159070000.159075000","chr2.159090000.159095000",20000,45,8.09957e-06,159070000,159090000,159075000,159095000,"chr2",83469,0,1,2,3,"chr2",1,0.0158227848101266
"2888","chr2.241410000.241415000","chr2.241490000.241495000",80000,21,0.0001173801,241410000,241490000,241415000,241495000,"chr2",83478,0,1,2,3,"chr2",1,0.00738396624472574
"2889","chr2.54175000.54180000","chr2.54290000.54295000",115000,15,0.004802086,54175000,54290000,54180000,54295000,"chr2",83497,3,5,7,15,"chr2",1,0.0263713080168776
"2890","chr2.64820000.64825000","chr2.65040000.65045000",220000,15,5.874159e-05,64820000,65040000,64825000,65045000,"chr2",83634,5,7,9,21,"chr2",1,0.0369198312236287
"2891","chr2.70565000.70570000","chr2.70870000.70875000",305000,32,3.995727e-23,70565000,70870000,70570000,70875000,"chr2",83663,1,1,2,4,"chr2",1,0.0150023441162682
"2892","chr2.25200000.25205000","chr2.25290000.25295000",90000,26,2.869414e-08,25200000,25290000,25205000,25295000,"chr2",83667,2,16,12,30,"chr2",1,0.0914205344585091
"2893","chr2.202235000.202240000","chr2.202490000.202495000",255000,11,0.005703234,202235000,202490000,202240000,202495000,"chr2",83683,1,6,9,16,"chr2",1,0.0206282231598687
"2894","chr2.223610000.223615000","chr2.223725000.223730000",115000,30,6.022559e-13,223610000,223725000,223615000,223730000,"chr2",83712,4,2,2,8,"chr2",1,0.0281293952180028
"2895","chr2.53740000.53745000","chr2.53785000.53790000",45000,24,0.002886765,53740000,53785000,53745000,53790000,"chr2",83757,1,4,8,13,"chr2",1,0.0365682137834037
"2896","chr2.97675000.97680000","chr2.97765000.97770000",90000,19,0.0003712596,97675000,97765000,97680000,97770000,"chr2",83765,6,2,3,11,"chr2",1,0.0244960150023441
"2897","chr2.30380000.30385000","chr2.30925000.30930000",545000,14,1.940944e-07,30380000,30925000,30385000,30930000,"chr2",83781,0,1,5,6,"chr2",1,0.00984528832630099
"2898","chr2.70130000.70135000","chr2.70530000.70535000",400000,10,0.002409769,70130000,70530000,70135000,70535000,"chr2",83821,3,1,0,4,"chr2",1,0.0046882325363338
"2899","chr2.30675000.30680000","chr2.30715000.30720000",40000,28,0.0003417937,30675000,30715000,30680000,30720000,"chr2",83881,0,5,1,6,"chr2",1,0.019690576652602
"2900","chr2.144990000.144995000","chr2.145200000.145205000",210000,16,1.88628e-05,144990000,145200000,144995000,145205000,"chr2",83884,0,2,0,2,"chr2",1,0.00375058602906704
"2901","chr2.45870000.45875000","chr2.46060000.46065000",190000,18,2.031727e-06,45870000,46060000,45875000,46065000,"chr2",83939,1,3,2,6,"chr2",1,0.0126582278481013
"2902","chr2.24740000.24745000","chr2.25000000.25005000",260000,16,2.551883e-06,24740000,2.5e+07,24745000,25005000,"chr2",83969,1,2,2,5,"chr2",1,0.00937646507266761
"2903","chr2.32140000.32145000","chr2.32400000.32405000",260000,11,0.005083305,32140000,32400000,32145000,32405000,"chr2",83972,7,26,20,53,"chr2",1,0.0683309892170652
"2904","chr2.101330000.101335000","chr2.101580000.101585000",250000,13,0.0004295622,101330000,101580000,101335000,101585000,"chr2",83999,0,6,5,11,"chr2",1,0.0167604313173933
"2905","chr2.38515000.38520000","chr2.38540000.38545000",25000,36,0.001114518,38515000,38540000,38520000,38545000,"chr2",84002,0,5,4,9,"chr2",1,0.0379746835443038
"2906","chr2.55590000.55595000","chr2.55615000.55620000",25000,34,0.004425962,55590000,55615000,55595000,55620000,"chr2",84021,3,11,7,21,"chr2",1,0.0836849507735584
"2907","chr2.64820000.64825000","chr2.65265000.65270000",445000,13,8.168704e-06,64820000,65265000,64825000,65270000,"chr2",84039,0,0,4,4,"chr2",1,0.00609470229723394
"2908","chr2.217370000.217375000","chr2.218320000.218325000",950000,8,0.0005400855,217370000,218320000,217375000,218325000,"chr2",84051,2,3,6,11,"chr2",1,0.0103141115799344
"2909","chr2.200885000.200890000","chr2.201255000.201260000",370000,10,0.003444848,200885000,201255000,200890000,201260000,"chr2",84077,4,17,6,27,"chr2",1,0.0316455696202532
"2910","chr2.25290000.25295000","chr2.25315000.25320000",25000,39,0.0001128433,25290000,25315000,25295000,25320000,"chr2",84092,9,20,28,57,"chr2",1,0.260548523206751
"2911","chr2.44690000.44695000","chr2.44955000.44960000",265000,13,0.0002839226,44690000,44955000,44695000,44960000,"chr2",84106,2,6,1,9,"chr2",1,0.0137130801687764
"2912","chr2.9340000.9345000","chr2.9475000.9480000",135000,17,0.0001605672,9340000,9475000,9345000,9480000,"chr2",84119,1,3,2,6,"chr2",1,0.0119549929676512
"2913","chr2.54360000.54365000","chr2.54955000.54960000",595000,8,0.007225034,54360000,54955000,54365000,54960000,"chr2",84145,0,5,2,7,"chr2",1,0.00656352555086732
"2914","chr2.105745000.105750000","chr2.105810000.105815000",65000,19,0.006728756,105745000,105810000,105750000,105815000,"chr2",84151,0,1,0,1,"chr2",1,0.00222691045475856
"2915","chr2.64870000.64875000","chr2.65265000.65270000",395000,11,0.0005587728,64870000,65265000,64875000,65270000,"chr2",84208,0,0,4,4,"chr2",1,0.00515705578996718
"2916","chr2.74050000.74055000","chr2.74365000.74370000",315000,11,0.001825096,74050000,74365000,74055000,74370000,"chr2",84233,0,1,2,3,"chr2",1,0.00386779184247539
"2917","chr2.54955000.54960000","chr2.55400000.55405000",445000,11,0.0002864327,54955000,55400000,54960000,55405000,"chr2",84235,0,6,2,8,"chr2",1,0.0103141115799344
"2918","chr2.233030000.233035000","chr2.233180000.233185000",150000,15,0.001014892,233030000,233180000,233035000,233185000,"chr2",84240,3,3,3,9,"chr2",1,0.0158227848101266
"2919","chr2.70120000.70125000","chr2.70290000.70295000",170000,16,0.0001135799,70120000,70290000,70125000,70295000,"chr2",84317,4,8,19,31,"chr2",1,0.0581340834505391
"2920","chr2.230900000.230905000","chr2.230920000.230925000",20000,39,0.0009045029,230900000,230920000,230905000,230925000,"chr2",84365,1,3,4,8,"chr2",1,0.0365682137834037
"2921","chr2.233465000.233470000","chr2.233565000.233570000",100000,17,0.001435018,233465000,233565000,233470000,233570000,"chr2",84370,0,1,3,4,"chr2",1,0.00796999531176746
"2922","chr2.230690000.230695000","chr2.230780000.230785000",90000,18,0.001121902,230690000,230780000,230695000,230785000,"chr2",84398,0,7,4,11,"chr2",1,0.0232067510548523
"2923","chr2.10095000.10100000","chr2.10185000.10190000",90000,18,0.001121902,10095000,10185000,10100000,10190000,"chr2",84412,1,1,1,3,"chr2",1,0.00632911392405063
"2924","chr2.55590000.55595000","chr2.55645000.55650000",55000,37,2.149921e-11,55590000,55645000,55595000,55650000,"chr2",84417,3,12,7,22,"chr2",1,0.0954055321143929
"2925","chr2.43020000.43025000","chr2.43810000.43815000",790000,7,0.00949,43020000,43810000,43025000,43815000,"chr2",84440,3,5,2,10,"chr2",1,0.00820440693858415
"2926","chr2.219120000.219125000","chr2.219645000.219650000",525000,9,0.002886765,219120000,219645000,219125000,219650000,"chr2",84483,2,6,2,10,"chr2",1,0.0105485232067511
"2927","chr2.20650000.20655000","chr2.20810000.20815000",160000,18,1.037622e-05,20650000,20810000,20655000,20815000,"chr2",84487,1,1,1,3,"chr2",1,0.00632911392405063
"2928","chr2.158900000.158905000","chr2.159600000.159605000",700000,8,0.003369629,158900000,159600000,158905000,159605000,"chr2",84490,6,14,10,30,"chr2",1,0.0281293952180028
"2929","chr2.177260000.177265000","chr2.177305000.177310000",45000,26,0.0004875882,177260000,177305000,177265000,177310000,"chr2",84518,0,4,2,6,"chr2",1,0.0182841068917018
"2930","chr2.1855000.1860000","chr2.2300000.2305000",445000,9,0.006261311,1855000,2300000,1860000,2305000,"chr2",84536,0,2,0,2,"chr2",1,0.00210970464135021
"2931","chr2.160265000.160270000","chr2.160440000.160445000",175000,14,0.001310839,160265000,160440000,160270000,160445000,"chr2",84552,5,4,9,18,"chr2",1,0.029535864978903
"2932","chr2.122195000.122200000","chr2.122390000.122395000",195000,15,0.0001580014,122195000,122390000,122200000,122395000,"chr2",84559,0,2,1,3,"chr2",1,0.00527426160337553
"2933","chr2.230885000.230890000","chr2.230940000.230945000",55000,22,0.002337964,230885000,230940000,230890000,230945000,"chr2",84569,0,2,2,4,"chr2",1,0.0103141115799344
"2934","chr2.27440000.27445000","chr2.27500000.27505000",60000,25,3.958961e-05,27440000,27500000,27445000,27505000,"chr2",84600,1,6,6,13,"chr2",1,0.0380918893577121
"2935","chr2.85300000.85305000","chr2.85535000.85540000",235000,12,0.002534677,85300000,85535000,85305000,85540000,"chr2",84650,1,2,2,5,"chr2",1,0.0070323488045007
"2936","chr2.54495000.54500000","chr2.55165000.55170000",670000,9,0.0007779438,54495000,55165000,54500000,55170000,"chr2",84660,0,1,1,2,"chr2",1,0.00210970464135021
"2937","chr2.135705000.135710000","chr2.136310000.136315000",605000,8,0.006687492,135705000,136310000,135710000,136315000,"chr2",84736,2,5,4,11,"chr2",1,0.0103141115799344
"2938","chr2.172695000.172700000","chr2.172930000.172935000",235000,13,0.0006621599,172695000,172930000,172700000,172935000,"chr2",84747,0,1,2,3,"chr2",1,0.00457102672292546
"2939","chr2.25605000.25610000","chr2.25820000.25825000",215000,12,0.004349821,25605000,25820000,25610000,25825000,"chr2",84757,4,1,4,9,"chr2",1,0.0126582278481013
"2940","chr2.55455000.55460000","chr2.55510000.55515000",55000,21,0.005634437,55455000,55510000,55460000,55515000,"chr2",84759,1,10,2,13,"chr2",1,0.0319971870604782
"2941","chr2.47345000.47350000","chr2.47505000.47510000",160000,17,4.499498e-05,47345000,47505000,47350000,47510000,"chr2",84835,2,7,10,19,"chr2",1,0.0378574777308955
"2942","chr2.96855000.96860000","chr2.96910000.96915000",55000,25,0.000124966,96855000,96910000,96860000,96915000,"chr2",84870,2,4,1,7,"chr2",1,0.0205110173464604
"2943","chr2.28175000.28180000","chr2.28620000.28625000",445000,11,0.0002864327,28175000,28620000,28180000,28625000,"chr2",84881,0,2,0,2,"chr2",1,0.00257852789498359
"2944","chr2.26220000.26225000","chr2.26295000.26300000",75000,22,7.283957e-05,26220000,26295000,26225000,26300000,"chr2",85062,0,2,1,3,"chr2",1,0.00773558368495077
"2945","chr2.48340000.48345000","chr2.48560000.48565000",220000,19,7.270214e-08,48340000,48560000,48345000,48565000,"chr2",85199,2,0,2,4,"chr2",1,0.00890764181903422
"2946","chr2.48130000.48135000","chr2.48695000.48700000",565000,9,0.001975335,48130000,48695000,48135000,48700000,"chr2",85241,0,0,3,3,"chr2",1,0.00316455696202532
"2947","chr2.203135000.203140000","chr2.203495000.203500000",360000,10,0.003908408,203135000,203495000,203140000,203500000,"chr2",85387,0,3,3,6,"chr2",1,0.0070323488045007
"2948","chr2.37005000.37010000","chr2.37195000.37200000",190000,12,0.008687146,37005000,37195000,37010000,37200000,"chr2",85406,2,7,10,19,"chr2",1,0.0267229254571027
"2949","chr2.7710000.7715000","chr2.8625000.8630000",915000,9,9.754714e-05,7710000,8625000,7715000,8630000,"chr2",85439,4,8,5,17,"chr2",1,0.0179324894514768
"2950","chr2.154375000.154380000","chr2.155250000.155255000",875000,8,0.0009802333,154375000,155250000,154380000,155255000,"chr2",85483,0,0,1,1,"chr2",1,0.00093764650726676
"2951","chr2.20660000.20665000","chr2.20835000.20840000",175000,16,9.021355e-05,20660000,20835000,20665000,20840000,"chr2",85528,2,4,4,10,"chr2",1,0.0187529301453352
"2952","chr2.207710000.207715000","chr2.208310000.208315000",600000,9,0.001433298,207710000,208310000,207715000,208315000,"chr2",85619,0,4,2,6,"chr2",1,0.00632911392405063
"2953","chr2.64815000.64820000","chr2.64995000.65000000",180000,16,7.164951e-05,64815000,64995000,64820000,6.5e+07,"chr2",85624,5,8,13,26,"chr2",1,0.0487576183778715
"2954","chr2.207855000.207860000","chr2.208165000.208170000",310000,12,0.0004539299,207855000,208165000,207860000,208170000,"chr2",85630,0,7,12,19,"chr2",1,0.0267229254571027
"2955","chr2.42090000.42095000","chr2.42315000.42320000",225000,28,4.43844e-16,42090000,42315000,42095000,42320000,"chr2",85649,0,4,3,7,"chr2",1,0.0229723394280356
"2956","chr2.54925000.54930000","chr2.55400000.55405000",475000,12,3.282478e-05,54925000,55400000,54930000,55405000,"chr2",85698,0,3,2,5,"chr2",1,0.0070323488045007
"2957","chr2.148750000.148755000","chr2.149310000.149315000",560000,10,0.0003900578,148750000,149310000,148755000,149315000,"chr2",85743,3,4,2,9,"chr2",1,0.0105485232067511
"2958","chr2.47265000.47270000","chr2.47520000.47525000",255000,12,0.001538259,47265000,47520000,47270000,47525000,"chr2",85752,3,5,7,15,"chr2",1,0.0210970464135021
"2959","chr2.236510000.236515000","chr2.236565000.236570000",55000,22,0.002337964,236510000,236565000,236515000,236570000,"chr2",85754,1,2,0,3,"chr2",1,0.00773558368495077
"2960","chr2.42340000.42345000","chr2.42420000.42425000",80000,20,0.0003709646,42340000,42420000,42345000,42425000,"chr2",85834,0,0,1,1,"chr2",1,0.0023441162681669
"2961","chr2.196530000.196535000","chr2.196925000.196930000",395000,12,0.000109578,196530000,196925000,196535000,196930000,"chr2",85973,0,1,1,2,"chr2",1,0.00281293952180028
"2962","chr2.54330000.54335000","chr2.54950000.54955000",620000,8,0.005998319,54330000,54950000,54335000,54955000,"chr2",85978,0,1,3,4,"chr2",1,0.00375058602906704
"2963","chr2.54225000.54230000","chr2.54275000.54280000",50000,22,0.00575965,54225000,54275000,54230000,54280000,"chr2",86022,0,2,9,11,"chr2",1,0.0283638068448195
"2964","chr2.219365000.219370000","chr2.219385000.219390000",20000,44,1.88628e-05,219365000,219385000,219370000,219390000,"chr2",86037,0,7,3,10,"chr2",1,0.0515705578996718
"2965","chr2.47205000.47210000","chr2.47400000.47405000",195000,18,1.551728e-06,47205000,47400000,47210000,47405000,"chr2",86046,4,9,5,18,"chr2",1,0.0379746835443038
"2966","chr2.85925000.85930000","chr2.86290000.86295000",365000,10,0.003679247,85925000,86290000,85930000,86295000,"chr2",86134,2,8,6,16,"chr2",1,0.0187529301453352
"2967","chr2.61470000.61475000","chr2.61705000.61710000",235000,12,0.002534677,61470000,61705000,61475000,61710000,"chr2",86183,5,11,10,26,"chr2",1,0.0365682137834037
"2968","chr2.236045000.236050000","chr2.236135000.236140000",90000,24,5.575722e-07,236045000,236135000,236050000,236140000,"chr2",86279,3,7,13,23,"chr2",1,0.0646976090014065
"2969","chr2.58130000.58135000","chr2.58415000.58420000",285000,13,0.0001687235,58130000,58415000,58135000,58420000,"chr2",86302,0,0,3,3,"chr2",1,0.00457102672292546
"2970","chr2.100875000.100880000","chr2.101000000.101005000",125000,17,0.0002760066,100875000,1.01e+08,100880000,101005000,"chr2",86323,0,2,4,6,"chr2",1,0.0119549929676512
"2971","chr2.54270000.54275000","chr2.54880000.54885000",610000,8,0.006426477,54270000,54880000,54275000,54885000,"chr2",86399,0,5,2,7,"chr2",1,0.00656352555086732
"2972","chr2.47510000.47515000","chr2.47530000.47535000",20000,56,1.376457e-10,47510000,47530000,47515000,47535000,"chr2",86434,1,1,2,4,"chr2",1,0.0262541022034693
"2973","chr2.61915000.61920000","chr2.62075000.62080000",160000,14,0.002294501,61915000,62075000,61920000,62080000,"chr2",86436,2,15,10,27,"chr2",1,0.0443037974683544
"2974","chr2.54430000.54435000","chr2.54755000.54760000",325000,12,0.0003470198,54430000,54755000,54435000,54760000,"chr2",86491,1,4,4,9,"chr2",1,0.0126582278481013
"2975","chr2.28820000.28825000","chr2.29040000.29045000",220000,13,0.001032804,28820000,29040000,28825000,29045000,"chr2",86590,0,3,1,4,"chr2",1,0.00609470229723394
"2976","chr2.46465000.46470000","chr2.46490000.46495000",25000,36,0.001114518,46465000,46490000,46470000,46495000,"chr2",86606,4,10,14,28,"chr2",1,0.118143459915612
"2977","chr2.200860000.200865000","chr2.201360000.201365000",500000,17,5.881494e-10,200860000,201360000,200865000,201365000,"chr2",86612,0,2,0,2,"chr2",1,0.00398499765588373
"2978","chr2.230940000.230945000","chr2.231465000.231470000",525000,9,0.002886765,230940000,231465000,230945000,231470000,"chr2",86621,1,2,2,5,"chr2",1,0.00527426160337553
"2979","chr2.230865000.230870000","chr2.231015000.231020000",150000,16,0.0002879799,230865000,231015000,230870000,231020000,"chr2",86742,0,2,1,3,"chr2",1,0.00562587904360056
"2980","chr2.62145000.62150000","chr2.62175000.62180000",30000,38,4.830167e-06,62145000,62175000,62150000,62180000,"chr2",86743,0,4,1,5,"chr2",1,0.0222691045475856
"2981","chr2.219120000.219125000","chr2.219275000.219280000",155000,14,0.002774387,219120000,219275000,219125000,219280000,"chr2",86755,2,8,6,16,"chr2",1,0.0262541022034693
"2982","chr2.174745000.174750000","chr2.174900000.174905000",155000,16,0.000226149,174745000,174900000,174750000,174905000,"chr2",86865,2,1,3,6,"chr2",1,0.0112517580872011
"2983","chr2.72825000.72830000","chr2.72970000.72975000",145000,15,0.001250277,72825000,72970000,72830000,72975000,"chr2",86882,0,2,0,2,"chr2",1,0.00351617440225035
"2984","chr2.69720000.69725000","chr2.69770000.69775000",50000,24,0.001005454,69720000,69770000,69725000,69775000,"chr2",86900,6,8,8,22,"chr2",1,0.0618846694796062
"2985","chr2.54300000.54305000","chr2.54925000.54930000",625000,8,0.005803355,54300000,54925000,54305000,54930000,"chr2",87009,0,1,1,2,"chr2",1,0.00187529301453352
"2986","chr2.54160000.54165000","chr2.54925000.54930000",765000,8,0.002159006,54160000,54925000,54165000,54930000,"chr2",87059,0,3,2,5,"chr2",1,0.0046882325363338
"2987","chr2.241180000.241185000","chr2.241370000.241375000",190000,14,0.0007589069,241180000,241370000,241185000,241375000,"chr2",87236,1,4,9,14,"chr2",1,0.0229723394280356
"2988","chr2.178110000.178115000","chr2.178195000.178200000",85000,25,2.932692e-07,178110000,178195000,178115000,178200000,"chr2",87342,2,0,6,8,"chr2",1,0.023441162681669
"2989","chr2.68385000.68390000","chr2.68425000.68430000",40000,27,0.0008355202,68385000,68425000,68390000,68430000,"chr2",87348,2,1,1,4,"chr2",1,0.0126582278481013
"2990","chr2.11300000.11305000","chr2.11540000.11545000",240000,12,0.002235981,11300000,11540000,11305000,11545000,"chr2",87351,0,3,4,7,"chr2",1,0.00984528832630099
"2991","chr2.42090000.42095000","chr2.42420000.42425000",330000,12,0.0003158987,42090000,42420000,42095000,42425000,"chr2",87355,0,2,1,3,"chr2",1,0.00421940928270042
"2992","chr2.190650000.190655000","chr2.191155000.191160000",505000,9,0.003473507,190650000,191155000,190655000,191160000,"chr2",87401,0,3,3,6,"chr2",1,0.00632911392405063
"2993","chr2.159320000.159325000","chr2.159515000.159520000",195000,14,0.0006307952,159320000,159515000,159325000,159520000,"chr2",87402,1,2,5,8,"chr2",1,0.0131270511017346
"2994","chr2.47335000.47340000","chr2.47505000.47510000",170000,15,0.0004387141,47335000,47505000,47340000,47510000,"chr2",87426,2,7,10,19,"chr2",1,0.0334036568213783
"2995","chr2.45870000.45875000","chr2.46010000.46015000",140000,21,3.479897e-07,45870000,46010000,45875000,46015000,"chr2",87516,1,3,2,6,"chr2",1,0.0147679324894515
"2996","chr2.101800000.101805000","chr2.101830000.101835000",30000,31,0.002093764,101800000,101830000,101805000,101835000,"chr2",87554,0,0,3,3,"chr2",1,0.0109001406469761
"2997","chr2.159320000.159325000","chr2.159600000.159605000",280000,12,0.0008587206,159320000,159600000,159325000,159605000,"chr2",87604,1,4,5,10,"chr2",1,0.0140646976090014
"2998","chr2.212595000.212600000","chr2.213270000.213275000",675000,10,0.0001181419,212595000,213270000,212600000,213275000,"chr2",87639,0,2,0,2,"chr2",1,0.0023441162681669
"2999","chr2.55230000.55235000","chr2.55400000.55405000",170000,18,6.052846e-06,55230000,55400000,55235000,55405000,"chr2",87653,2,9,12,23,"chr2",1,0.0485232067510548
"3000","chr2.20580000.20585000","chr2.20835000.20840000",255000,15,1.65865e-05,20580000,20835000,20585000,20840000,"chr2",87665,1,6,2,9,"chr2",1,0.0158227848101266
"3001","chr2.61635000.61640000","chr2.61895000.61900000",260000,11,0.005083305,61635000,61895000,61640000,61900000,"chr2",87689,2,12,9,23,"chr2",1,0.0296530707923113
"3002","chr2.207855000.207860000","chr2.208115000.208120000",260000,12,0.001347242,207855000,208115000,207860000,208120000,"chr2",87795,0,7,6,13,"chr2",1,0.0182841068917018
"3003","chr2.43055000.43060000","chr2.43195000.43200000",140000,16,0.000454493,43055000,43195000,43060000,43200000,"chr2",87803,0,0,1,1,"chr2",1,0.00187529301453352
"3004","chr2.198050000.198055000","chr2.198160000.198165000",110000,20,1.52246e-05,198050000,198160000,198055000,198165000,"chr2",87834,3,18,9,30,"chr2",1,0.070323488045007
"3005","chr2.47225000.47230000","chr2.47400000.47405000",175000,26,2.586238e-12,47225000,47400000,47230000,47405000,"chr2",87873,0,3,2,5,"chr2",1,0.0152367557430849
"3006","chr2.47175000.47180000","chr2.47205000.47210000",30000,37,1.273575e-05,47175000,47205000,47180000,47210000,"chr2",87896,2,4,5,11,"chr2",1,0.0477027660571964
"3007","chr2.26240000.26245000","chr2.26355000.26360000",115000,17,0.0004957577,26240000,26355000,26245000,26360000,"chr2",87923,6,15,15,36,"chr2",1,0.0717299578059072
"3008","chr2.64870000.64875000","chr2.65055000.65060000",185000,19,5.158248e-07,64870000,65055000,64875000,65060000,"chr2",88062,13,23,23,59,"chr2",1,0.131387716830755
"3009","chr2.74440000.74445000","chr2.74460000.74465000",20000,37,0.003413209,74440000,74460000,74445000,74465000,"chr2",88085,1,2,5,8,"chr2",1,0.0346929207688701
"3010","chr2.64820000.64825000","chr2.64995000.65000000",175000,25,1.85491e-11,64820000,64995000,64825000,6.5e+07,"chr2",88215,5,7,9,21,"chr2",1,0.0615330520393812
"3011","chr2.197120000.197125000","chr2.197160000.197165000",40000,27,0.0008355202,197120000,197160000,197125000,197165000,"chr2",88219,0,2,3,5,"chr2",1,0.0158227848101266
"3012","chr2.25275000.25280000","chr2.25320000.25325000",45000,24,0.002886765,25275000,25320000,25280000,25325000,"chr2",88276,0,3,2,5,"chr2",1,0.0140646976090014
"3013","chr2.219160000.219165000","chr2.219570000.219575000",410000,10,0.002159006,219160000,219570000,219165000,219575000,"chr2",88353,0,2,2,4,"chr2",1,0.0046882325363338
"3014","chr2.64875000.64880000","chr2.65065000.65070000",190000,32,1.365662e-18,64875000,65065000,64880000,65070000,"chr2",88383,4,10,17,31,"chr2",1,0.116268166901078
"3015","chr2.85455000.85460000","chr2.85485000.85490000",30000,31,0.002093764,85455000,85485000,85460000,85490000,"chr2",88389,8,27,16,51,"chr2",1,0.185302390998594
"3016","chr2.85675000.85680000","chr2.85730000.85735000",55000,22,0.002337964,85675000,85730000,85680000,85735000,"chr2",88394,0,3,5,8,"chr2",1,0.0206282231598687
"3017","chr2.27095000.27100000","chr2.27115000.27120000",20000,38,0.001797953,27095000,27115000,27100000,27120000,"chr2",88401,5,6,8,19,"chr2",1,0.0846225972808251
"3018","chr2.121490000.121495000","chr2.121810000.121815000",320000,10,0.006519483,121490000,121810000,121495000,121815000,"chr2",88404,1,0,3,4,"chr2",1,0.0046882325363338
"3019","chr2.106190000.106195000","chr2.106635000.106640000",445000,12,5.076598e-05,106190000,106635000,106195000,106640000,"chr2",88441,0,2,0,2,"chr2",1,0.00281293952180028
"3020","chr2.74145000.74150000","chr2.74335000.74340000",190000,17,1.00669e-05,74145000,74335000,74150000,74340000,"chr2",88448,0,2,2,4,"chr2",1,0.00796999531176746
"3021","chr2.25200000.25205000","chr2.25340000.25345000",140000,42,8.240251e-26,25200000,25340000,25205000,25345000,"chr2",88453,2,5,1,8,"chr2",1,0.0393811533052039
"3022","chr2.25270000.25275000","chr2.25315000.25320000",45000,24,0.002886765,25270000,25315000,25275000,25320000,"chr2",88522,3,20,15,38,"chr2",1,0.106891701828411
"3023","chr2.74075000.74080000","chr2.74410000.74415000",335000,11,0.001310839,74075000,74410000,74080000,74415000,"chr2",88530,0,3,4,7,"chr2",1,0.00902484763244257
"3024","chr2.11415000.11420000","chr2.11540000.11545000",125000,15,0.002963736,11415000,11540000,11420000,11545000,"chr2",88550,0,3,4,7,"chr2",1,0.0123066104078762
"3025","chr2.60995000.61000000","chr2.61235000.61240000",240000,12,0.002235981,60995000,61235000,6.1e+07,61240000,"chr2",88643,2,4,2,8,"chr2",1,0.0112517580872011
"3026","chr2.96070000.96075000","chr2.96390000.96395000",320000,13,7.604898e-05,96070000,96390000,96075000,96395000,"chr2",88671,1,4,1,6,"chr2",1,0.00914205344585091
"3027","chr2.58550000.58555000","chr2.58570000.58575000",20000,37,0.003413209,58550000,58570000,58555000,58575000,"chr2",88694,0,0,2,2,"chr2",1,0.00867323019221753
"3028","chr2.191030000.191035000","chr2.191170000.191175000",140000,17,0.000124966,191030000,191170000,191035000,191175000,"chr2",88755,0,0,2,2,"chr2",1,0.00398499765588373
"3029","chr2.219325000.219330000","chr2.219530000.219535000",205000,12,0.005747455,219325000,219530000,219330000,219535000,"chr2",88779,3,2,1,6,"chr2",1,0.00843881856540084
"3030","chr2.230885000.230890000","chr2.230900000.230905000",15000,36,0.006345598,230885000,230900000,230890000,230905000,"chr2",88830,0,3,4,7,"chr2",1,0.029535864978903
"3031","chr2.16070000.16075000","chr2.16665000.16670000",595000,14,8.284764e-08,16070000,16665000,16075000,16670000,"chr2",88877,0,2,1,3,"chr2",1,0.00492264416315049
"3032","chr2.10070000.10075000","chr2.10120000.10125000",50000,22,0.00575965,10070000,10120000,10075000,10125000,"chr2",88941,1,9,6,16,"chr2",1,0.0412564463197375
"3033","chr2.197160000.197165000","chr2.197285000.197290000",125000,16,0.0009414249,197160000,197285000,197165000,197290000,"chr2",89055,0,2,1,3,"chr2",1,0.00562587904360056
"3034","chr2.10975000.10980000","chr2.11250000.11255000",275000,13,0.0002166617,10975000,11250000,10980000,11255000,"chr2",89078,4,5,8,17,"chr2",1,0.0259024847632443
"3035","chr2.38405000.38410000","chr2.38485000.38490000",80000,21,0.0001173801,38405000,38485000,38410000,38490000,"chr2",89082,2,14,12,28,"chr2",1,0.0689170182841069
"3036","chr2.43400000.43405000","chr2.43710000.43715000",310000,10,0.007583919,43400000,43710000,43405000,43715000,"chr2",89085,0,0,3,3,"chr2",1,0.00351617440225035
"3037","chr2.55280000.55285000","chr2.55365000.55370000",85000,27,1.527874e-08,55280000,55365000,55285000,55370000,"chr2",89088,4,16,10,30,"chr2",1,0.0949367088607595
"3038","chr2.70565000.70570000","chr2.70850000.70855000",285000,18,2.43309e-08,70565000,70850000,70570000,70855000,"chr2",89107,1,1,2,4,"chr2",1,0.00843881856540084
"3039","chr2.201780000.201785000","chr2.202005000.202010000",225000,16,1.00669e-05,201780000,202005000,201785000,202010000,"chr2",89133,0,5,3,8,"chr2",1,0.0150023441162682
"3040","chr2.20575000.20580000","chr2.20835000.20840000",260000,13,0.0003266359,20575000,20835000,20580000,20840000,"chr2",89174,2,1,1,4,"chr2",1,0.00609470229723394
"3041","chr2.64870000.64875000","chr2.64995000.65000000",125000,17,0.0002760066,64870000,64995000,64875000,6.5e+07,"chr2",89180,5,8,13,26,"chr2",1,0.0518049695264885
"3042","chr2.16020000.16025000","chr2.16470000.16475000",450000,9,0.00595415,16020000,16470000,16025000,16475000,"chr2",89246,0,2,0,2,"chr2",1,0.00210970464135021
"3043","chr2.54050000.54055000","chr2.54090000.54095000",40000,27,0.0008355202,54050000,54090000,54055000,54095000,"chr2",89247,3,11,16,30,"chr2",1,0.0949367088607595
"3044","chr2.11385000.11390000","chr2.11520000.11525000",135000,17,0.0001605672,11385000,11520000,11390000,11525000,"chr2",89263,0,1,0,1,"chr2",1,0.00199249882794187
"3045","chr2.27070000.27075000","chr2.27190000.27195000",120000,17,0.0003709646,27070000,27190000,27075000,27195000,"chr2",89300,0,4,0,4,"chr2",1,0.00796999531176746
"3046","chr2.54430000.54435000","chr2.54530000.54535000",100000,18,0.0004568419,54430000,54530000,54435000,54535000,"chr2",89355,2,4,9,15,"chr2",1,0.0316455696202532
"3047","chr2.127020000.127025000","chr2.127090000.127095000",70000,20,0.001334591,127020000,127090000,127025000,127095000,"chr2",89434,1,2,2,5,"chr2",1,0.0117205813408345
"3048","chr2.54930000.54935000","chr2.55295000.55300000",365000,10,0.003679247,54930000,55295000,54935000,55300000,"chr2",89510,1,7,6,14,"chr2",1,0.0164088138771683
"3049","chr2.47210000.47215000","chr2.47530000.47535000",320000,17,5.305207e-08,47210000,47530000,47215000,47535000,"chr2",89538,6,18,23,47,"chr2",1,0.0936474449132677
"3050","chr2.216010000.216015000","chr2.216030000.216035000",20000,40,0.0004387141,216010000,216030000,216015000,216035000,"chr2",89557,0,2,8,10,"chr2",1,0.046882325363338
"3051","chr2.54550000.54555000","chr2.54930000.54935000",380000,10,0.003066778,54550000,54930000,54555000,54935000,"chr2",89591,0,2,1,3,"chr2",1,0.00351617440225035
"3052","chr2.233470000.233475000","chr2.233490000.233495000",20000,45,8.09957e-06,233470000,233490000,233475000,233495000,"chr2",89596,1,6,1,8,"chr2",1,0.0421940928270042
"3053","chr2.218655000.218660000","chr2.218745000.218750000",90000,32,1.439545e-12,218655000,218745000,218660000,218750000,"chr2",89671,0,3,2,5,"chr2",1,0.0187529301453352
"3054","chr2.182585000.182590000","chr2.182900000.182905000",315000,10,0.007022645,182585000,182900000,182590000,182905000,"chr2",89706,0,2,1,3,"chr2",1,0.00351617440225035
"3055","chr2.54330000.54335000","chr2.54915000.54920000",585000,11,4.754369e-05,54330000,54915000,54335000,54920000,"chr2",89743,0,1,3,4,"chr2",1,0.00515705578996718
"3056","chr2.206960000.206965000","chr2.206980000.206985000",20000,37,0.003413209,206960000,206980000,206965000,206985000,"chr2",89786,0,0,2,2,"chr2",1,0.00867323019221753
"3057","chr2.74390000.74395000","chr2.74420000.74425000",30000,34,0.0001901193,74390000,74420000,74395000,74425000,"chr2",89858,1,6,6,13,"chr2",1,0.0518049695264885
"3058","chr2.69785000.69790000","chr2.69915000.69920000",130000,18,5.587351e-05,69785000,69915000,69790000,69920000,"chr2",89887,1,5,3,9,"chr2",1,0.0189873417721519
"3059","chr2.218370000.218375000","chr2.218565000.218570000",195000,13,0.002290301,218370000,218565000,218375000,218570000,"chr2",89910,2,4,4,10,"chr2",1,0.0152367557430849
"3060","chr2.219280000.219285000","chr2.219385000.219390000",105000,16,0.002972259,219280000,219385000,219285000,219390000,"chr2",89964,0,0,1,1,"chr2",1,0.00187529301453352
"3061","chr2.65175000.65180000","chr2.65265000.65270000",90000,28,1.234362e-09,65175000,65265000,65180000,65270000,"chr2",89977,0,0,4,4,"chr2",1,0.0131270511017346
"3062","chr2.218655000.218660000","chr2.218875000.218880000",220000,13,0.001032804,218655000,218875000,218660000,218880000,"chr2",90044,0,0,2,2,"chr2",1,0.00304735114861697
"3063","chr2.37340000.37345000","chr2.37365000.37370000",25000,39,0.0001128433,37340000,37365000,37345000,37370000,"chr2",90077,1,7,3,11,"chr2",1,0.05028129395218
"3064","chr2.74385000.74390000","chr2.74420000.74425000",35000,30,0.0004101189,74385000,74420000,74390000,74425000,"chr2",90104,1,6,7,14,"chr2",1,0.0492264416315049
"3065","chr2.27355000.27360000","chr2.27440000.27445000",85000,18,0.00185599,27355000,27440000,27360000,27445000,"chr2",90187,1,6,6,13,"chr2",1,0.0274261603375527
"3066","chr2.202275000.202280000","chr2.202490000.202495000",215000,13,0.001206533,202275000,202490000,202280000,202495000,"chr2",90217,3,22,17,42,"chr2",1,0.0639943741209564
"3067","chr2.24960000.24965000","chr2.24995000.25000000",35000,32,6.680712e-05,24960000,24995000,24965000,2.5e+07,"chr2",90249,0,10,7,17,"chr2",1,0.0637599624941397
"3068","chr2.86035000.86040000","chr2.86295000.86300000",260000,11,0.005083305,86035000,86295000,86040000,86300000,"chr2",90252,0,3,1,4,"chr2",1,0.00515705578996718
"3069","chr2.74145000.74150000","chr2.74195000.74200000",50000,26,0.0001443878,74145000,74195000,74150000,74200000,"chr2",90256,0,2,3,5,"chr2",1,0.0152367557430849
"3070","chr2.58130000.58135000","chr2.58505000.58510000",375000,11,0.0007420415,58130000,58505000,58135000,58510000,"chr2",90270,0,0,3,3,"chr2",1,0.00386779184247539
"3071","chr2.240050000.240055000","chr2.240925000.240930000",875000,7,0.005826815,240050000,240925000,240055000,240930000,"chr2",90304,0,2,2,4,"chr2",1,0.00328176277543366
"3072","chr2.27190000.27195000","chr2.27250000.27255000",60000,25,3.958961e-05,27190000,27250000,27195000,27255000,"chr2",90330,7,25,23,55,"chr2",1,0.161157993436474
"3073","chr2.74260000.74265000","chr2.74335000.74340000",75000,19,0.001945659,74260000,74335000,74265000,74340000,"chr2",90352,1,5,2,8,"chr2",1,0.0178152836380684
"3074","chr2.98540000.98545000","chr2.98570000.98575000",30000,34,0.0001901193,98540000,98570000,98545000,98575000,"chr2",90354,0,3,0,3,"chr2",1,0.0119549929676512
"3075","chr2.9345000.9350000","chr2.9470000.9475000",125000,16,0.0009414249,9345000,9470000,9350000,9475000,"chr2",90385,1,6,3,10,"chr2",1,0.0187529301453352
"3076","chr2.79965000.79970000","chr2.80060000.80065000",95000,16,0.005948559,79965000,80060000,79970000,80065000,"chr2",90400,0,0,3,3,"chr2",1,0.00562587904360056
"3077","chr2.219575000.219580000","chr2.219645000.219650000",70000,69,3.304281e-43,219575000,219645000,219580000,219650000,"chr2",90417,2,6,2,10,"chr2",1,0.0808720112517581
"3078","chr2.69825000.69830000","chr2.69930000.69935000",105000,15,0.008351178,69825000,69930000,69830000,69935000,"chr2",90456,0,2,1,3,"chr2",1,0.00527426160337553
"3079","chr2.61760000.61765000","chr2.61990000.61995000",230000,23,1.65656e-11,61760000,61990000,61765000,61995000,"chr2",90470,2,10,8,20,"chr2",1,0.0539146741678387
"3080","chr2.178130000.178135000","chr2.178190000.178195000",60000,21,0.002389334,178130000,178190000,178135000,178195000,"chr2",90618,2,5,5,12,"chr2",1,0.029535864978903
"3081","chr2.54550000.54555000","chr2.54705000.54710000",155000,16,0.000226149,54550000,54705000,54555000,54710000,"chr2",90623,0,2,1,3,"chr2",1,0.00562587904360056
"3082","chr2.64885000.64890000","chr2.64995000.65000000",110000,17,0.0006956574,64885000,64995000,64890000,6.5e+07,"chr2",90640,2,8,4,14,"chr2",1,0.0278949835911861
"3083","chr2.232950000.232955000","chr2.233205000.233210000",255000,13,0.0003712596,232950000,233205000,232955000,233210000,"chr2",90689,1,7,8,16,"chr2",1,0.0243788091889358
"3084","chr2.73005000.73010000","chr2.73100000.73105000",95000,17,0.002159006,73005000,73100000,73010000,73105000,"chr2",90697,0,2,1,3,"chr2",1,0.0059774964838256
"3085","chr2.218285000.218290000","chr2.218315000.218320000",30000,39,1.775139e-06,218285000,218315000,218290000,218320000,"chr2",90754,1,11,7,19,"chr2",1,0.0868495077355837
"3086","chr2.65265000.65270000","chr2.65360000.65365000",95000,20,6.563062e-05,65265000,65360000,65270000,65365000,"chr2",90817,0,0,4,4,"chr2",1,0.00937646507266761
"3087","chr2.98540000.98545000","chr2.98915000.98920000",375000,10,0.003261558,98540000,98915000,98545000,98920000,"chr2",90831,1,5,6,12,"chr2",1,0.0140646976090014
"3088","chr2.47205000.47210000","chr2.47510000.47515000",305000,15,3.537932e-06,47205000,47510000,47210000,47515000,"chr2",90884,1,1,2,4,"chr2",1,0.0070323488045007
"3089","chr2.219575000.219580000","chr2.219660000.219665000",85000,19,0.0006307952,219575000,219660000,219580000,219665000,"chr2",90928,2,13,7,22,"chr2",1,0.0489920300046882
"3090","chr2.1910000.1915000","chr2.2105000.2110000",195000,12,0.007583919,1910000,2105000,1915000,2110000,"chr2",90975,0,1,2,3,"chr2",1,0.00421940928270042
"3091","chr2.218670000.218675000","chr2.218745000.218750000",75000,18,0.005080411,218670000,218745000,218675000,218750000,"chr2",91025,0,2,3,5,"chr2",1,0.0105485232067511
"3092","chr2.38530000.38535000","chr2.38945000.38950000",415000,10,0.002039678,38530000,38945000,38535000,38950000,"chr2",91041,1,9,12,22,"chr2",1,0.0257852789498359
"3093","chr2.42335000.42340000","chr2.42420000.42425000",85000,18,0.00185599,42335000,42420000,42340000,42425000,"chr2",91048,0,2,1,3,"chr2",1,0.00632911392405063
"3094","chr2.172695000.172700000","chr2.172790000.172795000",95000,18,0.0007170619,172695000,172790000,172700000,172795000,"chr2",91087,0,1,2,3,"chr2",1,0.00632911392405063
"3095","chr2.24720000.24725000","chr2.24995000.25000000",275000,14,4.512301e-05,24720000,24995000,24725000,2.5e+07,"chr2",91095,1,2,3,6,"chr2",1,0.00984528832630099
"3096","chr2.230890000.230895000","chr2.231465000.231470000",575000,9,0.001818529,230890000,231465000,230895000,231470000,"chr2",91100,2,6,3,11,"chr2",1,0.0116033755274262
"3097","chr2.142855000.142860000","chr2.142880000.142885000",25000,35,0.002278734,142855000,142880000,142860000,142885000,"chr2",91206,2,3,6,11,"chr2",1,0.0451242381622128
"3098","chr2.38825000.38830000","chr2.38960000.38965000",135000,26,9.926034e-11,38825000,38960000,38830000,38965000,"chr2",91211,0,0,2,2,"chr2",1,0.00609470229723394
"3099","chr2.218385000.218390000","chr2.218575000.218580000",190000,12,0.008687146,218385000,218575000,218390000,218580000,"chr2",91216,4,18,18,40,"chr2",1,0.0562587904360056
"3100","chr2.38115000.38120000","chr2.38505000.38510000",390000,10,0.002740393,38115000,38505000,38120000,38510000,"chr2",91275,1,1,3,5,"chr2",1,0.00586029067041725
"3101","chr2.61915000.61920000","chr2.62115000.62120000",200000,12,0.006519483,61915000,62115000,61920000,62120000,"chr2",91278,5,7,5,17,"chr2",1,0.0239099859353024
"3102","chr2.172735000.172740000","chr2.172860000.172865000",125000,19,1.908347e-05,172735000,172860000,172740000,172865000,"chr2",91316,0,2,1,3,"chr2",1,0.00668073136427567
"3103","chr2.42360000.42365000","chr2.42380000.42385000",20000,36,0.006345598,42360000,42380000,42365000,42385000,"chr2",91332,4,6,5,15,"chr2",1,0.0632911392405063
"3104","chr2.39515000.39520000","chr2.39580000.39585000",65000,19,0.006728756,39515000,39580000,39520000,39585000,"chr2",91351,0,2,3,5,"chr2",1,0.0111345522737928
"3105","chr2.20575000.20580000","chr2.20640000.20645000",65000,24,4.147305e-05,20575000,20640000,20580000,20645000,"chr2",91399,1,1,1,3,"chr2",1,0.00843881856540084
"3106","chr2.230710000.230715000","chr2.230780000.230785000",70000,21,0.0004728668,230710000,230780000,230715000,230785000,"chr2",91411,2,7,10,19,"chr2",1,0.0467651195499297
"3107","chr2.112625000.112630000","chr2.112820000.112825000",195000,12,0.007583919,112625000,112820000,112630000,112825000,"chr2",91472,3,5,10,18,"chr2",1,0.0253164556962025
"3108","chr2.47210000.47215000","chr2.47520000.47525000",310000,14,1.803561e-05,47210000,47520000,47215000,47525000,"chr2",91481,3,5,7,15,"chr2",1,0.0246132208157525
"3109","chr2.208100000.208105000","chr2.208320000.208325000",220000,14,0.0002574937,208100000,208320000,208105000,208325000,"chr2",91554,3,7,7,17,"chr2",1,0.0278949835911861
"3110","chr2.48340000.48345000","chr2.48600000.48605000",260000,11,0.005083305,48340000,48600000,48345000,48605000,"chr2",91583,0,0,2,2,"chr2",1,0.00257852789498359
"3111","chr2.9430000.9435000","chr2.10185000.10190000",755000,8,0.002290301,9430000,10185000,9435000,10190000,"chr2",91619,1,1,1,3,"chr2",1,0.00281293952180028
"3112","chr2.178160000.178165000","chr2.178190000.178195000",30000,36,3.282478e-05,178160000,178190000,178165000,178195000,"chr2",91690,2,2,3,7,"chr2",1,0.029535864978903
"3113","chr2.24740000.24745000","chr2.24970000.24975000",230000,11,0.009837087,24740000,24970000,24745000,24975000,"chr2",91733,1,2,2,5,"chr2",1,0.00644631973745898
"3114","chr2.54105000.54110000","chr2.54330000.54335000",225000,13,0.0009045029,54105000,54330000,54110000,54335000,"chr2",91734,0,1,3,4,"chr2",1,0.00609470229723394
"3115","chr2.43195000.43200000","chr2.43715000.43720000",520000,9,0.00301907,43195000,43715000,43200000,43720000,"chr2",91745,0,16,16,32,"chr2",1,0.0337552742616034
"3116","chr2.101730000.101735000","chr2.101765000.101770000",35000,32,6.680712e-05,101730000,101765000,101735000,101770000,"chr2",91768,1,5,10,16,"chr2",1,0.0600093764650727
"3117","chr2.69790000.69795000","chr2.69825000.69830000",35000,26,0.009419337,69790000,69825000,69795000,69830000,"chr2",91892,0,3,1,4,"chr2",1,0.0121894045944679
"3118","chr2.25275000.25280000","chr2.25330000.25335000",55000,23,0.0009333356,25275000,25330000,25280000,25335000,"chr2",91970,0,1,2,3,"chr2",1,0.00808720112517581
"3119","chr2.96870000.96875000","chr2.96925000.96930000",55000,31,1.022664e-07,96870000,96925000,96875000,96930000,"chr2",91975,1,3,1,5,"chr2",1,0.0181669010782935
"3120","chr2.64915000.64920000","chr2.65065000.65070000",150000,19,4.11268e-06,64915000,65065000,64920000,65070000,"chr2",92055,5,11,17,33,"chr2",1,0.0734880450070323
"3121","chr2.232585000.232590000","chr2.232630000.232635000",45000,25,0.001208006,232585000,232630000,232590000,232635000,"chr2",92083,7,9,7,23,"chr2",1,0.0673933427097984
"3122","chr2.61760000.61765000","chr2.62115000.62120000",355000,14,6.674173e-06,61760000,62115000,61765000,62120000,"chr2",92157,2,7,5,14,"chr2",1,0.0229723394280356
"3123","chr2.47345000.47350000","chr2.47365000.47370000",20000,37,0.003413209,47345000,47365000,47350000,47370000,"chr2",92161,2,12,11,25,"chr2",1,0.108415377402719
"3124","chr2.61660000.61665000","chr2.62075000.62080000",415000,9,0.00850255,61660000,62075000,61665000,62080000,"chr2",92165,2,12,6,20,"chr2",1,0.0210970464135021
"3125","chr2.61990000.61995000","chr2.62115000.62120000",125000,16,0.0009414249,61990000,62115000,61995000,62120000,"chr2",92294,5,7,5,17,"chr2",1,0.0318799812470699
"3126","chr2.119640000.119645000","chr2.120040000.120045000",400000,9,0.009836434,119640000,120040000,119645000,120045000,"chr2",92327,6,8,5,19,"chr2",1,0.020042194092827
"3127","chr2.85580000.85585000","chr2.85795000.85800000",215000,12,0.004349821,85580000,85795000,85585000,85800000,"chr2",92427,0,3,2,5,"chr2",1,0.0070323488045007
"3128","chr2.69385000.69390000","chr2.69510000.69515000",125000,14,0.008580544,69385000,69510000,69390000,69515000,"chr2",92459,0,0,2,2,"chr2",1,0.00328176277543366
"3129","chr2.231760000.231765000","chr2.231850000.231855000",90000,23,2.304042e-06,231760000,231850000,231765000,231855000,"chr2",92606,5,8,11,24,"chr2",1,0.0646976090014065
"3130","chr2.42115000.42120000","chr2.42255000.42260000",140000,14,0.004846327,42115000,42255000,42120000,42260000,"chr2",92638,2,3,2,7,"chr2",1,0.0114861697140178
"3131","chr2.223610000.223615000","chr2.223650000.223655000",40000,26,0.001945659,223610000,223650000,223615000,223655000,"chr2",92743,0,2,2,4,"chr2",1,0.0121894045944679
"3132","chr2.37675000.37680000","chr2.38105000.38110000",430000,9,0.007245928,37675000,38105000,37680000,38110000,"chr2",92759,0,3,1,4,"chr2",1,0.00421940928270042
"3133","chr2.86065000.86070000","chr2.86290000.86295000",225000,14,0.0002166617,86065000,86290000,86070000,86295000,"chr2",92809,1,6,6,13,"chr2",1,0.0213314580403188
"3134","chr2.219570000.219575000","chr2.219640000.219645000",70000,22,0.0001599504,219570000,219640000,219575000,219645000,"chr2",92883,1,2,2,5,"chr2",1,0.012892639474918
"3135","chr2.27750000.27755000","chr2.27770000.27775000",20000,45,8.09957e-06,27750000,27770000,27755000,27775000,"chr2",93018,3,4,4,11,"chr2",1,0.0580168776371308
"3136","chr2.198295000.198300000","chr2.198380000.198385000",85000,31,2.447579e-11,198295000,198380000,198300000,198385000,"chr2",93062,0,2,3,5,"chr2",1,0.0181669010782935
"3137","chr2.80015000.80020000","chr2.80035000.80040000",20000,39,0.0009045029,80015000,80035000,80020000,80040000,"chr2",93099,0,1,1,2,"chr2",1,0.00914205344585091
"3138","chr2.24075000.24080000","chr2.24100000.24105000",25000,35,0.002278734,24075000,24100000,24080000,24105000,"chr2",93129,1,2,3,6,"chr2",1,0.0246132208157525
"3139","chr2.219570000.219575000","chr2.219645000.219650000",75000,50,8.810518e-26,219570000,219645000,219575000,219650000,"chr2",93184,2,2,2,6,"chr2",1,0.0351617440225035
"3140","chr2.61690000.61695000","chr2.61990000.61995000",300000,13,0.000118199,61690000,61990000,61695000,61995000,"chr2",93227,6,10,8,24,"chr2",1,0.0365682137834037
"3141","chr2.70130000.70135000","chr2.70505000.70510000",375000,11,0.0007420415,70130000,70505000,70135000,70510000,"chr2",93235,0,3,0,3,"chr2",1,0.00386779184247539
"3142","chr2.47310000.47315000","chr2.47335000.47340000",25000,36,0.001114518,47310000,47335000,47315000,47340000,"chr2",93305,5,11,5,21,"chr2",1,0.0886075949367089
"3143","chr2.54090000.54095000","chr2.54290000.54295000",200000,13,0.001954724,54090000,54290000,54095000,54295000,"chr2",93341,3,7,7,17,"chr2",1,0.0259024847632443
"3144","chr2.54440000.54445000","chr2.54930000.54935000",490000,14,5.158248e-07,54440000,54930000,54445000,54935000,"chr2",93353,5,7,6,18,"chr2",1,0.029535864978903
"3145","chr2.232760000.232765000","chr2.232955000.232960000",195000,12,0.007583919,232760000,232955000,232765000,232960000,"chr2",93457,2,4,3,9,"chr2",1,0.0126582278481013
"3146","chr2.171345000.171350000","chr2.171415000.171420000",70000,18,0.008738458,171345000,171415000,171350000,171420000,"chr2",93533,2,1,0,3,"chr2",1,0.00632911392405063
"3147","chr2.96870000.96875000","chr2.96920000.96925000",50000,23,0.002462653,96870000,96920000,96875000,96925000,"chr2",93651,0,17,16,33,"chr2",1,0.0889592123769339
"3148","chr2.197160000.197165000","chr2.197435000.197440000",275000,15,8.587624e-06,197160000,197435000,197165000,197440000,"chr2",93671,0,2,3,5,"chr2",1,0.00879043600562588
"3149","chr2.64325000.64330000","chr2.64460000.64465000",135000,16,0.0005730747,64325000,64460000,64330000,64465000,"chr2",93687,0,0,2,2,"chr2",1,0.00375058602906704
"3150","chr2.70530000.70535000","chr2.70860000.70865000",330000,19,6.249664e-10,70530000,70860000,70535000,70865000,"chr2",93724,3,1,0,4,"chr2",1,0.00890764181903422
"3151","chr2.1975000.1980000","chr2.2010000.2015000",35000,37,3.844298e-07,1975000,2010000,1980000,2015000,"chr2",93747,0,2,1,3,"chr2",1,0.0130098452883263
"3152","chr2.54175000.54180000","chr2.55135000.55140000",960000,8,0.0004946926,54175000,55135000,54180000,55140000,"chr2",93807,0,2,2,4,"chr2",1,0.00375058602906704
"3153","chr2.109065000.109070000","chr2.109195000.109200000",130000,15,0.002363495,109065000,109195000,109070000,109200000,"chr2",93833,0,0,3,3,"chr2",1,0.00527426160337553
"3154","chr2.42085000.42090000","chr2.42440000.42445000",355000,11,0.0009757651,42085000,42440000,42090000,42445000,"chr2",93846,2,1,2,5,"chr2",1,0.00644631973745898
"3155","chr2.232040000.232045000","chr2.232305000.232310000",265000,12,0.001195928,232040000,232305000,232045000,232310000,"chr2",93864,0,2,2,4,"chr2",1,0.00562587904360056
"3156","chr2.55510000.55515000","chr2.55645000.55650000",135000,22,1.000276e-07,55510000,55645000,55515000,55650000,"chr2",93979,5,10,16,31,"chr2",1,0.0799343647444913
"3157","chr2.26145000.26150000","chr2.26380000.26385000",235000,11,0.008738458,26145000,26380000,26150000,26385000,"chr2",94034,2,16,11,29,"chr2",1,0.0373886544772621
"3158","chr2.24640000.24645000","chr2.24985000.24990000",345000,10,0.004694997,24640000,24985000,24645000,24990000,"chr2",94058,2,1,0,3,"chr2",1,0.00351617440225035
"3159","chr2.47400000.47405000","chr2.47530000.47535000",130000,33,2.084063e-16,47400000,47530000,47405000,47535000,"chr2",94148,6,18,20,44,"chr2",1,0.170182841068917
"3160","chr2.9415000.9420000","chr2.9430000.9435000",15000,37,0.003413209,9415000,9430000,9420000,9435000,"chr2",94155,2,4,4,10,"chr2",1,0.0433661509610877
"3161","chr2.203135000.203140000","chr2.203235000.203240000",100000,16,0.00419449,203135000,203235000,203140000,203240000,"chr2",94182,1,3,3,7,"chr2",1,0.0131270511017346
"3162","chr2.80015000.80020000","chr2.80055000.80060000",40000,30,4.964184e-05,80015000,80055000,80020000,80060000,"chr2",94191,0,1,1,2,"chr2",1,0.0070323488045007
"3163","chr2.72810000.72815000","chr2.72970000.72975000",160000,15,0.0006747692,72810000,72970000,72815000,72975000,"chr2",94194,0,2,0,2,"chr2",1,0.00351617440225035
"3164","chr2.16055000.16060000","chr2.16665000.16670000",610000,8,0.006426477,16055000,16665000,16060000,16670000,"chr2",94290,0,2,1,3,"chr2",1,0.00281293952180028
"3165","chr2.27200000.27205000","chr2.27250000.27255000",50000,22,0.00575965,27200000,27250000,27205000,27255000,"chr2",94298,0,2,3,5,"chr2",1,0.012892639474918
"3166","chr2.69890000.69895000","chr2.69930000.69935000",40000,26,0.001945659,69890000,69930000,69895000,69935000,"chr2",94307,1,2,3,6,"chr2",1,0.0182841068917018
"3167","chr2.190945000.190950000","chr2.191035000.191040000",90000,18,0.001121902,190945000,191035000,190950000,191040000,"chr2",94355,2,4,1,7,"chr2",1,0.0147679324894515
"3168","chr2.55110000.55115000","chr2.55165000.55170000",55000,21,0.005634437,55110000,55165000,55115000,55170000,"chr2",94507,0,1,1,2,"chr2",1,0.00492264416315049
"3169","chr2.203495000.203500000","chr2.204105000.204110000",610000,8,0.006426477,203495000,204105000,203500000,204110000,"chr2",94511,0,4,3,7,"chr2",1,0.00656352555086732
"3170","chr2.54980000.54985000","chr2.55415000.55420000",435000,10,0.001614961,54980000,55415000,54985000,55420000,"chr2",94533,3,4,6,13,"chr2",1,0.0152367557430849
"3171","chr2.178210000.178215000","chr2.178250000.178255000",40000,36,6.458346e-08,178210000,178250000,178215000,178255000,"chr2",94604,0,5,2,7,"chr2",1,0.029535864978903
"3172","chr2.74175000.74180000","chr2.74195000.74200000",20000,45,8.09957e-06,74175000,74195000,74180000,74200000,"chr2",94636,1,16,11,28,"chr2",1,0.147679324894515
"3173","chr2.27070000.27075000","chr2.27120000.27125000",50000,32,1.507461e-07,27070000,27120000,27075000,27125000,"chr2",94643,0,3,0,3,"chr2",1,0.0112517580872011
"3174","chr2.10270000.10275000","chr2.10810000.10815000",540000,10,0.0004824085,10270000,10810000,10275000,10815000,"chr2",94682,3,4,4,11,"chr2",1,0.012892639474918
"3175","chr2.25105000.25110000","chr2.25125000.25130000",20000,36,0.006345598,25105000,25125000,25110000,25130000,"chr2",94760,2,15,9,26,"chr2",1,0.109704641350211
"3176","chr2.9300000.9305000","chr2.9475000.9480000",175000,19,9.29699e-07,9300000,9475000,9305000,9480000,"chr2",94762,2,6,6,14,"chr2",1,0.0311767463666198
"3177","chr2.61045000.61050000","chr2.61235000.61240000",190000,16,4.571848e-05,61045000,61235000,61050000,61240000,"chr2",94773,2,4,2,8,"chr2",1,0.0150023441162682
"3178","chr2.207625000.207630000","chr2.208440000.208445000",815000,8,0.001519918,207625000,208440000,207630000,208445000,"chr2",94812,5,17,11,33,"chr2",1,0.0309423347398031
"3179","chr2.219430000.219435000","chr2.219520000.219525000",90000,17,0.003259365,219430000,219520000,219435000,219525000,"chr2",94874,0,1,0,1,"chr2",1,0.00199249882794187
"3180","chr2.232850000.232855000","chr2.232955000.232960000",105000,18,0.0003075462,232850000,232955000,232855000,232960000,"chr2",94888,2,15,17,34,"chr2",1,0.0717299578059072
"3181","chr2.45835000.45840000","chr2.46170000.46175000",335000,12,0.0002879799,45835000,46170000,45840000,46175000,"chr2",94903,3,0,1,4,"chr2",1,0.00562587904360056
"3182","chr2.24640000.24645000","chr2.24880000.24885000",240000,11,0.007887179,24640000,24880000,24645000,24885000,"chr2",94927,0,1,0,1,"chr2",1,0.0012892639474918
"3183","chr2.64995000.65000000","chr2.65065000.65070000",70000,23,5.082543e-05,64995000,65065000,6.5e+07,65070000,"chr2",94942,5,8,13,26,"chr2",1,0.0700890764181903
"3184","chr2.105745000.105750000","chr2.105845000.105850000",100000,18,0.0004568419,105745000,105845000,105750000,105850000,"chr2",95037,2,1,0,3,"chr2",1,0.00632911392405063
"3185","chr2.39200000.39205000","chr2.39225000.39230000",25000,33,0.008420578,39200000,39225000,39205000,39230000,"chr2",95071,0,2,1,3,"chr2",1,0.0116033755274262
"3186","chr2.165715000.165720000","chr2.165760000.165765000",45000,27,0.0001900709,165715000,165760000,165720000,165765000,"chr2",95078,2,4,4,10,"chr2",1,0.0316455696202532
"3187","chr2.70190000.70195000","chr2.70290000.70295000",100000,18,0.0004568419,70190000,70290000,70195000,70295000,"chr2",95232,4,15,30,49,"chr2",1,0.10337552742616
"3188","chr2.198050000.198055000","chr2.198170000.198175000",120000,31,4.381447e-14,198050000,198170000,198055000,198175000,"chr2",95247,1,1,4,6,"chr2",1,0.0218002812939522
"3189","chr2.96070000.96075000","chr2.96405000.96410000",335000,10,0.005371145,96070000,96405000,96075000,96410000,"chr2",95254,1,4,1,6,"chr2",1,0.0070323488045007
"3190","chr2.27075000.27080000","chr2.27095000.27100000",20000,44,1.88628e-05,27075000,27095000,27080000,27100000,"chr2",95408,1,6,8,15,"chr2",1,0.0773558368495077
"3191","chr2.64820000.64825000","chr2.64885000.64890000",65000,19,0.006728756,64820000,64885000,64825000,64890000,"chr2",95440,2,7,4,13,"chr2",1,0.0289498359118612
"3192","chr2.230925000.230930000","chr2.231385000.231390000",460000,9,0.005418901,230925000,231385000,230930000,231390000,"chr2",95523,4,3,8,15,"chr2",1,0.0158227848101266
"3193","chr2.158930000.158935000","chr2.158995000.159000000",65000,24,4.147305e-05,158930000,158995000,158935000,1.59e+08,"chr2",95526,4,10,9,23,"chr2",1,0.0646976090014065
"3194","chr2.46695000.46700000","chr2.46855000.46860000",160000,16,0.0001810214,46695000,46855000,46700000,46860000,"chr2",95578,2,2,4,8,"chr2",1,0.0150023441162682
"3195","chr2.197265000.197270000","chr2.197290000.197295000",25000,33,0.008420578,197265000,197290000,197270000,197295000,"chr2",95583,0,3,0,3,"chr2",1,0.0116033755274262
"3196","chr2.148100000.148105000","chr2.148130000.148135000",30000,30,0.004323057,148100000,148130000,148105000,148135000,"chr2",95624,2,3,8,13,"chr2",1,0.0457102672292546
"3197","chr2.234935000.234940000","chr2.235430000.235435000",495000,9,0.003838505,234935000,235430000,234940000,235435000,"chr2",95634,0,3,4,7,"chr2",1,0.00738396624472574
"3198","chr2.232955000.232960000","chr2.232995000.233000000",40000,25,0.004349821,232955000,232995000,232960000,2.33e+08,"chr2",95639,1,16,15,32,"chr2",1,0.093764650726676
"3199","chr2.9005000.9010000","chr2.9265000.9270000",260000,13,0.0003266359,9005000,9265000,9010000,9270000,"chr2",95642,2,5,5,12,"chr2",1,0.0182841068917018
"3200","chr2.223590000.223595000","chr2.223685000.223690000",95000,18,0.0007170619,223590000,223685000,223595000,223690000,"chr2",95712,0,5,3,8,"chr2",1,0.0168776371308017
"3201","chr2.9300000.9305000","chr2.9595000.9600000",295000,12,0.0006175335,9300000,9595000,9305000,9600000,"chr2",95721,2,6,7,15,"chr2",1,0.0210970464135021
"3202","chr2.65165000.65170000","chr2.65230000.65235000",65000,20,0.002745608,65165000,65230000,65170000,65235000,"chr2",95736,8,14,8,30,"chr2",1,0.070323488045007
"3203","chr2.26135000.26140000","chr2.26350000.26355000",215000,12,0.004349821,26135000,26350000,26140000,26355000,"chr2",95737,0,4,6,10,"chr2",1,0.0140646976090014
"3204","chr2.160965000.160970000","chr2.161825000.161830000",860000,8,0.001086022,160965000,161825000,160970000,161830000,"chr2",95762,0,0,5,5,"chr2",1,0.0046882325363338
"3205","chr2.235050000.235055000","chr2.235380000.235385000",330000,15,1.846034e-06,235050000,235380000,235055000,235385000,"chr2",95778,0,0,4,4,"chr2",1,0.0070323488045007
"3206","chr2.183160000.183165000","chr2.183490000.183495000",330000,11,0.001422015,183160000,183490000,183165000,183495000,"chr2",95802,0,4,2,6,"chr2",1,0.00773558368495077
"3207","chr2.25200000.25205000","chr2.25270000.25275000",70000,19,0.003527572,25200000,25270000,25205000,25275000,"chr2",95827,2,16,12,30,"chr2",1,0.0668073136427567
"3208","chr2.24720000.24725000","chr2.24775000.24780000",55000,21,0.005634437,24720000,24775000,24725000,24780000,"chr2",95841,1,2,3,6,"chr2",1,0.0147679324894515
"3209","chr2.25275000.25280000","chr2.25300000.25305000",25000,33,0.008420578,25275000,25300000,25280000,25305000,"chr2",95860,0,3,2,5,"chr2",1,0.0193389592123769
"3210","chr2.201795000.201800000","chr2.201860000.201865000",65000,20,0.002745608,201795000,201860000,201800000,201865000,"chr2",95865,0,7,7,14,"chr2",1,0.0328176277543366
"3211","chr2.42085000.42090000","chr2.42340000.42345000",255000,14,8.147561e-05,42085000,42340000,42090000,42345000,"chr2",95915,0,0,4,4,"chr2",1,0.00656352555086732
"3212","chr2.11350000.11355000","chr2.11530000.11535000",180000,13,0.003742372,11350000,11530000,11355000,11535000,"chr2",95975,3,12,10,25,"chr2",1,0.0380918893577121
"3213","chr2.65165000.65170000","chr2.65265000.65270000",100000,29,3.911221e-11,65165000,65265000,65170000,65270000,"chr2",96002,0,0,4,4,"chr2",1,0.013595874355368
"3214","chr2.10950000.10955000","chr2.11760000.11765000",810000,8,0.001571541,10950000,11760000,10955000,11765000,"chr2",96041,0,2,6,8,"chr2",1,0.00750117205813408
"3215","chr2.69600000.69605000","chr2.69740000.69745000",140000,16,0.000454493,69600000,69740000,69605000,69745000,"chr2",96102,2,1,2,5,"chr2",1,0.00937646507266761
"3216","chr2.27890000.27895000","chr2.28680000.28685000",790000,7,0.00949,27890000,28680000,27895000,28685000,"chr2",96108,0,0,2,2,"chr2",1,0.00164088138771683
"3217","chr2.54175000.54180000","chr2.54270000.54275000",95000,16,0.005948559,54175000,54270000,54180000,54275000,"chr2",96116,3,5,7,15,"chr2",1,0.0281293952180028
"3218","chr2.27075000.27080000","chr2.27120000.27125000",45000,29,2.462297e-05,27075000,27120000,27080000,27125000,"chr2",96134,1,3,1,5,"chr2",1,0.01699484294421
"3219","chr2.43055000.43060000","chr2.43710000.43715000",655000,39,7.265607e-41,43055000,43710000,43060000,43715000,"chr2",96192,0,0,1,1,"chr2",1,0.00457102672292546
"3220","chr2.48105000.48110000","chr2.48325000.48330000",220000,13,0.001032804,48105000,48325000,48110000,48330000,"chr2",96226,0,1,1,2,"chr2",1,0.00304735114861697
"3221","chr2.86065000.86070000","chr2.86295000.86300000",230000,12,0.002895462,86065000,86295000,86070000,86300000,"chr2",96266,0,3,6,9,"chr2",1,0.0126582278481013
"3222","chr2.47175000.47180000","chr2.47530000.47535000",355000,11,0.0009757651,47175000,47530000,47180000,47535000,"chr2",96269,2,4,8,14,"chr2",1,0.0180496952648851
"3223","chr2.73005000.73010000","chr2.73060000.73065000",55000,21,0.005634437,73005000,73060000,73010000,73065000,"chr2",96311,0,2,1,3,"chr2",1,0.00738396624472574
"3224","chr2.224560000.224565000","chr2.224585000.224590000",25000,36,0.001114518,224560000,224585000,224565000,224590000,"chr2",96380,0,2,0,2,"chr2",1,0.00843881856540084
"3225","chr2.232760000.232765000","chr2.233180000.233185000",420000,11,0.000400534,232760000,233180000,232765000,233185000,"chr2",96403,3,4,3,10,"chr2",1,0.012892639474918
"3226","chr2.32770000.32775000","chr2.33595000.33600000",825000,10,2.828e-05,32770000,33595000,32775000,33600000,"chr2",96514,0,3,2,5,"chr2",1,0.00586029067041725
"3227","chr2.53565000.53570000","chr2.53880000.53885000",315000,10,0.007022645,53565000,53880000,53570000,53885000,"chr2",96586,0,3,0,3,"chr2",1,0.00351617440225035
"3228","chr2.218295000.218300000","chr2.218575000.218580000",280000,18,2.92713e-08,218295000,218575000,218300000,218580000,"chr2",96670,8,19,24,51,"chr2",1,0.107594936708861
"3229","chr2.219170000.219175000","chr2.219215000.219220000",45000,25,0.001208006,219170000,219215000,219175000,219220000,"chr2",96683,1,10,5,16,"chr2",1,0.046882325363338
"3230","chr2.197845000.197850000","chr2.198050000.198055000",205000,13,0.001674721,197845000,198050000,197850000,198055000,"chr2",96771,3,0,2,5,"chr2",1,0.00761837787154243
"3231","chr2.233470000.233475000","chr2.233565000.233570000",95000,18,0.0007170619,233470000,233565000,233475000,233570000,"chr2",96776,0,1,3,4,"chr2",1,0.00843881856540084
"3232","chr2.230865000.230870000","chr2.231465000.231470000",600000,8,0.006971584,230865000,231465000,230870000,231470000,"chr2",96780,0,2,1,3,"chr2",1,0.00281293952180028
"3233","chr2.178130000.178135000","chr2.178160000.178165000",30000,33,0.0004387141,178130000,178160000,178135000,178165000,"chr2",96813,2,2,3,7,"chr2",1,0.0270745428973277
"3234","chr2.42085000.42090000","chr2.42190000.42195000",105000,18,0.0003075462,42085000,42190000,42090000,42195000,"chr2",96922,4,11,7,22,"chr2",1,0.0464135021097046
"3235","chr2.48560000.48565000","chr2.48585000.48590000",25000,43,3.460641e-06,48560000,48585000,48565000,48590000,"chr2",96965,2,6,6,14,"chr2",1,0.0705578996718237
"3236","chr2.223260000.223265000","chr2.223305000.223310000",45000,27,0.0001900709,223260000,223305000,223265000,223310000,"chr2",96996,0,3,4,7,"chr2",1,0.0221518987341772
"3237","chr2.70540000.70545000","chr2.70745000.70750000",205000,13,0.001674721,70540000,70745000,70545000,70750000,"chr2",97139,0,1,4,5,"chr2",1,0.00761837787154243
"3238","chr2.85600000.85605000","chr2.85750000.85755000",150000,14,0.003346259,85600000,85750000,85605000,85755000,"chr2",97154,0,0,2,2,"chr2",1,0.00328176277543366
"3239","chr2.32275000.32280000","chr2.32355000.32360000",80000,18,0.003026855,32275000,32355000,32280000,32360000,"chr2",97165,3,11,3,17,"chr2",1,0.0358649789029536
"3240","chr2.26220000.26225000","chr2.26265000.26270000",45000,28,6.956095e-05,26220000,26265000,26225000,26270000,"chr2",97185,0,2,1,3,"chr2",1,0.00984528832630099
"3241","chr2.158890000.158895000","chr2.159595000.159600000",705000,13,1.520925e-07,158890000,159595000,158895000,159600000,"chr2",97198,2,5,10,17,"chr2",1,0.0259024847632443
"3242","chr2.24045000.24050000","chr2.24300000.24305000",255000,11,0.005703234,24045000,24300000,24050000,24305000,"chr2",97307,3,11,9,23,"chr2",1,0.0296530707923113
"3243","chr2.219175000.219180000","chr2.219305000.219310000",130000,14,0.007022645,219175000,219305000,219180000,219310000,"chr2",97424,0,4,0,4,"chr2",1,0.00656352555086732
"3244","chr2.178200000.178205000","chr2.178475000.178480000",275000,14,4.512301e-05,178200000,178475000,178205000,178480000,"chr2",97455,3,3,2,8,"chr2",1,0.0131270511017346
"3245","chr2.30395000.30400000","chr2.30925000.30930000",530000,10,0.0005379736,30395000,30925000,30400000,30930000,"chr2",97507,0,1,5,6,"chr2",1,0.0070323488045007
"3246","chr2.38825000.38830000","chr2.38945000.38950000",120000,24,1.369423e-08,38825000,38945000,38830000,38950000,"chr2",97527,1,9,26,36,"chr2",1,0.10126582278481
"3247","chr2.54310000.54315000","chr2.54930000.54935000",620000,8,0.005998319,54310000,54930000,54315000,54935000,"chr2",97570,0,2,1,3,"chr2",1,0.00281293952180028
"3248","chr2.183060000.183065000","chr2.183490000.183495000",430000,11,0.0003526635,183060000,183490000,183065000,183495000,"chr2",97603,0,4,2,6,"chr2",1,0.00773558368495077
"3249","chr2.233565000.233570000","chr2.234255000.234260000",690000,8,0.003612655,233565000,234255000,233570000,234260000,"chr2",97646,0,1,0,1,"chr2",1,0.00093764650726676
"3250","chr2.70140000.70145000","chr2.70340000.70345000",200000,14,0.000522239,70140000,70340000,70145000,70345000,"chr2",97729,0,7,8,15,"chr2",1,0.0246132208157525
"3251","chr2.101250000.101255000","chr2.101575000.101580000",325000,11,0.001546898,101250000,101575000,101255000,101580000,"chr2",97738,6,8,15,29,"chr2",1,0.0373886544772621
"3252","chr2.64195000.64200000","chr2.64220000.64225000",25000,39,0.0001128433,64195000,64220000,64200000,64225000,"chr2",97743,0,2,1,3,"chr2",1,0.0137130801687764
"3253","chr2.74405000.74410000","chr2.74420000.74425000",15000,46,3.358359e-06,74405000,74420000,74410000,74425000,"chr2",97752,1,6,7,14,"chr2",1,0.0754805438349742
"3254","chr2.219595000.219600000","chr2.219675000.219680000",80000,20,0.0003709646,219595000,219675000,219600000,219680000,"chr2",97764,0,4,4,8,"chr2",1,0.0187529301453352
"3255","chr2.27075000.27080000","chr2.27150000.27155000",75000,26,4.356148e-07,27075000,27150000,27080000,27155000,"chr2",97826,1,7,11,19,"chr2",1,0.0578996718237225
"3256","chr2.44265000.44270000","chr2.44575000.44580000",310000,10,0.007583919,44265000,44575000,44270000,44580000,"chr2",97833,3,10,5,18,"chr2",1,0.0210970464135021
"3257","chr2.25650000.25655000","chr2.25820000.25825000",170000,17,2.719959e-05,25650000,25820000,25655000,25825000,"chr2",97837,0,5,0,5,"chr2",1,0.00996249413970933
"3258","chr2.38530000.38535000","chr2.38960000.38965000",430000,12,6.381144e-05,38530000,38960000,38535000,38965000,"chr2",97877,0,0,2,2,"chr2",1,0.00281293952180028
"3259","chr2.85810000.85815000","chr2.85840000.85845000",30000,31,0.002093764,85810000,85840000,85815000,85845000,"chr2",97923,0,1,2,3,"chr2",1,0.0109001406469761
"3260","chr2.47505000.47510000","chr2.47530000.47535000",25000,47,6.926165e-08,47505000,47530000,47510000,47535000,"chr2",97954,2,7,10,19,"chr2",1,0.104664791373652
"3261","chr2.235465000.235470000","chr2.236010000.236015000",545000,13,1.576216e-06,235465000,236010000,235470000,236015000,"chr2",97964,3,5,5,13,"chr2",1,0.0198077824660103
"3262","chr2.9710000.9715000","chr2.9810000.9815000",100000,18,0.0004568419,9710000,9810000,9715000,9815000,"chr2",98035,0,9,4,13,"chr2",1,0.0274261603375527
"3263","chr2.211365000.211370000","chr2.211450000.211455000",85000,18,0.00185599,211365000,211450000,211370000,211455000,"chr2",98038,0,2,0,2,"chr2",1,0.00421940928270042
"3264","chr2.207855000.207860000","chr2.208265000.208270000",410000,10,0.002159006,207855000,208265000,207860000,208270000,"chr2",98112,0,14,12,26,"chr2",1,0.0304735114861697
"3265","chr2.64820000.64825000","chr2.64860000.64865000",40000,25,0.004349821,64820000,64860000,64825000,64865000,"chr2",98145,4,5,7,16,"chr2",1,0.046882325363338
"3266","chr2.235505000.235510000","chr2.235740000.235745000",235000,13,0.0006621599,235505000,235740000,235510000,235745000,"chr2",98158,1,6,4,11,"chr2",1,0.0167604313173933
"3267","chr2.85840000.85845000","chr2.86035000.86040000",195000,15,0.0001580014,85840000,86035000,85845000,86040000,"chr2",98196,0,5,1,6,"chr2",1,0.0105485232067511
"3268","chr2.223590000.223595000","chr2.223725000.223730000",135000,17,0.0001605672,223590000,223725000,223595000,223730000,"chr2",98257,1,5,4,10,"chr2",1,0.0199249882794187
"3269","chr2.232760000.232765000","chr2.233205000.233210000",445000,11,0.0002864327,232760000,233205000,232765000,233210000,"chr2",98277,3,4,3,10,"chr2",1,0.012892639474918
"3270","chr2.33520000.33525000","chr2.33580000.33585000",60000,20,0.00585082,33520000,33580000,33525000,33585000,"chr2",98288,1,3,2,6,"chr2",1,0.0140646976090014
"3271","chr2.69785000.69790000","chr2.69830000.69835000",45000,26,0.0004875882,69785000,69830000,69790000,69835000,"chr2",98289,1,5,3,9,"chr2",1,0.0274261603375527
"3272","chr2.64820000.64825000","chr2.64875000.64880000",55000,29,1.298968e-06,64820000,64875000,64825000,64880000,"chr2",98312,4,7,9,20,"chr2",1,0.0679793717768401
"3273","chr2.54440000.54445000","chr2.54875000.54880000",435000,13,9.686985e-06,54440000,54875000,54445000,54880000,"chr2",98314,2,0,0,2,"chr2",1,0.00304735114861697
"3274","chr2.232955000.232960000","chr2.233030000.233035000",75000,19,0.001945659,232955000,233030000,232960000,233035000,"chr2",98339,2,3,3,8,"chr2",1,0.0178152836380684
"3275","chr2.232040000.232045000","chr2.232310000.232315000",270000,13,0.0002468696,232040000,232310000,232045000,232315000,"chr2",98364,0,2,2,4,"chr2",1,0.00609470229723394
"3276","chr2.231015000.231020000","chr2.231460000.231465000",445000,10,0.001427765,231015000,231460000,231020000,231465000,"chr2",98384,0,1,2,3,"chr2",1,0.00351617440225035
"3277","chr2.55280000.55285000","chr2.55360000.55365000",80000,28,8.839162e-09,55280000,55360000,55285000,55365000,"chr2",98399,0,2,4,6,"chr2",1,0.019690576652602
"3278","chr2.85350000.85355000","chr2.85485000.85490000",135000,15,0.001935147,85350000,85485000,85355000,85490000,"chr2",98437,6,9,14,29,"chr2",1,0.0509845288326301
"3279","chr2.26330000.26335000","chr2.26350000.26355000",20000,47,1.34822e-06,26330000,26350000,26335000,26355000,"chr2",98475,6,19,19,44,"chr2",1,0.242381622128458
"3280","chr2.38540000.38545000","chr2.38945000.38950000",405000,13,1.617777e-05,38540000,38945000,38545000,38950000,"chr2",98495,0,5,4,9,"chr2",1,0.0137130801687764
"3281","chr2.46010000.46015000","chr2.46150000.46155000",140000,14,0.004846327,46010000,46150000,46015000,46155000,"chr2",98505,2,12,9,23,"chr2",1,0.0377402719174871
"3282","chr2.47260000.47265000","chr2.47385000.47390000",125000,15,0.002963736,47260000,47385000,47265000,47390000,"chr2",98510,1,10,4,15,"chr2",1,0.0263713080168776
"3283","chr2.38375000.38380000","chr2.38405000.38410000",30000,32,0.0009703642,38375000,38405000,38380000,38410000,"chr2",98515,3,3,1,7,"chr2",1,0.0262541022034693
"3284","chr2.64830000.64835000","chr2.65055000.65060000",225000,17,1.897969e-06,64830000,65055000,64835000,65060000,"chr2",98532,8,5,11,24,"chr2",1,0.0478199718706048
"3285","chr2.198270000.198275000","chr2.198295000.198300000",25000,36,0.001114518,198270000,198295000,198275000,198300000,"chr2",98592,0,4,1,5,"chr2",1,0.0210970464135021
"3286","chr2.26400000.26405000","chr2.26455000.26460000",55000,21,0.005634437,26400000,26455000,26405000,26460000,"chr2",98623,0,0,2,2,"chr2",1,0.00492264416315049
"3287","chr2.48130000.48135000","chr2.48430000.48435000",300000,10,0.008738458,48130000,48430000,48135000,48435000,"chr2",98668,1,3,0,4,"chr2",1,0.0046882325363338
"3288","chr2.26240000.26245000","chr2.26295000.26300000",55000,21,0.005634437,26240000,26295000,26245000,26300000,"chr2",98778,5,18,12,35,"chr2",1,0.0861462728551336
"3289","chr2.104820000.104825000","chr2.105230000.105235000",410000,9,0.008798952,104820000,105230000,104825000,105235000,"chr2",98854,0,5,1,6,"chr2",1,0.00632911392405063
"3290","chr2.74145000.74150000","chr2.74415000.74420000",270000,11,0.004187627,74145000,74415000,74150000,74420000,"chr2",98882,0,2,3,5,"chr2",1,0.00644631973745898
"3291","chr2.106190000.106195000","chr2.106560000.106565000",370000,12,0.0001605672,106190000,106560000,106195000,106565000,"chr2",98885,0,3,5,8,"chr2",1,0.0112517580872011
"3292","chr2.43150000.43155000","chr2.43710000.43715000",560000,14,1.498825e-07,43150000,43710000,43155000,43715000,"chr2",98948,0,1,3,4,"chr2",1,0.00656352555086732
"3293","chr2.1970000.1975000","chr2.1990000.1995000",20000,36,0.006345598,1970000,1990000,1975000,1995000,"chr2",98999,1,3,2,6,"chr2",1,0.0253164556962025
"3294","chr2.26295000.26300000","chr2.26350000.26355000",55000,26,4.290564e-05,26295000,26350000,26300000,26355000,"chr2",99151,5,18,12,35,"chr2",1,0.106657290201594
"3295","chr2.73005000.73010000","chr2.73090000.73095000",85000,27,1.527874e-08,73005000,73090000,73010000,73095000,"chr2",99234,0,2,1,3,"chr2",1,0.00949367088607595
"3296","chr2.190945000.190950000","chr2.191170000.191175000",225000,13,0.0009045029,190945000,191170000,190950000,191175000,"chr2",99245,0,4,1,5,"chr2",1,0.00761837787154243
"3297","chr2.25200000.25205000","chr2.25315000.25320000",115000,16,0.001617402,25200000,25315000,25205000,25320000,"chr2",99250,2,16,12,30,"chr2",1,0.0562587904360056
"3298","chr2.121490000.121495000","chr2.121790000.121795000",300000,13,0.000118199,121490000,121790000,121495000,121795000,"chr2",99296,1,0,3,4,"chr2",1,0.00609470229723394
"3299","chr2.43100000.43105000","chr2.43810000.43815000",710000,8,0.003139213,43100000,43810000,43105000,43815000,"chr2",99306,2,2,4,8,"chr2",1,0.00750117205813408
"3300","chr2.32165000.32170000","chr2.32355000.32360000",190000,12,0.008687146,32165000,32355000,32170000,32360000,"chr2",99315,1,10,3,14,"chr2",1,0.019690576652602
"3301","chr2.54980000.54985000","chr2.55400000.55405000",420000,10,0.001935147,54980000,55400000,54985000,55405000,"chr2",99319,2,9,12,23,"chr2",1,0.0269573370839194
"3302","chr2.26295000.26300000","chr2.26345000.26350000",50000,31,5.256614e-07,26295000,26345000,26300000,26350000,"chr2",99341,1,7,0,8,"chr2",1,0.0290670417252696
"3303","chr2.9325000.9330000","chr2.9430000.9435000",105000,18,0.0003075462,9325000,9430000,9330000,9435000,"chr2",99361,2,0,0,2,"chr2",1,0.00421940928270042
"3304","chr2.134135000.134140000","chr2.134190000.134195000",55000,21,0.005634437,134135000,134190000,134140000,134195000,"chr2",99363,5,13,14,32,"chr2",1,0.0787623066104079
"3305","chr2.61470000.61475000","chr2.61740000.61745000",270000,13,0.0002468696,61470000,61740000,61475000,61745000,"chr2",99384,6,15,19,40,"chr2",1,0.0609470229723394
"3306","chr2.55110000.55115000","chr2.55400000.55405000",290000,11,0.002819447,55110000,55400000,55115000,55405000,"chr2",99424,2,5,2,9,"chr2",1,0.0116033755274262
"3307","chr2.85650000.85655000","chr2.85745000.85750000",95000,21,1.81026e-05,85650000,85745000,85655000,85750000,"chr2",99450,2,3,2,7,"chr2",1,0.0172292545710267
"3308","chr2.43055000.43060000","chr2.43715000.43720000",660000,13,2.84136e-07,43055000,43715000,43060000,43720000,"chr2",99480,0,0,1,1,"chr2",1,0.00152367557430849
"3309","chr2.65130000.65135000","chr2.65185000.65190000",55000,21,0.005634437,65130000,65185000,65135000,65190000,"chr2",99529,3,29,18,50,"chr2",1,0.123066104078762
"3310","chr2.230690000.230695000","chr2.230745000.230750000",55000,24,0.0003526635,230690000,230745000,230695000,230750000,"chr2",99663,0,12,4,16,"chr2",1,0.0450070323488045
"3311","chr2.55130000.55135000","chr2.55400000.55405000",270000,13,0.0002468696,55130000,55400000,55135000,55405000,"chr2",99776,2,9,12,23,"chr2",1,0.0350445382090952
"3312","chr2.231850000.231855000","chr2.231915000.231920000",65000,22,0.0003732923,231850000,231915000,231855000,231920000,"chr2",99908,2,2,2,6,"chr2",1,0.0154711673699015
"3313","chr2.64870000.64875000","chr2.64985000.64990000",115000,23,1.129149e-07,64870000,64985000,64875000,64990000,"chr2",100010,1,5,8,14,"chr2",1,0.0377402719174871
"3314","chr2.70255000.70260000","chr2.70290000.70295000",35000,37,3.844298e-07,70255000,70290000,70260000,70295000,"chr2",100014,1,7,7,15,"chr2",1,0.0650492264416315
"3315","chr2.47260000.47265000","chr2.47520000.47525000",260000,17,4.295596e-07,47260000,47520000,47265000,47525000,"chr2",100021,1,5,4,10,"chr2",1,0.0199249882794187
"3316","chr2.54440000.54445000","chr2.54550000.54555000",110000,17,0.0006956574,54440000,54550000,54445000,54555000,"chr2",100083,0,2,1,3,"chr2",1,0.0059774964838256
"3317","chr2.69600000.69605000","chr2.69770000.69775000",170000,16,0.0001135799,69600000,69770000,69605000,69775000,"chr2",100104,2,1,2,5,"chr2",1,0.00937646507266761
"3318","chr2.231050000.231055000","chr2.231110000.231115000",60000,20,0.00585082,231050000,231110000,231055000,231115000,"chr2",100110,1,5,2,8,"chr2",1,0.0187529301453352
"3319","chr2.69385000.69390000","chr2.69490000.69495000",105000,16,0.002972259,69385000,69490000,69390000,69495000,"chr2",100170,1,1,3,5,"chr2",1,0.00937646507266761
"3320","chr2.74050000.74055000","chr2.74415000.74420000",365000,12,0.0001747693,74050000,74415000,74055000,74420000,"chr2",100228,4,6,2,12,"chr2",1,0.0168776371308017
"3321","chr2.231050000.231055000","chr2.231465000.231470000",415000,9,0.00850255,231050000,231465000,231055000,231470000,"chr2",100278,3,7,6,16,"chr2",1,0.0168776371308017
"3322","chr2.133885000.133890000","chr2.134245000.134250000",360000,11,0.0009173897,133885000,134245000,133890000,134250000,"chr2",100317,0,0,4,4,"chr2",1,0.00515705578996718
"3323","chr2.201780000.201785000","chr2.201970000.201975000",190000,13,0.002702847,201780000,201970000,201785000,201975000,"chr2",100318,0,0,3,3,"chr2",1,0.00457102672292546
"3324","chr2.38540000.38545000","chr2.38825000.38830000",285000,12,0.000765581,38540000,38825000,38545000,38830000,"chr2",100353,0,5,4,9,"chr2",1,0.0126582278481013
"3325","chr2.218655000.218660000","chr2.218895000.218900000",240000,12,0.002235981,218655000,218895000,218660000,218900000,"chr2",100434,2,3,2,7,"chr2",1,0.00984528832630099
"3326","chr2.11375000.11380000","chr2.11495000.11500000",120000,21,1.536966e-06,11375000,11495000,11380000,11500000,"chr2",100451,7,15,10,32,"chr2",1,0.0787623066104079
"3327","chr2.64885000.64890000","chr2.65065000.65070000",180000,13,0.003742372,64885000,65065000,64890000,65070000,"chr2",100538,2,9,4,15,"chr2",1,0.0228551336146273
"3328","chr2.159060000.159065000","chr2.159600000.159605000",540000,13,1.707369e-06,159060000,159600000,159065000,159605000,"chr2",100548,0,1,4,5,"chr2",1,0.00761837787154243
"3329","chr2.11375000.11380000","chr2.11420000.11425000",45000,27,0.0001900709,11375000,11420000,11380000,11425000,"chr2",100571,6,15,10,31,"chr2",1,0.0981012658227848
"3330","chr2.219275000.219280000","chr2.219570000.219575000",295000,10,0.009453251,219275000,219570000,219280000,219575000,"chr2",100592,2,2,2,6,"chr2",1,0.0070323488045007
"3331","chr2.72835000.72840000","chr2.72970000.72975000",135000,20,2.316985e-06,72835000,72970000,72840000,72975000,"chr2",100698,0,2,0,2,"chr2",1,0.0046882325363338
"3332","chr2.101710000.101715000","chr2.101800000.101805000",90000,16,0.008624295,101710000,101800000,101715000,101805000,"chr2",100831,1,4,5,10,"chr2",1,0.0187529301453352
"3333","chr2.1865000.1870000","chr2.2130000.2135000",265000,13,0.0002839226,1865000,2130000,1870000,2135000,"chr2",100845,0,3,0,3,"chr2",1,0.00457102672292546
"3334","chr2.227340000.227345000","chr2.227390000.227395000",50000,24,0.001005454,227340000,227390000,227345000,227395000,"chr2",100900,0,2,0,2,"chr2",1,0.00562587904360056
"3335","chr2.47205000.47210000","chr2.47310000.47315000",105000,16,0.002972259,47205000,47310000,47210000,47315000,"chr2",100968,4,9,5,18,"chr2",1,0.0337552742616034
"3336","chr2.10975000.10980000","chr2.11580000.11585000",605000,8,0.006687492,10975000,11580000,10980000,11585000,"chr2",101002,2,5,8,15,"chr2",1,0.0140646976090014
"3337","chr2.48340000.48345000","chr2.48695000.48700000",355000,13,3.942591e-05,48340000,48695000,48345000,48700000,"chr2",101101,0,0,2,2,"chr2",1,0.00304735114861697
"3338","chr2.24610000.24615000","chr2.25040000.25045000",430000,9,0.007245928,24610000,25040000,24615000,25045000,"chr2",101107,0,3,1,4,"chr2",1,0.00421940928270042
"3339","chr2.219170000.219175000","chr2.219335000.219340000",165000,13,0.006114697,219170000,219335000,219175000,219340000,"chr2",101136,3,11,17,31,"chr2",1,0.0472339428035631
"3340","chr2.54915000.54920000","chr2.55405000.55410000",490000,9,0.004052619,54915000,55405000,54920000,55410000,"chr2",101234,2,8,3,13,"chr2",1,0.0137130801687764
"3341","chr2.36575000.36580000","chr2.36750000.36755000",175000,14,0.001310839,36575000,36750000,36580000,36755000,"chr2",101250,0,7,6,13,"chr2",1,0.0213314580403188
"3342","chr2.196400000.196405000","chr2.196510000.196515000",110000,15,0.006252332,196400000,196510000,196405000,196515000,"chr2",101349,2,6,7,15,"chr2",1,0.0263713080168776
"3343","chr2.70540000.70545000","chr2.70990000.70995000",450000,12,4.717722e-05,70540000,70990000,70545000,70995000,"chr2",101363,0,3,3,6,"chr2",1,0.00843881856540084
"3344","chr2.54955000.54960000","chr2.55135000.55140000",180000,14,0.001084925,54955000,55135000,54960000,55140000,"chr2",101378,0,2,2,4,"chr2",1,0.00656352555086732
"3345","chr2.231615000.231620000","chr2.231640000.231645000",25000,33,0.008420578,231615000,231640000,231620000,231645000,"chr2",101390,4,18,19,41,"chr2",1,0.158579465541491
"3346","chr2.27735000.27740000","chr2.27770000.27775000",35000,29,0.0009559797,27735000,27770000,27740000,27775000,"chr2",101396,1,2,4,7,"chr2",1,0.023792780121894
"3347","chr2.46875000.46880000","chr2.47000000.47005000",125000,22,2.1785e-07,46875000,4.7e+07,46880000,47005000,"chr2",101405,0,1,1,2,"chr2",1,0.00515705578996718
"3348","chr2.219175000.219180000","chr2.219215000.219220000",40000,27,0.0008355202,219175000,219215000,219180000,219220000,"chr2",101439,0,4,0,4,"chr2",1,0.0126582278481013
"3349","chr2.11375000.11380000","chr2.11505000.11510000",130000,16,0.0007348989,11375000,11505000,11380000,11510000,"chr2",101452,4,10,10,24,"chr2",1,0.0450070323488045
"3350","chr2.28175000.28180000","chr2.28610000.28615000",435000,13,9.686985e-06,28175000,28610000,28180000,28615000,"chr2",101489,0,2,0,2,"chr2",1,0.00304735114861697
"3351","chr2.9675000.9680000","chr2.10075000.10080000",400000,9,0.009836434,9675000,10075000,9680000,10080000,"chr2",101491,0,7,4,11,"chr2",1,0.0116033755274262
"3352","chr2.70540000.70545000","chr2.70870000.70875000",330000,13,6.226865e-05,70540000,70870000,70545000,70875000,"chr2",101503,0,7,4,11,"chr2",1,0.0167604313173933
"3353","chr2.231705000.231710000","chr2.231850000.231855000",145000,19,5.572911e-06,231705000,231850000,231710000,231855000,"chr2",101506,0,4,1,5,"chr2",1,0.0111345522737928
"3354","chr2.64820000.64825000","chr2.64865000.64870000",45000,27,0.0001900709,64820000,64865000,64825000,64870000,"chr2",101522,2,4,5,11,"chr2",1,0.0348101265822785
"3355","chr2.160360000.160365000","chr2.160480000.160485000",120000,15,0.003742989,160360000,160480000,160365000,160485000,"chr2",101645,3,7,8,18,"chr2",1,0.0316455696202532
"3356","chr2.171195000.171200000","chr2.171345000.171350000",150000,14,0.003346259,171195000,171345000,171200000,171350000,"chr2",101654,2,1,0,3,"chr2",1,0.00492264416315049
"3357","chr2.178160000.178165000","chr2.178195000.178200000",35000,60,3.161415e-21,178160000,178195000,178165000,178200000,"chr2",101681,2,2,3,7,"chr2",1,0.0492264416315049
"3358","chr2.25200000.25205000","chr2.25330000.25335000",130000,23,2.86292e-08,25200000,25330000,25205000,25335000,"chr2",101709,0,1,3,4,"chr2",1,0.0107829348335677
"3359","chr2.20575000.20580000","chr2.20810000.20815000",235000,11,0.008738458,20575000,20810000,20580000,20815000,"chr2",101722,1,1,1,3,"chr2",1,0.00386779184247539
"3360","chr2.54950000.54955000","chr2.55400000.55405000",450000,13,7.556447e-06,54950000,55400000,54955000,55405000,"chr2",101755,0,7,3,10,"chr2",1,0.0152367557430849
"3361","chr2.203145000.203150000","chr2.203400000.203405000",255000,11,0.005703234,203145000,203400000,203150000,203405000,"chr2",101780,4,12,3,19,"chr2",1,0.0244960150023441
"3362","chr2.207925000.207930000","chr2.208115000.208120000",190000,13,0.002702847,207925000,208115000,207930000,208120000,"chr2",101805,1,7,4,12,"chr2",1,0.0182841068917018
"3363","chr2.47310000.47315000","chr2.47400000.47405000",90000,21,3.307489e-05,47310000,47400000,47315000,47405000,"chr2",101893,5,11,5,21,"chr2",1,0.0516877637130802
"3364","chr2.107570000.107575000","chr2.107595000.107600000",25000,34,0.004425962,107570000,107595000,107575000,107600000,"chr2",101895,1,8,11,20,"chr2",1,0.0796999531176746
"3365","chr2.54340000.54345000","chr2.54930000.54935000",590000,11,4.472719e-05,54340000,54930000,54345000,54935000,"chr2",101940,3,6,6,15,"chr2",1,0.0193389592123769
"3366","chr2.54930000.54935000","chr2.55415000.55420000",485000,10,0.0009062659,54930000,55415000,54935000,55420000,"chr2",101985,3,4,6,13,"chr2",1,0.0152367557430849
"3367","chr2.27320000.27325000","chr2.27495000.27500000",175000,13,0.004403514,27320000,27495000,27325000,27500000,"chr2",102018,1,1,1,3,"chr2",1,0.00457102672292546
"3368","chr2.47205000.47210000","chr2.47505000.47510000",300000,15,4.083224e-06,47205000,47505000,47210000,47510000,"chr2",102086,2,7,5,14,"chr2",1,0.0246132208157525
"3369","chr2.203780000.203785000","chr2.203885000.203890000",105000,17,0.0009851638,203780000,203885000,203785000,203890000,"chr2",102105,1,2,1,4,"chr2",1,0.00796999531176746
"3370","chr2.38530000.38535000","chr2.38825000.38830000",295000,11,0.002561661,38530000,38825000,38535000,38830000,"chr2",102117,4,25,12,41,"chr2",1,0.0528598218471636
"3371","chr2.134985000.134990000","chr2.135125000.135130000",140000,17,0.000124966,134985000,135125000,134990000,135130000,"chr2",102143,1,1,1,3,"chr2",1,0.0059774964838256
"3372","chr2.72515000.72520000","chr2.72770000.72775000",255000,11,0.005703234,72515000,72770000,72520000,72775000,"chr2",102160,0,2,0,2,"chr2",1,0.00257852789498359
"3373","chr2.42110000.42115000","chr2.42315000.42320000",205000,12,0.005747455,42110000,42315000,42115000,42320000,"chr2",102214,4,6,4,14,"chr2",1,0.019690576652602
"3374","chr2.232760000.232765000","chr2.233315000.233320000",555000,10,0.0004124094,232760000,233315000,232765000,233320000,"chr2",102247,3,4,3,10,"chr2",1,0.0117205813408345
"3375","chr2.54905000.54910000","chr2.54925000.54930000",20000,37,0.003413209,54905000,54925000,54910000,54930000,"chr2",102251,0,3,2,5,"chr2",1,0.0216830754805438
"3376","chr2.28180000.28185000","chr2.28220000.28225000",40000,26,0.001945659,28180000,28220000,28185000,28225000,"chr2",102273,0,1,2,3,"chr2",1,0.00914205344585091
"3377","chr2.28145000.28150000","chr2.28525000.28530000",380000,11,0.0006910251,28145000,28525000,28150000,28530000,"chr2",102292,0,1,4,5,"chr2",1,0.00644631973745898
"3378","chr2.64875000.64880000","chr2.65055000.65060000",180000,19,6.852538e-07,64875000,65055000,64880000,65060000,"chr2",102314,4,10,18,32,"chr2",1,0.0712611345522738
"3379","chr2.70530000.70535000","chr2.70990000.70995000",460000,14,8.970846e-07,70530000,70990000,70535000,70995000,"chr2",102337,0,1,0,1,"chr2",1,0.00164088138771683
"3380","chr2.196985000.196990000","chr2.197145000.197150000",160000,13,0.007175609,196985000,197145000,196990000,197150000,"chr2",102456,0,2,2,4,"chr2",1,0.00609470229723394
"3381","chr2.45890000.45895000","chr2.46010000.46015000",120000,15,0.003742989,45890000,46010000,45895000,46015000,"chr2",102501,3,6,9,18,"chr2",1,0.0316455696202532
"3382","chr2.219345000.219350000","chr2.219365000.219370000",20000,44,1.88628e-05,219345000,219365000,219350000,219370000,"chr2",102541,3,8,12,23,"chr2",1,0.118612283169245
"3383","chr2.208025000.208030000","chr2.208115000.208120000",90000,17,0.003259365,208025000,208115000,208030000,208120000,"chr2",102560,1,7,6,14,"chr2",1,0.0278949835911861
"3384","chr2.26295000.26300000","chr2.26355000.26360000",60000,21,0.002389334,26295000,26355000,26300000,26360000,"chr2",102566,5,15,12,32,"chr2",1,0.0787623066104079
"3385","chr2.25320000.25325000","chr2.25340000.25345000",20000,44,1.88628e-05,25320000,25340000,25325000,25345000,"chr2",102593,3,3,1,7,"chr2",1,0.0360993905297703
"3386","chr2.228620000.228625000","chr2.228745000.228750000",125000,14,0.008580544,228620000,228745000,228625000,228750000,"chr2",102634,0,2,1,3,"chr2",1,0.00492264416315049
"3387","chr2.47225000.47230000","chr2.47260000.47265000",35000,33,2.555721e-05,47225000,47260000,47230000,47265000,"chr2",102707,0,3,2,5,"chr2",1,0.0193389592123769
"3388","chr2.177145000.177150000","chr2.177235000.177240000",90000,20,0.0001135799,177145000,177235000,177150000,177240000,"chr2",102709,0,3,1,4,"chr2",1,0.00937646507266761
"3389","chr2.86135000.86140000","chr2.86200000.86205000",65000,19,0.006728756,86135000,86200000,86140000,86205000,"chr2",102782,0,2,5,7,"chr2",1,0.0155883731833099
"3390","chr2.26220000.26225000","chr2.26345000.26350000",125000,20,4.608684e-06,26220000,26345000,26225000,26350000,"chr2",102877,0,2,0,2,"chr2",1,0.0046882325363338
"3391","chr2.64820000.64825000","chr2.65140000.65145000",320000,11,0.001678478,64820000,65140000,64825000,65145000,"chr2",102905,6,7,9,22,"chr2",1,0.0283638068448195
"3392","chr2.54410000.54415000","chr2.54875000.54880000",465000,13,5.845278e-06,54410000,54875000,54415000,54880000,"chr2",102961,1,0,0,1,"chr2",1,0.00152367557430849
"3393","chr2.237435000.237440000","chr2.237965000.237970000",530000,9,0.002746063,237435000,237965000,237440000,237970000,"chr2",102968,1,4,2,7,"chr2",1,0.00738396624472574
"3394","chr2.189760000.189765000","chr2.189780000.189785000",20000,39,0.0009045029,189760000,189780000,189765000,189785000,"chr2",102991,0,5,6,11,"chr2",1,0.05028129395218
"3395","chr2.159070000.159075000","chr2.159600000.159605000",530000,10,0.0005379736,159070000,159600000,159075000,159605000,"chr2",103097,1,3,2,6,"chr2",1,0.0070323488045007
"3396","chr2.24640000.24645000","chr2.24995000.25000000",355000,16,1.489735e-07,24640000,24995000,24645000,2.5e+07,"chr2",103121,2,1,0,3,"chr2",1,0.00562587904360056
"3397","chr2.25270000.25275000","chr2.25340000.25345000",70000,22,0.0001599504,25270000,25340000,25275000,25345000,"chr2",103138,3,5,1,9,"chr2",1,0.0232067510548523
"3398","chr2.46695000.46700000","chr2.47000000.47005000",305000,12,0.0004977959,46695000,4.7e+07,46700000,47005000,"chr2",103145,0,2,2,4,"chr2",1,0.00562587904360056
"3399","chr2.199925000.199930000","chr2.200335000.200340000",410000,9,0.008798952,199925000,200335000,199930000,200340000,"chr2",103228,4,0,4,8,"chr2",1,0.00843881856540084
"3400","chr2.201970000.201975000","chr2.202030000.202035000",60000,22,0.0009333356,201970000,202030000,201975000,202035000,"chr2",103263,0,0,3,3,"chr2",1,0.00773558368495077
"3401","chr2.74050000.74055000","chr2.74420000.74425000",370000,18,1.616871e-09,74050000,74420000,74055000,74425000,"chr2",103306,1,6,2,9,"chr2",1,0.0189873417721519
"3402","chr2.48545000.48550000","chr2.48690000.48695000",145000,14,0.004052619,48545000,48690000,48550000,48695000,"chr2",103371,0,7,3,10,"chr2",1,0.0164088138771683
"3403","chr2.61015000.61020000","chr2.61210000.61215000",195000,15,0.0001580014,61015000,61210000,61020000,61215000,"chr2",103455,1,4,3,8,"chr2",1,0.0140646976090014
"3404","chr2.172425000.172430000","chr2.172560000.172565000",135000,19,1.016791e-05,172425000,172560000,172430000,172565000,"chr2",103469,1,3,0,4,"chr2",1,0.00890764181903422
"3405","chr2.26120000.26125000","chr2.26145000.26150000",25000,47,6.926165e-08,26120000,26145000,26125000,26150000,"chr2",103473,7,16,22,45,"chr2",1,0.24789029535865
"3406","chr2.70125000.70130000","chr2.70300000.70305000",175000,13,0.004403514,70125000,70300000,70130000,70305000,"chr2",103496,7,27,21,55,"chr2",1,0.0838021565869667
"3407","chr2.33495000.33500000","chr2.33595000.33600000",100000,18,0.0004568419,33495000,33595000,33500000,33600000,"chr2",103497,4,6,8,18,"chr2",1,0.0379746835443038
"3408","chr2.1910000.1915000","chr2.2120000.2125000",210000,12,0.004989964,1910000,2120000,1915000,2125000,"chr2",103502,0,1,2,3,"chr2",1,0.00421940928270042
"3409","chr2.64885000.64890000","chr2.64985000.64990000",100000,19,0.0001378973,64885000,64985000,64890000,64990000,"chr2",103504,1,5,4,10,"chr2",1,0.0222691045475856
"3410","chr2.48340000.48345000","chr2.48530000.48535000",190000,30,1.30007e-16,48340000,48530000,48345000,48535000,"chr2",103577,2,0,2,4,"chr2",1,0.0140646976090014
"3411","chr2.20580000.20585000","chr2.20600000.20605000",20000,37,0.003413209,20580000,20600000,20585000,20605000,"chr2",103596,1,4,2,7,"chr2",1,0.0303563056727614
"3412","chr2.219595000.219600000","chr2.219645000.219650000",50000,49,8.648306e-19,219595000,219645000,219600000,219650000,"chr2",103634,0,6,2,8,"chr2",1,0.0459446788560713
"3413","chr2.79965000.79970000","chr2.80070000.80075000",105000,16,0.002972259,79965000,80070000,79970000,80075000,"chr2",103644,4,4,2,10,"chr2",1,0.0187529301453352
"3414","chr2.178130000.178135000","chr2.178195000.178200000",65000,35,9.124337e-12,178130000,178195000,178135000,178200000,"chr2",103672,2,10,7,19,"chr2",1,0.0779418659165495
"3415","chr2.54075000.54080000","chr2.54310000.54315000",235000,12,0.002534677,54075000,54310000,54080000,54315000,"chr2",103712,0,2,1,3,"chr2",1,0.00421940928270042
"3416","chr2.58415000.58420000","chr2.58600000.58605000",185000,13,0.003174651,58415000,58600000,58420000,58605000,"chr2",103778,0,0,2,2,"chr2",1,0.00304735114861697
"3417","chr2.54090000.54095000","chr2.54175000.54180000",85000,25,2.932692e-07,54090000,54175000,54095000,54180000,"chr2",103794,3,5,8,16,"chr2",1,0.046882325363338
"3418","chr2.9705000.9710000","chr2.9765000.9770000",60000,20,0.00585082,9705000,9765000,9710000,9770000,"chr2",103821,2,3,3,8,"chr2",1,0.0187529301453352
"3419","chr2.42085000.42090000","chr2.42335000.42340000",250000,15,1.949445e-05,42085000,42335000,42090000,42340000,"chr2",103827,0,3,1,4,"chr2",1,0.0070323488045007
"3420","chr2.74385000.74390000","chr2.74405000.74410000",20000,38,0.001797953,74385000,74405000,74390000,74410000,"chr2",103873,2,9,10,21,"chr2",1,0.0935302390998594
"3421","chr2.20640000.20645000","chr2.20810000.20815000",170000,33,1.40533e-18,20640000,20810000,20645000,20815000,"chr2",103974,1,1,1,3,"chr2",1,0.0116033755274262
"3422","chr2.128090000.128095000","chr2.128230000.128235000",140000,21,3.479897e-07,128090000,128230000,128095000,128235000,"chr2",104002,4,27,35,66,"chr2",1,0.162447257383966
"3423","chr2.230860000.230865000","chr2.231050000.231055000",190000,12,0.008687146,230860000,231050000,230865000,231055000,"chr2",104046,2,3,1,6,"chr2",1,0.00843881856540084
"3424","chr2.55120000.55125000","chr2.55455000.55460000",335000,10,0.005371145,55120000,55455000,55125000,55460000,"chr2",104085,1,0,1,2,"chr2",1,0.0023441162681669
"3425","chr2.30445000.30450000","chr2.30925000.30930000",480000,9,0.00442711,30445000,30925000,30450000,30930000,"chr2",104087,0,1,4,5,"chr2",1,0.00527426160337553
"3426","chr2.48340000.48345000","chr2.48465000.48470000",125000,14,0.008580544,48340000,48465000,48345000,48470000,"chr2",104088,2,0,2,4,"chr2",1,0.00656352555086732
"3427","chr2.47205000.47210000","chr2.47520000.47525000",315000,13,8.502277e-05,47205000,47520000,47210000,47525000,"chr2",104092,3,5,5,13,"chr2",1,0.0198077824660103
"3428","chr2.135125000.135130000","chr2.135170000.135175000",45000,40,2.37998e-11,135125000,135170000,135130000,135175000,"chr2",104127,1,1,0,2,"chr2",1,0.00937646507266761
"3429","chr2.85865000.85870000","chr2.86035000.86040000",170000,18,6.052846e-06,85865000,86035000,85870000,86040000,"chr2",104158,0,5,1,6,"chr2",1,0.0126582278481013
"3430","chr2.54410000.54415000","chr2.54930000.54935000",520000,9,0.00301907,54410000,54930000,54415000,54935000,"chr2",104182,1,7,5,13,"chr2",1,0.0137130801687764
"3431","chr2.171345000.171350000","chr2.171595000.171600000",250000,11,0.006290121,171345000,171595000,171350000,171600000,"chr2",104241,2,1,0,3,"chr2",1,0.00386779184247539
"3432","chr2.178190000.178195000","chr2.178475000.178480000",285000,11,0.00308603,178190000,178475000,178195000,178480000,"chr2",104277,2,3,2,7,"chr2",1,0.00902484763244257
"3433","chr2.196985000.196990000","chr2.197160000.197165000",175000,13,0.004403514,196985000,197160000,196990000,197165000,"chr2",104303,0,2,3,5,"chr2",1,0.00761837787154243
"3434","chr2.54550000.54555000","chr2.55400000.55405000",850000,7,0.0067161,54550000,55400000,54555000,55405000,"chr2",104486,0,2,1,3,"chr2",1,0.00246132208157525
"3435","chr2.85675000.85680000","chr2.85725000.85730000",50000,28,1.75251e-05,85675000,85725000,85680000,85730000,"chr2",104525,4,15,10,29,"chr2",1,0.0951711204875762
"3436","chr2.61760000.61765000","chr2.61895000.61900000",135000,19,1.016791e-05,61760000,61895000,61765000,61900000,"chr2",104557,2,12,8,22,"chr2",1,0.0489920300046882
"3437","chr2.202750000.202755000","chr2.203055000.203060000",305000,11,0.002159006,202750000,203055000,202755000,203060000,"chr2",104563,1,5,2,8,"chr2",1,0.0103141115799344
"3438","chr2.85900000.85905000","chr2.86035000.86040000",135000,17,0.0001605672,85900000,86035000,85905000,86040000,"chr2",104569,0,5,1,6,"chr2",1,0.0119549929676512
"3439","chr2.28105000.28110000","chr2.28955000.28960000",850000,7,0.0067161,28105000,28955000,28110000,28960000,"chr2",104570,2,3,12,17,"chr2",1,0.0139474917955931
"3440","chr2.104575000.104580000","chr2.105230000.105235000",655000,9,0.0008950992,104575000,105230000,104580000,105235000,"chr2",104610,0,5,5,10,"chr2",1,0.0105485232067511
"3441","chr2.25225000.25230000","chr2.25250000.25255000",25000,36,0.001114518,25225000,25250000,25230000,25255000,"chr2",104634,0,2,1,3,"chr2",1,0.0126582278481013
"3442","chr2.207045000.207050000","chr2.207065000.207070000",20000,36,0.006345598,207045000,207065000,207050000,207070000,"chr2",104666,0,0,2,2,"chr2",1,0.00843881856540084
"3443","chr2.73975000.73980000","chr2.74000000.74005000",25000,40,4.929724e-05,73975000,7.4e+07,73980000,74005000,"chr2",104713,0,0,1,1,"chr2",1,0.0046882325363338
"3444","chr2.85300000.85305000","chr2.85520000.85525000",220000,17,2.393511e-06,85300000,85520000,85305000,85525000,"chr2",104754,1,7,2,10,"chr2",1,0.0199249882794187
"3445","chr2.43195000.43200000","chr2.43710000.43715000",515000,18,3.967799e-11,43195000,43710000,43200000,43715000,"chr2",104792,0,1,3,4,"chr2",1,0.00843881856540084
"3446","chr2.25295000.25300000","chr2.25330000.25335000",35000,40,1.191468e-08,25295000,25330000,25300000,25335000,"chr2",104840,0,1,3,4,"chr2",1,0.0187529301453352
"3447","chr2.54335000.54340000","chr2.54925000.54930000",590000,15,9.553621e-09,54335000,54925000,54340000,54930000,"chr2",104876,0,2,2,4,"chr2",1,0.0070323488045007
"3448","chr2.54335000.54340000","chr2.54950000.54955000",615000,12,4.512696e-06,54335000,54950000,54340000,54955000,"chr2",104928,0,2,3,5,"chr2",1,0.0070323488045007
"3449","chr2.218655000.218660000","chr2.218845000.218850000",190000,28,1.027332e-14,218655000,218845000,218660000,218850000,"chr2",104986,2,11,2,15,"chr2",1,0.0492264416315049
"3450","chr2.45990000.45995000","chr2.46060000.46065000",70000,19,0.003527572,45990000,46060000,45995000,46065000,"chr2",105012,3,9,2,14,"chr2",1,0.0311767463666198
"3451","chr2.11375000.11380000","chr2.11475000.11480000",100000,17,0.001435018,11375000,11475000,11380000,11480000,"chr2",105031,5,14,10,29,"chr2",1,0.0577824660103141
"3452","chr2.62195000.62200000","chr2.62215000.62220000",20000,43,4.321287e-05,62195000,62215000,62200000,62220000,"chr2",105049,0,3,2,5,"chr2",1,0.0251992498827942
"3453","chr2.15940000.15945000","chr2.16070000.16075000",130000,14,0.007022645,15940000,16070000,15945000,16075000,"chr2",105060,0,1,1,2,"chr2",1,0.00328176277543366
"3454","chr2.8665000.8670000","chr2.8820000.8825000",155000,15,0.0008356975,8665000,8820000,8670000,8825000,"chr2",105071,0,6,3,9,"chr2",1,0.0158227848101266
"3455","chr2.9330000.9335000","chr2.9475000.9480000",145000,18,2.398148e-05,9330000,9475000,9335000,9480000,"chr2",105149,0,4,6,10,"chr2",1,0.0210970464135021
"3456","chr2.38105000.38110000","chr2.38515000.38520000",410000,9,0.008798952,38105000,38515000,38110000,38520000,"chr2",105158,0,3,1,4,"chr2",1,0.00421940928270042
"3457","chr2.177235000.177240000","chr2.177260000.177265000",25000,36,0.001114518,177235000,177260000,177240000,177265000,"chr2",105159,0,4,2,6,"chr2",1,0.0253164556962025
"3458","chr2.25300000.25305000","chr2.25330000.25335000",30000,42,7.544502e-08,25300000,25330000,25305000,25335000,"chr2",105180,0,1,3,4,"chr2",1,0.019690576652602
"3459","chr2.208040000.208045000","chr2.208320000.208325000",280000,12,0.0008587206,208040000,208320000,208045000,208325000,"chr2",105262,3,7,7,17,"chr2",1,0.0239099859353024
"3460","chr2.191110000.191115000","chr2.191170000.191175000",60000,22,0.0009333356,191110000,191170000,191115000,191175000,"chr2",105326,0,4,2,6,"chr2",1,0.0154711673699015
"3461","chr2.86105000.86110000","chr2.86295000.86300000",190000,13,0.002702847,86105000,86295000,86110000,86300000,"chr2",105329,0,3,5,8,"chr2",1,0.0121894045944679
"3462","chr2.24880000.24885000","chr2.24895000.24900000",15000,37,0.003413209,24880000,24895000,24885000,24900000,"chr2",105391,0,6,2,8,"chr2",1,0.0346929207688701
"3463","chr2.142000000.142005000","chr2.142880000.142885000",880000,8,0.0009500447,1.42e+08,142880000,142005000,142885000,"chr2",105410,0,1,1,2,"chr2",1,0.00187529301453352
"3464","chr2.230860000.230865000","chr2.231560000.231565000",700000,8,0.003369629,230860000,231560000,230865000,231565000,"chr2",105433,2,3,1,6,"chr2",1,0.00562587904360056
"3465","chr2.85850000.85855000","chr2.86035000.86040000",185000,23,3.923623e-10,85850000,86035000,85855000,86040000,"chr2",105462,0,4,0,4,"chr2",1,0.0107829348335677
"3466","chr2.230890000.230895000","chr2.231015000.231020000",125000,22,2.1785e-07,230890000,231015000,230895000,231020000,"chr2",105463,1,6,3,10,"chr2",1,0.0257852789498359
"3467","chr2.9005000.9010000","chr2.9595000.9600000",590000,9,0.001577941,9005000,9595000,9010000,9600000,"chr2",105479,2,5,5,12,"chr2",1,0.0126582278481013
"3468","chr2.101330000.101335000","chr2.101515000.101520000",185000,13,0.003174651,101330000,101515000,101335000,101520000,"chr2",105559,0,2,2,4,"chr2",1,0.00609470229723394
"3469","chr2.172425000.172430000","chr2.172930000.172935000",505000,9,0.003473507,172425000,172930000,172430000,172935000,"chr2",105592,0,3,0,3,"chr2",1,0.00316455696202532
"3470","chr2.237420000.237425000","chr2.237975000.237980000",555000,8,0.00984918,237420000,237975000,237425000,237980000,"chr2",105645,0,12,11,23,"chr2",1,0.0215658696671355
"3471","chr2.54430000.54435000","chr2.54930000.54935000",500000,12,2.235678e-05,54430000,54930000,54435000,54935000,"chr2",105661,3,4,6,13,"chr2",1,0.0182841068917018
"3472","chr2.48910000.48915000","chr2.48945000.48950000",35000,32,6.680712e-05,48910000,48945000,48915000,48950000,"chr2",105697,2,1,0,3,"chr2",1,0.0112517580872011
"3473","chr2.61895000.61900000","chr2.61915000.61920000",20000,41,0.0002073649,61895000,61915000,61900000,61920000,"chr2",105721,2,12,9,23,"chr2",1,0.110525082044069
"3474","chr2.72780000.72785000","chr2.72825000.72830000",45000,25,0.001208006,72780000,72825000,72785000,72830000,"chr2",105902,0,5,1,6,"chr2",1,0.0175808720112518
"3475","chr2.232760000.232765000","chr2.233210000.233215000",450000,16,1.713189e-08,232760000,233210000,232765000,233215000,"chr2",105923,1,4,3,8,"chr2",1,0.0150023441162682
"3476","chr2.70530000.70535000","chr2.70870000.70875000",340000,23,5.195406e-14,70530000,70870000,70535000,70875000,"chr2",105999,3,1,0,4,"chr2",1,0.0107829348335677
"3477","chr2.64815000.64820000","chr2.65040000.65045000",225000,16,1.00669e-05,64815000,65040000,64820000,65045000,"chr2",106000,5,12,10,27,"chr2",1,0.0506329113924051
"3478","chr2.64870000.64875000","chr2.65065000.65070000",195000,18,1.551728e-06,64870000,65065000,64875000,65070000,"chr2",106035,5,29,17,51,"chr2",1,0.107594936708861
"3479","chr2.85650000.85655000","chr2.85840000.85845000",190000,12,0.008687146,85650000,85840000,85655000,85845000,"chr2",106055,1,6,5,12,"chr2",1,0.0168776371308017
"3480","chr2.47370000.47375000","chr2.47530000.47535000",160000,13,0.007175609,47370000,47530000,47375000,47535000,"chr2",106163,6,18,26,50,"chr2",1,0.0761837787154243
"3481","chr2.231005000.231010000","chr2.231460000.231465000",455000,11,0.000248511,231005000,231460000,231010000,231465000,"chr2",106170,0,1,2,3,"chr2",1,0.00386779184247539
"3482","chr2.160110000.160115000","chr2.160155000.160160000",45000,26,0.0004875882,160110000,160155000,160115000,160160000,"chr2",106176,0,2,0,2,"chr2",1,0.00609470229723394
"3483","chr2.38375000.38380000","chr2.38485000.38490000",110000,16,0.002167945,38375000,38485000,38380000,38490000,"chr2",106195,2,3,1,6,"chr2",1,0.0112517580872011
"3484","chr2.232760000.232765000","chr2.233285000.233290000",525000,16,3.436724e-09,232760000,233285000,232765000,233290000,"chr2",106246,3,4,3,10,"chr2",1,0.0187529301453352
"3485","chr2.197090000.197095000","chr2.197110000.197115000",20000,46,3.358359e-06,197090000,197110000,197095000,197115000,"chr2",106250,2,5,6,13,"chr2",1,0.0700890764181903
"3486","chr2.46855000.46860000","chr2.47570000.47575000",715000,9,0.000526803,46855000,47570000,46860000,47575000,"chr2",106252,2,1,2,5,"chr2",1,0.00527426160337553
"3487","chr2.55120000.55125000","chr2.55265000.55270000",145000,18,2.398148e-05,55120000,55265000,55125000,55270000,"chr2",106259,1,0,1,2,"chr2",1,0.00421940928270042
"3488","chr2.218010000.218015000","chr2.218370000.218375000",360000,11,0.0009173897,218010000,218370000,218015000,218375000,"chr2",106319,0,2,1,3,"chr2",1,0.00386779184247539
"3489","chr2.55280000.55285000","chr2.55400000.55405000",120000,21,1.536966e-06,55280000,55400000,55285000,55405000,"chr2",106337,2,9,10,21,"chr2",1,0.0516877637130802
"3490","chr2.26220000.26225000","chr2.26250000.26255000",30000,32,0.0009703642,26220000,26250000,26225000,26255000,"chr2",106360,0,2,1,3,"chr2",1,0.0112517580872011
"3491","chr2.172695000.172700000","chr2.172735000.172740000",40000,25,0.004349821,172695000,172735000,172700000,172740000,"chr2",106506,0,1,1,2,"chr2",1,0.00586029067041725
"3492","chr2.218655000.218660000","chr2.218730000.218735000",75000,22,7.283957e-05,218655000,218730000,218660000,218735000,"chr2",106545,2,11,2,15,"chr2",1,0.0386779184247539
"3493","chr2.16070000.16075000","chr2.16470000.16475000",400000,15,3.949361e-07,16070000,16470000,16075000,16475000,"chr2",106576,0,2,3,5,"chr2",1,0.00879043600562588
"3494","chr2.54980000.54985000","chr2.55430000.55435000",450000,10,0.001341526,54980000,55430000,54985000,55435000,"chr2",106609,0,3,6,9,"chr2",1,0.0105485232067511
"3495","chr2.25200000.25205000","chr2.25275000.25280000",75000,19,0.001945659,25200000,25275000,25205000,25280000,"chr2",106611,0,3,2,5,"chr2",1,0.0111345522737928
"3496","chr2.55175000.55180000","chr2.55400000.55405000",225000,12,0.003316906,55175000,55400000,55180000,55405000,"chr2",106624,2,9,6,17,"chr2",1,0.0239099859353024
"3497","chr2.74090000.74095000","chr2.74390000.74395000",300000,11,0.00233854,74090000,74390000,74095000,74395000,"chr2",106703,0,2,1,3,"chr2",1,0.00386779184247539
"3498","chr2.28185000.28190000","chr2.28605000.28610000",420000,9,0.008091968,28185000,28605000,28190000,28610000,"chr2",106720,2,2,2,6,"chr2",1,0.00632911392405063
"3499","chr2.219170000.219175000","chr2.219325000.219330000",155000,15,0.0008356975,219170000,219325000,219175000,219330000,"chr2",106740,3,11,15,29,"chr2",1,0.0509845288326301
"3500","chr2.101615000.101620000","chr2.101765000.101770000",150000,29,7.005633e-14,101615000,101765000,101620000,101770000,"chr2",106767,1,7,11,19,"chr2",1,0.0645804031879981
"3501","chr2.61065000.61070000","chr2.61210000.61215000",145000,17,9.587926e-05,61065000,61210000,61070000,61215000,"chr2",106868,2,1,4,7,"chr2",1,0.0139474917955931
"3502","chr2.101250000.101255000","chr2.101530000.101535000",280000,12,0.0008587206,101250000,101530000,101255000,101535000,"chr2",106917,3,5,4,12,"chr2",1,0.0168776371308017
"3503","chr2.47260000.47265000","chr2.47505000.47510000",245000,16,4.512696e-06,47260000,47505000,47265000,47510000,"chr2",106965,1,7,4,12,"chr2",1,0.0225035161744023
"3504","chr2.86070000.86075000","chr2.86290000.86295000",220000,16,1.245525e-05,86070000,86290000,86075000,86295000,"chr2",106995,2,2,10,14,"chr2",1,0.0262541022034693
"3505","chr2.48340000.48345000","chr2.48420000.48425000",80000,18,0.003026855,48340000,48420000,48345000,48425000,"chr2",107005,2,0,2,4,"chr2",1,0.00843881856540084
"3506","chr2.25300000.25305000","chr2.25320000.25325000",20000,48,5.303157e-07,25300000,25320000,25305000,25325000,"chr2",107055,1,3,4,8,"chr2",1,0.0450070323488045
"3507","chr2.55400000.55405000","chr2.55455000.55460000",55000,25,0.000124966,55400000,55455000,55405000,55460000,"chr2",107073,1,9,2,12,"chr2",1,0.0351617440225035
"3508","chr2.219305000.219310000","chr2.219325000.219330000",20000,39,0.0009045029,219305000,219325000,219310000,219330000,"chr2",107106,2,7,5,14,"chr2",1,0.0639943741209564
"3509","chr2.64860000.64865000","chr2.64985000.64990000",125000,19,1.908347e-05,64860000,64985000,64865000,64990000,"chr2",107138,1,5,7,13,"chr2",1,0.0289498359118612
"3510","chr2.64865000.64870000","chr2.64995000.65000000",130000,27,2.599321e-11,64865000,64995000,64870000,6.5e+07,"chr2",107146,2,4,5,11,"chr2",1,0.0348101265822785
"3511","chr2.36750000.36755000","chr2.36890000.36895000",140000,14,0.004846327,36750000,36890000,36755000,36895000,"chr2",107159,0,7,11,18,"chr2",1,0.029535864978903
"3512","chr2.32925000.32930000","chr2.33595000.33600000",670000,9,0.0007779438,32925000,33595000,32930000,33600000,"chr2",107176,0,2,3,5,"chr2",1,0.00527426160337553
"3513","chr2.11390000.11395000","chr2.11410000.11415000",20000,38,0.001797953,11390000,11410000,11395000,11415000,"chr2",107210,0,8,4,12,"chr2",1,0.0534458509142053
"3514","chr2.128090000.128095000","chr2.128235000.128240000",145000,16,0.0003666613,128090000,128235000,128095000,128240000,"chr2",107345,5,18,26,49,"chr2",1,0.0918893577121425
"3515","chr2.24995000.25000000","chr2.25250000.25255000",255000,11,0.005703234,24995000,25250000,2.5e+07,25255000,"chr2",107368,0,2,1,3,"chr2",1,0.00386779184247539
"3516","chr2.24640000.24645000","chr2.24960000.24965000",320000,12,0.0003750774,24640000,24960000,24645000,24965000,"chr2",107404,0,1,0,1,"chr2",1,0.00140646976090014
"3517","chr2.56005000.56010000","chr2.56185000.56190000",180000,20,1.271154e-07,56005000,56185000,56010000,56190000,"chr2",107406,0,3,2,5,"chr2",1,0.0117205813408345
"3518","chr2.24640000.24645000","chr2.25055000.25060000",415000,9,0.00850255,24640000,25055000,24645000,25060000,"chr2",107417,2,1,0,3,"chr2",1,0.00316455696202532
"3519","chr2.230865000.230870000","chr2.231105000.231110000",240000,11,0.007887179,230865000,231105000,230870000,231110000,"chr2",107475,0,2,1,3,"chr2",1,0.00386779184247539
"3520","chr2.48545000.48550000","chr2.48560000.48565000",15000,38,0.001797953,48545000,48560000,48550000,48565000,"chr2",107513,2,7,3,12,"chr2",1,0.0534458509142053
"3521","chr2.24855000.24860000","chr2.24880000.24885000",25000,34,0.004425962,24855000,24880000,24860000,24885000,"chr2",107545,0,4,1,5,"chr2",1,0.0199249882794187
"3522","chr2.219520000.219525000","chr2.219570000.219575000",50000,27,5.10944e-05,219520000,219570000,219525000,219575000,"chr2",107560,1,1,0,2,"chr2",1,0.00632911392405063
"3523","chr2.47260000.47265000","chr2.47530000.47535000",270000,13,0.0002468696,47260000,47530000,47265000,47535000,"chr2",107590,1,10,4,15,"chr2",1,0.0228551336146273
"3524","chr2.36595000.36600000","chr2.36660000.36665000",65000,21,0.001034425,36595000,36660000,36600000,36665000,"chr2",107709,2,2,3,7,"chr2",1,0.0172292545710267
"3525","chr2.70565000.70570000","chr2.70765000.70770000",200000,20,3.717576e-08,70565000,70765000,70570000,70770000,"chr2",107737,1,1,1,3,"chr2",1,0.0070323488045007
"3526","chr2.55135000.55140000","chr2.55400000.55405000",265000,22,1.66225e-11,55135000,55400000,55140000,55405000,"chr2",107738,0,2,2,4,"chr2",1,0.0103141115799344
"3527","chr2.171315000.171320000","chr2.171665000.171670000",350000,11,0.001042909,171315000,171665000,171320000,171670000,"chr2",107813,0,2,0,2,"chr2",1,0.00257852789498359
"3528","chr2.239270000.239275000","chr2.240025000.240030000",755000,8,0.002290301,239270000,240025000,239275000,240030000,"chr2",107834,0,0,2,2,"chr2",1,0.00187529301453352
"3529","chr2.45890000.45895000","chr2.45910000.45915000",20000,54,1.234362e-09,45890000,45910000,45895000,45915000,"chr2",107902,3,6,9,18,"chr2",1,0.113924050632911
"3530","chr2.122195000.122200000","chr2.122485000.122490000",290000,12,0.0006882773,122195000,122485000,122200000,122490000,"chr2",107928,0,4,1,5,"chr2",1,0.0070323488045007
"3531","chr2.45890000.45895000","chr2.46150000.46155000",260000,14,6.999599e-05,45890000,46150000,45895000,46155000,"chr2",107952,2,6,9,17,"chr2",1,0.0278949835911861
"3532","chr2.96885000.96890000","chr2.96925000.96930000",40000,28,0.0003417937,96885000,96925000,96890000,96930000,"chr2",108018,1,3,1,5,"chr2",1,0.0164088138771683
"3533","chr2.54175000.54180000","chr2.54275000.54280000",100000,20,3.958823e-05,54175000,54275000,54180000,54280000,"chr2",108153,0,5,8,13,"chr2",1,0.0304735114861697
"3534","chr2.27190000.27195000","chr2.27215000.27220000",25000,33,0.008420578,27190000,27215000,27195000,27220000,"chr2",108204,6,12,15,33,"chr2",1,0.127637130801688
"3535","chr2.26220000.26225000","chr2.26240000.26245000",20000,53,3.611938e-09,26220000,26240000,26225000,26245000,"chr2",108295,0,2,1,3,"chr2",1,0.0186357243319269
"3536","chr2.223590000.223595000","chr2.223610000.223615000",20000,52,1.028223e-08,223590000,223610000,223595000,223615000,"chr2",108308,1,2,2,5,"chr2",1,0.0304735114861697
"3537","chr2.102805000.102810000","chr2.102825000.102830000",20000,44,1.88628e-05,102805000,102825000,102810000,102830000,"chr2",108346,1,1,0,2,"chr2",1,0.0103141115799344
"3538","chr2.55110000.55115000","chr2.55415000.55420000",305000,17,8.383814e-08,55110000,55415000,55115000,55420000,"chr2",108347,2,4,2,8,"chr2",1,0.0159399906235349
"3539","chr2.240340000.240345000","chr2.240820000.240825000",480000,10,0.0009559797,240340000,240820000,240345000,240825000,"chr2",108391,2,1,1,4,"chr2",1,0.0046882325363338
"3540","chr2.202110000.202115000","chr2.202265000.202270000",155000,15,0.0008356975,202110000,202265000,202115000,202270000,"chr2",108420,0,2,1,3,"chr2",1,0.00527426160337553
"3541","chr2.70550000.70555000","chr2.70860000.70865000",310000,10,0.007583919,70550000,70860000,70555000,70865000,"chr2",108433,0,1,3,4,"chr2",1,0.0046882325363338
"3542","chr2.161110000.161115000","chr2.161990000.161995000",880000,7,0.00568429,161110000,161990000,161115000,161995000,"chr2",108443,0,2,1,3,"chr2",1,0.00246132208157525
"3543","chr2.64885000.64890000","chr2.65040000.65045000",155000,14,0.002774387,64885000,65040000,64890000,65045000,"chr2",108456,2,9,4,15,"chr2",1,0.0246132208157525
"3544","chr2.71220000.71225000","chr2.71290000.71295000",70000,21,0.0004728668,71220000,71290000,71225000,71295000,"chr2",108471,3,6,5,14,"chr2",1,0.0344585091420534
"3545","chr2.20650000.20655000","chr2.20840000.20845000",190000,18,2.031727e-06,20650000,20840000,20655000,20845000,"chr2",108530,2,1,1,4,"chr2",1,0.00843881856540084
"3546","chr2.70565000.70570000","chr2.71190000.71195000",625000,9,0.001132894,70565000,71190000,70570000,71195000,"chr2",108548,1,1,2,4,"chr2",1,0.00421940928270042
"3547","chr2.48125000.48130000","chr2.48545000.48550000",420000,13,1.252879e-05,48125000,48545000,48130000,48550000,"chr2",108549,2,7,3,12,"chr2",1,0.0182841068917018
"3548","chr2.55110000.55115000","chr2.55135000.55140000",25000,42,8.621903e-06,55110000,55135000,55115000,55140000,"chr2",108571,0,2,2,4,"chr2",1,0.019690576652602
"3549","chr2.46940000.46945000","chr2.46970000.46975000",30000,31,0.002093764,46940000,46970000,46945000,46975000,"chr2",108579,4,3,1,8,"chr2",1,0.0290670417252696
"3550","chr2.190675000.190680000","chr2.190695000.190700000",20000,39,0.0009045029,190675000,190695000,190680000,190700000,"chr2",108580,3,1,2,6,"chr2",1,0.0274261603375527
"3551","chr2.32275000.32280000","chr2.32400000.32405000",125000,14,0.008580544,32275000,32400000,32280000,32405000,"chr2",108661,8,15,20,43,"chr2",1,0.0705578996718237
"3552","chr2.69740000.69745000","chr2.69825000.69830000",85000,17,0.005024145,69740000,69825000,69745000,69830000,"chr2",108667,0,3,1,4,"chr2",1,0.00796999531176746
"3553","chr2.42095000.42100000","chr2.42420000.42425000",325000,14,1.265954e-05,42095000,42420000,42100000,42425000,"chr2",108670,0,2,1,3,"chr2",1,0.00492264416315049
"3554","chr2.55165000.55170000","chr2.55400000.55405000",235000,14,0.0001555264,55165000,55400000,55170000,55405000,"chr2",108678,0,1,1,2,"chr2",1,0.00328176277543366
"3555","chr2.196985000.196990000","chr2.197005000.197010000",20000,48,5.303157e-07,196985000,197005000,196990000,197010000,"chr2",108770,2,7,7,16,"chr2",1,0.090014064697609
"3556","chr2.228515000.228520000","chr2.228745000.228750000",230000,13,0.0007672627,228515000,228745000,228520000,228750000,"chr2",108794,0,4,4,8,"chr2",1,0.0121894045944679
"3557","chr2.231765000.231770000","chr2.231850000.231855000",85000,26,6.926165e-08,231765000,231850000,231770000,231855000,"chr2",108821,4,12,11,27,"chr2",1,0.0822784810126582
"3558","chr2.86140000.86145000","chr2.86245000.86250000",105000,18,0.0003075462,86140000,86245000,86145000,86250000,"chr2",108841,5,7,8,20,"chr2",1,0.0421940928270042
"3559","chr2.61470000.61475000","chr2.61690000.61695000",220000,13,0.001032804,61470000,61690000,61475000,61695000,"chr2",108847,6,17,13,36,"chr2",1,0.0548523206751055
"3560","chr2.190970000.190975000","chr2.191035000.191040000",65000,19,0.006728756,190970000,191035000,190975000,191040000,"chr2",108900,0,2,2,4,"chr2",1,0.00890764181903422
"3561","chr2.105035000.105040000","chr2.105480000.105485000",445000,10,0.001427765,105035000,105480000,105040000,105485000,"chr2",109090,0,3,1,4,"chr2",1,0.0046882325363338
"3562","chr2.56005000.56010000","chr2.56180000.56185000",175000,16,9.021355e-05,56005000,56180000,56010000,56185000,"chr2",109092,0,2,2,4,"chr2",1,0.00750117205813408
"3563","chr2.219575000.219580000","chr2.219595000.219600000",20000,73,5.934027e-20,219575000,219595000,219580000,219600000,"chr2",109109,0,9,6,15,"chr2",1,0.128340365682138
"3564","chr2.47260000.47265000","chr2.47285000.47290000",25000,42,8.621903e-06,47260000,47285000,47265000,47290000,"chr2",109150,1,9,4,14,"chr2",1,0.0689170182841069
"3565","chr2.64865000.64870000","chr2.65265000.65270000",400000,10,0.002409769,64865000,65265000,64870000,65270000,"chr2",109222,0,0,4,4,"chr2",1,0.0046882325363338
"3566","chr2.85300000.85305000","chr2.85445000.85450000",145000,16,0.0003666613,85300000,85445000,85305000,85450000,"chr2",109251,1,4,2,7,"chr2",1,0.0131270511017346
"3567","chr2.64855000.64860000","chr2.64995000.65000000",140000,16,0.000454493,64855000,64995000,64860000,6.5e+07,"chr2",109321,5,8,13,26,"chr2",1,0.0487576183778715
"3568","chr2.28810000.28815000","chr2.29040000.29045000",230000,11,0.009837087,28810000,29040000,28815000,29045000,"chr2",109329,0,3,1,4,"chr2",1,0.00515705578996718
"3569","chr2.1865000.1870000","chr2.2300000.2305000",435000,9,0.006907378,1865000,2300000,1870000,2305000,"chr2",109334,0,2,0,2,"chr2",1,0.00210970464135021
"3570","chr2.218485000.218490000","chr2.218575000.218580000",90000,16,0.008624295,218485000,218575000,218490000,218580000,"chr2",109368,6,16,14,36,"chr2",1,0.0675105485232067
"3571","chr2.73005000.73010000","chr2.73050000.73055000",45000,31,2.722742e-06,73005000,73050000,73010000,73055000,"chr2",109406,0,2,1,3,"chr2",1,0.0109001406469761
"3572","chr2.55135000.55140000","chr2.55405000.55410000",270000,12,0.001060841,55135000,55405000,55140000,55410000,"chr2",109417,0,2,2,4,"chr2",1,0.00562587904360056
"3573","chr2.48545000.48550000","chr2.48585000.48590000",40000,32,6.286924e-06,48545000,48585000,48550000,48590000,"chr2",109520,2,6,3,11,"chr2",1,0.0412564463197375
"3574","chr2.235540000.235545000","chr2.235940000.235945000",400000,9,0.009836434,235540000,235940000,235545000,235945000,"chr2",109532,1,4,3,8,"chr2",1,0.00843881856540084
"3575","chr2.55280000.55285000","chr2.55355000.55360000",75000,27,1.071429e-07,55280000,55355000,55285000,55360000,"chr2",109555,0,2,1,3,"chr2",1,0.00949367088607595
"3576","chr2.48130000.48135000","chr2.48545000.48550000",415000,11,0.000430015,48130000,48545000,48135000,48550000,"chr2",109630,2,4,3,9,"chr2",1,0.0116033755274262
"3577","chr2.54050000.54055000","chr2.54175000.54180000",125000,16,0.0009414249,54050000,54175000,54055000,54180000,"chr2",109751,3,5,8,16,"chr2",1,0.0300046882325363
"3578","chr2.74175000.74180000","chr2.74405000.74410000",230000,11,0.009837087,74175000,74405000,74180000,74410000,"chr2",109792,1,9,11,21,"chr2",1,0.0270745428973277
"3579","chr2.206125000.206130000","chr2.206160000.206165000",35000,26,0.009419337,206125000,206160000,206130000,206165000,"chr2",109805,1,6,3,10,"chr2",1,0.0304735114861697
"3580","chr2.72515000.72520000","chr2.72825000.72830000",310000,14,1.803561e-05,72515000,72825000,72520000,72830000,"chr2",109903,0,2,0,2,"chr2",1,0.00328176277543366
"3581","chr2.26250000.26255000","chr2.26350000.26355000",100000,27,1.156519e-09,26250000,26350000,26255000,26355000,"chr2",109936,2,8,8,18,"chr2",1,0.0569620253164557
"3582","chr2.158290000.158295000","chr2.159110000.159115000",820000,9,0.0002219465,158290000,159110000,158295000,159115000,"chr2",109954,4,7,7,18,"chr2",1,0.0189873417721519
"3583","chr2.54360000.54365000","chr2.54550000.54555000",190000,12,0.008687146,54360000,54550000,54365000,54555000,"chr2",110019,0,2,1,3,"chr2",1,0.00421940928270042
"3584","chr2.134915000.134920000","chr2.134985000.134990000",70000,18,0.008738458,134915000,134985000,134920000,134990000,"chr2",110055,1,1,1,3,"chr2",1,0.00632911392405063
"3585","chr2.101275000.101280000","chr2.101295000.101300000",20000,44,1.88628e-05,101275000,101295000,101280000,101300000,"chr2",110091,3,19,10,32,"chr2",1,0.16502578527895
"3586","chr2.9310000.9315000","chr2.9475000.9480000",165000,16,0.0001431418,9310000,9475000,9315000,9480000,"chr2",110116,2,7,5,14,"chr2",1,0.0262541022034693
"3587","chr2.74175000.74180000","chr2.74415000.74420000",240000,12,0.002235981,74175000,74415000,74180000,74420000,"chr2",110124,1,16,11,28,"chr2",1,0.0393811533052039
"3588","chr2.162115000.162120000","chr2.162160000.162165000",45000,24,0.002886765,162115000,162160000,162120000,162165000,"chr2",110214,0,3,1,4,"chr2",1,0.0112517580872011
"3589","chr2.74050000.74055000","chr2.74405000.74410000",355000,16,1.489735e-07,74050000,74405000,74055000,74410000,"chr2",110232,4,6,2,12,"chr2",1,0.0225035161744023
"3590","chr2.197160000.197165000","chr2.197450000.197455000",290000,11,0.002819447,197160000,197450000,197165000,197455000,"chr2",110247,0,1,3,4,"chr2",1,0.00515705578996718
"3591","chr2.201150000.201155000","chr2.201360000.201365000",210000,12,0.004989964,201150000,201360000,201155000,201365000,"chr2",110276,0,3,1,4,"chr2",1,0.00562587904360056
"3592","chr2.69770000.69775000","chr2.69930000.69935000",160000,15,0.0006747692,69770000,69930000,69775000,69935000,"chr2",110312,1,2,3,6,"chr2",1,0.0105485232067511
"3593","chr2.54360000.54365000","chr2.54925000.54930000",565000,8,0.00909664,54360000,54925000,54365000,54930000,"chr2",110323,0,3,2,5,"chr2",1,0.0046882325363338
"3594","chr2.85580000.85585000","chr2.85810000.85815000",230000,12,0.002895462,85580000,85810000,85585000,85815000,"chr2",110345,0,1,2,3,"chr2",1,0.00421940928270042
"3595","chr2.161120000.161125000","chr2.161270000.161275000",150000,14,0.003346259,161120000,161270000,161125000,161275000,"chr2",110365,0,1,5,6,"chr2",1,0.00984528832630099
"3596","chr2.232760000.232765000","chr2.232995000.233000000",235000,11,0.008738458,232760000,232995000,232765000,2.33e+08,"chr2",110368,1,4,3,8,"chr2",1,0.0103141115799344
"3597","chr2.1900000.1905000","chr2.2300000.2305000",400000,10,0.002409769,1900000,2300000,1905000,2305000,"chr2",110387,2,2,0,4,"chr2",1,0.0046882325363338
"3598","chr2.64820000.64825000","chr2.64870000.64875000",50000,29,5.65568e-06,64820000,64870000,64825000,64875000,"chr2",110405,7,7,9,23,"chr2",1,0.0781762775433661
"3599","chr2.98535000.98540000","chr2.98570000.98575000",35000,28,0.002159006,98535000,98570000,98540000,98575000,"chr2",110409,0,2,0,2,"chr2",1,0.00656352555086732
"3600","chr2.72800000.72805000","chr2.72970000.72975000",170000,14,0.00159096,72800000,72970000,72805000,72975000,"chr2",110428,0,2,0,2,"chr2",1,0.00328176277543366
"3601","chr2.69645000.69650000","chr2.69740000.69745000",95000,17,0.002159006,69645000,69740000,69650000,69745000,"chr2",110448,3,22,16,41,"chr2",1,0.0816924519456165
"3602","chr2.128060000.128065000","chr2.128090000.128095000",30000,35,7.95399e-05,128060000,128090000,128065000,128095000,"chr2",110505,7,24,12,43,"chr2",1,0.176394749179559
"3603","chr2.178195000.178200000","chr2.178270000.178275000",75000,20,0.0006903351,178195000,178270000,178200000,178275000,"chr2",110507,1,2,3,6,"chr2",1,0.0140646976090014
"3604","chr2.24720000.24725000","chr2.24970000.24975000",250000,16,3.701924e-06,24720000,24970000,24725000,24975000,"chr2",110647,1,2,3,6,"chr2",1,0.0112517580872011
"3605","chr2.235540000.235545000","chr2.236010000.236015000",470000,12,3.530606e-05,235540000,236010000,235545000,236015000,"chr2",110684,1,4,3,8,"chr2",1,0.0112517580872011
"3606","chr2.222910000.222915000","chr2.223415000.223420000",505000,13,3.029019e-06,222910000,223415000,222915000,223420000,"chr2",110748,1,0,4,5,"chr2",1,0.00761837787154243
"3607","chr2.1910000.1915000","chr2.2130000.2135000",220000,12,0.003776479,1910000,2130000,1915000,2135000,"chr2",110753,0,1,1,2,"chr2",1,0.00281293952180028
"3608","chr2.159090000.159095000","chr2.159110000.159115000",20000,38,0.001797953,159090000,159110000,159095000,159115000,"chr2",110756,0,1,3,4,"chr2",1,0.0178152836380684
"3609","chr2.61635000.61640000","chr2.61670000.61675000",35000,29,0.0009559797,61635000,61670000,61640000,61675000,"chr2",110799,3,12,3,18,"chr2",1,0.0611814345991561
"3610","chr2.85580000.85585000","chr2.85825000.85830000",245000,17,7.969776e-07,85580000,85825000,85585000,85830000,"chr2",110866,3,8,3,14,"chr2",1,0.0278949835911861
"3611","chr2.134985000.134990000","chr2.135165000.135170000",180000,19,6.852538e-07,134985000,135165000,134990000,135170000,"chr2",110886,1,1,1,3,"chr2",1,0.00668073136427567
"3612","chr2.47285000.47290000","chr2.47520000.47525000",235000,17,1.225205e-06,47285000,47520000,47290000,47525000,"chr2",110899,2,5,7,14,"chr2",1,0.0278949835911861
"3613","chr2.11375000.11380000","chr2.11720000.11725000",345000,10,0.004694997,11375000,11720000,11380000,11725000,"chr2",110988,0,1,2,3,"chr2",1,0.00351617440225035
"3614","chr2.54340000.54345000","chr2.54875000.54880000",535000,9,0.002616274,54340000,54875000,54345000,54880000,"chr2",111016,2,0,0,2,"chr2",1,0.00210970464135021
"3615","chr2.181075000.181080000","chr2.181740000.181745000",665000,8,0.004349491,181075000,181740000,181080000,181745000,"chr2",111124,0,1,0,1,"chr2",1,0.00093764650726676
"3616","chr2.104575000.104580000","chr2.105035000.105040000",460000,10,0.001195928,104575000,105035000,104580000,105040000,"chr2",111176,0,3,4,7,"chr2",1,0.00820440693858415
"3617","chr2.73210000.73215000","chr2.73385000.73390000",175000,14,0.001310839,73210000,73385000,73215000,73390000,"chr2",111201,2,9,8,19,"chr2",1,0.0311767463666198
"3618","chr2.171345000.171350000","chr2.171385000.171390000",40000,30,4.964184e-05,171345000,171385000,171350000,171390000,"chr2",111278,2,1,0,3,"chr2",1,0.0105485232067511
"3619","chr2.177210000.177215000","chr2.177305000.177310000",95000,17,0.002159006,177210000,177305000,177215000,177310000,"chr2",111293,0,8,6,14,"chr2",1,0.0278949835911861
"3620","chr2.55265000.55270000","chr2.55365000.55370000",100000,24,1.36142e-07,55265000,55365000,55270000,55370000,"chr2",111322,1,14,7,22,"chr2",1,0.0618846694796062
"3621","chr2.61895000.61900000","chr2.62075000.62080000",180000,14,0.001084925,61895000,62075000,61900000,62080000,"chr2",111329,2,12,9,23,"chr2",1,0.0377402719174871
"3622","chr2.47265000.47270000","chr2.47530000.47535000",265000,11,0.004599226,47265000,47530000,47270000,47535000,"chr2",111396,6,9,11,26,"chr2",1,0.0335208626347867
"3623","chr2.128060000.128065000","chr2.128230000.128235000",170000,14,0.00159096,128060000,128230000,128065000,128235000,"chr2",111409,4,24,12,40,"chr2",1,0.0656352555086732
"3624","chr2.201780000.201785000","chr2.202015000.202020000",235000,11,0.008738458,201780000,202015000,201785000,202020000,"chr2",111418,1,5,4,10,"chr2",1,0.012892639474918
"3625","chr2.48325000.48330000","chr2.48560000.48565000",235000,11,0.008738458,48325000,48560000,48330000,48565000,"chr2",111444,0,4,2,6,"chr2",1,0.00773558368495077
"3626","chr2.27315000.27320000","chr2.27355000.27360000",40000,25,0.004349821,27315000,27355000,27320000,27360000,"chr2",111497,7,25,24,56,"chr2",1,0.164088138771683
"3627","chr2.230940000.230945000","chr2.231480000.231485000",540000,11,8.2444e-05,230940000,231480000,230945000,231485000,"chr2",111539,1,2,2,5,"chr2",1,0.00644631973745898
"3628","chr2.85550000.85555000","chr2.85580000.85585000",30000,46,7.523621e-10,85550000,85580000,85555000,85585000,"chr2",111543,2,8,7,17,"chr2",1,0.0916549460853258
"3629","chr2.102240000.102245000","chr2.102440000.102445000",200000,13,0.001954724,102240000,102440000,102245000,102445000,"chr2",111622,0,5,2,7,"chr2",1,0.0106657290201594
"3630","chr2.69645000.69650000","chr2.69770000.69775000",125000,14,0.008580544,69645000,69770000,69650000,69775000,"chr2",111628,3,8,8,19,"chr2",1,0.0311767463666198
"3631","chr2.219280000.219285000","chr2.219325000.219330000",45000,23,0.006426477,219280000,219325000,219285000,219330000,"chr2",111637,2,0,1,3,"chr2",1,0.00808720112517581
"3632","chr2.47365000.47370000","chr2.47505000.47510000",140000,17,0.000124966,47365000,47505000,47370000,47510000,"chr2",111704,2,7,10,19,"chr2",1,0.0378574777308955
"3633","chr2.102635000.102640000","chr2.102845000.102850000",210000,18,7.105871e-07,102635000,102845000,102640000,102850000,"chr2",111745,0,2,2,4,"chr2",1,0.00843881856540084
"3634","chr2.70550000.70555000","chr2.70980000.70985000",430000,9,0.007245928,70550000,70980000,70555000,70985000,"chr2",111754,0,1,3,4,"chr2",1,0.00421940928270042
"3635","chr2.26265000.26270000","chr2.26355000.26360000",90000,21,3.307489e-05,26265000,26355000,26270000,26360000,"chr2",111873,8,15,23,46,"chr2",1,0.113220815752461
"3636","chr2.43210000.43215000","chr2.43710000.43715000",500000,11,0.0001378973,43210000,43710000,43215000,43715000,"chr2",111927,0,1,3,4,"chr2",1,0.00515705578996718
"3637","chr2.47235000.47240000","chr2.47505000.47510000",270000,13,0.0002468696,47235000,47505000,47240000,47510000,"chr2",111932,2,6,4,12,"chr2",1,0.0182841068917018
"3638","chr2.20595000.20600000","chr2.20840000.20845000",245000,11,0.007014255,20595000,20840000,20600000,20845000,"chr2",111941,0,0,2,2,"chr2",1,0.00257852789498359
"3639","chr2.20225000.20230000","chr2.20520000.20525000",295000,10,0.009453251,20225000,20520000,20230000,20525000,"chr2",112036,1,2,4,7,"chr2",1,0.00820440693858415
"3640","chr2.98770000.98775000","chr2.98800000.98805000",30000,29,0.008519007,98770000,98800000,98775000,98805000,"chr2",112066,0,0,3,3,"chr2",1,0.010196905766526
"3641","chr2.60995000.61000000","chr2.61210000.61215000",215000,19,9.491003e-08,60995000,61210000,6.1e+07,61215000,"chr2",112071,2,4,7,13,"chr2",1,0.0289498359118612
"3642","chr2.20650000.20655000","chr2.20835000.20840000",185000,27,1.327318e-13,20650000,20835000,20655000,20840000,"chr2",112093,2,1,1,4,"chr2",1,0.0126582278481013
"3643","chr2.202275000.202280000","chr2.202295000.202300000",20000,37,0.003413209,202275000,202295000,202280000,202300000,"chr2",112170,0,11,11,22,"chr2",1,0.0954055321143929
"3644","chr2.158890000.158895000","chr2.159600000.159605000",710000,14,1.381237e-08,158890000,159600000,158895000,159605000,"chr2",112327,3,5,10,18,"chr2",1,0.029535864978903
"3645","chr2.74050000.74055000","chr2.74385000.74390000",335000,11,0.001310839,74050000,74385000,74055000,74390000,"chr2",112411,2,6,2,10,"chr2",1,0.012892639474918
"3646","chr2.231960000.231965000","chr2.232310000.232315000",350000,11,0.001042909,231960000,232310000,231965000,232315000,"chr2",112423,4,9,6,19,"chr2",1,0.0244960150023441
"3647","chr2.202120000.202125000","chr2.202275000.202280000",155000,14,0.002774387,202120000,202275000,202125000,202280000,"chr2",112542,1,7,6,14,"chr2",1,0.0229723394280356
"3648","chr2.10120000.10125000","chr2.10185000.10190000",65000,53,3.345067e-26,10120000,10185000,10125000,10190000,"chr2",112555,1,1,1,3,"chr2",1,0.0186357243319269
"3649","chr2.20580000.20585000","chr2.20810000.20815000",230000,11,0.009837087,20580000,20810000,20585000,20815000,"chr2",112667,1,2,2,5,"chr2",1,0.00644631973745898
"3650","chr2.20580000.20585000","chr2.20640000.20645000",60000,31,2.000846e-08,20580000,20640000,20585000,20645000,"chr2",112771,1,1,1,3,"chr2",1,0.0109001406469761
"3651","chr2.55265000.55270000","chr2.55405000.55410000",140000,14,0.004846327,55265000,55405000,55270000,55410000,"chr2",112909,1,14,7,22,"chr2",1,0.0360993905297703
"3652","chr2.47265000.47270000","chr2.47400000.47405000",135000,14,0.005846758,47265000,47400000,47270000,47405000,"chr2",112942,6,9,11,26,"chr2",1,0.0426629160806376
"3653","chr2.46560000.46565000","chr2.46590000.46595000",30000,32,0.0009703642,46560000,46590000,46565000,46595000,"chr2",113036,3,5,8,16,"chr2",1,0.0600093764650727
"3654","chr2.39580000.39585000","chr2.39670000.39675000",90000,17,0.003259365,39580000,39670000,39585000,39675000,"chr2",113062,0,1,0,1,"chr2",1,0.00199249882794187
"3655","chr2.72825000.72830000","chr2.72860000.72865000",35000,28,0.002159006,72825000,72860000,72830000,72865000,"chr2",113320,0,2,0,2,"chr2",1,0.00656352555086732
"3656","chr2.54405000.54410000","chr2.54925000.54930000",520000,19,3.061792e-12,54405000,54925000,54410000,54930000,"chr2",113404,0,3,2,5,"chr2",1,0.0111345522737928
"3657","chr2.33290000.33295000","chr2.33580000.33585000",290000,11,0.002819447,33290000,33580000,33295000,33585000,"chr2",113429,1,3,2,6,"chr2",1,0.00773558368495077
"3658","chr2.85295000.85300000","chr2.85485000.85490000",190000,18,2.031727e-06,85295000,85485000,85300000,85490000,"chr2",113487,5,21,6,32,"chr2",1,0.0675105485232067
"3659","chr2.9300000.9305000","chr2.9460000.9465000",160000,14,0.002294501,9300000,9460000,9305000,9465000,"chr2",113501,2,6,7,15,"chr2",1,0.0246132208157525
"3660","chr2.233035000.233040000","chr2.233115000.233120000",80000,25,6.874232e-07,233035000,233115000,233040000,233120000,"chr2",113554,2,12,8,22,"chr2",1,0.0644631973745898
"3661","chr2.208165000.208170000","chr2.208320000.208325000",155000,13,0.008519007,208165000,208320000,208170000,208325000,"chr2",113587,1,7,7,15,"chr2",1,0.0228551336146273
"3662","chr2.53860000.53865000","chr2.53880000.53885000",20000,43,4.321287e-05,53860000,53880000,53865000,53885000,"chr2",113717,2,8,7,17,"chr2",1,0.0856774496015002
"3663","chr2.230860000.230865000","chr2.231015000.231020000",155000,19,3.058346e-06,230860000,231015000,230865000,231020000,"chr2",113745,1,3,1,5,"chr2",1,0.0111345522737928
"3664","chr2.227655000.227660000","chr2.227860000.227865000",205000,12,0.005747455,227655000,227860000,227660000,227865000,"chr2",113791,0,4,2,6,"chr2",1,0.00843881856540084
"3665","chr2.85295000.85300000","chr2.85520000.85525000",225000,18,3.359739e-07,85295000,85520000,85300000,85525000,"chr2",113815,4,20,6,30,"chr2",1,0.0632911392405063
"3666","chr2.64885000.64890000","chr2.64940000.64945000",55000,33,7.014e-09,64885000,64940000,64890000,64945000,"chr2",113885,2,5,4,11,"chr2",1,0.0425457102672293
"3667","chr2.218655000.218660000","chr2.218850000.218855000",195000,18,1.551728e-06,218655000,218850000,218660000,218855000,"chr2",113977,2,11,2,15,"chr2",1,0.0316455696202532
"3668","chr2.219530000.219535000","chr2.219570000.219575000",40000,33,2.094347e-06,219530000,219570000,219535000,219575000,"chr2",113979,3,2,1,6,"chr2",1,0.0232067510548523
"3669","chr2.208070000.208075000","chr2.208320000.208325000",250000,13,0.0004295622,208070000,208320000,208075000,208325000,"chr2",113983,3,7,7,17,"chr2",1,0.0259024847632443
"3670","chr2.26265000.26270000","chr2.26330000.26335000",65000,30,1.749122e-08,26265000,26330000,26270000,26335000,"chr2",114135,8,15,36,59,"chr2",1,0.207454289732771
"3671","chr2.26160000.26165000","chr2.26380000.26385000",220000,14,0.0002574937,26160000,26380000,26165000,26385000,"chr2",114138,2,18,11,31,"chr2",1,0.0508673230192218
"3672","chr2.45900000.45905000","chr2.45935000.45940000",35000,27,0.004599226,45900000,45935000,45905000,45940000,"chr2",114291,1,5,3,9,"chr2",1,0.0284810126582278
"3673","chr2.9705000.9710000","chr2.9970000.9975000",265000,14,6.024716e-05,9705000,9970000,9710000,9975000,"chr2",114327,0,0,2,2,"chr2",1,0.00328176277543366
"3674","chr2.104925000.104930000","chr2.104945000.104950000",20000,36,0.006345598,104925000,104945000,104930000,104950000,"chr2",114413,0,2,0,2,"chr2",1,0.00843881856540084
"3675","chr2.48340000.48345000","chr2.48690000.48695000",350000,12,0.0002216703,48340000,48690000,48345000,48695000,"chr2",114443,0,0,2,2,"chr2",1,0.00281293952180028
"3676","chr2.232605000.232610000","chr2.232625000.232630000",20000,45,8.09957e-06,232605000,232625000,232610000,232630000,"chr2",114453,8,12,15,35,"chr2",1,0.184599156118143
"3677","chr2.200885000.200890000","chr2.200905000.200910000",20000,38,0.001797953,200885000,200905000,200890000,200910000,"chr2",114474,5,15,6,26,"chr2",1,0.115799343647445
"3678","chr2.235790000.235795000","chr2.236010000.236015000",220000,16,1.245525e-05,235790000,236010000,235795000,236015000,"chr2",114684,0,4,1,5,"chr2",1,0.00937646507266761
"3679","chr2.25990000.25995000","chr2.26030000.26035000",40000,24,0.009214397,25990000,26030000,25995000,26035000,"chr2",114738,6,15,23,44,"chr2",1,0.123769338959212
"3680","chr2.131125000.131130000","chr2.131145000.131150000",20000,37,0.003413209,131125000,131145000,131130000,131150000,"chr2",114764,0,4,7,11,"chr2",1,0.0477027660571964
"3681","chr2.54330000.54335000","chr2.54930000.54935000",600000,17,6.664729e-11,54330000,54930000,54335000,54935000,"chr2",114805,0,1,3,4,"chr2",1,0.00796999531176746
"3682","chr2.36575000.36580000","chr2.36890000.36895000",315000,35,5.159292e-27,36575000,36890000,36580000,36895000,"chr2",114881,1,7,6,14,"chr2",1,0.0574308485700891
"3683","chr2.200860000.200865000","chr2.201275000.201280000",415000,9,0.00850255,200860000,201275000,200865000,201280000,"chr2",114947,2,2,0,4,"chr2",1,0.00421940928270042
"3684","chr2.73750000.73755000","chr2.73775000.73780000",25000,39,0.0001128433,73750000,73775000,73755000,73780000,"chr2",114956,0,2,1,3,"chr2",1,0.0137130801687764
"3685","chr2.25250000.25255000","chr2.25300000.25305000",50000,29,5.65568e-06,25250000,25300000,25255000,25305000,"chr2",115130,0,2,1,3,"chr2",1,0.010196905766526
"3686","chr2.47630000.47635000","chr2.48560000.48565000",930000,7,0.004125112,47630000,48560000,47635000,48565000,"chr2",115300,1,3,0,4,"chr2",1,0.00328176277543366
"3687","chr2.72515000.72520000","chr2.72970000.72975000",455000,9,0.005714291,72515000,72970000,72520000,72975000,"chr2",115435,0,2,0,2,"chr2",1,0.00210970464135021
"3688","chr2.65265000.65270000","chr2.65455000.65460000",190000,14,0.0007589069,65265000,65455000,65270000,65460000,"chr2",115446,0,0,4,4,"chr2",1,0.00656352555086732
"3689","chr2.64815000.64820000","chr2.65265000.65270000",450000,9,0.00595415,64815000,65265000,64820000,65270000,"chr2",115499,0,0,4,4,"chr2",1,0.00421940928270042
"3690","chr2.61760000.61765000","chr2.62075000.62080000",315000,11,0.001825096,61760000,62075000,61765000,62080000,"chr2",115502,2,14,8,24,"chr2",1,0.0309423347398031
"3691","chr2.24050000.24055000","chr2.24100000.24105000",50000,22,0.00575965,24050000,24100000,24055000,24105000,"chr2",115521,1,2,3,6,"chr2",1,0.0154711673699015
"3692","chr2.235790000.235795000","chr2.235940000.235945000",150000,15,0.001014892,235790000,235940000,235795000,235945000,"chr2",115592,0,4,1,5,"chr2",1,0.00879043600562588
"3693","chr2.55135000.55140000","chr2.55295000.55300000",160000,17,4.499498e-05,55135000,55295000,55140000,55300000,"chr2",115631,0,2,2,4,"chr2",1,0.00796999531176746
"3694","chr2.3395000.3400000","chr2.3475000.3480000",80000,20,0.0003709646,3395000,3475000,3400000,3480000,"chr2",115718,1,4,1,6,"chr2",1,0.0140646976090014
"3695","chr2.36575000.36580000","chr2.37005000.37010000",430000,9,0.007245928,36575000,37005000,36580000,37010000,"chr2",115834,2,7,6,15,"chr2",1,0.0158227848101266
"3696","chr2.45870000.45875000","chr2.46150000.46155000",280000,13,0.0001912134,45870000,46150000,45875000,46155000,"chr2",115865,1,3,2,6,"chr2",1,0.00914205344585091
"3697","chr2.46885000.46890000","chr2.47095000.47100000",210000,12,0.004989964,46885000,47095000,46890000,47100000,"chr2",115910,0,8,0,8,"chr2",1,0.0112517580872011
"3698","chr2.25275000.25280000","chr2.25315000.25320000",40000,31,1.803561e-05,25275000,25315000,25280000,25320000,"chr2",115915,0,3,2,5,"chr2",1,0.0181669010782935
"3699","chr2.154400000.154405000","chr2.155240000.155245000",840000,7,0.007136669,154400000,155240000,154405000,155245000,"chr2",115920,0,1,1,2,"chr2",1,0.00164088138771683
"3700","chr2.219325000.219330000","chr2.219345000.219350000",20000,41,0.0002073649,219325000,219345000,219330000,219350000,"chr2",115953,3,8,12,23,"chr2",1,0.110525082044069
"3701","chr2.45835000.45840000","chr2.46010000.46015000",175000,13,0.004403514,45835000,46010000,45840000,46015000,"chr2",115972,7,12,12,31,"chr2",1,0.0472339428035631
"3702","chr2.85300000.85305000","chr2.85485000.85490000",185000,16,5.736194e-05,85300000,85485000,85305000,85490000,"chr2",116074,1,7,2,10,"chr2",1,0.0187529301453352
"3703","chr2.65360000.65365000","chr2.65455000.65460000",95000,18,0.0007170619,65360000,65455000,65365000,65460000,"chr2",116075,0,2,4,6,"chr2",1,0.0126582278481013
"3704","chr2.200885000.200890000","chr2.201125000.201130000",240000,13,0.0005662405,200885000,201125000,200890000,201130000,"chr2",116089,2,4,3,9,"chr2",1,0.0137130801687764
"3705","chr2.69790000.69795000","chr2.69915000.69920000",125000,14,0.008580544,69790000,69915000,69795000,69920000,"chr2",116130,1,6,10,17,"chr2",1,0.0278949835911861
"3706","chr2.64870000.64875000","chr2.65085000.65090000",215000,13,0.001206533,64870000,65085000,64875000,65090000,"chr2",116145,2,4,8,14,"chr2",1,0.0213314580403188
"3707","chr2.11375000.11380000","chr2.11525000.11530000",150000,14,0.003346259,11375000,11525000,11380000,11530000,"chr2",116208,1,8,6,15,"chr2",1,0.0246132208157525
"3708","chr2.65140000.65145000","chr2.65390000.65395000",250000,12,0.001748493,65140000,65390000,65145000,65395000,"chr2",116210,3,3,6,12,"chr2",1,0.0168776371308017
"3709","chr2.45870000.45875000","chr2.46170000.46175000",300000,11,0.00233854,45870000,46170000,45875000,46175000,"chr2",116214,1,0,1,2,"chr2",1,0.00257852789498359
"3710","chr2.230920000.230925000","chr2.231015000.231020000",95000,26,1.283842e-08,230920000,231015000,230925000,231020000,"chr2",116228,1,11,9,21,"chr2",1,0.0639943741209564
"3711","chr2.43055000.43060000","chr2.43830000.43835000",775000,13,6.03516e-08,43055000,43830000,43060000,43835000,"chr2",116240,0,0,1,1,"chr2",1,0.00152367557430849
"3712","chr2.199380000.199385000","chr2.200225000.200230000",845000,8,0.001208006,199380000,200225000,199385000,200230000,"chr2",116364,4,5,6,15,"chr2",1,0.0140646976090014
"3713","chr2.232840000.232845000","chr2.232980000.232985000",140000,15,0.001560022,232840000,232980000,232845000,232985000,"chr2",116391,1,11,4,16,"chr2",1,0.0281293952180028
"3714","chr2.235825000.235830000","chr2.235855000.235860000",30000,35,7.95399e-05,235825000,235855000,235830000,235860000,"chr2",116491,0,4,1,5,"chr2",1,0.0205110173464604
"3715","chr2.42095000.42100000","chr2.42190000.42195000",95000,19,0.0002219465,42095000,42190000,42100000,42195000,"chr2",116554,3,7,7,17,"chr2",1,0.0378574777308955
"3716","chr2.24640000.24645000","chr2.25040000.25045000",400000,21,7.51777e-13,24640000,25040000,24645000,25045000,"chr2",116575,0,1,0,1,"chr2",1,0.00246132208157525
"3717","chr2.46875000.46880000","chr2.47095000.47100000",220000,14,0.0002574937,46875000,47095000,46880000,47100000,"chr2",116583,0,1,0,1,"chr2",1,0.00164088138771683
"3718","chr2.85610000.85615000","chr2.85795000.85800000",185000,15,0.0002359588,85610000,85795000,85615000,85800000,"chr2",116593,0,3,2,5,"chr2",1,0.00879043600562588
"3719","chr2.47205000.47210000","chr2.47530000.47535000",325000,17,4.54435e-08,47205000,47530000,47210000,47535000,"chr2",116601,4,9,5,18,"chr2",1,0.0358649789029536
"3720","chr2.64865000.64870000","chr2.65055000.65060000",190000,12,0.008687146,64865000,65055000,64870000,65060000,"chr2",116693,2,4,5,11,"chr2",1,0.0154711673699015
"3721","chr2.24790000.24795000","chr2.24810000.24815000",20000,37,0.003413209,24790000,24810000,24795000,24815000,"chr2",116695,0,1,0,1,"chr2",1,0.00433661509610877
"3722","chr2.54225000.54230000","chr2.54290000.54295000",65000,22,0.0003732923,54225000,54290000,54230000,54295000,"chr2",116753,0,2,7,9,"chr2",1,0.0232067510548523
"3723","chr2.48450000.48455000","chr2.48585000.48590000",135000,15,0.001935147,48450000,48585000,48455000,48590000,"chr2",116769,3,6,6,15,"chr2",1,0.0263713080168776
"3724","chr2.27095000.27100000","chr2.27120000.27125000",25000,37,0.0005349065,27095000,27120000,27100000,27125000,"chr2",116852,3,3,1,7,"chr2",1,0.0303563056727614
"3725","chr2.99065000.99070000","chr2.99150000.99155000",85000,17,0.005024145,99065000,99150000,99070000,99155000,"chr2",116882,2,11,7,20,"chr2",1,0.0398499765588373
"3726","chr2.47310000.47315000","chr2.47530000.47535000",220000,15,5.874159e-05,47310000,47530000,47315000,47535000,"chr2",116902,5,11,5,21,"chr2",1,0.0369198312236287
"3727","chr2.218645000.218650000","chr2.218860000.218865000",215000,15,7.129008e-05,218645000,218860000,218650000,218865000,"chr2",116915,1,4,4,9,"chr2",1,0.0158227848101266
"3728","chr2.197160000.197165000","chr2.197625000.197630000",465000,14,8.165916e-07,197160000,197625000,197165000,197630000,"chr2",116936,0,2,3,5,"chr2",1,0.00820440693858415
"3729","chr2.28185000.28190000","chr2.28220000.28225000",35000,26,0.009419337,28185000,28220000,28190000,28225000,"chr2",116938,2,1,2,5,"chr2",1,0.0152367557430849
"3730","chr2.85675000.85680000","chr2.85755000.85760000",80000,35,8.404294e-14,85675000,85755000,85680000,85760000,"chr2",116977,1,4,1,6,"chr2",1,0.0246132208157525
"3731","chr2.46940000.46945000","chr2.47505000.47510000",565000,9,0.001975335,46940000,47505000,46945000,47510000,"chr2",116995,2,7,10,19,"chr2",1,0.020042194092827
"3732","chr2.25290000.25295000","chr2.25330000.25335000",40000,27,0.0008355202,25290000,25330000,25295000,25335000,"chr2",117013,0,1,3,4,"chr2",1,0.0126582278481013
"3733","chr2.134985000.134990000","chr2.135155000.135160000",170000,17,2.719959e-05,134985000,135155000,134990000,135160000,"chr2",117035,1,1,1,3,"chr2",1,0.0059774964838256
"3734","chr2.219365000.219370000","chr2.219400000.219405000",35000,28,0.002159006,219365000,219400000,219370000,219405000,"chr2",117157,0,4,2,6,"chr2",1,0.019690576652602
"3735","chr2.201780000.201785000","chr2.202030000.202035000",250000,16,3.701924e-06,201780000,202030000,201785000,202035000,"chr2",117160,2,11,9,22,"chr2",1,0.0412564463197375
"3736","chr2.54755000.54760000","chr2.54875000.54880000",120000,15,0.003742989,54755000,54875000,54760000,54880000,"chr2",117191,1,0,0,1,"chr2",1,0.00175808720112518
"3737","chr2.54405000.54410000","chr2.54520000.54525000",115000,15,0.004802086,54405000,54520000,54410000,54525000,"chr2",117272,3,11,7,21,"chr2",1,0.0369198312236287
"3738","chr2.42315000.42320000","chr2.42420000.42425000",105000,23,3.331753e-07,42315000,42420000,42320000,42425000,"chr2",117329,0,2,1,3,"chr2",1,0.00808720112517581
"3739","chr2.218370000.218375000","chr2.218575000.218580000",205000,15,0.0001059786,218370000,218575000,218375000,218580000,"chr2",117340,8,24,27,59,"chr2",1,0.103727144866385
"3740","chr2.70140000.70145000","chr2.70290000.70295000",150000,20,8.737371e-07,70140000,70290000,70145000,70295000,"chr2",117366,0,14,11,25,"chr2",1,0.0586029067041725
"3741","chr2.26160000.26165000","chr2.26350000.26355000",190000,19,3.844298e-07,26160000,26350000,26165000,26355000,"chr2",117373,6,19,18,43,"chr2",1,0.0957571495546179
"3742","chr2.64875000.64880000","chr2.64985000.64990000",110000,24,3.95208e-08,64875000,64985000,64880000,64990000,"chr2",117389,1,5,8,14,"chr2",1,0.0393811533052039
"3743","chr2.9970000.9975000","chr2.10185000.10190000",215000,12,0.004349821,9970000,10185000,9975000,10190000,"chr2",117400,0,0,1,1,"chr2",1,0.00140646976090014
"3744","chr2.11375000.11380000","chr2.11580000.11585000",205000,16,2.35545e-05,11375000,11580000,11380000,11585000,"chr2",117444,2,14,10,26,"chr2",1,0.0487576183778715
"3745","chr2.65160000.65165000","chr2.65265000.65270000",105000,23,3.331753e-07,65160000,65265000,65165000,65270000,"chr2",117463,0,0,4,4,"chr2",1,0.0107829348335677
"3746","chr2.42420000.42425000","chr2.42440000.42445000",20000,53,3.611938e-09,42420000,42440000,42425000,42445000,"chr2",117485,0,1,1,2,"chr2",1,0.0124238162212846
"3747","chr2.54980000.54985000","chr2.55110000.55115000",130000,14,0.007022645,54980000,55110000,54985000,55115000,"chr2",117564,2,5,2,9,"chr2",1,0.0147679324894515
"3748","chr2.47235000.47240000","chr2.47400000.47405000",165000,13,0.006114697,47235000,47400000,47240000,47405000,"chr2",117577,5,6,4,15,"chr2",1,0.0228551336146273
"3749","chr2.178210000.178215000","chr2.178475000.178480000",265000,20,1.062218e-09,178210000,178475000,178215000,178480000,"chr2",117580,2,3,2,7,"chr2",1,0.0164088138771683
"3750","chr2.85925000.85930000","chr2.86315000.86320000",390000,10,0.002740393,85925000,86315000,85930000,86320000,"chr2",117591,1,12,6,19,"chr2",1,0.0222691045475856
"3751","chr2.42360000.42365000","chr2.42420000.42425000",60000,24,0.0001181142,42360000,42420000,42365000,42425000,"chr2",117754,0,2,1,3,"chr2",1,0.00843881856540084
"3752","chr2.26220000.26225000","chr2.26245000.26250000",25000,37,0.0005349065,26220000,26245000,26225000,26250000,"chr2",117767,0,2,1,3,"chr2",1,0.0130098452883263
"3753","chr2.55135000.55140000","chr2.55365000.55370000",230000,13,0.0007672627,55135000,55365000,55140000,55370000,"chr2",117794,0,2,2,4,"chr2",1,0.00609470229723394
"3754","chr2.64865000.64870000","chr2.65085000.65090000",220000,14,0.0002574937,64865000,65085000,64870000,65090000,"chr2",117812,2,4,5,11,"chr2",1,0.0180496952648851
"3755","chr2.11385000.11390000","chr2.11420000.11425000",35000,28,0.002159006,11385000,11420000,11390000,11425000,"chr2",117845,0,2,0,2,"chr2",1,0.00656352555086732
"3756","chr2.64915000.64920000","chr2.64940000.64945000",25000,36,0.001114518,64915000,64940000,64920000,64945000,"chr2",117956,5,5,7,17,"chr2",1,0.0717299578059072
"3757","chr2.46855000.46860000","chr2.46940000.46945000",85000,21,6.0953e-05,46855000,46940000,46860000,46945000,"chr2",117987,4,14,7,25,"chr2",1,0.0615330520393812
"3758","chr2.55510000.55515000","chr2.55615000.55620000",105000,15,0.008351178,55510000,55615000,55515000,55620000,"chr2",118026,4,10,7,21,"chr2",1,0.0369198312236287
"3759","chr2.24200000.24205000","chr2.24220000.24225000",20000,42,9.587926e-05,24200000,24220000,24205000,24225000,"chr2",118057,0,2,0,2,"chr2",1,0.00984528832630099
"3760","chr2.230930000.230935000","chr2.231025000.231030000",95000,20,6.563062e-05,230930000,231025000,230935000,231030000,"chr2",118085,0,3,0,3,"chr2",1,0.0070323488045007
"3761","chr2.196940000.196945000","chr2.197160000.197165000",220000,18,4.316118e-07,196940000,197160000,196945000,197165000,"chr2",118109,0,1,1,2,"chr2",1,0.00421940928270042
"3762","chr2.69825000.69830000","chr2.69915000.69920000",90000,21,3.307489e-05,69825000,69915000,69830000,69920000,"chr2",118148,0,3,1,4,"chr2",1,0.00984528832630099
"3763","chr2.48105000.48110000","chr2.48545000.48550000",440000,9,0.006519483,48105000,48545000,48110000,48550000,"chr2",118177,0,1,1,2,"chr2",1,0.00210970464135021
"3764","chr2.224560000.224565000","chr2.224650000.224655000",90000,19,0.0003712596,224560000,224650000,224565000,224655000,"chr2",118210,0,6,3,9,"chr2",1,0.020042194092827
"3765","chr2.217610000.217615000","chr2.218565000.218570000",955000,9,6.679384e-05,217610000,218565000,217615000,218570000,"chr2",118224,0,1,4,5,"chr2",1,0.00527426160337553
"3766","chr2.46695000.46700000","chr2.47095000.47100000",400000,11,0.000522239,46695000,47095000,46700000,47100000,"chr2",118258,0,2,0,2,"chr2",1,0.00257852789498359
"3767","chr2.61895000.61900000","chr2.61990000.61995000",95000,29,9.443526e-11,61895000,61990000,61900000,61995000,"chr2",118286,2,10,8,20,"chr2",1,0.0679793717768401
"3768","chr2.47225000.47230000","chr2.47505000.47510000",280000,16,1.259839e-06,47225000,47505000,47230000,47510000,"chr2",118300,0,3,2,5,"chr2",1,0.00937646507266761
"3769","chr2.20660000.20665000","chr2.20810000.20815000",150000,15,0.001014892,20660000,20810000,20665000,20815000,"chr2",118352,1,2,4,7,"chr2",1,0.0123066104078762
"3770","chr2.20575000.20580000","chr2.20840000.20845000",265000,16,2.115266e-06,20575000,20840000,20580000,20845000,"chr2",118376,2,1,1,4,"chr2",1,0.00750117205813408
"3771","chr2.190525000.190530000","chr2.190650000.190655000",125000,19,1.908347e-05,190525000,190650000,190530000,190655000,"chr2",118394,0,3,3,6,"chr2",1,0.0133614627285513
"3772","chr2.47175000.47180000","chr2.47520000.47525000",345000,12,0.0002407399,47175000,47520000,47180000,47525000,"chr2",118467,2,4,7,13,"chr2",1,0.0182841068917018
"3773","chr2.198090000.198095000","chr2.198170000.198175000",80000,27,3.934651e-08,198090000,198170000,198095000,198175000,"chr2",118472,0,1,4,5,"chr2",1,0.0158227848101266
"3774","chr2.47245000.47250000","chr2.47520000.47525000",275000,15,8.587624e-06,47245000,47520000,47250000,47525000,"chr2",118574,3,5,7,15,"chr2",1,0.0263713080168776
"3775","chr2.64885000.64890000","chr2.65085000.65090000",200000,13,0.001954724,64885000,65085000,64890000,65090000,"chr2",118638,2,4,4,10,"chr2",1,0.0152367557430849
"3776","chr2.223060000.223065000","chr2.223415000.223420000",355000,10,0.004187627,223060000,223415000,223065000,223420000,"chr2",118714,0,0,1,1,"chr2",1,0.00117205813408345
"3777","chr2.232895000.232900000","chr2.232955000.232960000",60000,25,3.958961e-05,232895000,232955000,232900000,232960000,"chr2",118724,0,2,0,2,"chr2",1,0.00586029067041725
"3778","chr2.1900000.1905000","chr2.2130000.2135000",230000,12,0.002895462,1900000,2130000,1905000,2135000,"chr2",118749,0,3,1,4,"chr2",1,0.00562587904360056
"3779","chr2.27190000.27195000","chr2.27500000.27505000",310000,10,0.007583919,27190000,27500000,27195000,27505000,"chr2",118759,1,6,6,13,"chr2",1,0.0152367557430849
"3780","chr2.24880000.24885000","chr2.24900000.24905000",20000,38,0.001797953,24880000,24900000,24885000,24905000,"chr2",118804,0,6,2,8,"chr2",1,0.0356305672761369
"3781","chr2.198050000.198055000","chr2.198295000.198300000",245000,13,0.0004878768,198050000,198295000,198055000,198300000,"chr2",118811,3,18,9,30,"chr2",1,0.0457102672292546
"3782","chr2.231015000.231020000","chr2.231050000.231055000",35000,28,0.002159006,231015000,231050000,231020000,231055000,"chr2",118835,1,7,6,14,"chr2",1,0.0459446788560713
"3783","chr2.54955000.54960000","chr2.55415000.55420000",460000,9,0.005418901,54955000,55415000,54960000,55420000,"chr2",118849,0,4,2,6,"chr2",1,0.00632911392405063
"3784","chr2.69770000.69775000","chr2.69830000.69835000",60000,20,0.00585082,69770000,69830000,69775000,69835000,"chr2",118872,6,8,8,22,"chr2",1,0.0515705578996718
"3785","chr2.190530000.190535000","chr2.190945000.190950000",415000,10,0.002039678,190530000,190945000,190535000,190950000,"chr2",118874,0,3,1,4,"chr2",1,0.0046882325363338
"3786","chr2.96870000.96875000","chr2.96975000.96980000",105000,15,0.008351178,96870000,96975000,96875000,96980000,"chr2",118922,6,17,22,45,"chr2",1,0.0791139240506329
"3787","chr2.47245000.47250000","chr2.47400000.47405000",155000,17,5.792366e-05,47245000,47400000,47250000,47405000,"chr2",118946,6,15,13,34,"chr2",1,0.0677449601500234
"3788","chr2.24610000.24615000","chr2.24995000.25000000",385000,13,2.282262e-05,24610000,24995000,24615000,2.5e+07,"chr2",118993,2,3,1,6,"chr2",1,0.00914205344585091
"3789","chr2.105735000.105740000","chr2.105845000.105850000",110000,17,0.0006956574,105735000,105845000,105740000,105850000,"chr2",119093,0,7,3,10,"chr2",1,0.0199249882794187
"3790","chr2.208115000.208120000","chr2.208320000.208325000",205000,13,0.001674721,208115000,208320000,208120000,208325000,"chr2",119191,1,7,6,14,"chr2",1,0.0213314580403188
"3791","chr2.55295000.55300000","chr2.55365000.55370000",70000,21,0.0004728668,55295000,55365000,55300000,55370000,"chr2",119204,1,9,13,23,"chr2",1,0.0566104078762307
"3792","chr2.9300000.9305000","chr2.9325000.9330000",25000,39,0.0001128433,9300000,9325000,9305000,9330000,"chr2",119237,2,0,0,2,"chr2",1,0.00914205344585091
"3793","chr2.218685000.218690000","chr2.218745000.218750000",60000,22,0.0009333356,218685000,218745000,218690000,218750000,"chr2",119294,0,3,3,6,"chr2",1,0.0154711673699015
"3794","chr2.232665000.232670000","chr2.233115000.233120000",450000,9,0.00595415,232665000,233115000,232670000,233120000,"chr2",119333,4,12,14,30,"chr2",1,0.0316455696202532
"3795","chr2.26120000.26125000","chr2.26160000.26165000",40000,25,0.004349821,26120000,26160000,26125000,26165000,"chr2",119426,8,27,18,53,"chr2",1,0.155297702766057
"3796","chr2.42085000.42090000","chr2.42420000.42425000",335000,12,0.0002879799,42085000,42420000,42090000,42425000,"chr2",119468,0,2,1,3,"chr2",1,0.00421940928270042
"3797","chr2.55110000.55115000","chr2.55130000.55135000",20000,37,0.003413209,55110000,55130000,55115000,55135000,"chr2",119470,2,5,2,9,"chr2",1,0.0390295358649789
"3798","chr2.26015000.26020000","chr2.26345000.26350000",330000,10,0.005747455,26015000,26345000,26020000,26350000,"chr2",119565,1,7,0,8,"chr2",1,0.00937646507266761
"3799","chr2.240155000.240160000","chr2.240925000.240930000",770000,9,0.0003417937,240155000,240925000,240160000,240930000,"chr2",119567,0,2,1,3,"chr2",1,0.00316455696202532
"3800","chr2.216495000.216500000","chr2.216515000.216520000",20000,44,1.88628e-05,216495000,216515000,216500000,216520000,"chr2",119586,6,12,13,31,"chr2",1,0.159868729488983
"3801","chr2.64820000.64825000","chr2.65085000.65090000",265000,19,7.963638e-09,64820000,65085000,64825000,65090000,"chr2",119616,2,4,8,14,"chr2",1,0.0311767463666198
"3802","chr2.178195000.178200000","chr2.178265000.178270000",70000,20,0.001334591,178195000,178265000,178200000,178270000,"chr2",119638,2,7,7,16,"chr2",1,0.0375058602906704
"3803","chr2.25590000.25595000","chr2.25820000.25825000",230000,11,0.009837087,25590000,25820000,25595000,25825000,"chr2",119648,0,1,3,4,"chr2",1,0.00515705578996718
"3804","chr2.58415000.58420000","chr2.58550000.58555000",135000,18,4.227874e-05,58415000,58550000,58420000,58555000,"chr2",119663,0,0,8,8,"chr2",1,0.0168776371308017
"3805","chr2.160210000.160215000","chr2.160630000.160635000",420000,9,0.008091968,160210000,160630000,160215000,160635000,"chr2",119693,0,0,3,3,"chr2",1,0.00316455696202532
"3806","chr2.61015000.61020000","chr2.61235000.61240000",220000,13,0.001032804,61015000,61235000,61020000,61240000,"chr2",119800,1,4,2,7,"chr2",1,0.0106657290201594
"3807","chr2.48340000.48345000","chr2.48545000.48550000",205000,18,9.29699e-07,48340000,48545000,48345000,48550000,"chr2",119812,2,0,2,4,"chr2",1,0.00843881856540084
"3808","chr2.46695000.46700000","chr2.46875000.46880000",180000,34,4.253736e-20,46695000,46875000,46700000,46880000,"chr2",119827,0,1,1,2,"chr2",1,0.00796999531176746
"3809","chr2.69810000.69815000","chr2.69830000.69835000",20000,45,8.09957e-06,69810000,69830000,69815000,69835000,"chr2",119903,2,15,15,32,"chr2",1,0.168776371308017
"3810","chr2.171345000.171350000","chr2.171390000.171395000",45000,26,0.0004875882,171345000,171390000,171350000,171395000,"chr2",119908,2,1,0,3,"chr2",1,0.00914205344585091
"3811","chr2.54900000.54905000","chr2.54925000.54930000",25000,37,0.0005349065,54900000,54925000,54905000,54930000,"chr2",119929,0,3,2,5,"chr2",1,0.0216830754805438
"3812","chr2.26245000.26250000","chr2.26380000.26385000",135000,15,0.001935147,26245000,26380000,26250000,26385000,"chr2",119957,0,12,11,23,"chr2",1,0.040436005625879
"3813","chr2.20625000.20630000","chr2.20835000.20840000",210000,15,8.678974e-05,20625000,20835000,20630000,20840000,"chr2",120016,1,2,1,4,"chr2",1,0.0070323488045007
"3814","chr2.25315000.25320000","chr2.25340000.25345000",25000,38,0.000248511,25315000,25340000,25320000,25345000,"chr2",120039,3,5,1,9,"chr2",1,0.040084388185654
"3815","chr2.241160000.241165000","chr2.241410000.241415000",250000,12,0.001748493,241160000,241410000,241165000,241415000,"chr2",120041,3,6,6,15,"chr2",1,0.0210970464135021
"3816","chr2.20550000.20555000","chr2.20835000.20840000",285000,13,0.0001687235,20550000,20835000,20555000,20840000,"chr2",120118,2,5,8,15,"chr2",1,0.0228551336146273
"3817","chr2.219360000.219365000","chr2.219385000.219390000",25000,33,0.008420578,219360000,219385000,219365000,219390000,"chr2",120130,0,7,3,10,"chr2",1,0.0386779184247539
"3818","chr2.198295000.198300000","chr2.198495000.198500000",200000,19,2.163266e-07,198295000,198495000,198300000,198500000,"chr2",120196,3,5,3,11,"chr2",1,0.0244960150023441
"3819","chr2.202750000.202755000","chr2.202870000.202875000",120000,17,0.0003709646,202750000,202870000,202755000,202875000,"chr2",120203,0,5,2,7,"chr2",1,0.0139474917955931
"3820","chr2.25200000.25205000","chr2.25295000.25300000",95000,27,2.611499e-09,25200000,25295000,25205000,25300000,"chr2",120215,1,4,3,8,"chr2",1,0.0253164556962025
"3821","chr2.73995000.74000000","chr2.74410000.74415000",415000,9,0.00850255,73995000,74410000,7.4e+07,74415000,"chr2",120229,0,3,2,5,"chr2",1,0.00527426160337553
"3822","chr2.46590000.46595000","chr2.46695000.46700000",105000,15,0.008351178,46590000,46695000,46595000,46700000,"chr2",120234,2,2,4,8,"chr2",1,0.0140646976090014
"3823","chr2.182585000.182590000","chr2.182785000.182790000",200000,12,0.006519483,182585000,182785000,182590000,182790000,"chr2",120274,0,2,1,3,"chr2",1,0.00421940928270042
"3824","chr2.219570000.219575000","chr2.219685000.219690000",115000,16,0.001617402,219570000,219685000,219575000,219690000,"chr2",120314,2,2,2,6,"chr2",1,0.0112517580872011
"3825","chr2.109065000.109070000","chr2.109260000.109265000",195000,12,0.007583919,109065000,109260000,109070000,109265000,"chr2",120317,0,2,3,5,"chr2",1,0.0070323488045007
"3826","chr2.20640000.20645000","chr2.20835000.20840000",195000,69,9.843621e-64,20640000,20835000,20645000,20840000,"chr2",120343,1,1,1,3,"chr2",1,0.0242616033755274
"3827","chr2.26265000.26270000","chr2.26380000.26385000",115000,19,3.958961e-05,26265000,26380000,26270000,26385000,"chr2",120347,2,15,11,28,"chr2",1,0.0623534927332396
"3828","chr2.147840000.147845000","chr2.148645000.148650000",805000,7,0.008738458,147840000,148645000,147845000,148650000,"chr2",120396,0,1,0,1,"chr2",1,0.000820440693858415
"3829","chr2.64270000.64275000","chr2.64460000.64465000",190000,12,0.008687146,64270000,64460000,64275000,64465000,"chr2",120419,1,0,1,2,"chr2",1,0.00281293952180028
"3830","chr2.70530000.70535000","chr2.70995000.71000000",465000,12,3.807238e-05,70530000,70995000,70535000,7.1e+07,"chr2",120480,3,1,0,4,"chr2",1,0.00562587904360056
"3831","chr2.232955000.232960000","chr2.233145000.233150000",190000,12,0.008687146,232955000,233145000,232960000,233150000,"chr2",120525,0,1,0,1,"chr2",1,0.00140646976090014
"3832","chr2.72745000.72750000","chr2.72770000.72775000",25000,34,0.004425962,72745000,72770000,72750000,72775000,"chr2",120696,3,1,3,7,"chr2",1,0.0278949835911861
"3833","chr2.230710000.230715000","chr2.230755000.230760000",45000,27,0.0001900709,230710000,230755000,230715000,230760000,"chr2",120704,2,2,6,10,"chr2",1,0.0316455696202532
"3834","chr2.69705000.69710000","chr2.69770000.69775000",65000,19,0.006728756,69705000,69770000,69710000,69775000,"chr2",120752,6,8,8,22,"chr2",1,0.0489920300046882
"3835","chr2.235150000.235155000","chr2.235170000.235175000",20000,52,1.028223e-08,235150000,235170000,235155000,235175000,"chr2",120761,2,5,3,10,"chr2",1,0.0609470229723394
"3836","chr2.6650000.6655000","chr2.6970000.6975000",320000,10,0.006519483,6650000,6970000,6655000,6975000,"chr2",120795,0,1,3,4,"chr2",1,0.0046882325363338
"3837","chr2.85580000.85585000","chr2.85840000.85845000",260000,22,2.175993e-11,85580000,85840000,85585000,85845000,"chr2",120817,1,6,5,12,"chr2",1,0.0309423347398031
"3838","chr2.30420000.30425000","chr2.30925000.30930000",505000,12,2.080958e-05,30420000,30925000,30425000,30930000,"chr2",120871,0,1,6,7,"chr2",1,0.00984528832630099
"3839","chr2.86130000.86135000","chr2.86290000.86295000",160000,13,0.007175609,86130000,86290000,86135000,86295000,"chr2",120925,0,5,3,8,"chr2",1,0.0121894045944679
"3840","chr2.25195000.25200000","chr2.25320000.25325000",125000,16,0.0009414249,25195000,25320000,25200000,25325000,"chr2",120950,3,3,4,10,"chr2",1,0.0187529301453352
"3841","chr2.26250000.26255000","chr2.26355000.26360000",105000,15,0.008351178,26250000,26355000,26255000,26360000,"chr2",121005,2,8,8,18,"chr2",1,0.0316455696202532
"3842","chr2.223260000.223265000","chr2.223415000.223420000",155000,15,0.0008356975,223260000,223415000,223265000,223420000,"chr2",121050,0,0,4,4,"chr2",1,0.0070323488045007
"3843","chr2.33520000.33525000","chr2.33555000.33560000",35000,27,0.004599226,33520000,33555000,33525000,33560000,"chr2",121117,0,0,5,5,"chr2",1,0.0158227848101266
"3844","chr2.42360000.42365000","chr2.42545000.42550000",185000,15,0.0002359588,42360000,42545000,42365000,42550000,"chr2",121130,4,6,11,21,"chr2",1,0.0369198312236287
"3845","chr2.190350000.190355000","chr2.190370000.190375000",20000,38,0.001797953,190350000,190370000,190355000,190375000,"chr2",121251,0,4,1,5,"chr2",1,0.0222691045475856
"3846","chr2.26220000.26225000","chr2.26355000.26360000",135000,14,0.005846758,26220000,26355000,26225000,26360000,"chr2",121297,0,2,1,3,"chr2",1,0.00492264416315049
"3847","chr2.206085000.206090000","chr2.206125000.206130000",40000,25,0.004349821,206085000,206125000,206090000,206130000,"chr2",121411,4,15,29,48,"chr2",1,0.140646976090014
"3848","chr2.25225000.25230000","chr2.25330000.25335000",105000,17,0.0009851638,25225000,25330000,25230000,25335000,"chr2",121417,0,1,3,4,"chr2",1,0.00796999531176746
"3849","chr2.54340000.54345000","chr2.54925000.54930000",585000,8,0.007871192,54340000,54925000,54345000,54930000,"chr2",121496,0,3,2,5,"chr2",1,0.0046882325363338
"3850","chr2.73750000.73755000","chr2.73770000.73775000",20000,43,4.321287e-05,73750000,73770000,73755000,73775000,"chr2",121528,0,2,1,3,"chr2",1,0.0151195499296765
"3851","chr2.24880000.24885000","chr2.24995000.25000000",115000,15,0.004802086,24880000,24995000,24885000,2.5e+07,"chr2",121541,0,6,2,8,"chr2",1,0.0140646976090014
"3852","chr2.54340000.54345000","chr2.54950000.54955000",610000,14,6.592871e-08,54340000,54950000,54345000,54955000,"chr2",121558,0,6,3,9,"chr2",1,0.0147679324894515
"3853","chr2.74050000.74055000","chr2.74410000.74415000",360000,13,3.566009e-05,74050000,74410000,74055000,74415000,"chr2",121637,1,3,2,6,"chr2",1,0.00914205344585091
"3854","chr2.20560000.20565000","chr2.20580000.20585000",20000,37,0.003413209,20560000,20580000,20565000,20585000,"chr2",121650,1,6,2,9,"chr2",1,0.0390295358649789
"3855","chr2.190650000.190655000","chr2.191215000.191220000",565000,8,0.00909664,190650000,191215000,190655000,191220000,"chr2",121688,1,2,3,6,"chr2",1,0.00562587904360056
"3856","chr2.101140000.101145000","chr2.101770000.101775000",630000,10,0.0001872155,101140000,101770000,101145000,101775000,"chr2",121795,0,5,3,8,"chr2",1,0.00937646507266761
"3857","chr2.232815000.232820000","chr2.233205000.233210000",390000,12,0.0001181142,232815000,233205000,232820000,233210000,"chr2",121823,2,1,6,9,"chr2",1,0.0126582278481013
"3858","chr2.70555000.70560000","chr2.70860000.70865000",305000,18,1.174799e-08,70555000,70860000,70560000,70865000,"chr2",121852,2,2,4,8,"chr2",1,0.0168776371308017
"3859","chr2.55135000.55140000","chr2.55230000.55235000",95000,18,0.0007170619,55135000,55230000,55140000,55235000,"chr2",121853,0,2,2,4,"chr2",1,0.00843881856540084
"3860","chr2.173980000.173985000","chr2.174035000.174040000",55000,25,0.000124966,173980000,174035000,173985000,174040000,"chr2",121861,2,2,3,7,"chr2",1,0.0205110173464604
"3861","chr2.198380000.198385000","chr2.198495000.198500000",115000,27,1.404985e-10,198380000,198495000,198385000,198500000,"chr2",122084,0,2,3,5,"chr2",1,0.0158227848101266
"3862","chr2.24035000.24040000","chr2.24435000.24440000",400000,9,0.009836434,24035000,24435000,24040000,24440000,"chr2",122101,4,12,11,27,"chr2",1,0.0284810126582278
"3863","chr2.208005000.208010000","chr2.208025000.208030000",20000,52,1.028223e-08,208005000,208025000,208010000,208030000,"chr2",122135,6,10,10,26,"chr2",1,0.158462259728083
"3864","chr2.55130000.55135000","chr2.55415000.55420000",285000,12,0.000765581,55130000,55415000,55135000,55420000,"chr2",122187,3,4,6,13,"chr2",1,0.0182841068917018
"3865","chr2.26240000.26245000","chr2.26265000.26270000",25000,35,0.002278734,26240000,26265000,26245000,26270000,"chr2",122232,6,15,15,36,"chr2",1,0.147679324894515
"3866","chr2.177225000.177230000","chr2.177260000.177265000",35000,29,0.0009559797,177225000,177260000,177230000,177265000,"chr2",122265,0,4,2,6,"chr2",1,0.020393811533052
"3867","chr2.25950000.25955000","chr2.26030000.26035000",80000,19,0.001084925,25950000,26030000,25955000,26035000,"chr2",122320,3,17,27,47,"chr2",1,0.104664791373652
"3868","chr2.228340000.228345000","chr2.228515000.228520000",175000,16,9.021355e-05,228340000,228515000,228345000,228520000,"chr2",122380,0,1,2,3,"chr2",1,0.00562587904360056
"3869","chr2.85675000.85680000","chr2.85750000.85755000",75000,55,1.697922e-30,85675000,85750000,85680000,85755000,"chr2",122398,0,0,2,2,"chr2",1,0.012892639474918
"3870","chr2.64865000.64870000","chr2.65065000.65070000",200000,14,0.000522239,64865000,65065000,64870000,65070000,"chr2",122417,2,4,5,11,"chr2",1,0.0180496952648851
"3871","chr2.39475000.39480000","chr2.39670000.39675000",195000,12,0.007583919,39475000,39670000,39480000,39675000,"chr2",122448,0,1,0,1,"chr2",1,0.00140646976090014
"3872","chr2.54360000.54365000","chr2.54755000.54760000",395000,10,0.002561661,54360000,54755000,54365000,54760000,"chr2",122451,1,4,4,9,"chr2",1,0.0105485232067511
"3873","chr2.70115000.70120000","chr2.70290000.70295000",175000,15,0.0003633045,70115000,70290000,70120000,70295000,"chr2",122456,3,9,5,17,"chr2",1,0.029887482419128
"3874","chr2.24720000.24725000","chr2.24880000.24885000",160000,14,0.002294501,24720000,24880000,24725000,24885000,"chr2",122462,0,2,2,4,"chr2",1,0.00656352555086732
"3875","chr2.64875000.64880000","chr2.65085000.65090000",210000,19,1.246708e-07,64875000,65085000,64880000,65090000,"chr2",122485,2,4,8,14,"chr2",1,0.0311767463666198
"3876","chr2.174785000.174790000","chr2.174900000.174905000",115000,19,3.958961e-05,174785000,174900000,174790000,174905000,"chr2",122524,3,7,8,18,"chr2",1,0.040084388185654
"3877","chr2.171175000.171180000","chr2.171195000.171200000",20000,36,0.006345598,171175000,171195000,171180000,171200000,"chr2",122537,2,11,13,26,"chr2",1,0.109704641350211
"3878","chr2.228340000.228345000","chr2.228745000.228750000",405000,12,9.401489e-05,228340000,228745000,228345000,228750000,"chr2",122645,0,1,2,3,"chr2",1,0.00421940928270042
"3879","chr2.135125000.135130000","chr2.135155000.135160000",30000,33,0.0004387141,135125000,135155000,135130000,135160000,"chr2",122689,2,2,7,11,"chr2",1,0.0425457102672293
"3880","chr2.64940000.64945000","chr2.64995000.65000000",55000,24,0.0003526635,64940000,64995000,64945000,6.5e+07,"chr2",122745,5,5,7,17,"chr2",1,0.0478199718706048
"3881","chr2.54550000.54555000","chr2.54590000.54595000",40000,24,0.009214397,54550000,54590000,54555000,54595000,"chr2",122881,0,2,1,3,"chr2",1,0.00843881856540084
"3882","chr2.45870000.45875000","chr2.45990000.45995000",120000,23,6.976014e-08,45870000,45990000,45875000,45995000,"chr2",122893,1,3,2,6,"chr2",1,0.0161744022503516
"3883","chr2.54440000.54445000","chr2.54925000.54930000",485000,10,0.0009062659,54440000,54925000,54445000,54930000,"chr2",122899,0,3,2,5,"chr2",1,0.00586029067041725
"3884","chr2.198090000.198095000","chr2.198160000.198165000",70000,24,1.541106e-05,198090000,198160000,198095000,198165000,"chr2",122911,0,2,7,9,"chr2",1,0.0253164556962025
"3885","chr2.26220000.26225000","chr2.26350000.26355000",130000,18,5.587351e-05,26220000,26350000,26225000,26355000,"chr2",123008,0,2,1,3,"chr2",1,0.00632911392405063
"3886","chr2.196985000.196990000","chr2.197110000.197115000",125000,14,0.008580544,196985000,197110000,196990000,197115000,"chr2",123012,2,9,6,17,"chr2",1,0.0278949835911861
"3887","chr2.28820000.28825000","chr2.28955000.28960000",135000,22,1.000276e-07,28820000,28955000,28825000,28960000,"chr2",123066,3,14,12,29,"chr2",1,0.0747773089545241
"3888","chr2.218385000.218390000","chr2.218565000.218570000",180000,13,0.003742372,218385000,218565000,218390000,218570000,"chr2",123116,2,4,4,10,"chr2",1,0.0152367557430849
"3889","chr2.25250000.25255000","chr2.25340000.25345000",90000,26,2.869414e-08,25250000,25340000,25255000,25345000,"chr2",123255,0,2,1,3,"chr2",1,0.00914205344585091
"3890","chr2.154330000.154335000","chr2.155240000.155245000",910000,7,0.004660007,154330000,155240000,154335000,155245000,"chr2",123263,0,1,4,5,"chr2",1,0.00410220346929208
"3891","chr2.46695000.46700000","chr2.46870000.46875000",175000,22,5.302477e-09,46695000,46870000,46700000,46875000,"chr2",123271,0,1,0,1,"chr2",1,0.00257852789498359
"3892","chr2.219120000.219125000","chr2.219280000.219285000",160000,13,0.007175609,219120000,219280000,219125000,219285000,"chr2",123337,2,0,1,3,"chr2",1,0.00457102672292546
"3893","chr2.54430000.54435000","chr2.54550000.54555000",120000,16,0.001208006,54430000,54550000,54435000,54555000,"chr2",123374,0,2,1,3,"chr2",1,0.00562587904360056
"3894","chr2.25530000.25535000","chr2.25820000.25825000",290000,14,3.003624e-05,25530000,25820000,25535000,25825000,"chr2",123413,4,8,5,17,"chr2",1,0.0278949835911861
"3895","chr2.54410000.54415000","chr2.54880000.54885000",470000,11,0.0002051138,54410000,54880000,54415000,54885000,"chr2",123426,0,5,2,7,"chr2",1,0.00902484763244257
"3896","chr2.61895000.61900000","chr2.62115000.62120000",220000,13,0.001032804,61895000,62115000,61900000,62120000,"chr2",123556,2,7,5,14,"chr2",1,0.0213314580403188
"3897","chr3.15220000.15225000","chr3.15555000.15560000",335000,10,0.007260165,15220000,15555000,15225000,15560000,"chr3",123765,3,4,5,12,"chr3",1,0.0140646976090014
"3898","chr3.52035000.52040000","chr3.52235000.52240000",200000,12,0.008858162,52035000,52235000,52040000,52240000,"chr3",123824,1,1,3,5,"chr3",1,0.0070323488045007
"3899","chr3.48805000.48810000","chr3.48965000.48970000",160000,21,1.601308e-07,48805000,48965000,48810000,48970000,"chr3",123852,4,18,21,43,"chr3",1,0.105836849507736
"3900","chr3.182505000.182510000","chr3.183110000.183115000",605000,8,0.008849446,182505000,183110000,182510000,183115000,"chr3",123897,0,6,1,7,"chr3",1,0.00656352555086732
"3901","chr3.182900000.182905000","chr3.183120000.183125000",220000,15,9.349312e-05,182900000,183120000,182905000,183125000,"chr3",123974,2,14,3,19,"chr3",1,0.0334036568213783
"3902","chr3.9140000.9145000","chr3.9170000.9175000",30000,34,0.0003107272,9140000,9170000,9145000,9175000,"chr3",123998,1,1,3,5,"chr3",1,0.0199249882794187
"3903","chr3.49395000.49400000","chr3.49465000.49470000",70000,20,0.001865254,49395000,49465000,49400000,49470000,"chr3",124068,11,32,25,68,"chr3",1,0.159399906235349
"3904","chr3.4750000.4755000","chr3.5015000.5020000",265000,20,2.237782e-09,4750000,5015000,4755000,5020000,"chr3",124100,3,11,6,20,"chr3",1,0.046882325363338
"3905","chr3.156270000.156275000","chr3.156380000.156385000",110000,21,6.270054e-06,156270000,156380000,156275000,156385000,"chr3",124114,0,1,1,2,"chr3",1,0.00492264416315049
"3906","chr3.11700000.11705000","chr3.11835000.11840000",135000,14,0.00790472,11700000,11835000,11705000,11840000,"chr3",124169,0,8,2,10,"chr3",1,0.0164088138771683
"3907","chr3.107395000.107400000","chr3.108155000.108160000",760000,8,0.003034478,107395000,108155000,107400000,108160000,"chr3",124171,0,1,1,2,"chr3",1,0.00187529301453352
"3908","chr3.43640000.43645000","chr3.43770000.43775000",130000,15,0.003322656,43640000,43770000,43645000,43775000,"chr3",124232,1,0,2,3,"chr3",1,0.00527426160337553
"3909","chr3.15305000.15310000","chr3.15375000.15380000",70000,36,6.825325e-13,15305000,15375000,15310000,15380000,"chr3",124248,2,10,13,25,"chr3",1,0.105485232067511
"3910","chr3.107395000.107400000","chr3.107450000.107455000",55000,43,3.540658e-15,107395000,107450000,107400000,107455000,"chr3",124264,1,3,1,5,"chr3",1,0.0251992498827942
"3911","chr3.65760000.65765000","chr3.65900000.65905000",140000,16,0.0006749162,65760000,65900000,65765000,65905000,"chr3",124311,4,3,2,9,"chr3",1,0.0168776371308017
"3912","chr3.53375000.53380000","chr3.53865000.53870000",490000,9,0.005432899,53375000,53865000,53380000,53870000,"chr3",124459,4,3,10,17,"chr3",1,0.0179324894514768
"3913","chr3.107420000.107425000","chr3.107450000.107455000",30000,42,1.514263e-07,107420000,107450000,107425000,107455000,"chr3",124497,1,3,4,8,"chr3",1,0.0393811533052039
"3914","chr3.53285000.53290000","chr3.53530000.53535000",245000,11,0.009475458,53285000,53530000,53290000,53535000,"chr3",124537,1,1,0,2,"chr3",1,0.00257852789498359
"3915","chr3.196285000.196290000","chr3.196600000.196605000",315000,10,0.00947524,196285000,196600000,196290000,196605000,"chr3",124547,1,8,10,19,"chr3",1,0.0222691045475856
"3916","chr3.56895000.56900000","chr3.57015000.57020000",120000,15,0.005183894,56895000,57015000,56900000,57020000,"chr3",124634,2,11,12,25,"chr3",1,0.0439521800281294
"3917","chr3.107270000.107275000","chr3.107370000.107375000",100000,21,1.668433e-05,107270000,107370000,107275000,107375000,"chr3",124643,3,4,7,14,"chr3",1,0.0344585091420534
"3918","chr3.85015000.85020000","chr3.85360000.85365000",345000,10,0.006442157,85015000,85360000,85020000,85365000,"chr3",124656,0,0,3,3,"chr3",1,0.00351617440225035
"3919","chr3.177340000.177345000","chr3.177495000.177500000",155000,16,0.0003415612,177340000,177495000,177345000,177500000,"chr3",124693,0,5,2,7,"chr3",1,0.0131270511017346
"3920","chr3.58175000.58180000","chr3.58290000.58295000",115000,18,0.0002208138,58175000,58290000,58180000,58295000,"chr3",124764,0,4,0,4,"chr3",1,0.00843881856540084
"3921","chr3.165835000.165840000","chr3.166680000.166685000",845000,7,0.008968842,165835000,166680000,165840000,166685000,"chr3",124822,0,4,1,5,"chr3",1,0.00410220346929208
"3922","chr3.10185000.10190000","chr3.10245000.10250000",60000,22,0.001336201,10185000,10245000,10190000,10250000,"chr3",124825,7,18,26,51,"chr3",1,0.131504922644163
"3923","chr3.183750000.183755000","chr3.183825000.183830000",75000,21,0.0003387817,183750000,183825000,183755000,183830000,"chr3",124884,2,0,1,3,"chr3",1,0.00738396624472574
"3924","chr3.107270000.107275000","chr3.107395000.107400000",125000,15,0.004113739,107270000,107395000,107275000,107400000,"chr3",124889,1,3,1,5,"chr3",1,0.00879043600562588
"3925","chr3.63340000.63345000","chr3.63815000.63820000",475000,10,0.001420507,63340000,63815000,63345000,63820000,"chr3",124929,0,0,4,4,"chr3",1,0.0046882325363338
"3926","chr3.37500000.37505000","chr3.37805000.37810000",305000,11,0.00305279,37500000,37805000,37505000,37810000,"chr3",124979,0,3,0,3,"chr3",1,0.00386779184247539
"3927","chr3.48990000.48995000","chr3.49020000.49025000",30000,32,0.001484935,48990000,49020000,48995000,49025000,"chr3",125008,1,8,7,16,"chr3",1,0.0600093764650727
"3928","chr3.48030000.48035000","chr3.48190000.48195000",160000,30,7.686458e-15,48030000,48190000,48035000,48195000,"chr3",125015,14,34,25,73,"chr3",1,0.256680731364276
"3929","chr3.50235000.50240000","chr3.50255000.50260000",20000,58,3.263634e-11,50235000,50255000,50240000,50260000,"chr3",125062,0,1,0,1,"chr3",1,0.00679793717768401
"3930","chr3.196440000.196445000","chr3.196600000.196605000",160000,13,0.009664013,196440000,196600000,196445000,196605000,"chr3",125106,1,8,16,25,"chr3",1,0.0380918893577121
"3931","chr3.124700000.124705000","chr3.125140000.125145000",440000,12,8.472501e-05,124700000,125140000,124705000,125145000,"chr3",125123,3,5,22,30,"chr3",1,0.0421940928270042
"3932","chr3.47540000.47545000","chr3.47835000.47840000",295000,13,0.0002055542,47540000,47835000,47545000,47840000,"chr3",125137,1,10,4,15,"chr3",1,0.0228551336146273
"3933","chr3.129330000.129335000","chr3.129650000.129655000",320000,14,2.313231e-05,129330000,129650000,129335000,129655000,"chr3",125141,0,0,6,6,"chr3",1,0.00984528832630099
"3934","chr3.58320000.58325000","chr3.58495000.58500000",175000,13,0.006099929,58320000,58495000,58325000,58500000,"chr3",125148,5,13,11,29,"chr3",1,0.0441865916549461
"3935","chr3.56975000.56980000","chr3.56995000.57000000",20000,38,0.002618443,56975000,56995000,56980000,5.7e+07,"chr3",125153,1,3,1,5,"chr3",1,0.0222691045475856
"3936","chr3.11460000.11465000","chr3.11480000.11485000",20000,36,0.008858162,11460000,11480000,11465000,11485000,"chr3",125168,2,2,6,10,"chr3",1,0.0421940928270042
"3937","chr3.10980000.10985000","chr3.11095000.11100000",115000,17,0.0007311562,10980000,11095000,10985000,11100000,"chr3",125277,1,1,1,3,"chr3",1,0.0059774964838256
"3938","chr3.194985000.194990000","chr3.195235000.195240000",250000,12,0.002492257,194985000,195235000,194990000,195240000,"chr3",125296,2,3,3,8,"chr3",1,0.0112517580872011
"3939","chr3.45550000.45555000","chr3.45580000.45585000",30000,41,4.387275e-07,45550000,45580000,45555000,45585000,"chr3",125298,4,7,7,18,"chr3",1,0.0864978902953586
"3940","chr3.72720000.72725000","chr3.72845000.72850000",125000,17,0.0004147058,72720000,72845000,72725000,72850000,"chr3",125317,0,7,12,19,"chr3",1,0.0378574777308955
"3941","chr3.72010000.72015000","chr3.72820000.72825000",810000,9,0.0003485205,72010000,72820000,72015000,72825000,"chr3",125388,3,0,5,8,"chr3",1,0.00843881856540084
"3942","chr3.48040000.48045000","chr3.48085000.48090000",45000,33,4.719885e-07,48040000,48085000,48045000,48090000,"chr3",125389,2,16,13,31,"chr3",1,0.119901547116737
"3943","chr3.9790000.9795000","chr3.9835000.9840000",45000,25,0.00175765,9790000,9835000,9795000,9840000,"chr3",125401,3,4,8,15,"chr3",1,0.0439521800281294
"3944","chr3.40410000.40415000","chr3.40450000.40455000",40000,41,2.271736e-10,40410000,40450000,40415000,40455000,"chr3",125463,0,4,6,10,"chr3",1,0.0480543834974215
"3945","chr3.9120000.9125000","chr3.9170000.9175000",50000,24,0.001456577,9120000,9170000,9125000,9175000,"chr3",125587,0,2,3,5,"chr3",1,0.0140646976090014
"3946","chr3.71955000.71960000","chr3.72885000.72890000",930000,7,0.005415362,71955000,72885000,71960000,72890000,"chr3",125618,0,2,3,5,"chr3",1,0.00410220346929208
"3947","chr3.49020000.49025000","chr3.49125000.49130000",105000,16,0.004113739,49020000,49125000,49025000,49130000,"chr3",125672,3,8,9,20,"chr3",1,0.0375058602906704
"3948","chr3.156245000.156250000","chr3.156790000.156795000",545000,12,1.857344e-05,156245000,156790000,156250000,156795000,"chr3",125695,3,5,4,12,"chr3",1,0.0168776371308017
"3949","chr3.15240000.15245000","chr3.15435000.15440000",195000,19,5.220558e-07,15240000,15435000,15245000,15440000,"chr3",125701,2,1,1,4,"chr3",1,0.00890764181903422
"3950","chr3.184285000.184290000","chr3.184425000.184430000",140000,15,0.002219268,184285000,184425000,184290000,184430000,"chr3",125719,2,10,14,26,"chr3",1,0.0457102672292546
"3951","chr3.58020000.58025000","chr3.58150000.58155000",130000,15,0.003322656,58020000,58150000,58025000,58155000,"chr3",125740,2,4,4,10,"chr3",1,0.0175808720112518
"3952","chr3.170325000.170330000","chr3.170520000.170525000",195000,14,0.000927336,170325000,170520000,170330000,170525000,"chr3",125754,0,1,2,3,"chr3",1,0.00492264416315049
"3953","chr3.142845000.142850000","chr3.143040000.143045000",195000,13,0.003248518,142845000,143040000,142850000,143045000,"chr3",125757,3,9,8,20,"chr3",1,0.0304735114861697
"3954","chr3.16325000.16330000","chr3.16440000.16445000",115000,15,0.006587037,16325000,16440000,16330000,16445000,"chr3",125793,0,0,3,3,"chr3",1,0.00527426160337553
"3955","chr3.61845000.61850000","chr3.61880000.61885000",35000,36,2.149133e-06,61845000,61880000,61850000,61885000,"chr3",125796,1,8,2,11,"chr3",1,0.0464135021097046
"3956","chr3.45550000.45555000","chr3.45685000.45690000",135000,27,3.490591e-11,45550000,45685000,45555000,45690000,"chr3",125826,4,7,7,18,"chr3",1,0.0569620253164557
"3957","chr3.151135000.151140000","chr3.151565000.151570000",430000,13,1.677428e-05,151135000,151565000,151140000,151570000,"chr3",125873,0,3,2,5,"chr3",1,0.00761837787154243
"3958","chr3.184315000.184320000","chr3.184425000.184430000",110000,20,2.466441e-05,184315000,184425000,184320000,184430000,"chr3",125878,2,11,7,20,"chr3",1,0.046882325363338
"3959","chr3.149245000.149250000","chr3.149270000.149275000",25000,34,0.006479597,149245000,149270000,149250000,149275000,"chr3",125884,2,3,0,5,"chr3",1,0.0199249882794187
"3960","chr3.182615000.182620000","chr3.182680000.182685000",65000,22,0.000549876,182615000,182680000,182620000,182685000,"chr3",125953,0,1,0,1,"chr3",1,0.00257852789498359
"3961","chr3.190530000.190535000","chr3.190860000.190865000",330000,10,0.007790869,190530000,190860000,190535000,190865000,"chr3",126078,1,8,3,12,"chr3",1,0.0140646976090014
"3962","chr3.11095000.11100000","chr3.11375000.11380000",280000,11,0.004727206,11095000,11375000,11100000,11380000,"chr3",126085,1,6,1,8,"chr3",1,0.0103141115799344
"3963","chr3.20020000.20025000","chr3.20055000.20060000",35000,33,4.369058e-05,20020000,20055000,20025000,20060000,"chr3",126139,0,4,7,11,"chr3",1,0.0425457102672293
"3964","chr3.23240000.23245000","chr3.23860000.23865000",620000,8,0.00790447,23240000,23860000,23245000,23865000,"chr3",126153,1,3,1,5,"chr3",1,0.0046882325363338
"3965","chr3.47475000.47480000","chr3.47835000.47840000",360000,13,5.625673e-05,47475000,47835000,47480000,47840000,"chr3",126155,6,7,17,30,"chr3",1,0.0457102672292546
"3966","chr3.170410000.170415000","chr3.170520000.170525000",110000,21,6.270054e-06,170410000,170520000,170415000,170525000,"chr3",126177,0,1,4,5,"chr3",1,0.0123066104078762
"3967","chr3.48965000.48970000","chr3.49020000.49025000",55000,23,0.00134018,48965000,49020000,48970000,49025000,"chr3",126196,3,8,9,20,"chr3",1,0.0539146741678387
"3968","chr3.129550000.129555000","chr3.129650000.129655000",100000,19,0.0002105433,129550000,129650000,129555000,129655000,"chr3",126246,0,0,6,6,"chr3",1,0.0133614627285513
"3969","chr3.52195000.52200000","chr3.52240000.52245000",45000,24,0.004086146,52195000,52240000,52200000,52245000,"chr3",126264,1,4,2,7,"chr3",1,0.019690576652602
"3970","chr3.15655000.15660000","chr3.16135000.16140000",480000,15,1.391379e-07,15655000,16135000,15660000,16140000,"chr3",126269,0,3,3,6,"chr3",1,0.0105485232067511
"3971","chr3.13135000.13140000","chr3.13475000.13480000",340000,13,8.145482e-05,13135000,13475000,13140000,13480000,"chr3",126274,1,4,9,14,"chr3",1,0.0213314580403188
"3972","chr3.47510000.47515000","chr3.47820000.47825000",310000,12,0.0006739722,47510000,47820000,47515000,47825000,"chr3",126281,2,10,9,21,"chr3",1,0.029535864978903
"3973","chr3.42370000.42375000","chr3.42420000.42425000",50000,23,0.003458127,42370000,42420000,42375000,42425000,"chr3",126297,2,3,2,7,"chr3",1,0.0188701359587436
"3974","chr3.11465000.11470000","chr3.11670000.11675000",205000,12,0.007829931,11465000,11670000,11470000,11675000,"chr3",126354,0,4,4,8,"chr3",1,0.0112517580872011
"3975","chr3.16330000.16335000","chr3.16600000.16605000",270000,19,1.262771e-08,16330000,16600000,16335000,16605000,"chr3",126451,0,1,1,2,"chr3",1,0.00445382090951711
"3976","chr3.23990000.23995000","chr3.24025000.24030000",35000,40,2.484659e-08,23990000,24025000,23995000,24030000,"chr3",126514,3,7,10,20,"chr3",1,0.093764650726676
"3977","chr3.77050000.77055000","chr3.77310000.77315000",260000,11,0.006950373,77050000,77310000,77055000,77315000,"chr3",126545,1,9,3,13,"chr3",1,0.0167604313173933
"3978","chr3.56735000.56740000","chr3.56995000.57000000",260000,12,0.00192738,56735000,56995000,56740000,5.7e+07,"chr3",126602,1,3,1,5,"chr3",1,0.0070323488045007
"3979","chr3.113440000.113445000","chr3.113765000.113770000",325000,11,0.002195056,113440000,113765000,113445000,113770000,"chr3",126603,0,5,1,6,"chr3",1,0.00773558368495077
"3980","chr3.156510000.156515000","chr3.156790000.156795000",280000,17,3.690329e-07,156510000,156790000,156515000,156795000,"chr3",126635,0,0,4,4,"chr3",1,0.00796999531176746
"3981","chr3.42165000.42170000","chr3.42225000.42230000",60000,20,0.00785248,42165000,42225000,42170000,42230000,"chr3",126640,1,3,4,8,"chr3",1,0.0187529301453352
"3982","chr3.47580000.47585000","chr3.47600000.47605000",20000,41,0.000324247,47580000,47600000,47585000,47605000,"chr3",126670,4,15,9,28,"chr3",1,0.13455227379278
"3983","chr3.9170000.9175000","chr3.9280000.9285000",110000,26,3.005738e-09,9170000,9280000,9175000,9285000,"chr3",126672,1,2,3,6,"chr3",1,0.0182841068917018
"3984","chr3.186945000.186950000","chr3.187395000.187400000",450000,12,7.311888e-05,186945000,187395000,186950000,187400000,"chr3",126705,0,4,4,8,"chr3",1,0.0112517580872011
"3985","chr3.183245000.183250000","chr3.183300000.183305000",55000,23,0.00134018,183245000,183300000,183250000,183305000,"chr3",126711,1,2,4,7,"chr3",1,0.0188701359587436
"3986","chr3.184135000.184140000","chr3.184255000.184260000",120000,16,0.001733304,184135000,184255000,184140000,184260000,"chr3",126796,1,9,9,19,"chr3",1,0.0356305672761369
"3987","chr3.4800000.4805000","chr3.5015000.5020000",215000,18,9.853478e-07,4800000,5015000,4805000,5020000,"chr3",126803,2,10,4,16,"chr3",1,0.0337552742616034
"3988","chr3.138360000.138365000","chr3.138410000.138415000",50000,22,0.007850461,138360000,138410000,138365000,138415000,"chr3",126829,3,7,11,21,"chr3",1,0.0541490857946554
"3989","chr3.23940000.23945000","chr3.23980000.23985000",40000,42,5.900284e-11,23940000,23980000,23945000,23985000,"chr3",126868,3,7,5,15,"chr3",1,0.0738396624472574
"3990","chr3.47475000.47480000","chr3.47510000.47515000",35000,31,0.000273205,47475000,47510000,47480000,47515000,"chr3",126883,2,7,9,18,"chr3",1,0.0654008438818565
"3991","chr3.10220000.10225000","chr3.10245000.10250000",25000,35,0.003377467,10220000,10245000,10225000,10250000,"chr3",126951,2,9,18,29,"chr3",1,0.11896390060947
"3992","chr3.4895000.4900000","chr3.5015000.5020000",120000,29,4.489908e-12,4895000,5015000,4900000,5020000,"chr3",126980,0,9,6,15,"chr3",1,0.0509845288326301
"3993","chr3.52140000.52145000","chr3.52170000.52175000",30000,32,0.001484935,52140000,52170000,52145000,52175000,"chr3",126996,2,4,2,8,"chr3",1,0.0300046882325363
"3994","chr3.48870000.48875000","chr3.48915000.48920000",45000,24,0.004086146,48870000,48915000,48875000,48920000,"chr3",127019,12,32,38,82,"chr3",1,0.230661040787623
"3995","chr3.129395000.129400000","chr3.129440000.129445000",45000,34,1.417964e-07,129395000,129440000,129400000,129445000,"chr3",127056,0,4,4,8,"chr3",1,0.0318799812470699
"3996","chr3.43745000.43750000","chr3.43770000.43775000",25000,43,6.342196e-06,43745000,43770000,43750000,43775000,"chr3",127089,1,0,2,3,"chr3",1,0.0151195499296765
"3997","chr3.63345000.63350000","chr3.63725000.63730000",380000,11,0.001001395,63345000,63725000,63350000,63730000,"chr3",127113,0,2,3,5,"chr3",1,0.00644631973745898
"3998","chr3.183570000.183575000","chr3.183985000.183990000",415000,10,0.002831847,183570000,183985000,183575000,183990000,"chr3",127126,0,2,2,4,"chr3",1,0.0046882325363338
"3999","chr3.182490000.182495000","chr3.182680000.182685000",190000,13,0.003768144,182490000,182680000,182495000,182685000,"chr3",127139,0,1,3,4,"chr3",1,0.00609470229723394
"4000","chr3.19970000.19975000","chr3.20100000.20105000",130000,15,0.003322656,19970000,20100000,19975000,20105000,"chr3",127155,2,11,12,25,"chr3",1,0.0439521800281294
"4001","chr3.159000000.159005000","chr3.159525000.159530000",525000,15,5.78097e-08,1.59e+08,159525000,159005000,159530000,"chr3",127208,1,0,2,3,"chr3",1,0.00527426160337553
"4002","chr3.122575000.122580000","chr3.122745000.122750000",170000,13,0.007077402,122575000,122745000,122580000,122750000,"chr3",127234,1,8,4,13,"chr3",1,0.0198077824660103
"4003","chr3.15240000.15245000","chr3.15280000.15285000",40000,27,0.001256406,15240000,15280000,15245000,15285000,"chr3",127248,2,1,1,4,"chr3",1,0.0126582278481013
"4004","chr3.196175000.196180000","chr3.196195000.196200000",20000,39,0.001340184,196175000,196195000,196180000,196200000,"chr3",127258,2,8,3,13,"chr3",1,0.0594233473980309
"4005","chr3.39465000.39470000","chr3.39485000.39490000",20000,37,0.004863644,39465000,39485000,39470000,39490000,"chr3",127259,0,1,2,3,"chr3",1,0.0130098452883263
"4006","chr3.58330000.58335000","chr3.58395000.58400000",65000,20,0.0037657,58330000,58395000,58335000,58400000,"chr3",127328,0,3,2,5,"chr3",1,0.0117205813408345
"4007","chr3.4425000.4430000","chr3.4630000.4635000",205000,12,0.007829931,4425000,4630000,4430000,4635000,"chr3",127398,3,3,4,10,"chr3",1,0.0140646976090014
"4008","chr3.170180000.170185000","chr3.170520000.170525000",340000,10,0.006827181,170180000,170520000,170185000,170525000,"chr3",127415,0,1,4,5,"chr3",1,0.00586029067041725
"4009","chr3.45565000.45570000","chr3.45685000.45690000",120000,19,4.36095e-05,45565000,45685000,45570000,45690000,"chr3",127438,4,10,8,22,"chr3",1,0.0489920300046882
"4010","chr3.43960000.43965000","chr3.44235000.44240000",275000,13,0.0003296162,43960000,44235000,43965000,44240000,"chr3",127439,3,5,13,21,"chr3",1,0.0319971870604782
"4011","chr3.43620000.43625000","chr3.43640000.43645000",20000,46,5.90835e-06,43620000,43640000,43625000,43645000,"chr3",127465,0,0,2,2,"chr3",1,0.0107829348335677
"4012","chr3.72235000.72240000","chr3.72270000.72275000",35000,31,0.000273205,72235000,72270000,72240000,72275000,"chr3",127526,0,2,1,3,"chr3",1,0.0109001406469761
"4013","chr3.69370000.69375000","chr3.69445000.69450000",75000,22,0.0001118066,69370000,69445000,69375000,69450000,"chr3",127533,0,7,4,11,"chr3",1,0.0283638068448195
"4014","chr3.13135000.13140000","chr3.13350000.13355000",215000,13,0.001733304,13135000,13350000,13140000,13355000,"chr3",127558,2,0,3,5,"chr3",1,0.00761837787154243
"4015","chr3.116005000.116010000","chr3.116160000.116165000",155000,17,9.160749e-05,116005000,116160000,116010000,116165000,"chr3",127570,0,1,0,1,"chr3",1,0.00199249882794187
"4016","chr3.57990000.57995000","chr3.58285000.58290000",295000,15,7.883835e-06,57990000,58285000,57995000,58290000,"chr3",127606,3,20,19,42,"chr3",1,0.0738396624472574
"4017","chr3.72410000.72415000","chr3.72830000.72835000",420000,10,0.00268828,72410000,72830000,72415000,72835000,"chr3",127618,1,1,2,4,"chr3",1,0.0046882325363338
"4018","chr3.148725000.148730000","chr3.148745000.148750000",20000,49,3.831916e-07,148725000,148745000,148730000,148750000,"chr3",127633,0,6,3,9,"chr3",1,0.0516877637130802
"4019","chr3.45550000.45555000","chr3.45655000.45660000",105000,28,2.068571e-10,45550000,45655000,45555000,45660000,"chr3",127634,5,7,7,19,"chr3",1,0.0623534927332396
"4020","chr3.155745000.155750000","chr3.156245000.156250000",500000,11,0.0002058766,155745000,156245000,155750000,156250000,"chr3",127678,0,2,2,4,"chr3",1,0.00515705578996718
"4021","chr3.149245000.149250000","chr3.149525000.149530000",280000,16,2.199224e-06,149245000,149525000,149250000,149530000,"chr3",127755,1,3,0,4,"chr3",1,0.00750117205813408
"4022","chr3.53345000.53350000","chr3.53375000.53380000",30000,32,0.001484935,53345000,53375000,53350000,53380000,"chr3",127762,5,18,22,45,"chr3",1,0.168776371308017
"4023","chr3.194070000.194075000","chr3.194125000.194130000",55000,24,0.0005215728,194070000,194125000,194075000,194130000,"chr3",127799,2,8,6,16,"chr3",1,0.0450070323488045
"4024","chr3.170100000.170105000","chr3.170510000.170515000",410000,14,3.870969e-06,170100000,170510000,170105000,170515000,"chr3",127853,0,6,10,16,"chr3",1,0.0262541022034693
"4025","chr3.170220000.170225000","chr3.170415000.170420000",195000,15,0.0002431127,170220000,170415000,170225000,170420000,"chr3",127928,5,17,13,35,"chr3",1,0.0615330520393812
"4026","chr3.129380000.129385000","chr3.129480000.129485000",100000,20,6.206319e-05,129380000,129480000,129385000,129485000,"chr3",127932,2,6,5,13,"chr3",1,0.0304735114861697
"4027","chr3.56365000.56370000","chr3.56480000.56485000",115000,17,0.0007311562,56365000,56480000,56370000,56485000,"chr3",127940,5,2,2,9,"chr3",1,0.0179324894514768
"4028","chr3.9890000.9895000","chr3.9945000.9950000",55000,24,0.0005215728,9890000,9945000,9895000,9950000,"chr3",127981,2,4,3,9,"chr3",1,0.0253164556962025
"4029","chr3.13410000.13415000","chr3.13490000.13495000",80000,21,0.0001777811,13410000,13490000,13415000,13495000,"chr3",128035,0,5,6,11,"chr3",1,0.0270745428973277
"4030","chr3.183855000.183860000","chr3.184015000.184020000",160000,15,0.000990646,183855000,184015000,183860000,184020000,"chr3",128042,0,7,8,15,"chr3",1,0.0263713080168776
"4031","chr3.107385000.107390000","chr3.107430000.107435000",45000,26,0.0007311562,107385000,107430000,107390000,107435000,"chr3",128093,0,1,2,3,"chr3",1,0.00914205344585091
"4032","chr3.69235000.69240000","chr3.69320000.69325000",85000,21,9.440884e-05,69235000,69320000,69240000,69325000,"chr3",128098,3,6,3,12,"chr3",1,0.029535864978903
"4033","chr3.66345000.66350000","chr3.66535000.66540000",190000,13,0.003768144,66345000,66535000,66350000,66540000,"chr3",128186,1,2,1,4,"chr3",1,0.00609470229723394
"4034","chr3.107235000.107240000","chr3.107270000.107275000",35000,28,0.003176334,107235000,107270000,107240000,107275000,"chr3",128198,0,2,5,7,"chr3",1,0.0229723394280356
"4035","chr3.45095000.45100000","chr3.45510000.45515000",415000,10,0.002831847,45095000,45510000,45100000,45515000,"chr3",128240,2,6,6,14,"chr3",1,0.0164088138771683
"4036","chr3.57990000.57995000","chr3.58215000.58220000",225000,12,0.004617662,57990000,58215000,57995000,58220000,"chr3",128241,8,19,11,38,"chr3",1,0.0534458509142053
"4037","chr3.17470000.17475000","chr3.17685000.17690000",215000,13,0.001733304,17470000,17685000,17475000,17690000,"chr3",128274,3,2,5,10,"chr3",1,0.0152367557430849
"4038","chr3.23495000.23500000","chr3.23855000.23860000",360000,12,0.0002875254,23495000,23855000,23500000,23860000,"chr3",128287,4,8,7,19,"chr3",1,0.0267229254571027
"4039","chr3.183230000.183235000","chr3.183830000.183835000",600000,8,0.009081355,183230000,183830000,183235000,183835000,"chr3",128306,1,8,6,15,"chr3",1,0.0140646976090014
"4040","chr3.47520000.47525000","chr3.47820000.47825000",300000,14,3.734838e-05,47520000,47820000,47525000,47825000,"chr3",128321,3,25,26,54,"chr3",1,0.0886075949367089
"4041","chr3.138415000.138420000","chr3.138625000.138630000",210000,25,2.499666e-12,138415000,138625000,138420000,138630000,"chr3",128345,0,1,5,6,"chr3",1,0.0175808720112518
"4042","chr3.47865000.47870000","chr3.48035000.48040000",170000,36,4.352458e-21,47865000,48035000,47870000,48040000,"chr3",128360,0,4,3,7,"chr3",1,0.029535864978903
"4043","chr3.11480000.11485000","chr3.11700000.11705000",220000,12,0.005236669,11480000,11700000,11485000,11705000,"chr3",128363,4,10,6,20,"chr3",1,0.0281293952180028
"4044","chr3.107340000.107345000","chr3.107370000.107375000",30000,34,0.0003107272,107340000,107370000,107345000,107375000,"chr3",128370,0,2,0,2,"chr3",1,0.00796999531176746
"4045","chr3.52030000.52035000","chr3.52160000.52165000",130000,20,5.546654e-06,52030000,52160000,52035000,52165000,"chr3",128436,1,14,13,28,"chr3",1,0.0656352555086732
"4046","chr3.58305000.58310000","chr3.58430000.58435000",125000,20,7.722424e-06,58305000,58430000,58310000,58435000,"chr3",128459,3,14,8,25,"chr3",1,0.0586029067041725
"4047","chr3.58295000.58300000","chr3.58420000.58425000",125000,15,0.004113739,58295000,58420000,58300000,58425000,"chr3",128516,0,3,2,5,"chr3",1,0.00879043600562588
"4048","chr3.195990000.195995000","chr3.196230000.196235000",240000,16,9.235939e-06,195990000,196230000,195995000,196235000,"chr3",128517,2,12,10,24,"chr3",1,0.0450070323488045
"4049","chr3.149480000.149485000","chr3.149895000.149900000",415000,13,2.196076e-05,149480000,149895000,149485000,149900000,"chr3",128550,2,7,11,20,"chr3",1,0.0304735114861697
"4050","chr3.53150000.53155000","chr3.53250000.53255000",100000,20,6.206319e-05,53150000,53250000,53155000,53255000,"chr3",128557,1,3,3,7,"chr3",1,0.0164088138771683
"4051","chr3.71015000.71020000","chr3.71380000.71385000",365000,10,0.005036593,71015000,71380000,71020000,71385000,"chr3",128564,0,3,2,5,"chr3",1,0.00586029067041725
"4052","chr3.23865000.23870000","chr3.23940000.23945000",75000,18,0.006827181,23865000,23940000,23870000,23945000,"chr3",128576,5,8,17,30,"chr3",1,0.0632911392405063
"4053","chr3.48740000.48745000","chr3.48995000.49000000",255000,11,0.007772406,48740000,48995000,48745000,4.9e+07,"chr3",128579,2,11,14,27,"chr3",1,0.0348101265822785
"4054","chr3.32570000.32575000","chr3.32590000.32595000",20000,42,0.0001542994,32570000,32590000,32575000,32595000,"chr3",128614,2,6,5,13,"chr3",1,0.0639943741209564
"4055","chr3.13330000.13335000","chr3.13490000.13495000",160000,23,5.453479e-09,13330000,13490000,13335000,13495000,"chr3",128665,0,5,6,11,"chr3",1,0.0296530707923113
"4056","chr3.179645000.179650000","chr3.179730000.179735000",85000,35,5.065289e-14,179645000,179730000,179650000,179735000,"chr3",128691,0,3,4,7,"chr3",1,0.0287154242850445
"4057","chr3.45085000.45090000","chr3.45685000.45690000",600000,9,0.001972578,45085000,45685000,45090000,45690000,"chr3",128709,0,4,3,7,"chr3",1,0.00738396624472574
"4058","chr3.16325000.16330000","chr3.16595000.16600000",270000,23,3.339188e-12,16325000,16595000,16330000,16600000,"chr3",128728,0,0,2,2,"chr3",1,0.00539146741678387
"4059","chr3.61880000.61885000","chr3.62110000.62115000",230000,12,0.004069429,61880000,62110000,61885000,62115000,"chr3",128729,6,7,5,18,"chr3",1,0.0253164556962025
"4060","chr3.10185000.10190000","chr3.10220000.10225000",35000,27,0.006592248,10185000,10220000,10190000,10225000,"chr3",128733,2,9,18,29,"chr3",1,0.0917721518987342
"4061","chr3.124785000.124790000","chr3.125125000.125130000",340000,10,0.006827181,124785000,125125000,124790000,125130000,"chr3",128746,1,8,16,25,"chr3",1,0.0293014533520863
"4062","chr3.72100000.72105000","chr3.72175000.72180000",75000,19,0.002712535,72100000,72175000,72105000,72180000,"chr3",128760,2,4,1,7,"chr3",1,0.0155883731833099
"4063","chr3.58285000.58290000","chr3.58395000.58400000",110000,15,0.008416159,58285000,58395000,58290000,58400000,"chr3",128800,0,3,2,5,"chr3",1,0.00879043600562588
"4064","chr3.170180000.170185000","chr3.170485000.170490000",305000,11,0.00305279,170180000,170485000,170185000,170490000,"chr3",128814,0,1,0,1,"chr3",1,0.0012892639474918
"4065","chr3.58295000.58300000","chr3.58470000.58475000",175000,19,1.62463e-06,58295000,58470000,58300000,58475000,"chr3",128846,2,3,2,7,"chr3",1,0.0155883731833099
"4066","chr3.52110000.52115000","chr3.52150000.52155000",40000,36,1.260004e-07,52110000,52150000,52115000,52155000,"chr3",128856,4,17,13,34,"chr3",1,0.143459915611814
"4067","chr3.41960000.41965000","chr3.42120000.42125000",160000,16,0.0002774243,41960000,42120000,41965000,42125000,"chr3",128886,1,11,15,27,"chr3",1,0.0506329113924051
"4068","chr3.53375000.53380000","chr3.53880000.53885000",505000,10,0.001018107,53375000,53880000,53380000,53885000,"chr3",128942,3,11,16,30,"chr3",1,0.0351617440225035
"4069","chr3.47905000.47910000","chr3.48040000.48045000",135000,15,0.002729852,47905000,48040000,47910000,48045000,"chr3",128945,0,9,9,18,"chr3",1,0.0316455696202532
"4070","chr3.149580000.149585000","chr3.149655000.149660000",75000,18,0.006827181,149580000,149655000,149585000,149660000,"chr3",128976,1,10,7,18,"chr3",1,0.0379746835443038
"4071","chr3.51555000.51560000","chr3.51700000.51705000",145000,19,9.303364e-06,51555000,51700000,51560000,51705000,"chr3",129127,2,2,3,7,"chr3",1,0.0155883731833099
"4072","chr3.14255000.14260000","chr3.14475000.14480000",220000,13,0.001492164,14255000,14475000,14260000,14480000,"chr3",129129,0,1,1,2,"chr3",1,0.00304735114861697
"4073","chr3.51555000.51560000","chr3.51665000.51670000",110000,17,0.001012851,51555000,51665000,51560000,51670000,"chr3",129173,0,3,2,5,"chr3",1,0.00996249413970933
"4074","chr3.16330000.16335000","chr3.16595000.16600000",265000,14,9.554521e-05,16330000,16595000,16335000,16600000,"chr3",129201,0,1,2,3,"chr3",1,0.00492264416315049
"4075","chr3.170220000.170225000","chr3.170550000.170555000",330000,10,0.007790869,170220000,170550000,170225000,170555000,"chr3",129324,0,2,2,4,"chr3",1,0.0046882325363338
"4076","chr3.183155000.183160000","chr3.183400000.183405000",245000,11,0.009475458,183155000,183400000,183160000,183405000,"chr3",129357,3,9,8,20,"chr3",1,0.0257852789498359
"4077","chr3.138330000.138335000","chr3.138415000.138420000",85000,20,0.0003037761,138330000,138415000,138335000,138420000,"chr3",129408,2,1,6,9,"chr3",1,0.0210970464135021
"4078","chr3.156375000.156380000","chr3.156790000.156795000",415000,21,1.050714e-12,156375000,156790000,156380000,156795000,"chr3",129477,0,3,0,3,"chr3",1,0.00738396624472574
"4079","chr3.9055000.9060000","chr3.9280000.9285000",225000,12,0.004617662,9055000,9280000,9060000,9285000,"chr3",129599,0,5,5,10,"chr3",1,0.0140646976090014
"4080","chr3.52035000.52040000","chr3.52150000.52155000",115000,33,4.39504e-15,52035000,52150000,52040000,52155000,"chr3",129606,3,1,3,7,"chr3",1,0.0270745428973277
"4081","chr3.51980000.51985000","chr3.52005000.52010000",25000,35,0.003377467,51980000,52005000,51985000,52010000,"chr3",129612,4,7,16,27,"chr3",1,0.110759493670886
"4082","chr3.48270000.48275000","chr3.48435000.48440000",165000,22,2.124458e-08,48270000,48435000,48275000,48440000,"chr3",129689,0,0,1,1,"chr3",1,0.00257852789498359
"4083","chr3.156350000.156355000","chr3.156790000.156795000",440000,9,0.008767949,156350000,156790000,156355000,156795000,"chr3",129718,3,1,3,7,"chr3",1,0.00738396624472574
"4084","chr3.47580000.47585000","chr3.47820000.47825000",240000,18,3.042743e-07,47580000,47820000,47585000,47825000,"chr3",129794,3,15,9,27,"chr3",1,0.0569620253164557
"4085","chr3.9180000.9185000","chr3.9280000.9285000",100000,23,1.051846e-06,9180000,9280000,9185000,9285000,"chr3",129803,1,3,4,8,"chr3",1,0.0215658696671355
"4086","chr3.51565000.51570000","chr3.51700000.51705000",135000,20,3.976439e-06,51565000,51700000,51570000,51705000,"chr3",129810,2,2,3,7,"chr3",1,0.0164088138771683
"4087","chr3.9195000.9200000","chr3.9280000.9285000",85000,20,0.0003037761,9195000,9280000,9200000,9285000,"chr3",129845,1,2,6,9,"chr3",1,0.0210970464135021
"4088","chr3.183230000.183235000","chr3.183305000.183310000",75000,25,2.820049e-06,183230000,183305000,183235000,183310000,"chr3",129856,0,4,1,5,"chr3",1,0.0146507266760431
"4089","chr3.185660000.185665000","chr3.186220000.186225000",560000,9,0.002836109,185660000,186220000,185665000,186225000,"chr3",129881,0,6,11,17,"chr3",1,0.0179324894514768
"4090","chr3.15425000.15430000","chr3.15600000.15605000",175000,13,0.006099929,15425000,15600000,15430000,15605000,"chr3",129941,0,0,3,3,"chr3",1,0.00457102672292546
"4091","chr3.128695000.128700000","chr3.128800000.128805000",105000,16,0.004113739,128695000,128800000,128700000,128805000,"chr3",130013,4,4,7,15,"chr3",1,0.0281293952180028
"4092","chr3.149270000.149275000","chr3.149485000.149490000",215000,13,0.001733304,149270000,149485000,149275000,149490000,"chr3",130102,2,5,7,14,"chr3",1,0.0213314580403188
"4093","chr3.170445000.170450000","chr3.170525000.170530000",80000,19,0.001532444,170445000,170525000,170450000,170530000,"chr3",130163,1,6,1,8,"chr3",1,0.0178152836380684
"4094","chr3.11430000.11435000","chr3.11665000.11670000",235000,12,0.003553338,11430000,11665000,11435000,11670000,"chr3",130227,3,4,5,12,"chr3",1,0.0168776371308017
"4095","chr3.170445000.170450000","chr3.170520000.170525000",75000,18,0.006827181,170445000,170520000,170450000,170525000,"chr3",130293,0,1,4,5,"chr3",1,0.0105485232067511
"4096","chr3.159525000.159530000","chr3.159625000.159630000",100000,21,1.668433e-05,159525000,159625000,159530000,159630000,"chr3",130320,1,0,2,3,"chr3",1,0.00738396624472574
"4097","chr3.171775000.171780000","chr3.172040000.172045000",265000,15,1.96712e-05,171775000,172040000,171780000,172045000,"chr3",130339,0,7,7,14,"chr3",1,0.0246132208157525
"4098","chr3.23495000.23500000","chr3.23775000.23780000",280000,11,0.004727206,23495000,23775000,23500000,23780000,"chr3",130393,4,8,7,19,"chr3",1,0.0244960150023441
"4099","chr3.11820000.11825000","chr3.11835000.11840000",15000,38,0.002618443,11820000,11835000,11825000,11840000,"chr3",130405,0,8,2,10,"chr3",1,0.0445382090951711
"4100","chr3.194985000.194990000","chr3.195270000.195275000",285000,12,0.001119793,194985000,195270000,194990000,195275000,"chr3",130488,2,3,3,8,"chr3",1,0.0112517580872011
"4101","chr3.186000000.186005000","chr3.186205000.186210000",205000,12,0.007829931,1.86e+08,186205000,186005000,186210000,"chr3",130614,1,2,1,4,"chr3",1,0.00562587904360056
"4102","chr3.9250000.9255000","chr3.9280000.9285000",30000,45,5.54415e-09,9250000,9280000,9255000,9285000,"chr3",130682,1,5,5,11,"chr3",1,0.0580168776371308
"4103","chr3.155850000.155855000","chr3.156245000.156250000",395000,13,3.080203e-05,155850000,156245000,155855000,156250000,"chr3",130695,3,5,9,17,"chr3",1,0.0259024847632443
"4104","chr3.171555000.171560000","chr3.171750000.171755000",195000,20,9.590897e-08,171555000,171750000,171560000,171755000,"chr3",130708,0,1,1,2,"chr3",1,0.0046882325363338
"4105","chr3.27365000.27370000","chr3.27710000.27715000",345000,10,0.006442157,27365000,27710000,27370000,27715000,"chr3",130734,0,1,0,1,"chr3",1,0.00117205813408345
"4106","chr3.57995000.58000000","chr3.58150000.58155000",155000,19,5.243294e-06,57995000,58150000,5.8e+07,58155000,"chr3",130741,3,4,4,11,"chr3",1,0.0244960150023441
"4107","chr3.53160000.53165000","chr3.53250000.53255000",90000,18,0.001599689,53160000,53250000,53165000,53255000,"chr3",130768,0,2,1,3,"chr3",1,0.00632911392405063
"4108","chr3.107140000.107145000","chr3.107240000.107245000",100000,16,0.005731548,107140000,107240000,107145000,107245000,"chr3",130774,0,2,3,5,"chr3",1,0.00937646507266761
"4109","chr3.42155000.42160000","chr3.42215000.42220000",60000,30,1.40412e-07,42155000,42215000,42160000,42220000,"chr3",130779,2,2,2,6,"chr3",1,0.0210970464135021
"4110","chr3.47865000.47870000","chr3.48190000.48195000",325000,27,1.539554e-17,47865000,48190000,47870000,48195000,"chr3",130782,0,4,3,7,"chr3",1,0.0221518987341772
"4111","chr3.42590000.42595000","chr3.42830000.42835000",240000,13,0.0008413164,42590000,42830000,42595000,42835000,"chr3",130808,3,17,13,33,"chr3",1,0.05028129395218
"4112","chr3.116005000.116010000","chr3.116140000.116145000",135000,15,0.002729852,116005000,116140000,116010000,116145000,"chr3",130870,0,1,0,1,"chr3",1,0.00175808720112518
"4113","chr3.5160000.5165000","chr3.5230000.5235000",70000,19,0.004822257,5160000,5230000,5165000,5235000,"chr3",130886,2,12,5,19,"chr3",1,0.0423112986404126
"4114","chr3.47865000.47870000","chr3.48030000.48035000",165000,42,5.631519e-27,47865000,48030000,47870000,48035000,"chr3",130938,0,4,3,7,"chr3",1,0.0344585091420534
"4115","chr3.182490000.182495000","chr3.183120000.183125000",630000,8,0.007383657,182490000,183120000,182495000,183125000,"chr3",130981,0,1,3,4,"chr3",1,0.00375058602906704
"4116","chr3.155870000.155875000","chr3.156790000.156795000",920000,8,0.0009759225,155870000,156790000,155875000,156795000,"chr3",130994,3,3,4,10,"chr3",1,0.00937646507266761
"4117","chr3.45550000.45555000","chr3.45665000.45670000",115000,16,0.002289584,45550000,45665000,45555000,45670000,"chr3",131023,0,3,0,3,"chr3",1,0.00562587904360056
"4118","chr3.141875000.141880000","chr3.141940000.141945000",65000,19,0.00893155,141875000,141940000,141880000,141945000,"chr3",131030,0,3,3,6,"chr3",1,0.0133614627285513
"4119","chr3.69390000.69395000","chr3.69430000.69435000",40000,46,2.06504e-13,69390000,69430000,69395000,69435000,"chr3",131043,0,2,1,3,"chr3",1,0.0161744022503516
"4120","chr3.48040000.48045000","chr3.48190000.48195000",150000,19,6.938847e-06,48040000,48190000,48045000,48195000,"chr3",131046,2,29,18,49,"chr3",1,0.109118612283169
"4121","chr3.127350000.127355000","chr3.127705000.127710000",355000,11,0.001405053,127350000,127705000,127355000,127710000,"chr3",131052,0,1,1,2,"chr3",1,0.00257852789498359
"4122","chr3.20035000.20040000","chr3.20055000.20060000",20000,36,0.008858162,20035000,20055000,20040000,20060000,"chr3",131082,0,4,6,10,"chr3",1,0.0421940928270042
"4123","chr3.194635000.194640000","chr3.195260000.195265000",625000,9,0.0015789,194635000,195260000,194640000,195265000,"chr3",131083,0,3,1,4,"chr3",1,0.00421940928270042
"4124","chr3.151005000.151010000","chr3.151100000.151105000",95000,16,0.007976203,151005000,151100000,151010000,151105000,"chr3",131130,0,1,3,4,"chr3",1,0.00750117205813408
"4125","chr3.58150000.58155000","chr3.58285000.58290000",135000,14,0.00790472,58150000,58285000,58155000,58290000,"chr3",131222,3,4,4,11,"chr3",1,0.0180496952648851
"4126","chr3.53160000.53165000","chr3.53235000.53240000",75000,20,0.0009906659,53160000,53235000,53165000,53240000,"chr3",131235,0,2,1,3,"chr3",1,0.0070323488045007
"4127","chr3.170325000.170330000","chr3.170435000.170440000",110000,15,0.008416159,170325000,170435000,170330000,170440000,"chr3",131243,1,6,2,9,"chr3",1,0.0158227848101266
"4128","chr3.13135000.13140000","chr3.13540000.13545000",405000,10,0.003176334,13135000,13540000,13140000,13545000,"chr3",131289,2,4,9,15,"chr3",1,0.0175808720112518
"4129","chr3.141460000.141465000","chr3.141645000.141650000",185000,13,0.004420432,141460000,141645000,141465000,141650000,"chr3",131348,1,4,7,12,"chr3",1,0.0182841068917018
"4130","chr3.129400000.129405000","chr3.129485000.129490000",85000,32,9.559711e-12,129400000,129485000,129405000,129490000,"chr3",131351,0,0,3,3,"chr3",1,0.0112517580872011
"4131","chr3.155075000.155080000","chr3.155415000.155420000",340000,13,8.145482e-05,155075000,155415000,155080000,155420000,"chr3",131365,0,3,2,5,"chr3",1,0.00761837787154243
"4132","chr3.47635000.47640000","chr3.47660000.47665000",25000,37,0.0008448135,47635000,47660000,47640000,47665000,"chr3",131381,5,22,14,41,"chr3",1,0.177801218940459
"4133","chr3.16335000.16340000","chr3.16595000.16600000",260000,17,7.751549e-07,16335000,16595000,16340000,16600000,"chr3",131385,0,2,1,3,"chr3",1,0.0059774964838256
"4134","chr3.52035000.52040000","chr3.52155000.52160000",120000,24,2.627314e-08,52035000,52155000,52040000,52160000,"chr3",131416,3,1,3,7,"chr3",1,0.019690576652602
"4135","chr3.42155000.42160000","chr3.42230000.42235000",75000,37,2.434675e-14,42155000,42230000,42160000,42235000,"chr3",131445,1,2,5,8,"chr3",1,0.0346929207688701
"4136","chr3.52030000.52035000","chr3.52170000.52175000",140000,29,4.817846e-13,52030000,52170000,52035000,52175000,"chr3",131447,5,14,7,26,"chr3",1,0.0883731833098922
"4137","chr3.69250000.69255000","chr3.69285000.69290000",35000,33,4.369058e-05,69250000,69285000,69255000,69290000,"chr3",131486,0,4,2,6,"chr3",1,0.0232067510548523
"4138","chr3.149485000.149490000","chr3.149525000.149530000",40000,71,4.161724e-32,149485000,149525000,149490000,149530000,"chr3",131492,1,3,2,6,"chr3",1,0.049929676511955
"4139","chr3.72990000.72995000","chr3.73100000.73105000",110000,24,7.423412e-08,72990000,73100000,72995000,73105000,"chr3",131514,0,8,7,15,"chr3",1,0.0421940928270042
"4140","chr3.9045000.9050000","chr3.9070000.9075000",25000,35,0.003377467,9045000,9070000,9050000,9075000,"chr3",131523,2,2,2,6,"chr3",1,0.0246132208157525
"4141","chr3.129380000.129385000","chr3.129650000.129655000",270000,13,0.0003746069,129380000,129650000,129385000,129655000,"chr3",131539,0,0,5,5,"chr3",1,0.00761837787154243
"4142","chr3.13300000.13305000","chr3.13490000.13495000",190000,16,7.311888e-05,13300000,13490000,13305000,13495000,"chr3",131566,0,5,6,11,"chr3",1,0.0206282231598687
"4143","chr3.11460000.11465000","chr3.11580000.11585000",120000,15,0.005183894,11460000,11580000,11465000,11585000,"chr3",131578,0,2,0,2,"chr3",1,0.00351617440225035
"4144","chr3.136260000.136265000","chr3.136660000.136665000",400000,11,0.0007563689,136260000,136660000,136265000,136665000,"chr3",131640,2,8,8,18,"chr3",1,0.0232067510548523
"4145","chr3.42070000.42075000","chr3.42115000.42120000",45000,26,0.0007311562,42070000,42115000,42075000,42120000,"chr3",131669,2,6,4,12,"chr3",1,0.0365682137834037
"4146","chr3.124555000.124560000","chr3.124590000.124595000",35000,33,4.369058e-05,124555000,124590000,124560000,124595000,"chr3",131696,2,6,3,11,"chr3",1,0.0425457102672293
"4147","chr3.53880000.53885000","chr3.53900000.53905000",20000,37,0.004863644,53880000,53900000,53885000,53905000,"chr3",131788,0,0,2,2,"chr3",1,0.00867323019221753
"4148","chr3.149480000.149485000","chr3.149530000.149535000",50000,24,0.001456577,149480000,149530000,149485000,149535000,"chr3",131796,2,9,7,18,"chr3",1,0.0506329113924051
"4149","chr3.48030000.48035000","chr3.48085000.48090000",55000,23,0.00134018,48030000,48085000,48035000,48090000,"chr3",131800,3,16,13,32,"chr3",1,0.086263478668542
"4150","chr3.129440000.129445000","chr3.129490000.129495000",50000,27,8.150052e-05,129440000,129490000,129445000,129495000,"chr3",131819,0,3,4,7,"chr3",1,0.0221518987341772
"4151","chr3.52110000.52115000","chr3.52140000.52145000",30000,40,1.22161e-06,52110000,52140000,52115000,52145000,"chr3",131876,2,4,2,8,"chr3",1,0.0375058602906704
"4152","chr3.10140000.10145000","chr3.10185000.10190000",45000,24,0.004086146,10140000,10185000,10145000,10190000,"chr3",131887,8,21,21,50,"chr3",1,0.140646976090014
"4153","chr3.133930000.133935000","chr3.134195000.134200000",265000,13,0.0004298827,133930000,134195000,133935000,134200000,"chr3",131956,0,3,0,3,"chr3",1,0.00457102672292546
"4154","chr3.182855000.182860000","chr3.183115000.183120000",260000,12,0.00192738,182855000,183115000,182860000,183120000,"chr3",131965,0,0,3,3,"chr3",1,0.00421940928270042
"4155","chr3.69280000.69285000","chr3.69330000.69335000",50000,36,1.492361e-09,69280000,69330000,69285000,69335000,"chr3",131981,1,13,6,20,"chr3",1,0.0843881856540084
"4156","chr3.42640000.42645000","chr3.42720000.42725000",80000,20,0.000546274,42640000,42720000,42645000,42725000,"chr3",131988,0,0,1,1,"chr3",1,0.0023441162681669
"4157","chr3.43770000.43775000","chr3.44235000.44240000",465000,13,9.426911e-06,43770000,44235000,43775000,44240000,"chr3",131997,1,0,2,3,"chr3",1,0.00457102672292546
"4158","chr3.185990000.185995000","chr3.186265000.186270000",275000,12,0.001383502,185990000,186265000,185995000,186270000,"chr3",132004,0,7,6,13,"chr3",1,0.0182841068917018
"4159","chr3.183180000.183185000","chr3.183500000.183505000",320000,11,0.002383804,183180000,183500000,183185000,183505000,"chr3",132023,0,4,2,6,"chr3",1,0.00773558368495077
"4160","chr3.72155000.72160000","chr3.72270000.72275000",115000,15,0.006587037,72155000,72270000,72160000,72275000,"chr3",132028,0,6,1,7,"chr3",1,0.0123066104078762
"4161","chr3.71125000.71130000","chr3.71650000.71655000",525000,9,0.003908625,71125000,71650000,71130000,71655000,"chr3",132036,1,2,1,4,"chr3",1,0.00421940928270042
"4162","chr3.72955000.72960000","chr3.73055000.73060000",100000,20,6.206319e-05,72955000,73055000,72960000,73060000,"chr3",132042,1,5,5,11,"chr3",1,0.0257852789498359
"4163","chr3.187780000.187785000","chr3.188455000.188460000",675000,8,0.005368394,187780000,188455000,187785000,188460000,"chr3",132184,1,3,2,6,"chr3",1,0.00562587904360056
"4164","chr3.101510000.101515000","chr3.101940000.101945000",430000,14,2.632869e-06,101510000,101940000,101515000,101945000,"chr3",132229,3,3,11,17,"chr3",1,0.0278949835911861
"4165","chr3.129380000.129385000","chr3.129550000.129555000",170000,20,4.36532e-07,129380000,129550000,129385000,129555000,"chr3",132233,2,6,5,13,"chr3",1,0.0304735114861697
"4166","chr3.65900000.65905000","chr3.65990000.65995000",90000,18,0.001599689,65900000,65990000,65905000,65995000,"chr3",132342,4,9,2,15,"chr3",1,0.0316455696202532
"4167","chr3.186080000.186085000","chr3.186220000.186225000",140000,14,0.006633655,186080000,186220000,186085000,186225000,"chr3",132388,0,2,1,3,"chr3",1,0.00492264416315049
"4168","chr3.40235000.40240000","chr3.40365000.40370000",130000,16,0.001071151,40235000,40365000,40240000,40370000,"chr3",132412,0,1,2,3,"chr3",1,0.00562587904360056
"4169","chr3.156380000.156385000","chr3.156790000.156795000",410000,15,5.662223e-07,156380000,156790000,156385000,156795000,"chr3",132523,0,3,4,7,"chr3",1,0.0123066104078762
"4170","chr3.129380000.129385000","chr3.129400000.129405000",20000,75,1.048788e-20,129380000,129400000,129385000,129405000,"chr3",132559,2,6,5,13,"chr3",1,0.114275668073136
"4171","chr3.69865000.69870000","chr3.69995000.70000000",130000,24,1.065632e-08,69865000,69995000,69870000,7e+07,"chr3",132658,0,2,0,2,"chr3",1,0.00562587904360056
"4172","chr3.58430000.58435000","chr3.58470000.58475000",40000,26,0.002831847,58430000,58470000,58435000,58475000,"chr3",132770,2,7,2,11,"chr3",1,0.0335208626347867
"4173","chr3.170220000.170225000","chr3.170525000.170530000",305000,16,1.003058e-06,170220000,170525000,170225000,170530000,"chr3",132826,1,6,1,8,"chr3",1,0.0150023441162682
"4174","chr3.69160000.69165000","chr3.69180000.69185000",20000,43,7.137249e-05,69160000,69180000,69165000,69185000,"chr3",132901,4,10,13,27,"chr3",1,0.136075949367089
"4175","chr3.170425000.170430000","chr3.170525000.170530000",100000,16,0.005731548,170425000,170525000,170430000,170530000,"chr3",132981,1,6,1,8,"chr3",1,0.0150023441162682
"4176","chr3.58215000.58220000","chr3.58290000.58295000",75000,25,2.820049e-06,58215000,58290000,58220000,58295000,"chr3",133045,5,19,11,35,"chr3",1,0.102555086732302
"4177","chr3.69270000.69275000","chr3.69290000.69295000",20000,36,0.008858162,69270000,69290000,69275000,69295000,"chr3",133069,0,2,2,4,"chr3",1,0.0168776371308017
"4178","chr3.186000000.186005000","chr3.186265000.186270000",265000,13,0.0004298827,1.86e+08,186265000,186005000,186270000,"chr3",133106,0,2,1,3,"chr3",1,0.00457102672292546
"4179","chr3.9495000.9500000","chr3.9695000.9700000",200000,12,0.008858162,9495000,9695000,9500000,9700000,"chr3",133153,0,8,4,12,"chr3",1,0.0168776371308017
"4180","chr3.9930000.9935000","chr3.10185000.10190000",255000,14,0.0001291737,9930000,10185000,9935000,10190000,"chr3",133280,0,5,4,9,"chr3",1,0.0147679324894515
"4181","chr3.197540000.197545000","chr3.197555000.197560000",15000,49,3.831916e-07,197540000,197555000,197545000,197560000,"chr3",133311,0,7,3,10,"chr3",1,0.0574308485700891
"4182","chr3.149610000.149615000","chr3.149665000.149670000",55000,21,0.007608433,149610000,149665000,149615000,149670000,"chr3",133349,0,8,3,11,"chr3",1,0.0270745428973277
"4183","chr3.141310000.141315000","chr3.141360000.141365000",50000,22,0.007850461,141310000,141360000,141315000,141365000,"chr3",133420,0,0,3,3,"chr3",1,0.00773558368495077
"4184","chr3.48960000.48965000","chr3.48995000.49000000",35000,40,2.484659e-08,48960000,48995000,48965000,4.9e+07,"chr3",133439,2,11,2,15,"chr3",1,0.070323488045007
"4185","chr3.142985000.142990000","chr3.143115000.143120000",130000,14,0.009475458,142985000,143115000,142990000,143120000,"chr3",133465,0,4,4,8,"chr3",1,0.0131270511017346
"4186","chr3.42190000.42195000","chr3.42215000.42220000",25000,48,5.084679e-08,42190000,42215000,42195000,42220000,"chr3",133472,2,6,2,10,"chr3",1,0.0562587904360056
"4187","chr3.107385000.107390000","chr3.107450000.107455000",65000,25,2.014295e-05,107385000,107450000,107390000,107455000,"chr3",133532,0,1,2,3,"chr3",1,0.00879043600562588
"4188","chr3.42590000.42595000","chr3.42805000.42810000",215000,21,4.811898e-09,42590000,42805000,42595000,42810000,"chr3",133616,1,14,13,28,"chr3",1,0.0689170182841069
"4189","chr3.23240000.23245000","chr3.23685000.23690000",445000,12,7.897084e-05,23240000,23685000,23245000,23690000,"chr3",133663,1,4,1,6,"chr3",1,0.00843881856540084
"4190","chr3.156270000.156275000","chr3.156790000.156795000",520000,23,2.458883e-16,156270000,156790000,156275000,156795000,"chr3",133700,0,1,1,2,"chr3",1,0.00539146741678387
"4191","chr3.72030000.72035000","chr3.72890000.72895000",860000,7,0.00828391,72030000,72890000,72035000,72895000,"chr3",133731,3,8,7,18,"chr3",1,0.0147679324894515
"4192","chr3.185980000.185985000","chr3.186250000.186255000",270000,19,1.262771e-08,185980000,186250000,185985000,186255000,"chr3",133746,0,7,5,12,"chr3",1,0.0267229254571027
"4193","chr3.48965000.48970000","chr3.48990000.48995000",25000,57,1.9491e-12,48965000,48990000,48970000,48995000,"chr3",133784,1,15,7,23,"chr3",1,0.15365682137834
"4194","chr3.15655000.15660000","chr3.16265000.16270000",610000,10,0.0003319824,15655000,16265000,15660000,16270000,"chr3",133829,0,5,3,8,"chr3",1,0.00937646507266761
"4195","chr3.15040000.15045000","chr3.15065000.15070000",25000,38,0.0004050057,15040000,15065000,15045000,15070000,"chr3",133831,1,0,1,2,"chr3",1,0.00890764181903422
"4196","chr3.194985000.194990000","chr3.195260000.195265000",275000,29,2.258628e-18,194985000,195260000,194990000,195265000,"chr3",133870,0,3,1,4,"chr3",1,0.013595874355368
"4197","chr3.51970000.51975000","chr3.52235000.52240000",265000,11,0.006348929,51970000,52235000,51975000,52240000,"chr3",133871,1,4,9,14,"chr3",1,0.0180496952648851
"4198","chr3.129435000.129440000","chr3.129535000.129540000",100000,21,1.668433e-05,129435000,129535000,129440000,129540000,"chr3",133999,3,2,9,14,"chr3",1,0.0344585091420534
"4199","chr3.170760000.170765000","chr3.171120000.171125000",360000,10,0.005342738,170760000,171120000,170765000,171125000,"chr3",134017,0,0,3,3,"chr3",1,0.00351617440225035
"4200","chr3.71495000.71500000","chr3.71565000.71570000",70000,19,0.004822257,71495000,71565000,71500000,71570000,"chr3",134022,0,2,2,4,"chr3",1,0.00890764181903422
"4201","chr3.15280000.15285000","chr3.15425000.15430000",145000,22,8.910304e-08,15280000,15425000,15285000,15430000,"chr3",134070,3,14,11,28,"chr3",1,0.0721987810595406
"4202","chr3.107390000.107395000","chr3.107420000.107425000",30000,34,0.0003107272,107390000,107420000,107395000,107425000,"chr3",134123,1,9,10,20,"chr3",1,0.0796999531176746
"4203","chr3.9045000.9050000","chr3.9315000.9320000",270000,12,0.001532444,9045000,9315000,9050000,9320000,"chr3",134150,3,6,4,13,"chr3",1,0.0182841068917018
"4204","chr3.143760000.143765000","chr3.143785000.143790000",25000,34,0.006479597,143760000,143785000,143765000,143790000,"chr3",134161,1,2,2,5,"chr3",1,0.0199249882794187
"4205","chr3.42095000.42100000","chr3.42115000.42120000",20000,43,7.137249e-05,42095000,42115000,42100000,42120000,"chr3",134212,0,2,2,4,"chr3",1,0.0201593999062353
"4206","chr3.40265000.40270000","chr3.40325000.40330000",60000,20,0.00785248,40265000,40325000,40270000,40330000,"chr3",134217,0,0,1,1,"chr3",1,0.0023441162681669
"4207","chr3.54575000.54580000","chr3.54600000.54605000",25000,34,0.006479597,54575000,54600000,54580000,54605000,"chr3",134229,2,1,1,4,"chr3",1,0.0159399906235349
"4208","chr3.9170000.9175000","chr3.9245000.9250000",75000,19,0.002712535,9170000,9245000,9175000,9250000,"chr3",134235,0,2,2,4,"chr3",1,0.00890764181903422
"4209","chr3.170695000.170700000","chr3.171180000.171185000",485000,9,0.005730947,170695000,171180000,170700000,171185000,"chr3",134357,1,4,2,7,"chr3",1,0.00738396624472574
"4210","chr3.151135000.151140000","chr3.151540000.151545000",405000,16,8.62969e-08,151135000,151540000,151140000,151545000,"chr3",134481,0,3,2,5,"chr3",1,0.00937646507266761
"4211","chr3.72030000.72035000","chr3.72885000.72890000",855000,7,0.008540868,72030000,72885000,72035000,72890000,"chr3",134526,1,5,3,9,"chr3",1,0.00738396624472574
"4212","chr3.48300000.48305000","chr3.48740000.48745000",440000,9,0.008767949,48300000,48740000,48305000,48745000,"chr3",134559,2,8,3,13,"chr3",1,0.0137130801687764
"4213","chr3.183390000.183395000","chr3.183430000.183435000",40000,33,3.767739e-06,183390000,183430000,183395000,183435000,"chr3",134653,3,3,6,12,"chr3",1,0.0464135021097046
"4214","chr3.177220000.177225000","chr3.177480000.177485000",260000,11,0.006950373,177220000,177480000,177225000,177485000,"chr3",134654,0,5,2,7,"chr3",1,0.00902484763244257
"4215","chr3.51975000.51980000","chr3.52005000.52010000",30000,35,0.0001340947,51975000,52005000,51980000,52010000,"chr3",134655,0,6,8,14,"chr3",1,0.0574308485700891
"4216","chr3.15670000.15675000","chr3.16245000.16250000",575000,9,0.002501477,15670000,16245000,15675000,16250000,"chr3",134708,0,1,1,2,"chr3",1,0.00210970464135021
"4217","chr3.42085000.42090000","chr3.42120000.42125000",35000,31,0.000273205,42085000,42120000,42090000,42125000,"chr3",134737,1,6,2,9,"chr3",1,0.0327004219409283
"4218","chr3.111855000.111860000","chr3.112110000.112115000",255000,13,0.0005557914,111855000,112110000,111860000,112115000,"chr3",134747,0,2,3,5,"chr3",1,0.00761837787154243
"4219","chr3.48300000.48305000","chr3.48995000.49000000",695000,10,0.0001460188,48300000,48995000,48305000,4.9e+07,"chr3",134774,2,8,3,13,"chr3",1,0.0152367557430849
"4220","chr3.194405000.194410000","chr3.195235000.195240000",830000,11,5.045343e-06,194405000,195235000,194410000,195240000,"chr3",134876,2,1,3,6,"chr3",1,0.00773558368495077
"4221","chr3.15240000.15245000","chr3.15405000.15410000",165000,17,5.623174e-05,15240000,15405000,15245000,15410000,"chr3",134877,2,1,1,4,"chr3",1,0.00796999531176746
"4222","chr3.138360000.138365000","chr3.138390000.138395000",30000,30,0.006277855,138360000,138390000,138365000,138395000,"chr3",134904,3,7,6,16,"chr3",1,0.0562587904360056
"4223","chr3.185685000.185690000","chr3.185940000.185945000",255000,12,0.002195056,185685000,185940000,185690000,185945000,"chr3",134949,2,9,9,20,"chr3",1,0.0281293952180028
"4224","chr3.185975000.185980000","chr3.186265000.186270000",290000,26,1.176188e-15,185975000,186265000,185980000,186270000,"chr3",135041,0,5,6,11,"chr3",1,0.0335208626347867
"4225","chr3.193570000.193575000","chr3.193590000.193595000",20000,45,1.381185e-05,193570000,193590000,193575000,193595000,"chr3",135057,0,3,3,6,"chr3",1,0.0316455696202532
"4226","chr3.40235000.40240000","chr3.40325000.40330000",90000,18,0.001599689,40235000,40325000,40240000,40330000,"chr3",135082,1,0,2,3,"chr3",1,0.00632911392405063
"4227","chr3.185660000.185665000","chr3.185935000.185940000",275000,15,1.429029e-05,185660000,185935000,185665000,185940000,"chr3",135098,1,5,10,16,"chr3",1,0.0281293952180028
"4228","chr3.117145000.117150000","chr3.117175000.117180000",30000,30,0.006277855,117145000,117175000,117150000,117180000,"chr3",135132,0,1,1,2,"chr3",1,0.0070323488045007
"4229","chr3.48735000.48740000","chr3.48965000.48970000",230000,16,1.378235e-05,48735000,48965000,48740000,48970000,"chr3",135150,4,20,25,49,"chr3",1,0.0918893577121425
"4230","chr3.42030000.42035000","chr3.42520000.42525000",490000,9,0.005432899,42030000,42520000,42035000,42525000,"chr3",135217,1,9,5,15,"chr3",1,0.0158227848101266
"4231","chr3.72010000.72015000","chr3.72270000.72275000",260000,11,0.006950373,72010000,72270000,72015000,72275000,"chr3",135239,2,6,5,13,"chr3",1,0.0167604313173933
"4232","chr3.58295000.58300000","chr3.58430000.58435000",135000,15,0.002729852,58295000,58430000,58300000,58435000,"chr3",135313,3,3,8,14,"chr3",1,0.0246132208157525
"4233","chr3.149955000.149960000","chr3.150210000.150215000",255000,29,1.003211e-17,149955000,150210000,149960000,150215000,"chr3",135317,1,5,9,15,"chr3",1,0.0509845288326301
"4234","chr3.150005000.150010000","chr3.150210000.150215000",205000,19,3.040267e-07,150005000,150210000,150010000,150215000,"chr3",135328,0,2,0,2,"chr3",1,0.00445382090951711
"4235","chr3.177340000.177345000","chr3.177360000.177365000",20000,40,0.0006722116,177340000,177360000,177345000,177365000,"chr3",135400,0,5,5,10,"chr3",1,0.046882325363338
"4236","chr3.125120000.125125000","chr3.125140000.125145000",20000,38,0.002618443,125120000,125140000,125125000,125145000,"chr3",135441,3,5,5,13,"chr3",1,0.0578996718237225
"4237","chr3.87350000.87355000","chr3.88215000.88220000",865000,7,0.008031451,87350000,88215000,87355000,88220000,"chr3",135501,2,4,1,7,"chr3",1,0.00574308485700891
"4238","chr3.20080000.20085000","chr3.20185000.20190000",105000,20,3.833446e-05,20080000,20185000,20085000,20190000,"chr3",135506,0,5,1,6,"chr3",1,0.0140646976090014
"4239","chr3.107150000.107155000","chr3.107240000.107245000",90000,37,3.381756e-16,107150000,107240000,107155000,107245000,"chr3",135563,0,1,2,3,"chr3",1,0.0130098452883263
"4240","chr3.72990000.72995000","chr3.73055000.73060000",65000,23,0.0001912085,72990000,73055000,72995000,73060000,"chr3",135564,1,5,5,11,"chr3",1,0.0296530707923113
"4241","chr3.53120000.53125000","chr3.53250000.53255000",130000,15,0.003322656,53120000,53250000,53125000,53255000,"chr3",135586,3,1,1,5,"chr3",1,0.00879043600562588
"4242","chr3.185975000.185980000","chr3.186205000.186210000",230000,14,0.0002836512,185975000,186205000,185980000,186210000,"chr3",135590,0,5,6,11,"chr3",1,0.0180496952648851
"4243","chr3.185685000.185690000","chr3.186235000.186240000",550000,12,1.719762e-05,185685000,186235000,185690000,186240000,"chr3",135624,1,4,2,7,"chr3",1,0.00984528832630099
"4244","chr3.114175000.114180000","chr3.114875000.114880000",700000,12,2.505658e-06,114175000,114875000,114180000,114880000,"chr3",135636,3,5,5,13,"chr3",1,0.0182841068917018
"4245","chr3.32590000.32595000","chr3.32680000.32685000",90000,18,0.001599689,32590000,32680000,32595000,32685000,"chr3",135665,3,11,10,24,"chr3",1,0.0506329113924051
"4246","chr3.64020000.64025000","chr3.64480000.64485000",460000,11,0.0003415612,64020000,64480000,64025000,64485000,"chr3",135676,1,4,4,9,"chr3",1,0.0116033755274262
"4247","chr3.107150000.107155000","chr3.107270000.107275000",120000,18,0.000159826,107150000,107270000,107155000,107275000,"chr3",135685,1,1,2,4,"chr3",1,0.00843881856540084
"4248","chr3.23885000.23890000","chr3.23970000.23975000",85000,17,0.006799165,23885000,23970000,23890000,23975000,"chr3",135756,3,10,4,17,"chr3",1,0.0338724800750117
"4249","chr3.183120000.183125000","chr3.183155000.183160000",35000,28,0.003176334,183120000,183155000,183125000,183160000,"chr3",135761,2,9,3,14,"chr3",1,0.0459446788560713
"4250","chr3.185980000.185985000","chr3.186265000.186270000",285000,11,0.00429647,185980000,186265000,185985000,186270000,"chr3",135774,0,7,6,13,"chr3",1,0.0167604313173933
"4251","chr3.129400000.129405000","chr3.129625000.129630000",225000,12,0.004617662,129400000,129625000,129405000,129630000,"chr3",135796,4,8,15,27,"chr3",1,0.0379746835443038
"4252","chr3.185730000.185735000","chr3.186200000.186205000",470000,11,0.0003037761,185730000,186200000,185735000,186205000,"chr3",135808,0,2,1,3,"chr3",1,0.00386779184247539
"4253","chr3.170615000.170620000","chr3.171145000.171150000",530000,9,0.003735396,170615000,171145000,170620000,171150000,"chr3",135830,0,0,3,3,"chr3",1,0.00316455696202532
"4254","chr3.43620000.43625000","chr3.44235000.44240000",615000,10,0.0003177655,43620000,44235000,43625000,44240000,"chr3",135837,0,4,2,6,"chr3",1,0.0070323488045007
"4255","chr3.9130000.9135000","chr3.9280000.9285000",150000,18,2.972189e-05,9130000,9280000,9135000,9285000,"chr3",135839,0,5,6,11,"chr3",1,0.0232067510548523
"4256","chr3.8995000.9000000","chr3.9345000.9350000",350000,10,0.006075222,8995000,9345000,9e+06,9350000,"chr3",135971,4,1,0,5,"chr3",1,0.00586029067041725
"4257","chr3.107250000.107255000","chr3.107270000.107275000",20000,43,7.137249e-05,107250000,107270000,107255000,107275000,"chr3",135997,4,4,7,15,"chr3",1,0.0755977496483826
"4258","chr3.23940000.23945000","chr3.24025000.24030000",85000,17,0.006799165,23940000,24025000,23945000,24030000,"chr3",136014,7,7,12,26,"chr3",1,0.0518049695264885
"4259","chr3.141360000.141365000","chr3.141430000.141435000",70000,19,0.004822257,141360000,141430000,141365000,141435000,"chr3",136053,0,5,3,8,"chr3",1,0.0178152836380684
"4260","chr3.9105000.9110000","chr3.9180000.9185000",75000,21,0.0003387817,9105000,9180000,9110000,9185000,"chr3",136062,1,0,0,1,"chr3",1,0.00246132208157525
"4261","chr3.150350000.150355000","chr3.150385000.150390000",35000,28,0.003176334,150350000,150385000,150355000,150390000,"chr3",136075,0,2,1,3,"chr3",1,0.00984528832630099
"4262","chr3.150880000.150885000","chr3.151565000.151570000",685000,9,0.0009681855,150880000,151565000,150885000,151570000,"chr3",136114,1,3,2,6,"chr3",1,0.00632911392405063
"4263","chr3.107150000.107155000","chr3.107250000.107255000",100000,17,0.002026797,107150000,107250000,107155000,107255000,"chr3",136172,1,1,2,4,"chr3",1,0.00796999531176746
"4264","chr3.63345000.63350000","chr3.63790000.63795000",445000,11,0.0004213775,63345000,63790000,63350000,63795000,"chr3",136195,0,5,9,14,"chr3",1,0.0180496952648851
"4265","chr3.62580000.62585000","chr3.63205000.63210000",625000,9,0.0015789,62580000,63205000,62585000,63210000,"chr3",136246,1,7,4,12,"chr3",1,0.0126582278481013
"4266","chr3.23980000.23985000","chr3.24225000.24230000",245000,14,0.0001754053,23980000,24225000,23985000,24230000,"chr3",136258,2,7,5,14,"chr3",1,0.0229723394280356
"4267","chr3.19170000.19175000","chr3.19945000.19950000",775000,10,6.959823e-05,19170000,19945000,19175000,19950000,"chr3",136259,0,0,5,5,"chr3",1,0.00586029067041725
"4268","chr3.15310000.15315000","chr3.15355000.15360000",45000,48,2.825854e-16,15310000,15355000,15315000,15360000,"chr3",136319,4,11,15,30,"chr3",1,0.168776371308017
"4269","chr3.183430000.183435000","chr3.183460000.183465000",30000,39,3.342514e-06,183430000,183460000,183435000,183465000,"chr3",136368,1,5,7,13,"chr3",1,0.0594233473980309
"4270","chr3.42050000.42055000","chr3.42190000.42195000",140000,14,0.006633655,42050000,42190000,42055000,42195000,"chr3",136407,1,7,8,16,"chr3",1,0.0262541022034693
"4271","chr3.10185000.10190000","chr3.10205000.10210000",20000,42,0.0001542994,10185000,10205000,10190000,10210000,"chr3",136417,9,20,17,46,"chr3",1,0.226441631504923
"4272","chr3.185730000.185735000","chr3.185935000.185940000",205000,21,8.796434e-09,185730000,185935000,185735000,185940000,"chr3",136431,1,5,8,14,"chr3",1,0.0344585091420534
"4273","chr3.179650000.179655000","chr3.179730000.179735000",80000,26,2.982152e-07,179650000,179730000,179655000,179735000,"chr3",136457,0,3,4,7,"chr3",1,0.0213314580403188
"4274","chr3.25040000.25045000","chr3.25590000.25595000",550000,9,0.003141885,25040000,25590000,25045000,25595000,"chr3",136500,1,4,6,11,"chr3",1,0.0116033755274262
"4275","chr3.186035000.186040000","chr3.186205000.186210000",170000,14,0.002269375,186035000,186205000,186040000,186210000,"chr3",136533,1,4,8,13,"chr3",1,0.0213314580403188
"4276","chr3.194395000.194400000","chr3.194985000.194990000",590000,17,1.685562e-10,194395000,194985000,194400000,194990000,"chr3",136590,1,3,3,7,"chr3",1,0.0139474917955931
"4277","chr3.10975000.10980000","chr3.11060000.11065000",85000,18,0.002607953,10975000,11060000,10980000,11065000,"chr3",136608,3,2,6,11,"chr3",1,0.0232067510548523
"4278","chr3.129400000.129405000","chr3.129460000.129465000",60000,25,6.156629e-05,129400000,129460000,129405000,129465000,"chr3",136612,7,8,2,17,"chr3",1,0.0498124706985466
"4279","chr3.48435000.48440000","chr3.48470000.48475000",35000,32,0.0001118066,48435000,48470000,48440000,48475000,"chr3",136630,0,3,1,4,"chr3",1,0.0150023441162682
"4280","chr3.183300000.183305000","chr3.183430000.183435000",130000,14,0.009475458,183300000,183430000,183305000,183435000,"chr3",136637,2,7,4,13,"chr3",1,0.0213314580403188
"4281","chr3.148725000.148730000","chr3.148990000.148995000",265000,12,0.001725161,148725000,148990000,148730000,148995000,"chr3",136645,1,10,5,16,"chr3",1,0.0225035161744023
"4282","chr3.56765000.56770000","chr3.56800000.56805000",35000,28,0.003176334,56765000,56800000,56770000,56805000,"chr3",136694,1,7,9,17,"chr3",1,0.0557899671823722
"4283","chr3.107370000.107375000","chr3.107390000.107395000",20000,38,0.002618443,107370000,107390000,107375000,107395000,"chr3",136776,1,4,9,14,"chr3",1,0.0623534927332396
"4284","chr3.186010000.186015000","chr3.186245000.186250000",235000,12,0.003553338,186010000,186245000,186015000,186250000,"chr3",136874,0,4,3,7,"chr3",1,0.00984528832630099
"4285","chr3.47575000.47580000","chr3.47820000.47825000",245000,23,1.433623e-11,47575000,47820000,47580000,47825000,"chr3",136876,0,5,3,8,"chr3",1,0.0215658696671355
"4286","chr3.141450000.141455000","chr3.141940000.141945000",490000,9,0.005432899,141450000,141940000,141455000,141945000,"chr3",137018,2,9,3,14,"chr3",1,0.0147679324894515
"4287","chr3.15670000.15675000","chr3.15720000.15725000",50000,28,2.835829e-05,15670000,15720000,15675000,15725000,"chr3",137055,2,5,3,10,"chr3",1,0.0328176277543366
"4288","chr3.116095000.116100000","chr3.116140000.116145000",45000,23,0.008858162,116095000,116140000,116100000,116145000,"chr3",137074,0,1,0,1,"chr3",1,0.00269573370839194
"4289","chr3.182910000.182915000","chr3.183070000.183075000",160000,16,0.0002774243,182910000,183070000,182915000,183075000,"chr3",137096,3,0,1,4,"chr3",1,0.00750117205813408
"4290","chr3.52595000.52600000","chr3.52705000.52710000",110000,24,7.423412e-08,52595000,52705000,52600000,52710000,"chr3",137100,6,6,7,19,"chr3",1,0.0534458509142053
"4291","chr3.15240000.15245000","chr3.15575000.15580000",335000,11,0.001865254,15240000,15575000,15245000,15580000,"chr3",137133,2,1,1,4,"chr3",1,0.00515705578996718
"4292","chr3.196975000.196980000","chr3.197220000.197225000",245000,19,3.928643e-08,196975000,197220000,196980000,197225000,"chr3",137136,1,3,9,13,"chr3",1,0.0289498359118612
"4293","chr3.52140000.52145000","chr3.52235000.52240000",95000,16,0.007976203,52140000,52235000,52145000,52240000,"chr3",137147,1,4,2,7,"chr3",1,0.0131270511017346
"4294","chr3.39460000.39465000","chr3.39485000.39490000",25000,58,5.688989e-13,39460000,39485000,39465000,39490000,"chr3",137174,2,1,4,7,"chr3",1,0.0475855602437881
"4295","chr3.20080000.20085000","chr3.20100000.20105000",20000,37,0.004863644,20080000,20100000,20085000,20105000,"chr3",137205,0,5,1,6,"chr3",1,0.0260196905766526
"4296","chr3.42260000.42265000","chr3.42590000.42595000",330000,11,0.002016097,42260000,42590000,42265000,42595000,"chr3",137235,0,2,3,5,"chr3",1,0.00644631973745898
"4297","chr3.61845000.61850000","chr3.62110000.62115000",265000,13,0.0004298827,61845000,62110000,61850000,62115000,"chr3",137282,1,7,2,10,"chr3",1,0.0152367557430849
"4298","chr3.42650000.42655000","chr3.42680000.42685000",30000,47,5.270232e-10,42650000,42680000,42655000,42685000,"chr3",137412,1,5,4,10,"chr3",1,0.0550867323019222
"4299","chr3.9130000.9135000","chr3.9195000.9200000",65000,23,0.0001912085,9130000,9195000,9135000,9200000,"chr3",137421,0,2,6,8,"chr3",1,0.0215658696671355
"4300","chr3.47635000.47640000","chr3.47820000.47825000",185000,14,0.001336201,47635000,47820000,47640000,47825000,"chr3",137450,3,26,14,43,"chr3",1,0.0705578996718237
"4301","chr3.156270000.156275000","chr3.156785000.156790000",515000,11,0.0001712997,156270000,156785000,156275000,156790000,"chr3",137482,0,1,1,2,"chr3",1,0.00257852789498359
"4302","chr3.42590000.42595000","chr3.42680000.42685000",90000,17,0.004470148,42590000,42680000,42595000,42685000,"chr3",137510,1,13,5,19,"chr3",1,0.0378574777308955
"4303","chr3.185980000.185985000","chr3.186275000.186280000",295000,15,7.883835e-06,185980000,186275000,185985000,186280000,"chr3",137540,1,2,2,5,"chr3",1,0.00879043600562588
"4304","chr3.149490000.149495000","chr3.149895000.149900000",405000,10,0.003176334,149490000,149895000,149495000,149900000,"chr3",137559,2,1,1,4,"chr3",1,0.0046882325363338
"4305","chr3.194470000.194475000","chr3.194585000.194590000",115000,15,0.006587037,194470000,194585000,194475000,194590000,"chr3",137590,1,6,4,11,"chr3",1,0.0193389592123769
"4306","chr3.37500000.37505000","chr3.37795000.37800000",295000,13,0.0002055542,37500000,37795000,37505000,37800000,"chr3",137612,0,3,0,3,"chr3",1,0.00457102672292546
"4307","chr3.148900000.148905000","chr3.148990000.148995000",90000,21,5.197146e-05,148900000,148990000,148905000,148995000,"chr3",137620,0,3,6,9,"chr3",1,0.0221518987341772
"4308","chr3.42050000.42055000","chr3.42155000.42160000",105000,18,0.0004584521,42050000,42155000,42055000,42160000,"chr3",137727,1,2,5,8,"chr3",1,0.0168776371308017
"4309","chr3.57945000.57950000","chr3.58150000.58155000",205000,12,0.007829931,57945000,58150000,57950000,58155000,"chr3",137788,3,4,4,11,"chr3",1,0.0154711673699015
"4310","chr3.15310000.15315000","chr3.15425000.15430000",115000,22,9.379274e-07,15310000,15425000,15315000,15430000,"chr3",137802,4,11,14,29,"chr3",1,0.0747773089545241
"4311","chr3.65760000.65765000","chr3.66020000.66025000",260000,11,0.006950373,65760000,66020000,65765000,66025000,"chr3",137811,0,3,1,4,"chr3",1,0.00515705578996718
"4312","chr3.52030000.52035000","chr3.52275000.52280000",245000,15,3.821181e-05,52030000,52275000,52035000,52280000,"chr3",137845,0,14,8,22,"chr3",1,0.0386779184247539
"4313","chr3.15240000.15245000","chr3.15355000.15360000",115000,21,4.027894e-06,15240000,15355000,15245000,15360000,"chr3",137894,2,1,1,4,"chr3",1,0.00984528832630099
"4314","chr3.185660000.185665000","chr3.186265000.186270000",605000,11,5.766382e-05,185660000,186265000,185665000,186270000,"chr3",137910,0,7,6,13,"chr3",1,0.0167604313173933
"4315","chr3.23970000.23975000","chr3.23995000.24000000",25000,37,0.0008448135,23970000,23995000,23975000,2.4e+07,"chr3",137928,0,4,4,8,"chr3",1,0.0346929207688701
"4316","chr3.182505000.182510000","chr3.182680000.182685000",175000,14,0.001869257,182505000,182680000,182510000,182685000,"chr3",137959,0,2,1,3,"chr3",1,0.00492264416315049
"4317","chr3.188050000.188055000","chr3.188915000.188920000",865000,7,0.008031451,188050000,188915000,188055000,188920000,"chr3",138044,0,0,3,3,"chr3",1,0.00246132208157525
"4318","chr3.42050000.42055000","chr3.42085000.42090000",35000,44,1.800274e-10,42050000,42085000,42055000,42090000,"chr3",138144,1,6,2,9,"chr3",1,0.0464135021097046
"4319","chr3.11460000.11465000","chr3.11700000.11705000",240000,18,3.042743e-07,11460000,11700000,11465000,11705000,"chr3",138174,2,2,6,10,"chr3",1,0.0210970464135021
"4320","chr3.182505000.182510000","chr3.182615000.182620000",110000,15,0.008416159,182505000,182615000,182510000,182620000,"chr3",138294,0,1,0,1,"chr3",1,0.00175808720112518
"4321","chr3.177115000.177120000","chr3.177480000.177485000",365000,12,0.0002655857,177115000,177480000,177120000,177485000,"chr3",138308,0,1,1,2,"chr3",1,0.00281293952180028
"4322","chr3.4685000.4690000","chr3.5070000.5075000",385000,12,0.0001934121,4685000,5070000,4690000,5075000,"chr3",138352,1,3,7,11,"chr3",1,0.0154711673699015
"4323","chr3.185730000.185735000","chr3.186220000.186225000",490000,9,0.005432899,185730000,186220000,185735000,186225000,"chr3",138355,0,6,8,14,"chr3",1,0.0147679324894515
"4324","chr3.112785000.112790000","chr3.113020000.113025000",235000,15,5.480045e-05,112785000,113020000,112790000,113025000,"chr3",138373,0,1,6,7,"chr3",1,0.0123066104078762
"4325","chr3.156405000.156410000","chr3.156790000.156795000",385000,19,2.532439e-10,156405000,156790000,156410000,156795000,"chr3",138565,1,2,0,3,"chr3",1,0.00668073136427567
"4326","chr3.58220000.58225000","chr3.58290000.58295000",70000,36,6.825325e-13,58220000,58290000,58225000,58295000,"chr3",138576,3,11,15,29,"chr3",1,0.122362869198312
"4327","chr3.42025000.42030000","chr3.42080000.42085000",55000,25,0.0001901332,42025000,42080000,42030000,42085000,"chr3",138582,1,8,6,15,"chr3",1,0.0439521800281294
"4328","chr3.69270000.69275000","chr3.69320000.69325000",50000,25,0.0005851413,69270000,69320000,69275000,69325000,"chr3",138638,2,6,6,14,"chr3",1,0.0410220346929208
"4329","chr3.159525000.159530000","chr3.159730000.159735000",205000,15,0.0001654254,159525000,159730000,159530000,159735000,"chr3",138666,0,0,2,2,"chr3",1,0.00351617440225035
"4330","chr3.42720000.42725000","chr3.42780000.42785000",60000,21,0.003322656,42720000,42780000,42725000,42785000,"chr3",138686,0,0,6,6,"chr3",1,0.0147679324894515
"4331","chr3.48870000.48875000","chr3.48945000.48950000",75000,18,0.006827181,48870000,48945000,48875000,48950000,"chr3",138700,0,5,10,15,"chr3",1,0.0316455696202532
"4332","chr3.190255000.190260000","chr3.190420000.190425000",165000,14,0.002729852,190255000,190420000,190260000,190425000,"chr3",138762,2,5,2,9,"chr3",1,0.0147679324894515
"4333","chr3.149655000.149660000","chr3.149895000.149900000",240000,16,9.235939e-06,149655000,149895000,149660000,149900000,"chr3",138838,1,7,7,15,"chr3",1,0.0281293952180028
"4334","chr3.45595000.45600000","chr3.45685000.45690000",90000,17,0.004470148,45595000,45685000,45600000,45690000,"chr3",138858,4,4,8,16,"chr3",1,0.0318799812470699
"4335","chr3.122510000.122515000","chr3.122575000.122580000",65000,19,0.00893155,122510000,122575000,122515000,122580000,"chr3",138859,1,8,4,13,"chr3",1,0.0289498359118612
"4336","chr3.58220000.58225000","chr3.58285000.58290000",65000,32,1.849211e-09,58220000,58285000,58225000,58290000,"chr3",138886,3,11,15,29,"chr3",1,0.108766994842944
"4337","chr3.72010000.72015000","chr3.72680000.72685000",670000,10,0.0001847939,72010000,72680000,72015000,72685000,"chr3",138931,0,3,0,3,"chr3",1,0.00351617440225035
"4338","chr3.129395000.129400000","chr3.129535000.129540000",140000,20,2.867661e-06,129395000,129535000,129400000,129540000,"chr3",139011,3,8,9,20,"chr3",1,0.046882325363338
"4339","chr3.183110000.183115000","chr3.183155000.183160000",45000,27,0.0002944238,183110000,183155000,183115000,183160000,"chr3",139095,3,9,8,20,"chr3",1,0.0632911392405063
"4340","chr3.15685000.15690000","chr3.16290000.16295000",605000,8,0.008849446,15685000,16290000,15690000,16295000,"chr3",139117,1,3,6,10,"chr3",1,0.00937646507266761
"4341","chr3.58215000.58220000","chr3.58265000.58270000",50000,26,0.0002216793,58215000,58265000,58220000,58270000,"chr3",139136,4,12,9,25,"chr3",1,0.0761837787154243
"4342","chr3.10025000.10030000","chr3.10355000.10360000",330000,10,0.007790869,10025000,10355000,10030000,10360000,"chr3",139198,0,0,2,2,"chr3",1,0.0023441162681669
"4343","chr3.172255000.172260000","chr3.172310000.172315000",55000,22,0.003264775,172255000,172310000,172260000,172315000,"chr3",139221,0,0,4,4,"chr3",1,0.0103141115799344
"4344","chr3.48855000.48860000","chr3.48965000.48970000",110000,16,0.003064209,48855000,48965000,48860000,48970000,"chr3",139233,4,24,19,47,"chr3",1,0.0881387716830755
"4345","chr3.141075000.141080000","chr3.141190000.141195000",115000,18,0.0002208138,141075000,141190000,141080000,141195000,"chr3",139237,0,0,3,3,"chr3",1,0.00632911392405063
"4346","chr3.62720000.62725000","chr3.63205000.63210000",485000,9,0.005730947,62720000,63205000,62725000,63210000,"chr3",139263,1,1,12,14,"chr3",1,0.0147679324894515
"4347","chr3.122255000.122260000","chr3.122510000.122515000",255000,12,0.002195056,122255000,122510000,122260000,122515000,"chr3",139266,1,13,8,22,"chr3",1,0.0309423347398031
"4348","chr3.20080000.20085000","chr3.20140000.20145000",60000,21,0.003322656,20080000,20140000,20085000,20145000,"chr3",139279,0,5,1,6,"chr3",1,0.0147679324894515
"4349","chr3.47540000.47545000","chr3.47825000.47830000",285000,15,1.053806e-05,47540000,47825000,47545000,47830000,"chr3",139280,1,7,4,12,"chr3",1,0.0210970464135021
"4350","chr3.122510000.122515000","chr3.122960000.122965000",450000,9,0.00790472,122510000,122960000,122515000,122965000,"chr3",139297,2,2,2,6,"chr3",1,0.00632911392405063
"4351","chr3.15670000.15675000","chr3.16265000.16270000",595000,10,0.0003909222,15670000,16265000,15675000,16270000,"chr3",139346,0,5,3,8,"chr3",1,0.00937646507266761
"4352","chr3.194400000.194405000","chr3.194835000.194840000",435000,9,0.009098522,194400000,194835000,194405000,194840000,"chr3",139355,1,2,2,5,"chr3",1,0.00527426160337553
"4353","chr3.195985000.195990000","chr3.196250000.196255000",265000,12,0.001725161,195985000,196250000,195990000,196255000,"chr3",139384,0,1,0,1,"chr3",1,0.00140646976090014
"4354","chr3.138415000.138420000","chr3.138605000.138610000",190000,14,0.001110777,138415000,138605000,138420000,138610000,"chr3",139387,4,1,6,11,"chr3",1,0.0180496952648851
"4355","chr3.71970000.71975000","chr3.72885000.72890000",915000,8,0.001012851,71970000,72885000,71975000,72890000,"chr3",139414,1,1,3,5,"chr3",1,0.0046882325363338
"4356","chr3.184135000.184140000","chr3.184240000.184245000",105000,17,0.001420507,184135000,184240000,184140000,184245000,"chr3",139524,1,1,2,4,"chr3",1,0.00796999531176746
"4357","chr3.15240000.15245000","chr3.15425000.15430000",185000,27,3.25095e-13,15240000,15425000,15245000,15430000,"chr3",139533,2,1,1,4,"chr3",1,0.0126582278481013
"4358","chr3.173120000.173125000","chr3.173265000.173270000",145000,16,0.000546274,173120000,173265000,173125000,173270000,"chr3",139653,0,3,2,5,"chr3",1,0.00937646507266761
"4359","chr3.129385000.129390000","chr3.129400000.129405000",15000,41,0.000324247,129385000,129400000,129390000,129405000,"chr3",139700,4,4,10,18,"chr3",1,0.0864978902953586
"4360","chr3.71925000.71930000","chr3.72890000.72895000",965000,12,9.239697e-08,71925000,72890000,71930000,72895000,"chr3",139717,2,0,1,3,"chr3",1,0.00421940928270042
"4361","chr3.50270000.50275000","chr3.50290000.50295000",20000,48,9.712232e-07,50270000,50290000,50275000,50295000,"chr3",139724,8,5,8,21,"chr3",1,0.118143459915612
"4362","chr3.4825000.4830000","chr3.4865000.4870000",40000,28,0.0005285764,4825000,4865000,4830000,4870000,"chr3",139735,0,3,2,5,"chr3",1,0.0164088138771683
"4363","chr3.9045000.9050000","chr3.9065000.9070000",20000,47,2.417215e-06,9045000,9065000,9050000,9070000,"chr3",139762,1,7,11,19,"chr3",1,0.104664791373652
"4364","chr3.150005000.150010000","chr3.150080000.150085000",75000,22,0.0001118066,150005000,150080000,150010000,150085000,"chr3",139774,0,2,0,2,"chr3",1,0.00515705578996718
"4365","chr3.45665000.45670000","chr3.45685000.45690000",20000,47,2.417215e-06,45665000,45685000,45670000,45690000,"chr3",139786,0,3,0,3,"chr3",1,0.0165260196905767
"4366","chr3.15240000.15245000","chr3.15600000.15605000",360000,19,5.226206e-10,15240000,15600000,15245000,15605000,"chr3",139811,0,0,1,1,"chr3",1,0.00222691045475856
"4367","chr3.63995000.64000000","chr3.64485000.64490000",490000,11,0.0002339782,63995000,64485000,6.4e+07,64490000,"chr3",139817,0,3,1,4,"chr3",1,0.00515705578996718
"4368","chr3.49445000.49450000","chr3.49465000.49470000",20000,52,2.057507e-08,49445000,49465000,49450000,49470000,"chr3",139877,13,32,28,73,"chr3",1,0.444913267698078
"4369","chr3.58295000.58300000","chr3.58495000.58500000",200000,13,0.002787948,58295000,58495000,58300000,58500000,"chr3",139984,3,3,8,14,"chr3",1,0.0213314580403188
"4370","chr3.183425000.183430000","chr3.183460000.183465000",35000,40,2.484659e-08,183425000,183460000,183430000,183465000,"chr3",140017,1,5,7,13,"chr3",1,0.0609470229723394
"4371","chr3.47910000.47915000","chr3.48030000.48035000",120000,21,2.640948e-06,47910000,48030000,47915000,48035000,"chr3",140022,1,3,3,7,"chr3",1,0.0172292545710267
"4372","chr3.183175000.183180000","chr3.183490000.183495000",315000,16,7.625814e-07,183175000,183490000,183180000,183495000,"chr3",140068,0,6,1,7,"chr3",1,0.0131270511017346
"4373","chr3.42090000.42095000","chr3.42115000.42120000",25000,52,6.922621e-10,42090000,42115000,42095000,42120000,"chr3",140098,2,6,5,13,"chr3",1,0.0792311298640413
"4374","chr3.156270000.156275000","chr3.156510000.156515000",240000,13,0.0008413164,156270000,156510000,156275000,156515000,"chr3",140180,0,0,1,1,"chr3",1,0.00152367557430849
"4375","chr3.196770000.196775000","chr3.196800000.196805000",30000,30,0.006277855,196770000,196800000,196775000,196805000,"chr3",140183,1,15,8,24,"chr3",1,0.0843881856540084
"4376","chr3.196565000.196570000","chr3.196665000.196670000",100000,16,0.005731548,196565000,196665000,196570000,196670000,"chr3",140187,5,15,9,29,"chr3",1,0.0543834974214721
"4377","chr3.149330000.149335000","chr3.149350000.149355000",20000,49,3.831916e-07,149330000,149350000,149335000,149355000,"chr3",140233,0,2,3,5,"chr3",1,0.0287154242850445
"4378","chr3.52105000.52110000","chr3.52140000.52145000",35000,27,0.006592248,52105000,52140000,52110000,52145000,"chr3",140245,2,4,2,8,"chr3",1,0.0253164556962025
"4379","chr3.149270000.149275000","chr3.149350000.149355000",80000,21,0.0001777811,149270000,149350000,149275000,149355000,"chr3",140251,2,2,4,8,"chr3",1,0.019690576652602
"4380","chr3.124700000.124705000","chr3.125165000.125170000",465000,11,0.0003236447,124700000,125165000,124705000,125170000,"chr3",140398,0,3,2,5,"chr3",1,0.00644631973745898
"4381","chr3.15220000.15225000","chr3.15425000.15430000",205000,16,3.833446e-05,15220000,15425000,15225000,15430000,"chr3",140423,3,7,5,15,"chr3",1,0.0281293952180028
"4382","chr3.72885000.72890000","chr3.73040000.73045000",155000,17,9.160749e-05,72885000,73040000,72890000,73045000,"chr3",140427,0,5,3,8,"chr3",1,0.0159399906235349
"4383","chr3.9065000.9070000","chr3.9095000.9100000",30000,32,0.001484935,9065000,9095000,9070000,9100000,"chr3",140489,1,9,11,21,"chr3",1,0.0787623066104079
"4384","chr3.40475000.40480000","chr3.40580000.40585000",105000,17,0.001420507,40475000,40580000,40480000,40585000,"chr3",140571,0,2,0,2,"chr3",1,0.00398499765588373
"4385","chr3.32150000.32155000","chr3.32610000.32615000",460000,9,0.007212873,32150000,32610000,32155000,32615000,"chr3",140584,1,11,6,18,"chr3",1,0.0189873417721519
"4386","chr3.47820000.47825000","chr3.48030000.48035000",210000,12,0.006827181,47820000,48030000,47825000,48035000,"chr3",140586,3,26,25,54,"chr3",1,0.0759493670886076
"4387","chr3.156290000.156295000","chr3.156790000.156795000",500000,11,0.0002058766,156290000,156790000,156295000,156795000,"chr3",140602,0,3,2,5,"chr3",1,0.00644631973745898
"4388","chr3.184130000.184135000","chr3.184240000.184245000",110000,15,0.008416159,184130000,184240000,184135000,184245000,"chr3",140653,3,1,2,6,"chr3",1,0.0105485232067511
"4389","chr3.141300000.141305000","chr3.141465000.141470000",165000,13,0.00828391,141300000,141465000,141305000,141470000,"chr3",140665,0,3,1,4,"chr3",1,0.00609470229723394
"4390","chr3.9065000.9070000","chr3.9105000.9110000",40000,42,5.900284e-11,9065000,9105000,9070000,9110000,"chr3",140668,1,0,0,1,"chr3",1,0.00492264416315049
"4391","chr3.48270000.48275000","chr3.48470000.48475000",200000,12,0.008858162,48270000,48470000,48275000,48475000,"chr3",140676,0,0,3,3,"chr3",1,0.00421940928270042
"4392","chr3.42830000.42835000","chr3.42870000.42875000",40000,28,0.0005285764,42830000,42870000,42835000,42875000,"chr3",140709,6,12,9,27,"chr3",1,0.0886075949367089
"4393","chr3.52240000.52245000","chr3.52315000.52320000",75000,22,0.0001118066,52240000,52315000,52245000,52320000,"chr3",140750,0,1,0,1,"chr3",1,0.00257852789498359
"4394","chr3.48740000.48745000","chr3.48870000.48875000",130000,17,0.0003177655,48740000,48870000,48745000,48875000,"chr3",140768,10,35,43,88,"chr3",1,0.175339896858884
"4395","chr3.42050000.42055000","chr3.42080000.42085000",30000,45,5.54415e-09,42050000,42080000,42055000,42085000,"chr3",140815,1,7,8,16,"chr3",1,0.0843881856540084
"4396","chr3.42030000.42035000","chr3.42135000.42140000",105000,23,5.905186e-07,42030000,42135000,42035000,42140000,"chr3",140835,10,8,9,27,"chr3",1,0.0727848101265823
"4397","chr3.11450000.11455000","chr3.11665000.11670000",215000,18,9.853478e-07,11450000,11665000,11455000,11670000,"chr3",140851,1,5,6,12,"chr3",1,0.0253164556962025
"4398","chr3.4740000.4745000","chr3.5015000.5020000",275000,12,0.001383502,4740000,5015000,4745000,5020000,"chr3",140868,3,11,6,20,"chr3",1,0.0281293952180028
"4399","chr3.58305000.58310000","chr3.58395000.58400000",90000,29,4.997828e-10,58305000,58395000,58310000,58400000,"chr3",140872,0,3,2,5,"chr3",1,0.01699484294421
"4400","chr3.191855000.191860000","chr3.192130000.192135000",275000,11,0.005188069,191855000,192130000,191860000,192135000,"chr3",140898,0,0,3,3,"chr3",1,0.00386779184247539
"4401","chr3.50000000.50005000","chr3.50100000.50105000",100000,17,0.002026797,5e+07,50100000,50005000,50105000,"chr3",140908,2,3,2,7,"chr3",1,0.0139474917955931
"4402","chr3.42115000.42120000","chr3.42135000.42140000",20000,49,3.831916e-07,42115000,42135000,42120000,42140000,"chr3",140981,2,6,5,13,"chr3",1,0.0746601031411158
"4403","chr3.150925000.150930000","chr3.151540000.151545000",615000,8,0.008203125,150925000,151540000,150930000,151545000,"chr3",141017,0,0,2,2,"chr3",1,0.00187529301453352
"4404","chr3.42050000.42055000","chr3.42135000.42140000",85000,44,1.422164e-21,42050000,42135000,42055000,42140000,"chr3",141084,1,7,8,16,"chr3",1,0.0825128926394749
"4405","chr3.15855000.15860000","chr3.16265000.16270000",410000,15,5.662223e-07,15855000,16265000,15860000,16270000,"chr3",141109,0,3,1,4,"chr3",1,0.0070323488045007
"4406","chr3.37030000.37035000","chr3.37225000.37230000",195000,22,2.636515e-09,37030000,37225000,37035000,37230000,"chr3",141118,3,7,6,16,"chr3",1,0.0412564463197375
"4407","chr3.42050000.42055000","chr3.42230000.42235000",180000,15,0.0004424239,42050000,42230000,42055000,42235000,"chr3",141147,1,7,5,13,"chr3",1,0.0228551336146273
"4408","chr3.72010000.72015000","chr3.72885000.72890000",875000,7,0.007651276,72010000,72885000,72015000,72890000,"chr3",141183,1,5,3,9,"chr3",1,0.00738396624472574
"4409","chr3.72890000.72895000","chr3.72935000.72940000",45000,23,0.008858162,72890000,72935000,72895000,72940000,"chr3",141230,3,8,8,19,"chr3",1,0.0512189404594468
"4410","chr3.52035000.52040000","chr3.52135000.52140000",100000,16,0.005731548,52035000,52135000,52040000,52140000,"chr3",141231,2,1,3,6,"chr3",1,0.0112517580872011
"4411","chr3.71970000.71975000","chr3.72905000.72910000",935000,7,0.005223737,71970000,72905000,71975000,72910000,"chr3",141254,3,1,3,7,"chr3",1,0.00574308485700891
"4412","chr3.20100000.20105000","chr3.20225000.20230000",125000,15,0.004113739,20100000,20225000,20105000,20230000,"chr3",141273,2,4,8,14,"chr3",1,0.0246132208157525
"4413","chr3.185655000.185660000","chr3.186275000.186280000",620000,10,0.0003037761,185655000,186275000,185660000,186280000,"chr3",141330,1,2,2,5,"chr3",1,0.00586029067041725
"4414","chr3.8485000.8490000","chr3.8520000.8525000",35000,27,0.006592248,8485000,8520000,8490000,8525000,"chr3",141343,0,1,2,3,"chr3",1,0.00949367088607595
"4415","chr3.72905000.72910000","chr3.72950000.72955000",45000,23,0.008858162,72905000,72950000,72910000,72955000,"chr3",141346,4,5,3,12,"chr3",1,0.0323488045007032
"4416","chr3.196975000.196980000","chr3.197225000.197230000",250000,13,0.0006444882,196975000,197225000,196980000,197230000,"chr3",141419,2,3,13,18,"chr3",1,0.0274261603375527
"4417","chr3.185655000.185660000","chr3.185935000.185940000",280000,12,0.001256406,185655000,185935000,185660000,185940000,"chr3",141489,1,5,6,12,"chr3",1,0.0168776371308017
"4418","chr3.66470000.66475000","chr3.66500000.66505000",30000,37,2.267092e-05,66470000,66500000,66475000,66505000,"chr3",141499,0,2,1,3,"chr3",1,0.0130098452883263
"4419","chr3.72965000.72970000","chr3.73115000.73120000",150000,17,0.0001170734,72965000,73115000,72970000,73120000,"chr3",141526,10,23,20,53,"chr3",1,0.105602437880919
"4420","chr3.9245000.9250000","chr3.9280000.9285000",35000,42,2.240731e-09,9245000,9280000,9250000,9285000,"chr3",141562,0,3,2,5,"chr3",1,0.0246132208157525
"4421","chr3.156500000.156505000","chr3.156790000.156795000",290000,13,0.0002304037,156500000,156790000,156505000,156795000,"chr3",141592,0,2,0,2,"chr3",1,0.00304735114861697
"4422","chr3.194405000.194410000","chr3.194835000.194840000",430000,13,1.677428e-05,194405000,194835000,194410000,194840000,"chr3",141597,2,1,3,6,"chr3",1,0.00914205344585091
"4423","chr3.129380000.129385000","chr3.129485000.129490000",105000,17,0.001420507,129380000,129485000,129385000,129490000,"chr3",141675,0,0,3,3,"chr3",1,0.0059774964838256
"4424","chr3.69270000.69275000","chr3.69330000.69335000",60000,25,6.156629e-05,69270000,69330000,69275000,69335000,"chr3",141695,2,11,6,19,"chr3",1,0.0556727613689639
"4425","chr3.171555000.171560000","chr3.172040000.172045000",485000,10,0.001286347,171555000,172040000,171560000,172045000,"chr3",141764,0,6,1,7,"chr3",1,0.00820440693858415
"4426","chr3.48960000.48965000","chr3.49005000.49010000",45000,25,0.00175765,48960000,49005000,48965000,49010000,"chr3",141771,2,3,2,7,"chr3",1,0.0205110173464604
"4427","chr3.61920000.61925000","chr3.62110000.62115000",190000,14,0.001110777,61920000,62110000,61925000,62115000,"chr3",141784,4,7,6,17,"chr3",1,0.0278949835911861
"4428","chr3.182505000.182510000","chr3.183175000.183180000",670000,8,0.005586801,182505000,183175000,182510000,183180000,"chr3",141793,0,6,1,7,"chr3",1,0.00656352555086732
"4429","chr3.184280000.184285000","chr3.184445000.184450000",165000,22,2.124458e-08,184280000,184445000,184285000,184450000,"chr3",141821,1,12,19,32,"chr3",1,0.0825128926394749
"4430","chr3.10980000.10985000","chr3.11060000.11065000",80000,23,1.618736e-05,10980000,11060000,10985000,11065000,"chr3",141847,1,1,2,4,"chr3",1,0.0107829348335677
"4431","chr3.58320000.58325000","chr3.58395000.58400000",75000,20,0.0009906659,58320000,58395000,58325000,58400000,"chr3",141849,0,3,2,5,"chr3",1,0.0117205813408345
"4432","chr3.99815000.99820000","chr3.99970000.99975000",155000,14,0.003881213,99815000,99970000,99820000,99975000,"chr3",141931,0,3,1,4,"chr3",1,0.00656352555086732
"4433","chr3.4395000.4400000","chr3.4670000.4675000",275000,28,2.564588e-17,4395000,4670000,4400000,4675000,"chr3",141947,0,2,2,4,"chr3",1,0.0131270511017346
"4434","chr3.23860000.23865000","chr3.23945000.23950000",85000,23,7.727121e-06,23860000,23945000,23865000,23950000,"chr3",141975,0,3,0,3,"chr3",1,0.00808720112517581
"4435","chr3.15890000.15895000","chr3.16245000.16250000",355000,12,0.0003107272,15890000,16245000,15895000,16250000,"chr3",142003,0,1,1,2,"chr3",1,0.00281293952180028
"4436","chr3.57995000.58000000","chr3.58025000.58030000",30000,32,0.001484935,57995000,58025000,5.8e+07,58030000,"chr3",142025,6,21,26,53,"chr3",1,0.198781059540553
"4437","chr3.13365000.13370000","chr3.13490000.13495000",125000,16,0.001353974,13365000,13490000,13370000,13495000,"chr3",142032,0,5,6,11,"chr3",1,0.0206282231598687
"4438","chr3.9695000.9700000","chr3.9835000.9840000",140000,17,0.0001918557,9695000,9835000,9700000,9840000,"chr3",142070,0,8,4,12,"chr3",1,0.0239099859353024
"4439","chr3.171120000.171125000","chr3.171145000.171150000",25000,41,3.6592e-05,171120000,171145000,171125000,171150000,"chr3",142075,0,0,3,3,"chr3",1,0.0144163150492264
"4440","chr3.49785000.49790000","chr3.50100000.50105000",315000,10,0.00947524,49785000,50100000,49790000,50105000,"chr3",142086,2,3,2,7,"chr3",1,0.00820440693858415
"4441","chr3.69285000.69290000","chr3.69305000.69310000",20000,49,3.831916e-07,69285000,69305000,69290000,69310000,"chr3",142143,0,7,2,9,"chr3",1,0.0516877637130802
"4442","chr3.138325000.138330000","chr3.138415000.138420000",90000,21,5.197146e-05,138325000,138415000,138330000,138420000,"chr3",142144,0,1,2,3,"chr3",1,0.00738396624472574
"4443","chr3.9045000.9050000","chr3.9360000.9365000",315000,13,0.0001336423,9045000,9360000,9050000,9365000,"chr3",142165,5,7,11,23,"chr3",1,0.0350445382090952
"4444","chr3.58320000.58325000","chr3.58385000.58390000",65000,19,0.00893155,58320000,58385000,58325000,58390000,"chr3",142170,4,5,7,16,"chr3",1,0.0356305672761369
"4445","chr3.40410000.40415000","chr3.40430000.40435000",20000,38,0.002618443,40410000,40430000,40415000,40435000,"chr3",142337,0,4,4,8,"chr3",1,0.0356305672761369
"4446","chr3.99815000.99820000","chr3.99925000.99930000",110000,16,0.003064209,99815000,99925000,99820000,99930000,"chr3",142362,1,2,1,4,"chr3",1,0.00750117205813408
"4447","chr3.42070000.42075000","chr3.42095000.42100000",25000,34,0.006479597,42070000,42095000,42075000,42100000,"chr3",142396,0,2,2,4,"chr3",1,0.0159399906235349
"4448","chr3.183430000.183435000","chr3.183490000.183495000",60000,30,1.40412e-07,183430000,183490000,183435000,183495000,"chr3",142401,0,6,1,7,"chr3",1,0.0246132208157525
"4449","chr3.170100000.170105000","chr3.170550000.170555000",450000,9,0.00790472,170100000,170550000,170105000,170555000,"chr3",142481,0,2,2,4,"chr3",1,0.00421940928270042
"4450","chr3.4825000.4830000","chr3.5070000.5075000",245000,17,1.406173e-06,4825000,5070000,4830000,5075000,"chr3",142491,0,3,2,5,"chr3",1,0.00996249413970933
"4451","chr3.47570000.47575000","chr3.47820000.47825000",250000,19,3.106046e-08,47570000,47820000,47575000,47825000,"chr3",142518,3,25,17,45,"chr3",1,0.100210970464135
"4452","chr3.53375000.53380000","chr3.53530000.53535000",155000,14,0.003881213,53375000,53530000,53380000,53535000,"chr3",142522,1,1,0,2,"chr3",1,0.00328176277543366
"4453","chr3.72010000.72015000","chr3.72235000.72240000",225000,12,0.004617662,72010000,72235000,72015000,72240000,"chr3",142555,0,2,1,3,"chr3",1,0.00421940928270042
"4454","chr3.47825000.47830000","chr3.48030000.48035000",205000,16,3.833446e-05,47825000,48030000,47830000,48035000,"chr3",142666,4,7,15,26,"chr3",1,0.0487576183778715
"4455","chr3.42650000.42655000","chr3.42720000.42725000",70000,23,7.897084e-05,42650000,42720000,42655000,42725000,"chr3",142677,0,0,4,4,"chr3",1,0.0107829348335677
"4456","chr3.9105000.9110000","chr3.9345000.9350000",240000,14,0.0002045485,9105000,9345000,9110000,9350000,"chr3",142758,2,0,0,2,"chr3",1,0.00328176277543366
"4457","chr3.155075000.155080000","chr3.155570000.155575000",495000,9,0.005183894,155075000,155570000,155080000,155575000,"chr3",142798,4,11,6,21,"chr3",1,0.0221518987341772
"4458","chr3.151165000.151170000","chr3.151565000.151570000",400000,11,0.0007563689,151165000,151565000,151170000,151570000,"chr3",142869,0,3,2,5,"chr3",1,0.00644631973745898
"4459","chr3.42080000.42085000","chr3.42120000.42125000",40000,41,2.271736e-10,42080000,42120000,42085000,42125000,"chr3",142929,1,11,16,28,"chr3",1,0.13455227379278
"4460","chr3.47660000.47665000","chr3.47680000.47685000",20000,44,3.154249e-05,47660000,47680000,47665000,47685000,"chr3",142933,5,11,22,38,"chr3",1,0.195968120018753
"4461","chr3.42090000.42095000","chr3.42120000.42125000",30000,56,4.163597e-15,42090000,42120000,42095000,42125000,"chr3",142963,1,11,5,17,"chr3",1,0.111579934364744
"4462","chr3.56370000.56375000","chr3.56480000.56485000",110000,16,0.003064209,56370000,56480000,56375000,56485000,"chr3",142993,1,4,3,8,"chr3",1,0.0150023441162682
"4463","chr3.149580000.149585000","chr3.149895000.149900000",315000,16,7.625814e-07,149580000,149895000,149585000,149900000,"chr3",143000,2,7,11,20,"chr3",1,0.0375058602906704
"4464","chr3.196600000.196605000","chr3.196635000.196640000",35000,30,0.000645626,196600000,196635000,196605000,196640000,"chr3",143081,1,8,8,17,"chr3",1,0.059774964838256
"4465","chr3.52040000.52045000","chr3.52140000.52145000",100000,19,0.0002105433,52040000,52140000,52045000,52145000,"chr3",143133,0,4,2,6,"chr3",1,0.0133614627285513
"4466","chr3.47610000.47615000","chr3.47820000.47825000",210000,20,3.979915e-08,47610000,47820000,47615000,47825000,"chr3",143138,0,1,3,4,"chr3",1,0.00937646507266761
"4467","chr3.47580000.47585000","chr3.47800000.47805000",220000,13,0.001492164,47580000,47800000,47585000,47805000,"chr3",143170,2,10,4,16,"chr3",1,0.0243788091889358
"4468","chr3.48030000.48035000","chr3.48130000.48135000",100000,21,1.668433e-05,48030000,48130000,48035000,48135000,"chr3",143183,8,34,19,61,"chr3",1,0.15014064697609
"4469","chr3.107430000.107435000","chr3.107450000.107455000",20000,36,0.008858162,107430000,107450000,107435000,107455000,"chr3",143187,1,3,4,8,"chr3",1,0.0337552742616034
"4470","chr3.195130000.195135000","chr3.195235000.195240000",105000,16,0.004113739,195130000,195235000,195135000,195240000,"chr3",143198,2,3,7,12,"chr3",1,0.0225035161744023
"4471","chr3.107660000.107665000","chr3.108220000.108225000",560000,12,1.515401e-05,107660000,108220000,107665000,108225000,"chr3",143260,0,0,6,6,"chr3",1,0.00843881856540084
"4472","chr3.156400000.156405000","chr3.156790000.156795000",390000,34,3.5495e-27,156400000,156790000,156405000,156795000,"chr3",143266,0,2,0,2,"chr3",1,0.00796999531176746
"4473","chr3.129380000.129385000","chr3.129440000.129445000",60000,22,0.001336201,129380000,129440000,129385000,129445000,"chr3",143293,0,4,4,8,"chr3",1,0.0206282231598687
"4474","chr3.15310000.15315000","chr3.15600000.15605000",290000,11,0.003933946,15310000,15600000,15315000,15605000,"chr3",143295,0,0,3,3,"chr3",1,0.00386779184247539
"4475","chr3.183180000.183185000","chr3.183490000.183495000",310000,13,0.0001485064,183180000,183490000,183185000,183495000,"chr3",143305,0,4,1,5,"chr3",1,0.00761837787154243
"4476","chr3.183285000.183290000","chr3.183445000.183450000",160000,13,0.009664013,183285000,183445000,183290000,183450000,"chr3",143416,0,7,3,10,"chr3",1,0.0152367557430849
"4477","chr3.129340000.129345000","chr3.129650000.129655000",310000,16,8.824373e-07,129340000,129650000,129345000,129655000,"chr3",143468,0,0,6,6,"chr3",1,0.0112517580872011
"4478","chr3.194400000.194405000","chr3.194985000.194990000",585000,22,5.122714e-16,194400000,194985000,194405000,194990000,"chr3",143482,1,2,2,5,"chr3",1,0.012892639474918
"4479","chr3.51975000.51980000","chr3.52030000.52035000",55000,22,0.003264775,51975000,52030000,51980000,52035000,"chr3",143511,0,6,8,14,"chr3",1,0.0360993905297703
"4480","chr3.197540000.197545000","chr3.197600000.197605000",60000,25,6.156629e-05,197540000,197600000,197545000,197605000,"chr3",143552,0,10,3,13,"chr3",1,0.0380918893577121
"4481","chr3.57225000.57230000","chr3.57960000.57965000",735000,8,0.003548449,57225000,57960000,57230000,57965000,"chr3",143574,3,12,12,27,"chr3",1,0.0253164556962025
"4482","chr3.47800000.47805000","chr3.48270000.48275000",470000,9,0.006587037,47800000,48270000,47805000,48275000,"chr3",143669,0,0,3,3,"chr3",1,0.00316455696202532
"4483","chr3.177220000.177225000","chr3.177815000.177820000",595000,8,0.009475458,177220000,177815000,177225000,177820000,"chr3",143674,0,2,1,3,"chr3",1,0.00281293952180028
"4484","chr3.53345000.53350000","chr3.53900000.53905000",555000,13,2.256562e-06,53345000,53900000,53350000,53905000,"chr3",143712,0,0,2,2,"chr3",1,0.00304735114861697
"4485","chr3.124970000.124975000","chr3.125085000.125090000",115000,16,0.002289584,124970000,125085000,124975000,125090000,"chr3",143766,2,5,1,8,"chr3",1,0.0150023441162682
"4486","chr3.129460000.129465000","chr3.129480000.129485000",20000,54,2.609419e-09,129460000,129480000,129465000,129485000,"chr3",143798,3,8,2,13,"chr3",1,0.0822784810126582
"4487","chr3.185685000.185690000","chr3.185935000.185940000",250000,22,8.583874e-11,185685000,185935000,185690000,185940000,"chr3",143806,1,5,9,15,"chr3",1,0.0386779184247539
"4488","chr3.49780000.49785000","chr3.49940000.49945000",160000,13,0.009664013,49780000,49940000,49785000,49945000,"chr3",143808,10,15,22,47,"chr3",1,0.0716127519924988
"4489","chr3.42720000.42725000","chr3.42775000.42780000",55000,25,0.0001901332,42720000,42775000,42725000,42780000,"chr3",143829,0,0,6,6,"chr3",1,0.0175808720112518
"4490","chr3.156400000.156405000","chr3.156465000.156470000",65000,23,0.0001912085,156400000,156465000,156405000,156470000,"chr3",143848,0,2,0,2,"chr3",1,0.00539146741678387
"4491","chr3.149490000.149495000","chr3.149525000.149530000",35000,39,7.877601e-08,149490000,149525000,149495000,149530000,"chr3",143893,1,1,1,3,"chr3",1,0.0137130801687764
"4492","chr3.185730000.185735000","chr3.186275000.186280000",545000,11,0.0001170734,185730000,186275000,185735000,186280000,"chr3",143964,1,2,2,5,"chr3",1,0.00644631973745898
"4493","chr3.11460000.11465000","chr3.11665000.11670000",205000,21,8.796434e-09,11460000,11665000,11465000,11670000,"chr3",143966,2,2,6,10,"chr3",1,0.0246132208157525
"4494","chr3.47440000.47445000","chr3.47820000.47825000",380000,11,0.001001395,47440000,47820000,47445000,47825000,"chr3",144023,3,25,26,54,"chr3",1,0.069620253164557
"4495","chr3.23810000.23815000","chr3.23940000.23945000",130000,14,0.009475458,23810000,23940000,23815000,23945000,"chr3",144053,5,14,9,28,"chr3",1,0.0459446788560713
"4496","chr3.197490000.197495000","chr3.197510000.197515000",20000,40,0.0006722116,197490000,197510000,197495000,197515000,"chr3",144067,1,6,2,9,"chr3",1,0.0421940928270042
"4497","chr3.71925000.71930000","chr3.72885000.72890000",960000,7,0.004403606,71925000,72885000,71930000,72890000,"chr3",144079,1,0,1,2,"chr3",1,0.00164088138771683
"4498","chr3.62090000.62095000","chr3.62110000.62115000",20000,39,0.001340184,62090000,62110000,62095000,62115000,"chr3",144100,0,1,2,3,"chr3",1,0.0137130801687764
"4499","chr3.170485000.170490000","chr3.170520000.170525000",35000,27,0.006592248,170485000,170520000,170490000,170525000,"chr3",144117,0,1,0,1,"chr3",1,0.00316455696202532
"4500","chr3.4865000.4870000","chr3.5015000.5020000",150000,22,6.192071e-08,4865000,5015000,4870000,5020000,"chr3",144166,2,3,2,7,"chr3",1,0.0180496952648851
"4501","chr3.183285000.183290000","chr3.183430000.183435000",145000,14,0.005586801,183285000,183430000,183290000,183435000,"chr3",144181,0,7,3,10,"chr3",1,0.0164088138771683
"4502","chr3.182900000.182905000","chr3.183175000.183180000",275000,12,0.001383502,182900000,183175000,182905000,183180000,"chr3",144196,4,11,16,31,"chr3",1,0.0436005625879044
"4503","chr3.15305000.15310000","chr3.15405000.15410000",100000,18,0.0006749162,15305000,15405000,15310000,15410000,"chr3",144222,3,11,4,18,"chr3",1,0.0379746835443038
"4504","chr3.72935000.72940000","chr3.72995000.73000000",60000,20,0.00785248,72935000,72995000,72940000,7.3e+07,"chr3",144259,4,3,5,12,"chr3",1,0.0281293952180028
"4505","chr3.123375000.123380000","chr3.123430000.123435000",55000,27,2.255487e-05,123375000,123430000,123380000,123435000,"chr3",144266,3,3,2,8,"chr3",1,0.0253164556962025
"4506","chr3.47570000.47575000","chr3.47835000.47840000",265000,23,4.440653e-12,47570000,47835000,47575000,47840000,"chr3",144295,8,25,17,50,"chr3",1,0.134786685419597
"4507","chr3.10115000.10120000","chr3.10140000.10145000",25000,45,9.853478e-07,10115000,10140000,10120000,10145000,"chr3",144300,8,21,21,50,"chr3",1,0.263713080168776
"4508","chr3.9445000.9450000","chr3.9810000.9815000",365000,10,0.005036593,9445000,9810000,9450000,9815000,"chr3",144301,0,9,4,13,"chr3",1,0.0152367557430849
"4509","chr3.15240000.15245000","chr3.15310000.15315000",70000,29,3.504729e-08,15240000,15310000,15245000,15315000,"chr3",144321,2,1,1,4,"chr3",1,0.013595874355368
"4510","chr3.56765000.56770000","chr3.57015000.57020000",250000,12,0.002492257,56765000,57015000,56770000,57020000,"chr3",144362,1,10,9,20,"chr3",1,0.0281293952180028
"4511","chr3.43870000.43875000","chr3.44235000.44240000",365000,12,0.0002655857,43870000,44235000,43875000,44240000,"chr3",144469,1,2,4,7,"chr3",1,0.00984528832630099
"4512","chr3.56775000.56780000","chr3.56985000.56990000",210000,12,0.006827181,56775000,56985000,56780000,56990000,"chr3",144496,2,7,4,13,"chr3",1,0.0182841068917018
"4513","chr3.52035000.52040000","chr3.52195000.52200000",160000,13,0.009664013,52035000,52195000,52040000,52200000,"chr3",144499,1,1,2,4,"chr3",1,0.00609470229723394
"4514","chr3.13135000.13140000","chr3.13490000.13495000",355000,35,1.498116e-27,13135000,13490000,13140000,13495000,"chr3",144506,0,4,6,10,"chr3",1,0.0410220346929208
"4515","chr3.33165000.33170000","chr3.33410000.33415000",245000,16,7.644431e-06,33165000,33410000,33170000,33415000,"chr3",144536,4,9,10,23,"chr3",1,0.043131739334271
"4516","chr3.195985000.195990000","chr3.196440000.196445000",455000,9,0.007608453,195985000,196440000,195990000,196445000,"chr3",144574,0,1,0,1,"chr3",1,0.00105485232067511
"4517","chr3.129440000.129445000","chr3.129485000.129490000",45000,37,3.146109e-09,129440000,129485000,129445000,129490000,"chr3",144583,0,0,3,3,"chr3",1,0.0130098452883263
"4518","chr3.14245000.14250000","chr3.14430000.14435000",185000,13,0.004420432,14245000,14430000,14250000,14435000,"chr3",144618,0,1,0,1,"chr3",1,0.00152367557430849
"4519","chr3.184770000.184775000","chr3.184935000.184940000",165000,13,0.00828391,184770000,184935000,184775000,184940000,"chr3",144623,3,3,9,15,"chr3",1,0.0228551336146273
"4520","chr3.73055000.73060000","chr3.73085000.73090000",30000,33,0.0006853895,73055000,73085000,73060000,73090000,"chr3",144624,1,5,5,11,"chr3",1,0.0425457102672293
"4521","chr3.106965000.106970000","chr3.107150000.107155000",185000,20,1.735132e-07,106965000,107150000,106970000,107155000,"chr3",144676,1,1,2,4,"chr3",1,0.00937646507266761
"4522","chr3.17470000.17475000","chr3.17670000.17675000",200000,13,0.002787948,17470000,17670000,17475000,17675000,"chr3",144789,2,3,1,6,"chr3",1,0.00914205344585091
"4523","chr3.184295000.184300000","chr3.184440000.184445000",145000,15,0.001788894,184295000,184440000,184300000,184445000,"chr3",144790,4,20,15,39,"chr3",1,0.0685654008438819
"4524","chr3.185645000.185650000","chr3.186500000.186505000",855000,7,0.008540868,185645000,186500000,185650000,186505000,"chr3",144849,0,3,1,4,"chr3",1,0.00328176277543366
"4525","chr3.72995000.73000000","chr3.73100000.73105000",105000,23,5.905186e-07,72995000,73100000,7.3e+07,73105000,"chr3",144863,0,3,5,8,"chr3",1,0.0215658696671355
"4526","chr3.58205000.58210000","chr3.58265000.58270000",60000,20,0.00785248,58205000,58265000,58210000,58270000,"chr3",144872,3,10,3,16,"chr3",1,0.0375058602906704
"4527","chr3.42680000.42685000","chr3.42720000.42725000",40000,25,0.006186759,42680000,42720000,42685000,42725000,"chr3",144884,0,0,5,5,"chr3",1,0.0146507266760431
"4528","chr3.107240000.107245000","chr3.107385000.107390000",145000,18,3.858472e-05,107240000,107385000,107245000,107390000,"chr3",144916,0,1,2,3,"chr3",1,0.00632911392405063
"4529","chr3.24045000.24050000","chr3.24210000.24215000",165000,14,0.002729852,24045000,24210000,24050000,24215000,"chr3",144932,5,9,16,30,"chr3",1,0.0492264416315049
"4530","chr3.20080000.20085000","chr3.20225000.20230000",145000,23,1.705282e-08,20080000,20225000,20085000,20230000,"chr3",144971,0,4,1,5,"chr3",1,0.0134786685419597
"4531","chr3.129400000.129405000","chr3.129440000.129445000",40000,44,3.651765e-12,129400000,129440000,129405000,129445000,"chr3",144985,0,4,4,8,"chr3",1,0.0412564463197375
"4532","chr3.185935000.185940000","chr3.186275000.186280000",340000,14,1.496556e-05,185935000,186275000,185940000,186280000,"chr3",145012,1,2,2,5,"chr3",1,0.00820440693858415
"4533","chr3.194585000.194590000","chr3.194635000.194640000",50000,23,0.003458127,194585000,194635000,194590000,194640000,"chr3",145084,1,6,4,11,"chr3",1,0.0296530707923113
"4534","chr3.52030000.52035000","chr3.52135000.52140000",105000,17,0.001420507,52030000,52135000,52035000,52140000,"chr3",145122,2,6,13,21,"chr3",1,0.0418424753867792
"4535","chr3.9140000.9145000","chr3.9280000.9285000",140000,16,0.0006749162,9140000,9280000,9145000,9285000,"chr3",145139,1,1,6,8,"chr3",1,0.0150023441162682
"4536","chr3.129440000.129445000","chr3.129535000.129540000",95000,30,3.636112e-11,129440000,129535000,129445000,129540000,"chr3",145151,0,4,4,8,"chr3",1,0.0281293952180028
"4537","chr3.124885000.124890000","chr3.125140000.125145000",255000,11,0.007772406,124885000,125140000,124890000,125145000,"chr3",145245,2,1,1,4,"chr3",1,0.00515705578996718
"4538","chr3.48745000.48750000","chr3.48995000.49000000",250000,13,0.0006444882,48745000,48995000,48750000,4.9e+07,"chr3",145259,2,11,14,27,"chr3",1,0.0411392405063291
"4539","chr3.23240000.23245000","chr3.23970000.23975000",730000,14,1.912416e-08,23240000,23970000,23245000,23975000,"chr3",145335,1,4,1,6,"chr3",1,0.00984528832630099
"4540","chr3.11450000.11455000","chr3.11695000.11700000",245000,13,0.0007286439,11450000,11695000,11455000,11700000,"chr3",145358,1,8,6,15,"chr3",1,0.0228551336146273
"4541","chr3.72950000.72955000","chr3.73115000.73120000",165000,18,1.326087e-05,72950000,73115000,72955000,73120000,"chr3",145425,10,23,20,53,"chr3",1,0.111814345991561
"4542","chr3.45085000.45090000","chr3.45445000.45450000",360000,12,0.0002875254,45085000,45445000,45090000,45450000,"chr3",145488,0,4,3,7,"chr3",1,0.00984528832630099
"4543","chr3.48970000.48975000","chr3.48990000.48995000",20000,41,0.000324247,48970000,48990000,48975000,48995000,"chr3",145534,1,15,7,23,"chr3",1,0.110525082044069
"4544","chr3.69370000.69375000","chr3.69430000.69435000",60000,43,2.775421e-16,69370000,69430000,69375000,69435000,"chr3",145554,0,3,1,4,"chr3",1,0.0201593999062353
"4545","chr3.187780000.187785000","chr3.188325000.188330000",545000,9,0.003257236,187780000,188325000,187785000,188330000,"chr3",145582,0,2,1,3,"chr3",1,0.00316455696202532
"4546","chr3.182900000.182905000","chr3.183115000.183120000",215000,13,0.001733304,182900000,183115000,182905000,183120000,"chr3",145649,4,18,16,38,"chr3",1,0.0578996718237225
"4547","chr3.13355000.13360000","chr3.13495000.13500000",140000,15,0.002219268,13355000,13495000,13360000,13500000,"chr3",145684,0,1,3,4,"chr3",1,0.0070323488045007
"4548","chr3.42080000.42085000","chr3.42115000.42120000",35000,27,0.006592248,42080000,42115000,42085000,42120000,"chr3",145702,2,6,5,13,"chr3",1,0.0411392405063291
"4549","chr3.9045000.9050000","chr3.9130000.9135000",85000,20,0.0003037761,9045000,9130000,9050000,9135000,"chr3",145768,0,6,6,12,"chr3",1,0.0281293952180028
"4550","chr3.52140000.52145000","chr3.52195000.52200000",55000,21,0.007608433,52140000,52195000,52145000,52200000,"chr3",145770,1,4,2,7,"chr3",1,0.0172292545710267
"4551","chr3.149485000.149490000","chr3.149530000.149535000",45000,23,0.008858162,149485000,149530000,149490000,149535000,"chr3",145882,2,6,7,15,"chr3",1,0.040436005625879
"4552","chr3.129400000.129405000","chr3.129550000.129555000",150000,17,0.0001170734,129400000,129550000,129405000,129555000,"chr3",145889,3,9,15,27,"chr3",1,0.0537974683544304
"4553","chr3.148900000.148905000","chr3.148955000.148960000",55000,21,0.007608433,148900000,148955000,148905000,148960000,"chr3",145898,0,2,1,3,"chr3",1,0.00738396624472574
"4554","chr3.45660000.45665000","chr3.46410000.46415000",750000,8,0.003233734,45660000,46410000,45665000,46415000,"chr3",145932,1,4,5,10,"chr3",1,0.00937646507266761
"4555","chr3.32565000.32570000","chr3.32590000.32595000",25000,39,0.0001869498,32565000,32590000,32570000,32595000,"chr3",145934,3,11,10,24,"chr3",1,0.109704641350211
"4556","chr3.24045000.24050000","chr3.24680000.24685000",635000,8,0.007090384,24045000,24680000,24050000,24685000,"chr3",145935,1,1,1,3,"chr3",1,0.00281293952180028
"4557","chr3.185395000.185400000","chr3.185470000.185475000",75000,19,0.002712535,185395000,185470000,185400000,185475000,"chr3",145981,1,10,6,17,"chr3",1,0.0378574777308955
"4558","chr3.170705000.170710000","chr3.171260000.171265000",555000,9,0.003000404,170705000,171260000,170710000,171265000,"chr3",146029,1,3,6,10,"chr3",1,0.0105485232067511
"4559","chr3.107150000.107155000","chr3.107245000.107250000",95000,17,0.003021882,107150000,107245000,107155000,107250000,"chr3",146066,1,1,2,4,"chr3",1,0.00796999531176746
"4560","chr3.183390000.183395000","chr3.183830000.183835000",440000,9,0.008767949,183390000,183830000,183395000,183835000,"chr3",146079,1,3,6,10,"chr3",1,0.0105485232067511
"4561","chr3.156540000.156545000","chr3.156790000.156795000",250000,20,4.667322e-09,156540000,156790000,156545000,156795000,"chr3",146082,1,4,4,9,"chr3",1,0.0210970464135021
"4562","chr3.56735000.56740000","chr3.57005000.57010000",270000,16,3.078126e-06,56735000,57005000,56740000,57010000,"chr3",146096,0,1,1,2,"chr3",1,0.00375058602906704
"4563","chr3.53335000.53340000","chr3.53375000.53380000",40000,41,2.271736e-10,53335000,53375000,53340000,53380000,"chr3",146141,6,9,19,34,"chr3",1,0.163384903891233
"4564","chr3.156400000.156405000","chr3.156785000.156790000",385000,19,2.532439e-10,156400000,156785000,156405000,156790000,"chr3",146158,0,2,0,2,"chr3",1,0.00445382090951711
"4565","chr3.56860000.56865000","chr3.56985000.56990000",125000,15,0.004113739,56860000,56985000,56865000,56990000,"chr3",146186,2,7,4,13,"chr3",1,0.0228551336146273
"4566","chr3.42070000.42075000","chr3.42090000.42095000",20000,51,5.515639e-08,42070000,42090000,42075000,42095000,"chr3",146295,3,7,4,14,"chr3",1,0.0836849507735584
"4567","chr3.183230000.183235000","chr3.183300000.183305000",70000,37,1.257856e-13,183230000,183300000,183235000,183305000,"chr3",146299,1,7,4,12,"chr3",1,0.0520393811533052
"4568","chr3.167760000.167765000","chr3.167880000.167885000",120000,31,1.046501e-13,167760000,167880000,167765000,167885000,"chr3",146326,2,8,4,14,"chr3",1,0.0508673230192218
"4569","chr3.42010000.42015000","chr3.42050000.42055000",40000,34,1.234099e-06,42010000,42050000,42015000,42055000,"chr3",146335,1,7,5,13,"chr3",1,0.0518049695264885
"4570","chr3.124560000.124565000","chr3.124590000.124595000",30000,37,2.267092e-05,124560000,124590000,124565000,124595000,"chr3",146370,3,6,10,19,"chr3",1,0.0823956868260666
"4571","chr3.124800000.124805000","chr3.125165000.125170000",365000,12,0.0002655857,124800000,125165000,124805000,125170000,"chr3",146371,0,3,2,5,"chr3",1,0.0070323488045007
"4572","chr3.9140000.9145000","chr3.9245000.9250000",105000,23,5.905186e-07,9140000,9245000,9145000,9250000,"chr3",146421,0,1,2,3,"chr3",1,0.00808720112517581
"4573","chr3.11665000.11670000","chr3.11700000.11705000",35000,30,0.000645626,11665000,11700000,11670000,11705000,"chr3",146495,6,5,10,21,"chr3",1,0.0738396624472574
"4574","chr3.40235000.40240000","chr3.40360000.40365000",125000,27,9.534672e-11,40235000,40360000,40240000,40365000,"chr3",146545,0,2,1,3,"chr3",1,0.00949367088607595
"4575","chr3.78880000.78885000","chr3.78900000.78905000",20000,38,0.002618443,78880000,78900000,78885000,78905000,"chr3",146554,0,2,2,4,"chr3",1,0.0178152836380684
"4576","chr3.47630000.47635000","chr3.47820000.47825000",190000,16,7.311888e-05,47630000,47820000,47635000,47825000,"chr3",146568,3,15,7,25,"chr3",1,0.046882325363338
"4577","chr3.141190000.141195000","chr3.141660000.141665000",470000,10,0.001492164,141190000,141660000,141195000,141665000,"chr3",146604,0,0,3,3,"chr3",1,0.00351617440225035
"4578","chr3.196685000.196690000","chr3.197220000.197225000",535000,11,0.0001336423,196685000,197220000,196690000,197225000,"chr3",146666,1,3,9,13,"chr3",1,0.0167604313173933
"4579","chr3.106965000.106970000","chr3.107250000.107255000",285000,11,0.00429647,106965000,107250000,106970000,107255000,"chr3",146671,2,8,6,16,"chr3",1,0.0206282231598687
"4580","chr3.42645000.42650000","chr3.42680000.42685000",35000,40,2.484659e-08,42645000,42680000,42650000,42685000,"chr3",146695,1,3,2,6,"chr3",1,0.0281293952180028
"4581","chr3.171565000.171570000","chr3.172040000.172045000",475000,9,0.006284056,171565000,172040000,171570000,172045000,"chr3",146783,2,12,3,17,"chr3",1,0.0179324894514768
"4582","chr3.123755000.123760000","chr3.123775000.123780000",20000,43,7.137249e-05,123755000,123775000,123760000,123780000,"chr3",146869,1,1,1,3,"chr3",1,0.0151195499296765
"4583","chr3.186945000.186950000","chr3.187015000.187020000",70000,21,0.0006845089,186945000,187015000,186950000,187020000,"chr3",146872,1,1,2,4,"chr3",1,0.00984528832630099
"4584","chr3.42830000.42835000","chr3.42880000.42885000",50000,30,2.9976e-06,42830000,42880000,42835000,42885000,"chr3",146889,3,12,12,27,"chr3",1,0.0949367088607595
"4585","chr3.150080000.150085000","chr3.150210000.150215000",130000,18,8.835065e-05,150080000,150210000,150085000,150215000,"chr3",146935,1,5,9,15,"chr3",1,0.0316455696202532
"4586","chr3.72950000.72955000","chr3.73085000.73090000",135000,15,0.002729852,72950000,73085000,72955000,73090000,"chr3",146959,14,33,35,82,"chr3",1,0.144163150492264
"4587","chr3.185730000.185735000","chr3.186235000.186240000",505000,11,0.000192881,185730000,186235000,185735000,186240000,"chr3",146970,1,4,2,7,"chr3",1,0.00902484763244257
"4588","chr3.11450000.11455000","chr3.11700000.11705000",250000,15,3.19881e-05,11450000,11700000,11455000,11705000,"chr3",147103,1,8,6,15,"chr3",1,0.0263713080168776
"4589","chr3.42190000.42195000","chr3.42230000.42235000",40000,25,0.006186759,42190000,42230000,42195000,42235000,"chr3",147105,1,10,5,16,"chr3",1,0.046882325363338
"4590","chr3.183230000.183235000","chr3.183340000.183345000",110000,24,7.423412e-08,183230000,183340000,183235000,183345000,"chr3",147140,1,8,6,15,"chr3",1,0.0421940928270042
"4591","chr3.11195000.11200000","chr3.11375000.11380000",180000,13,0.005183894,11195000,11375000,11200000,11380000,"chr3",147144,1,8,4,13,"chr3",1,0.0198077824660103
"4592","chr3.8995000.9000000","chr3.9350000.9355000",355000,10,0.005714973,8995000,9350000,9e+06,9355000,"chr3",147150,1,1,0,2,"chr3",1,0.0023441162681669
"4593","chr3.15310000.15315000","chr3.15345000.15350000",35000,34,1.658086e-05,15310000,15345000,15315000,15350000,"chr3",147157,3,5,5,13,"chr3",1,0.0518049695264885
"4594","chr3.183230000.183235000","chr3.183490000.183495000",260000,14,0.0001118066,183230000,183490000,183235000,183495000,"chr3",147226,0,6,1,7,"chr3",1,0.0114861697140178
"4595","chr3.182510000.182515000","chr3.182615000.182620000",105000,18,0.0004584521,182510000,182615000,182515000,182620000,"chr3",147244,0,1,0,1,"chr3",1,0.00210970464135021
"4596","chr3.42115000.42120000","chr3.42230000.42235000",115000,16,0.002289584,42115000,42230000,42120000,42235000,"chr3",147250,1,6,5,12,"chr3",1,0.0225035161744023
"4597","chr3.149245000.149250000","chr3.149455000.149460000",210000,12,0.006827181,149245000,149455000,149250000,149460000,"chr3",147273,0,3,0,3,"chr3",1,0.00421940928270042
"4598","chr3.16335000.16340000","chr3.16600000.16605000",265000,23,4.440653e-12,16335000,16600000,16340000,16605000,"chr3",147280,0,2,1,3,"chr3",1,0.00808720112517581
"4599","chr3.15305000.15310000","chr3.15425000.15430000",120000,23,1.293508e-07,15305000,15425000,15310000,15430000,"chr3",147294,7,11,14,32,"chr3",1,0.086263478668542
"4600","chr3.47680000.47685000","chr3.47820000.47825000",140000,15,0.002219268,47680000,47820000,47685000,47825000,"chr3",147326,3,11,26,40,"chr3",1,0.070323488045007
"4601","chr3.127890000.127895000","chr3.127910000.127915000",20000,49,3.831916e-07,127890000,127910000,127895000,127915000,"chr3",147374,0,0,2,2,"chr3",1,0.0114861697140178
"4602","chr3.185660000.185665000","chr3.185940000.185945000",280000,11,0.004727206,185660000,185940000,185665000,185945000,"chr3",147421,2,9,9,20,"chr3",1,0.0257852789498359
"4603","chr3.42095000.42100000","chr3.42120000.42125000",25000,50,6.286941e-09,42095000,42120000,42100000,42125000,"chr3",147431,0,2,2,4,"chr3",1,0.023441162681669
"4604","chr3.177345000.177350000","chr3.177800000.177805000",455000,9,0.007608453,177345000,177800000,177350000,177805000,"chr3",147449,0,3,2,5,"chr3",1,0.00527426160337553
"4605","chr3.11510000.11515000","chr3.11830000.11835000",320000,10,0.008858162,11510000,11830000,11515000,11835000,"chr3",147480,1,5,7,13,"chr3",1,0.0152367557430849
"4606","chr3.149665000.149670000","chr3.149895000.149900000",230000,20,1.316238e-08,149665000,149895000,149670000,149900000,"chr3",147600,0,7,3,10,"chr3",1,0.023441162681669
"4607","chr3.183385000.183390000","chr3.183430000.183435000",45000,29,4.03842e-05,183385000,183430000,183390000,183435000,"chr3",147633,1,4,4,9,"chr3",1,0.0305907172995781
"4608","chr3.9840000.9845000","chr3.9945000.9950000",105000,16,0.004113739,9840000,9945000,9845000,9950000,"chr3",147659,2,4,3,9,"chr3",1,0.0168776371308017
"4609","chr3.149475000.149480000","chr3.149525000.149530000",50000,27,8.150052e-05,149475000,149525000,149480000,149530000,"chr3",147669,1,3,2,6,"chr3",1,0.0189873417721519
"4610","chr3.182855000.182860000","chr3.183110000.183115000",255000,11,0.007772406,182855000,183110000,182860000,183115000,"chr3",147705,0,0,3,3,"chr3",1,0.00386779184247539
"4611","chr3.42070000.42075000","chr3.42155000.42160000",85000,20,0.0003037761,42070000,42155000,42075000,42160000,"chr3",147774,3,2,4,9,"chr3",1,0.0210970464135021
"4612","chr3.122395000.122400000","chr3.122510000.122515000",115000,15,0.006587037,122395000,122510000,122400000,122515000,"chr3",147778,0,2,0,2,"chr3",1,0.00351617440225035
"4613","chr3.47610000.47615000","chr3.47835000.47840000",225000,13,0.001315422,47610000,47835000,47615000,47840000,"chr3",147804,0,1,3,4,"chr3",1,0.00609470229723394
"4614","chr3.138345000.138350000","chr3.138415000.138420000",70000,19,0.004822257,138345000,138415000,138350000,138420000,"chr3",147809,2,1,6,9,"chr3",1,0.020042194092827
"4615","chr3.44065000.44070000","chr3.44105000.44110000",40000,28,0.0005285764,44065000,44105000,44070000,44110000,"chr3",147813,0,0,2,2,"chr3",1,0.00656352555086732
"4616","chr3.42050000.42055000","chr3.42225000.42230000",175000,14,0.001869257,42050000,42225000,42055000,42230000,"chr3",147819,1,3,4,8,"chr3",1,0.0131270511017346
"4617","chr3.170180000.170185000","chr3.170510000.170515000",330000,14,1.851616e-05,170180000,170510000,170185000,170515000,"chr3",147832,0,8,12,20,"chr3",1,0.0328176277543366
"4618","chr3.69735000.69740000","chr3.69995000.70000000",260000,20,2.818252e-09,69735000,69995000,69740000,7e+07,"chr3",147851,0,2,0,2,"chr3",1,0.0046882325363338
"4619","chr3.129435000.129440000","chr3.129480000.129485000",45000,23,0.008858162,129435000,129480000,129440000,129485000,"chr3",147854,3,2,9,14,"chr3",1,0.0377402719174871
"4620","chr3.186325000.186330000","chr3.186500000.186505000",175000,18,7.722424e-06,186325000,186500000,186330000,186505000,"chr3",147863,0,3,1,4,"chr3",1,0.00843881856540084
"4621","chr3.64020000.64025000","chr3.64460000.64465000",440000,11,0.0004512643,64020000,64460000,64025000,64465000,"chr3",147866,1,3,4,8,"chr3",1,0.0103141115799344
"4622","chr3.114055000.114060000","chr3.114875000.114880000",820000,11,5.62524e-06,114055000,114875000,114060000,114880000,"chr3",147874,1,3,0,4,"chr3",1,0.00515705578996718
"4623","chr3.9045000.9050000","chr3.9345000.9350000",300000,11,0.003300199,9045000,9345000,9050000,9350000,"chr3",147894,5,7,11,23,"chr3",1,0.0296530707923113
"4624","chr3.185730000.185735000","chr3.185975000.185980000",245000,13,0.0007286439,185730000,185975000,185735000,185980000,"chr3",147908,0,5,6,11,"chr3",1,0.0167604313173933
"4625","chr3.47520000.47525000","chr3.47835000.47840000",315000,10,0.00947524,47520000,47835000,47525000,47840000,"chr3",147910,12,25,27,64,"chr3",1,0.0750117205813408
"4626","chr3.52030000.52035000","chr3.52140000.52145000",110000,27,5.614852e-10,52030000,52140000,52035000,52145000,"chr3",147915,2,4,2,8,"chr3",1,0.0253164556962025
"4627","chr3.56815000.56820000","chr3.57015000.57020000",200000,13,0.002787948,56815000,57015000,56820000,57020000,"chr3",147997,2,8,5,15,"chr3",1,0.0228551336146273
"4628","chr3.64020000.64025000","chr3.64205000.64210000",185000,16,9.123936e-05,64020000,64205000,64025000,64210000,"chr3",148024,1,0,0,1,"chr3",1,0.00187529301453352
"4629","chr3.42640000.42645000","chr3.42780000.42785000",140000,16,0.0006749162,42640000,42780000,42645000,42785000,"chr3",148045,0,2,1,3,"chr3",1,0.00562587904360056
"4630","chr3.114120000.114125000","chr3.114140000.114145000",20000,38,0.002618443,114120000,114140000,114125000,114145000,"chr3",148106,1,4,1,6,"chr3",1,0.0267229254571027
"4631","chr3.149655000.149660000","chr3.150210000.150215000",555000,14,2.85796e-07,149655000,150210000,149660000,150215000,"chr3",148190,1,10,7,18,"chr3",1,0.029535864978903
"4632","chr3.156270000.156275000","chr3.156400000.156405000",130000,17,0.0003177655,156270000,156400000,156275000,156405000,"chr3",148220,0,1,0,1,"chr3",1,0.00199249882794187
"4633","chr3.23240000.23245000","chr3.23630000.23635000",390000,10,0.0037657,23240000,23630000,23245000,23635000,"chr3",148222,1,4,1,6,"chr3",1,0.0070323488045007
"4634","chr3.47610000.47615000","chr3.47660000.47665000",50000,22,0.007850461,47610000,47660000,47615000,47665000,"chr3",148230,0,1,3,4,"chr3",1,0.0103141115799344
"4635","chr3.52035000.52040000","chr3.52170000.52175000",135000,21,8.833536e-07,52035000,52170000,52040000,52175000,"chr3",148308,3,1,3,7,"chr3",1,0.0172292545710267
"4636","chr3.23995000.24000000","chr3.24025000.24030000",30000,34,0.0003107272,23995000,24025000,2.4e+07,24030000,"chr3",148313,0,4,6,10,"chr3",1,0.0398499765588373
"4637","chr3.176935000.176940000","chr3.177815000.177820000",880000,8,0.001330891,176935000,177815000,176940000,177820000,"chr3",148359,0,0,1,1,"chr3",1,0.00093764650726676
"4638","chr3.15685000.15690000","chr3.15720000.15725000",35000,30,0.000645626,15685000,15720000,15690000,15725000,"chr3",148503,3,8,7,18,"chr3",1,0.0632911392405063
"4639","chr3.42030000.42035000","chr3.42050000.42055000",20000,39,0.001340184,42030000,42050000,42035000,42055000,"chr3",148506,1,7,8,16,"chr3",1,0.0731364275668073
"4640","chr3.4900000.4905000","chr3.5015000.5020000",115000,20,1.62922e-05,4900000,5015000,4905000,5020000,"chr3",148513,3,11,6,20,"chr3",1,0.046882325363338
"4641","chr3.16100000.16105000","chr3.16270000.16275000",170000,13,0.007077402,16100000,16270000,16105000,16275000,"chr3",148516,1,1,1,3,"chr3",1,0.00457102672292546
"4642","chr3.125125000.125130000","chr3.125165000.125170000",40000,25,0.006186759,125125000,125165000,125130000,125170000,"chr3",148554,0,3,2,5,"chr3",1,0.0146507266760431
"4643","chr3.155870000.155875000","chr3.156270000.156275000",400000,14,4.657615e-06,155870000,156270000,155875000,156275000,"chr3",148644,0,1,1,2,"chr3",1,0.00328176277543366
"4644","chr3.72100000.72105000","chr3.72885000.72890000",785000,9,0.0004323905,72100000,72885000,72105000,72890000,"chr3",148650,1,5,3,9,"chr3",1,0.00949367088607595
"4645","chr3.69280000.69285000","chr3.69320000.69325000",40000,28,0.0005285764,69280000,69320000,69285000,69325000,"chr3",148658,1,6,6,13,"chr3",1,0.0426629160806376
"4646","chr3.72955000.72960000","chr3.73115000.73120000",160000,17,7.190345e-05,72955000,73115000,72960000,73120000,"chr3",148702,10,23,20,53,"chr3",1,0.105602437880919
"4647","chr3.45660000.45665000","chr3.45685000.45690000",25000,36,0.001719696,45660000,45685000,45665000,45690000,"chr3",148734,4,10,8,22,"chr3",1,0.0928270042194093
"4648","chr3.42155000.42160000","chr3.42225000.42230000",70000,25,7.211335e-06,42155000,42225000,42160000,42230000,"chr3",148766,1,2,4,7,"chr3",1,0.0205110173464604
"4649","chr3.11460000.11465000","chr3.11670000.11675000",210000,13,0.002026797,11460000,11670000,11465000,11675000,"chr3",148851,0,2,4,6,"chr3",1,0.00914205344585091
"4650","chr3.52030000.52035000","chr3.52250000.52255000",220000,16,2.051686e-05,52030000,52250000,52035000,52255000,"chr3",148914,5,14,7,26,"chr3",1,0.0487576183778715
"4651","chr3.149475000.149480000","chr3.149895000.149900000",420000,10,0.00268828,149475000,149895000,149480000,149900000,"chr3",148948,2,7,11,20,"chr3",1,0.023441162681669
"4652","chr3.138385000.138390000","chr3.138415000.138420000",30000,43,5.178994e-08,138385000,138415000,138390000,138420000,"chr3",148980,2,1,6,9,"chr3",1,0.0453586497890295
"4653","chr3.72235000.72240000","chr3.72275000.72280000",40000,27,0.001256406,72235000,72275000,72240000,72280000,"chr3",148983,0,2,1,3,"chr3",1,0.00949367088607595
"4654","chr3.4395000.4400000","chr3.5070000.5075000",675000,8,0.005368394,4395000,5070000,4400000,5075000,"chr3",149045,0,2,2,4,"chr3",1,0.00375058602906704
"4655","chr3.12880000.12885000","chr3.13490000.13495000",610000,9,0.001795306,12880000,13490000,12885000,13495000,"chr3",149054,0,5,6,11,"chr3",1,0.0116033755274262
"4656","chr3.185990000.185995000","chr3.186250000.186255000",260000,12,0.00192738,185990000,186250000,185995000,186255000,"chr3",149084,0,7,5,12,"chr3",1,0.0168776371308017
"4657","chr3.182615000.182620000","chr3.183500000.183505000",885000,8,0.001282306,182615000,183500000,182620000,183505000,"chr3",149114,0,1,0,1,"chr3",1,0.00093764650726676
"4658","chr3.129380000.129385000","chr3.129460000.129465000",80000,19,0.001532444,129380000,129460000,129385000,129465000,"chr3",149136,2,6,2,10,"chr3",1,0.0222691045475856
"4659","chr3.48805000.48810000","chr3.48960000.48965000",155000,15,0.00122035,48805000,48960000,48810000,48965000,"chr3",149198,2,18,2,22,"chr3",1,0.0386779184247539
"4660","chr3.56735000.56740000","chr3.57015000.57020000",280000,29,1.573743e-18,56735000,57015000,56740000,57020000,"chr3",149237,2,18,21,41,"chr3",1,0.139357712142522
"4661","chr3.129660000.129665000","chr3.129720000.129725000",60000,21,0.003322656,129660000,129720000,129665000,129725000,"chr3",149292,4,11,16,31,"chr3",1,0.0763009845288326
"4662","chr3.170425000.170430000","chr3.170445000.170450000",20000,36,0.008858162,170425000,170445000,170430000,170450000,"chr3",149323,4,11,13,28,"chr3",1,0.118143459915612
"4663","chr3.15240000.15245000","chr3.15815000.15820000",575000,10,0.0004844251,15240000,15815000,15245000,15820000,"chr3",149339,2,1,1,4,"chr3",1,0.0046882325363338
"4664","chr3.42645000.42650000","chr3.42830000.42835000",185000,14,0.001336201,42645000,42830000,42650000,42835000,"chr3",149354,1,3,2,6,"chr3",1,0.00984528832630099
"4665","chr3.187985000.187990000","chr3.188150000.188155000",165000,13,0.00828391,187985000,188150000,187990000,188155000,"chr3",149429,0,2,1,3,"chr3",1,0.00457102672292546
"4666","chr3.71955000.71960000","chr3.72830000.72835000",875000,10,2.709083e-05,71955000,72830000,71960000,72835000,"chr3",149467,0,1,2,3,"chr3",1,0.00351617440225035
"4667","chr3.185685000.185690000","chr3.186220000.186225000",535000,10,0.0007300395,185685000,186220000,185690000,186225000,"chr3",149492,0,6,9,15,"chr3",1,0.0175808720112518
"4668","chr3.170310000.170315000","chr3.170415000.170420000",105000,20,3.833446e-05,170310000,170415000,170315000,170420000,"chr3",149570,2,16,10,28,"chr3",1,0.0656352555086732
"4669","chr3.48805000.48810000","chr3.48870000.48875000",65000,26,6.094511e-06,48805000,48870000,48810000,48875000,"chr3",149574,12,18,21,51,"chr3",1,0.155414908579466
"4670","chr3.42145000.42150000","chr3.42230000.42235000",85000,18,0.002607953,42145000,42230000,42150000,42235000,"chr3",149633,1,7,5,13,"chr3",1,0.0274261603375527
"4671","chr3.196565000.196570000","chr3.196685000.196690000",120000,24,2.627314e-08,196565000,196685000,196570000,196690000,"chr3",149650,1,7,9,17,"chr3",1,0.0478199718706048
"4672","chr3.129400000.129405000","chr3.129435000.129440000",35000,35,6.094511e-06,129400000,129435000,129405000,129440000,"chr3",149700,3,2,11,16,"chr3",1,0.0656352555086732
"4673","chr3.183300000.183305000","chr3.183340000.183345000",40000,29,0.0002105433,183300000,183340000,183305000,183345000,"chr3",149806,2,7,4,13,"chr3",1,0.0441865916549461
"4674","chr3.4445000.4450000","chr3.4465000.4470000",20000,41,0.000324247,4445000,4465000,4450000,4470000,"chr3",149808,1,1,0,2,"chr3",1,0.00961087669948429
"4675","chr3.138300000.138305000","chr3.138915000.138920000",615000,11,5.14705e-05,138300000,138915000,138305000,138920000,"chr3",149839,0,4,1,5,"chr3",1,0.00644631973745898
"4676","chr3.45550000.45555000","chr3.45660000.45665000",110000,17,0.001012851,45550000,45660000,45555000,45665000,"chr3",149846,5,7,7,19,"chr3",1,0.0378574777308955
"4677","chr3.156465000.156470000","chr3.156790000.156795000",325000,17,8.590473e-08,156465000,156790000,156470000,156795000,"chr3",149864,0,2,4,6,"chr3",1,0.0119549929676512
"4678","chr3.170300000.170305000","chr3.170520000.170525000",220000,13,0.001492164,170300000,170520000,170305000,170525000,"chr3",149876,0,1,0,1,"chr3",1,0.00152367557430849
"4679","chr3.9045000.9050000","chr3.9280000.9285000",235000,15,5.480045e-05,9045000,9280000,9050000,9285000,"chr3",149915,1,5,6,12,"chr3",1,0.0210970464135021
"4680","chr3.56875000.56880000","chr3.57010000.57015000",135000,16,0.0008448135,56875000,57010000,56880000,57015000,"chr3",150021,1,2,12,15,"chr3",1,0.0281293952180028
"4681","chr3.124885000.124890000","chr3.125120000.125125000",235000,12,0.003553338,124885000,125120000,124890000,125125000,"chr3",150052,2,1,1,4,"chr3",1,0.00562587904360056
"4682","chr3.27530000.27535000","chr3.27665000.27670000",135000,14,0.00790472,27530000,27665000,27535000,27670000,"chr3",150146,2,3,1,6,"chr3",1,0.00984528832630099
"4683","chr3.143760000.143765000","chr3.144495000.144500000",735000,12,1.642088e-06,143760000,144495000,143765000,144500000,"chr3",150180,2,2,2,6,"chr3",1,0.00843881856540084
"4684","chr3.37510000.37515000","chr3.37775000.37780000",265000,11,0.006348929,37510000,37775000,37515000,37780000,"chr3",150219,0,5,0,5,"chr3",1,0.00644631973745898
"4685","chr3.143760000.143765000","chr3.143845000.143850000",85000,23,7.727121e-06,143760000,143845000,143765000,143850000,"chr3",150234,2,0,2,4,"chr3",1,0.0107829348335677
"4686","chr3.186020000.186025000","chr3.186220000.186225000",200000,12,0.008858162,186020000,186220000,186025000,186225000,"chr3",150272,0,6,4,10,"chr3",1,0.0140646976090014
"4687","chr3.149270000.149275000","chr3.149475000.149480000",205000,12,0.007829931,149270000,149475000,149275000,149480000,"chr3",150278,2,5,9,16,"chr3",1,0.0225035161744023
"4688","chr3.106965000.106970000","chr3.107270000.107275000",305000,13,0.000165018,106965000,107270000,106970000,107275000,"chr3",150280,2,4,6,12,"chr3",1,0.0182841068917018
"4689","chr3.170410000.170415000","chr3.170525000.170530000",115000,17,0.0007311562,170410000,170525000,170415000,170530000,"chr3",150289,1,6,1,8,"chr3",1,0.0159399906235349
"4690","chr3.13350000.13355000","chr3.13490000.13495000",140000,23,2.493692e-08,13350000,13490000,13355000,13495000,"chr3",150311,0,0,3,3,"chr3",1,0.00808720112517581
"4691","chr3.15240000.15245000","chr3.15460000.15465000",220000,15,9.349312e-05,15240000,15460000,15245000,15465000,"chr3",150385,0,1,1,2,"chr3",1,0.00351617440225035
"4692","chr3.48040000.48045000","chr3.48135000.48140000",95000,16,0.007976203,48040000,48135000,48045000,48140000,"chr3",150413,2,19,18,39,"chr3",1,0.0731364275668073
"4693","chr3.15855000.15860000","chr3.16290000.16295000",435000,13,1.558782e-05,15855000,16290000,15860000,16295000,"chr3",150453,0,3,1,4,"chr3",1,0.00609470229723394
"4694","chr3.48130000.48135000","chr3.48190000.48195000",60000,22,0.001336201,48130000,48190000,48135000,48195000,"chr3",150485,8,51,19,78,"chr3",1,0.20112517580872
"4695","chr3.69160000.69165000","chr3.69430000.69435000",270000,13,0.0003746069,69160000,69430000,69165000,69435000,"chr3",150566,0,3,1,4,"chr3",1,0.00609470229723394
"4696","chr3.179035000.179040000","chr3.179320000.179325000",285000,17,3.064555e-07,179035000,179320000,179040000,179325000,"chr3",150590,0,2,0,2,"chr3",1,0.00398499765588373
"4697","chr3.185990000.185995000","chr3.186235000.186240000",245000,11,0.009475458,185990000,186235000,185995000,186240000,"chr3",150592,1,4,2,7,"chr3",1,0.00902484763244257
"4698","chr3.71950000.71955000","chr3.72820000.72825000",870000,7,0.007850461,71950000,72820000,71955000,72825000,"chr3",150620,0,0,3,3,"chr3",1,0.00246132208157525
"4699","chr3.45560000.45565000","chr3.45685000.45690000",125000,15,0.004113739,45560000,45685000,45565000,45690000,"chr3",150735,0,1,4,5,"chr3",1,0.00879043600562588
"4700","chr3.19970000.19975000","chr3.20225000.20230000",255000,12,0.002195056,19970000,20225000,19975000,20230000,"chr3",150745,3,4,8,15,"chr3",1,0.0210970464135021
"4701","chr3.184135000.184140000","chr3.184250000.184255000",115000,23,2.060607e-07,184135000,184250000,184140000,184255000,"chr3",150777,1,17,24,42,"chr3",1,0.113220815752461
"4702","chr3.15200000.15205000","chr3.15220000.15225000",20000,41,0.000324247,15200000,15220000,15205000,15225000,"chr3",150829,1,7,5,13,"chr3",1,0.0624706985466479
"4703","chr3.15310000.15315000","chr3.15375000.15380000",65000,40,4.834046e-15,15310000,15375000,15315000,15380000,"chr3",150832,2,10,13,25,"chr3",1,0.117205813408345
"4704","chr3.195990000.195995000","chr3.196195000.196200000",205000,13,0.002384877,195990000,196195000,195995000,196200000,"chr3",150995,2,8,3,13,"chr3",1,0.0198077824660103
"4705","chr3.101640000.101645000","chr3.101940000.101945000",300000,11,0.003300199,101640000,101940000,101645000,101945000,"chr3",151090,1,12,6,19,"chr3",1,0.0244960150023441
"4706","chr3.51575000.51580000","chr3.51700000.51705000",125000,28,1.558423e-11,51575000,51700000,51580000,51705000,"chr3",151128,1,0,3,4,"chr3",1,0.0131270511017346
"4707","chr3.23885000.23890000","chr3.23940000.23945000",55000,23,0.00134018,23885000,23940000,23890000,23945000,"chr3",151187,9,23,17,49,"chr3",1,0.132090951711205
"4708","chr3.42050000.42055000","chr3.42145000.42150000",95000,17,0.003021882,42050000,42145000,42055000,42150000,"chr3",151217,1,7,5,13,"chr3",1,0.0259024847632443
"4709","chr3.143770000.143775000","chr3.144495000.144500000",725000,9,0.0006869678,143770000,144495000,143775000,144500000,"chr3",151222,0,2,1,3,"chr3",1,0.00316455696202532
"4710","chr3.48035000.48040000","chr3.48085000.48090000",50000,25,0.0005851413,48035000,48085000,48040000,48090000,"chr3",151236,3,9,13,25,"chr3",1,0.0732536333802157
"4711","chr3.129480000.129485000","chr3.129535000.129540000",55000,32,5.053749e-08,129480000,129535000,129485000,129540000,"chr3",151285,3,8,9,20,"chr3",1,0.0750117205813408
"4712","chr3.15220000.15225000","chr3.15405000.15410000",185000,14,0.001336201,15220000,15405000,15225000,15410000,"chr3",151322,3,7,4,14,"chr3",1,0.0229723394280356
"4713","chr3.42050000.42055000","chr3.42115000.42120000",65000,48,2.127679e-21,42050000,42115000,42055000,42120000,"chr3",151334,1,6,5,12,"chr3",1,0.0675105485232067
"4714","chr3.66465000.66470000","chr3.66500000.66505000",35000,28,0.003176334,66465000,66500000,66470000,66505000,"chr3",151417,0,3,2,5,"chr3",1,0.0164088138771683
"4715","chr3.51970000.51975000","chr3.52030000.52035000",60000,23,0.0005056221,51970000,52030000,51975000,52035000,"chr3",151522,7,14,13,34,"chr3",1,0.0916549460853258
"4716","chr3.167105000.167110000","chr3.167740000.167745000",635000,8,0.007090384,167105000,167740000,167110000,167745000,"chr3",151533,2,3,5,10,"chr3",1,0.00937646507266761
"4717","chr3.32235000.32240000","chr3.32510000.32515000",275000,12,0.001383502,32235000,32510000,32240000,32515000,"chr3",151554,1,0,1,2,"chr3",1,0.00281293952180028
"4718","chr3.71065000.71070000","chr3.71355000.71360000",290000,11,0.003933946,71065000,71355000,71070000,71360000,"chr3",151569,1,1,0,2,"chr3",1,0.00257852789498359
"4719","chr3.15655000.15660000","chr3.15855000.15860000",200000,18,2.103842e-06,15655000,15855000,15660000,15860000,"chr3",151711,0,3,1,4,"chr3",1,0.00843881856540084
"4720","chr3.4810000.4815000","chr3.5015000.5020000",205000,18,1.63062e-06,4810000,5015000,4815000,5020000,"chr3",151750,3,1,4,8,"chr3",1,0.0168776371308017
"4721","chr3.143760000.143765000","chr3.144380000.144385000",620000,10,0.0003037761,143760000,144380000,143765000,144385000,"chr3",151826,1,2,2,5,"chr3",1,0.00586029067041725
"4722","chr3.124785000.124790000","chr3.124885000.124890000",100000,18,0.0006749162,124785000,124885000,124790000,124890000,"chr3",151829,2,1,1,4,"chr3",1,0.00843881856540084
"4723","chr3.179070000.179075000","chr3.179315000.179320000",245000,11,0.009475458,179070000,179315000,179075000,179320000,"chr3",151863,0,0,4,4,"chr3",1,0.00515705578996718
"4724","chr3.42050000.42055000","chr3.42090000.42095000",40000,27,0.001256406,42050000,42090000,42055000,42095000,"chr3",151963,1,7,5,13,"chr3",1,0.0411392405063291
"4725","chr3.52030000.52035000","chr3.52235000.52240000",205000,23,1.999691e-10,52030000,52235000,52035000,52240000,"chr3",152019,1,4,9,14,"chr3",1,0.0377402719174871
"4726","chr3.9105000.9110000","chr3.9350000.9355000",245000,11,0.009475458,9105000,9350000,9110000,9355000,"chr3",152043,1,0,0,1,"chr3",1,0.0012892639474918
"4727","chr3.23240000.23245000","chr3.23980000.23985000",740000,11,1.300052e-05,23240000,23980000,23245000,23985000,"chr3",152050,1,4,1,6,"chr3",1,0.00773558368495077
"4728","chr3.72010000.72015000","chr3.72405000.72410000",395000,10,0.003544905,72010000,72405000,72015000,72410000,"chr3",152079,0,1,1,2,"chr3",1,0.0023441162681669
"4729","chr3.42680000.42685000","chr3.42775000.42780000",95000,17,0.003021882,42680000,42775000,42685000,42780000,"chr3",152146,1,13,5,19,"chr3",1,0.0378574777308955
"4730","chr3.124995000.125000000","chr3.125105000.125110000",110000,16,0.003064209,124995000,125105000,1.25e+08,125110000,"chr3",152159,2,4,1,7,"chr3",1,0.0131270511017346
"4731","chr3.183810000.183815000","chr3.183830000.183835000",20000,49,3.831916e-07,183810000,183830000,183815000,183835000,"chr3",152234,1,14,11,26,"chr3",1,0.149320206282232
"4732","chr3.47600000.47605000","chr3.47825000.47830000",225000,12,0.004617662,47600000,47825000,47605000,47830000,"chr3",152249,4,7,15,26,"chr3",1,0.0365682137834037
"4733","chr3.156415000.156420000","chr3.156500000.156505000",85000,20,0.0003037761,156415000,156500000,156420000,156505000,"chr3",152252,0,1,0,1,"chr3",1,0.0023441162681669
"4734","chr3.124530000.124535000","chr3.124590000.124595000",60000,22,0.001336201,124530000,124590000,124535000,124595000,"chr3",152256,3,6,4,13,"chr3",1,0.0335208626347867
"4735","chr3.56810000.56815000","chr3.57010000.57015000",200000,12,0.008858162,56810000,57010000,56815000,57015000,"chr3",152316,0,4,3,7,"chr3",1,0.00984528832630099
"4736","chr3.69160000.69165000","chr3.69445000.69450000",285000,12,0.001119793,69160000,69445000,69165000,69450000,"chr3",152376,0,7,7,14,"chr3",1,0.019690576652602
"4737","chr3.138300000.138305000","chr3.138605000.138610000",305000,11,0.00305279,138300000,138605000,138305000,138610000,"chr3",152412,0,4,1,5,"chr3",1,0.00644631973745898
"4738","chr3.40235000.40240000","chr3.40300000.40305000",65000,22,0.000549876,40235000,40300000,40240000,40305000,"chr3",152452,3,7,2,12,"chr3",1,0.0309423347398031
"4739","chr3.42880000.42885000","chr3.42900000.42905000",20000,36,0.008858162,42880000,42900000,42885000,42905000,"chr3",152524,3,7,4,14,"chr3",1,0.0590717299578059
"4740","chr3.69285000.69290000","chr3.69320000.69325000",35000,28,0.003176334,69285000,69320000,69290000,69325000,"chr3",152538,0,6,2,8,"chr3",1,0.0262541022034693
"4741","chr3.48740000.48745000","chr3.48965000.48970000",225000,14,0.0003297595,48740000,48965000,48745000,48970000,"chr3",152542,4,30,28,62,"chr3",1,0.101734646038444
"4742","chr3.183780000.183785000","chr3.183830000.183835000",50000,26,0.0002216793,183780000,183830000,183785000,183835000,"chr3",152562,1,14,11,26,"chr3",1,0.0792311298640413
"4743","chr3.124785000.124790000","chr3.124995000.125000000",210000,12,0.006827181,124785000,124995000,124790000,1.25e+08,"chr3",152566,2,4,1,7,"chr3",1,0.00984528832630099
"4744","chr3.48300000.48305000","chr3.48435000.48440000",135000,16,0.0008448135,48300000,48435000,48305000,48440000,"chr3",152605,0,3,1,4,"chr3",1,0.00750117205813408
"4745","chr3.183300000.183305000","chr3.183490000.183495000",190000,32,3.92941e-18,183300000,183490000,183305000,183495000,"chr3",152609,0,6,1,7,"chr3",1,0.0262541022034693
"4746","chr3.4750000.4755000","chr3.5070000.5075000",320000,17,1.001906e-07,4750000,5070000,4755000,5075000,"chr3",152633,3,11,10,24,"chr3",1,0.0478199718706048
"4747","chr3.184145000.184150000","chr3.184465000.184470000",320000,10,0.008858162,184145000,184465000,184150000,184470000,"chr3",152676,3,11,11,25,"chr3",1,0.0293014533520863
"4748","chr3.179600000.179605000","chr3.180280000.180285000",680000,10,0.0001679931,179600000,180280000,179605000,180285000,"chr3",152699,3,9,6,18,"chr3",1,0.0210970464135021
"4749","chr3.47475000.47480000","chr3.47540000.47545000",65000,19,0.00893155,47475000,47540000,47480000,47545000,"chr3",152707,1,7,4,12,"chr3",1,0.0267229254571027
"4750","chr3.11510000.11515000","chr3.11835000.11840000",325000,10,0.008277964,11510000,11835000,11515000,11840000,"chr3",152712,0,8,2,10,"chr3",1,0.0117205813408345
"4751","chr3.101230000.101235000","chr3.101275000.101280000",45000,29,4.03842e-05,101230000,101275000,101235000,101280000,"chr3",152715,0,1,0,1,"chr3",1,0.00339896858884201
"4752","chr3.129435000.129440000","chr3.129490000.129495000",55000,25,0.0001901332,129435000,129490000,129440000,129495000,"chr3",152718,3,2,11,16,"chr3",1,0.046882325363338
"4753","chr3.4395000.4400000","chr3.4655000.4660000",260000,14,0.0001118066,4395000,4655000,4400000,4660000,"chr3",152744,0,2,2,4,"chr3",1,0.00656352555086732
"4754","chr3.66500000.66505000","chr3.66535000.66540000",35000,52,2.737305e-15,66500000,66535000,66505000,66540000,"chr3",152774,0,3,2,5,"chr3",1,0.0304735114861697
"4755","chr3.130770000.130775000","chr3.131730000.131735000",960000,7,0.004403606,130770000,131730000,130775000,131735000,"chr3",152795,2,2,4,8,"chr3",1,0.00656352555086732
"4756","chr3.186930000.186935000","chr3.187395000.187400000",465000,10,0.001576659,186930000,187395000,186935000,187400000,"chr3",152835,0,4,4,8,"chr3",1,0.00937646507266761
"4757","chr3.47540000.47545000","chr3.47800000.47805000",260000,16,4.407871e-06,47540000,47800000,47545000,47805000,"chr3",152869,1,10,4,15,"chr3",1,0.0281293952180028
"4758","chr3.123305000.123310000","chr3.123435000.123440000",130000,15,0.003322656,123305000,123435000,123310000,123440000,"chr3",152894,1,3,11,15,"chr3",1,0.0263713080168776
"4759","chr3.182900000.182905000","chr3.183095000.183100000",195000,26,1.051815e-12,182900000,183095000,182905000,183100000,"chr3",152920,4,3,12,19,"chr3",1,0.0578996718237225
"4760","chr3.11465000.11470000","chr3.11700000.11705000",235000,13,0.0009759225,11465000,11700000,11470000,11705000,"chr3",152932,2,6,10,18,"chr3",1,0.0274261603375527
"4761","chr3.49125000.49130000","chr3.49560000.49565000",435000,9,0.009098522,49125000,49560000,49130000,49565000,"chr3",152939,1,2,1,4,"chr3",1,0.00421940928270042
"4762","chr3.42640000.42645000","chr3.42805000.42810000",165000,18,1.326087e-05,42640000,42805000,42645000,42810000,"chr3",153072,0,2,1,3,"chr3",1,0.00632911392405063
"4763","chr3.9890000.9895000","chr3.9930000.9935000",40000,31,3.057562e-05,9890000,9930000,9895000,9935000,"chr3",153079,0,5,4,9,"chr3",1,0.0327004219409283
"4764","chr3.51575000.51580000","chr3.51645000.51650000",70000,19,0.004822257,51575000,51645000,51580000,51650000,"chr3",153089,1,0,3,4,"chr3",1,0.00890764181903422
"4765","chr3.179555000.179560000","chr3.179600000.179605000",45000,24,0.004086146,179555000,179600000,179560000,179605000,"chr3",153147,1,3,8,12,"chr3",1,0.0337552742616034
"4766","chr3.48740000.48745000","chr3.49005000.49010000",265000,11,0.006348929,48740000,49005000,48745000,49010000,"chr3",153150,3,3,2,8,"chr3",1,0.0103141115799344
"4767","chr3.123620000.123625000","chr3.123650000.123655000",30000,31,0.003143375,123620000,123650000,123625000,123655000,"chr3",153186,1,0,2,3,"chr3",1,0.0109001406469761
"4768","chr3.177245000.177250000","chr3.177345000.177350000",100000,19,0.0002105433,177245000,177345000,177250000,177350000,"chr3",153196,0,3,2,5,"chr3",1,0.0111345522737928
"4769","chr3.42805000.42810000","chr3.42880000.42885000",75000,22,0.0001118066,42805000,42880000,42810000,42885000,"chr3",153343,1,12,12,25,"chr3",1,0.0644631973745898
"4770","chr3.65480000.65485000","chr3.65710000.65715000",230000,12,0.004069429,65480000,65710000,65485000,65715000,"chr3",153384,2,3,0,5,"chr3",1,0.0070323488045007
"4771","chr3.101630000.101635000","chr3.101940000.101945000",310000,12,0.0006739722,101630000,101940000,101635000,101945000,"chr3",153400,3,7,11,21,"chr3",1,0.029535864978903
"4772","chr3.4825000.4830000","chr3.5015000.5020000",190000,14,0.001110777,4825000,5015000,4830000,5020000,"chr3",153484,0,3,2,5,"chr3",1,0.00820440693858415
"4773","chr3.148860000.148865000","chr3.148990000.148995000",130000,29,1.386296e-12,148860000,148990000,148865000,148995000,"chr3",153540,2,2,1,5,"chr3",1,0.01699484294421
"4774","chr3.47600000.47605000","chr3.47820000.47825000",220000,16,2.051686e-05,47600000,47820000,47605000,47825000,"chr3",153554,3,19,15,37,"chr3",1,0.0693858415377403
"4775","chr3.185730000.185735000","chr3.186265000.186270000",535000,15,4.8487e-08,185730000,186265000,185735000,186270000,"chr3",153629,0,7,6,13,"chr3",1,0.0228551336146273
"4776","chr3.53250000.53255000","chr3.53335000.53340000",85000,18,0.002607953,53250000,53335000,53255000,53340000,"chr3",153643,8,9,19,36,"chr3",1,0.0759493670886076
"4777","chr3.196605000.196610000","chr3.196650000.196655000",45000,26,0.0007311562,196605000,196650000,196610000,196655000,"chr3",153669,2,9,6,17,"chr3",1,0.0518049695264885
"4778","chr3.115675000.115680000","chr3.115695000.115700000",20000,40,0.0006722116,115675000,115695000,115680000,115700000,"chr3",153676,0,2,2,4,"chr3",1,0.0187529301453352
"4779","chr3.57995000.58000000","chr3.58020000.58025000",25000,36,0.001719696,57995000,58020000,5.8e+07,58025000,"chr3",153684,2,8,7,17,"chr3",1,0.0717299578059072
"4780","chr3.182615000.182620000","chr3.182790000.182795000",175000,13,0.006099929,182615000,182790000,182620000,182795000,"chr3",153685,0,1,0,1,"chr3",1,0.00152367557430849
"4781","chr3.42050000.42055000","chr3.42070000.42075000",20000,53,7.489329e-09,42050000,42070000,42055000,42075000,"chr3",153710,1,7,4,12,"chr3",1,0.0745428973277075
"4782","chr3.15815000.15820000","chr3.16265000.16270000",450000,10,0.001869257,15815000,16265000,15820000,16270000,"chr3",153770,0,3,3,6,"chr3",1,0.0070323488045007
"4783","chr3.23240000.23245000","chr3.23855000.23860000",615000,9,0.00173152,23240000,23855000,23245000,23860000,"chr3",153872,1,4,1,6,"chr3",1,0.00632911392405063
"4784","chr3.60010000.60015000","chr3.60125000.60130000",115000,17,0.0007311562,60010000,60125000,60015000,60130000,"chr3",153889,1,1,0,2,"chr3",1,0.00398499765588373
"4785","chr3.179645000.179650000","chr3.179750000.179755000",105000,26,5.813772e-09,179645000,179750000,179650000,179755000,"chr3",153901,2,5,7,14,"chr3",1,0.0426629160806376
"4786","chr3.69180000.69185000","chr3.69200000.69205000",20000,39,0.001340184,69180000,69200000,69185000,69205000,"chr3",153910,0,4,1,5,"chr3",1,0.0228551336146273
"4787","chr3.129395000.129400000","chr3.129550000.129555000",155000,17,9.160749e-05,129395000,129550000,129400000,129555000,"chr3",153919,3,9,19,31,"chr3",1,0.0617674636661978
"4788","chr3.9180000.9185000","chr3.9245000.9250000",65000,21,0.001468626,9180000,9245000,9185000,9250000,"chr3",153956,0,3,2,5,"chr3",1,0.0123066104078762
"4789","chr3.47865000.47870000","chr3.48135000.48140000",270000,14,8.324867e-05,47865000,48135000,47870000,48140000,"chr3",153977,0,4,3,7,"chr3",1,0.0114861697140178
"4790","chr3.101570000.101575000","chr3.101940000.101945000",370000,21,4.440653e-12,101570000,101940000,101575000,101945000,"chr3",154009,3,12,11,26,"chr3",1,0.0639943741209564
"4791","chr3.69250000.69255000","chr3.69330000.69335000",80000,19,0.001532444,69250000,69330000,69255000,69335000,"chr3",154028,2,4,2,8,"chr3",1,0.0178152836380684
"4792","chr3.156270000.156275000","chr3.156540000.156545000",270000,11,0.005745101,156270000,156540000,156275000,156545000,"chr3",154043,0,1,1,2,"chr3",1,0.00257852789498359
"4793","chr3.47865000.47870000","chr3.48130000.48135000",265000,19,1.578571e-08,47865000,48130000,47870000,48135000,"chr3",154123,0,4,3,7,"chr3",1,0.0155883731833099
"4794","chr3.64020000.64025000","chr3.64485000.64490000",465000,13,9.426911e-06,64020000,64485000,64025000,64490000,"chr3",154198,1,8,1,10,"chr3",1,0.0152367557430849
"4795","chr3.9105000.9110000","chr3.9280000.9285000",175000,21,5.925705e-08,9105000,9280000,9110000,9285000,"chr3",154245,1,0,0,1,"chr3",1,0.00246132208157525
"4796","chr3.182910000.182915000","chr3.183115000.183120000",205000,13,0.002384877,182910000,183115000,182915000,183120000,"chr3",154250,3,0,1,4,"chr3",1,0.00609470229723394
"4797","chr3.9095000.9100000","chr3.9130000.9135000",35000,28,0.003176334,9095000,9130000,9100000,9135000,"chr3",154258,0,6,6,12,"chr3",1,0.0393811533052039
"4798","chr3.149490000.149495000","chr3.149510000.149515000",20000,43,7.137249e-05,149490000,149510000,149495000,149515000,"chr3",154313,2,1,1,4,"chr3",1,0.0201593999062353
"4799","chr3.150495000.150500000","chr3.150860000.150865000",365000,12,0.0002655857,150495000,150860000,150500000,150865000,"chr3",154321,0,2,0,2,"chr3",1,0.00281293952180028
"4800","chr3.15670000.15675000","chr3.16100000.16105000",430000,10,0.002384877,15670000,16100000,15675000,16105000,"chr3",154329,1,1,1,3,"chr3",1,0.00351617440225035
"4801","chr3.50680000.50685000","chr3.51275000.51280000",595000,8,0.009475458,50680000,51275000,50685000,51280000,"chr3",154403,0,2,2,4,"chr3",1,0.00375058602906704
"4802","chr3.42095000.42100000","chr3.42135000.42140000",40000,30,8.198404e-05,42095000,42135000,42100000,42140000,"chr3",154425,0,2,2,4,"chr3",1,0.0140646976090014
"4803","chr3.9055000.9060000","chr3.9315000.9320000",260000,13,0.0004923911,9055000,9315000,9060000,9320000,"chr3",154435,0,6,4,10,"chr3",1,0.0152367557430849
"4804","chr3.48745000.48750000","chr3.48990000.48995000",245000,16,7.644431e-06,48745000,48990000,48750000,48995000,"chr3",154451,1,14,7,22,"chr3",1,0.0412564463197375
"4805","chr3.15220000.15225000","chr3.15240000.15245000",20000,39,0.001340184,15220000,15240000,15225000,15245000,"chr3",154498,2,1,1,4,"chr3",1,0.0182841068917018
"4806","chr3.40305000.40310000","chr3.40325000.40330000",20000,40,0.0006722116,40305000,40325000,40310000,40330000,"chr3",154565,0,0,2,2,"chr3",1,0.00937646507266761
"4807","chr3.194405000.194410000","chr3.194635000.194640000",230000,13,0.001125579,194405000,194635000,194410000,194640000,"chr3",154584,2,1,3,6,"chr3",1,0.00914205344585091
"4808","chr3.185685000.185690000","chr3.185990000.185995000",305000,13,0.000165018,185685000,185990000,185690000,185995000,"chr3",154608,1,11,9,21,"chr3",1,0.0319971870604782
"4809","chr3.191500000.191505000","chr3.192130000.192135000",630000,9,0.001511574,191500000,192130000,191505000,192135000,"chr3",154654,0,2,3,5,"chr3",1,0.00527426160337553
"4810","chr3.170305000.170310000","chr3.170520000.170525000",215000,12,0.006034057,170305000,170520000,170310000,170525000,"chr3",154700,0,1,4,5,"chr3",1,0.0070323488045007
"4811","chr3.194055000.194060000","chr3.194125000.194130000",70000,33,8.842586e-11,194055000,194125000,194060000,194130000,"chr3",154730,0,7,4,11,"chr3",1,0.0425457102672293
"4812","chr3.48035000.48040000","chr3.48135000.48140000",100000,21,1.668433e-05,48035000,48135000,48040000,48140000,"chr3",154732,5,9,14,28,"chr3",1,0.0689170182841069
"4813","chr3.47510000.47515000","chr3.48040000.48045000",530000,11,0.0001417511,47510000,48040000,47515000,48045000,"chr3",154750,2,10,9,21,"chr3",1,0.0270745428973277
"4814","chr3.182910000.182915000","chr3.183110000.183115000",200000,21,1.197003e-08,182910000,183110000,182915000,183115000,"chr3",154760,3,0,1,4,"chr3",1,0.00984528832630099
"4815","chr3.129485000.129490000","chr3.129535000.129540000",50000,31,9.294611e-07,129485000,129535000,129490000,129540000,"chr3",154829,0,0,3,3,"chr3",1,0.0109001406469761
"4816","chr3.57225000.57230000","chr3.57645000.57650000",420000,11,0.0005851413,57225000,57645000,57230000,57650000,"chr3",154830,0,3,1,4,"chr3",1,0.00515705578996718
"4817","chr3.185980000.185985000","chr3.186205000.186210000",225000,13,0.001315422,185980000,186205000,185985000,186210000,"chr3",154831,1,13,8,22,"chr3",1,0.0335208626347867
"4818","chr3.13355000.13360000","chr3.13490000.13495000",135000,21,8.833536e-07,13355000,13490000,13360000,13495000,"chr3",154896,0,1,3,4,"chr3",1,0.00984528832630099
"4819","chr3.170300000.170305000","chr3.170525000.170530000",225000,16,1.663915e-05,170300000,170525000,170305000,170530000,"chr3",154908,0,3,0,3,"chr3",1,0.00562587904360056
"4820","chr3.185685000.185690000","chr3.186275000.186280000",590000,10,0.0004118037,185685000,186275000,185690000,186280000,"chr3",154937,1,2,2,5,"chr3",1,0.00586029067041725
"4821","chr3.16325000.16330000","chr3.16600000.16605000",275000,17,4.387275e-07,16325000,16600000,16330000,16605000,"chr3",154975,0,0,1,1,"chr3",1,0.00199249882794187
"4822","chr3.182900000.182905000","chr3.183045000.183050000",145000,16,0.000546274,182900000,183045000,182905000,183050000,"chr3",154988,4,12,8,24,"chr3",1,0.0450070323488045
"4823","chr3.48805000.48810000","chr3.48945000.48950000",140000,17,0.0001918557,48805000,48945000,48810000,48950000,"chr3",155000,0,5,10,15,"chr3",1,0.029887482419128
"4824","chr3.52150000.52155000","chr3.52235000.52240000",85000,21,9.440884e-05,52150000,52235000,52155000,52240000,"chr3",155025,1,4,9,14,"chr3",1,0.0344585091420534
"4825","chr3.73025000.73030000","chr3.73085000.73090000",60000,23,0.0005056221,73025000,73085000,73030000,73090000,"chr3",155027,5,11,5,21,"chr3",1,0.0566104078762307
"4826","chr3.57995000.58000000","chr3.58220000.58225000",225000,14,0.0003297595,57995000,58220000,5.8e+07,58225000,"chr3",155028,3,11,15,29,"chr3",1,0.0475855602437881
"4827","chr3.177445000.177450000","chr3.177495000.177500000",50000,23,0.003458127,177445000,177495000,177450000,177500000,"chr3",155127,0,3,2,5,"chr3",1,0.0134786685419597
"4828","chr3.11700000.11705000","chr3.11820000.11825000",120000,15,0.005183894,11700000,11820000,11705000,11825000,"chr3",155139,6,18,16,40,"chr3",1,0.070323488045007
"4829","chr3.156380000.156385000","chr3.156540000.156545000",160000,16,0.0002774243,156380000,156540000,156385000,156545000,"chr3",155159,0,3,4,7,"chr3",1,0.0131270511017346
"4830","chr3.72890000.72895000","chr3.73115000.73120000",225000,13,0.001315422,72890000,73115000,72895000,73120000,"chr3",155172,3,8,10,21,"chr3",1,0.0319971870604782
"4831","chr3.176935000.176940000","chr3.177050000.177055000",115000,21,4.027894e-06,176935000,177050000,176940000,177055000,"chr3",155201,0,0,1,1,"chr3",1,0.00246132208157525
"4832","chr3.15265000.15270000","chr3.15460000.15465000",195000,15,0.0002431127,15265000,15460000,15270000,15465000,"chr3",155258,0,2,2,4,"chr3",1,0.0070323488045007
"4833","chr3.186205000.186210000","chr3.186265000.186270000",60000,21,0.003322656,186205000,186265000,186210000,186270000,"chr3",155273,0,7,6,13,"chr3",1,0.0319971870604782
"4834","chr3.186565000.186570000","chr3.186880000.186885000",315000,16,7.625814e-07,186565000,186880000,186570000,186885000,"chr3",155364,4,6,5,15,"chr3",1,0.0281293952180028
"4835","chr3.15305000.15310000","chr3.15355000.15360000",50000,33,7.841294e-08,15305000,15355000,15310000,15360000,"chr3",155391,8,11,19,38,"chr3",1,0.146976090014065
"4836","chr3.148910000.148915000","chr3.148990000.148995000",80000,23,1.618736e-05,148910000,148990000,148915000,148995000,"chr3",155393,0,2,1,3,"chr3",1,0.00808720112517581
"4837","chr3.42120000.42125000","chr3.42155000.42160000",35000,34,1.658086e-05,42120000,42155000,42125000,42160000,"chr3",155397,1,2,5,8,"chr3",1,0.0318799812470699
"4838","chr3.47820000.47825000","chr3.48040000.48045000",220000,12,0.005236669,47820000,48040000,47825000,48045000,"chr3",155401,2,26,18,46,"chr3",1,0.0646976090014065
"4839","chr3.40430000.40435000","chr3.40450000.40455000",20000,38,0.002618443,40430000,40450000,40435000,40455000,"chr3",155402,1,6,4,11,"chr3",1,0.0489920300046882
"4840","chr3.9045000.9050000","chr3.9350000.9355000",305000,11,0.00305279,9045000,9350000,9050000,9355000,"chr3",155416,1,3,2,6,"chr3",1,0.00773558368495077
"4841","chr3.10190000.10195000","chr3.10245000.10250000",55000,25,0.0001901332,10190000,10245000,10195000,10250000,"chr3",155481,5,15,17,37,"chr3",1,0.108415377402719
"4842","chr3.9130000.9135000","chr3.9170000.9175000",40000,35,3.967219e-07,9130000,9170000,9135000,9175000,"chr3",155520,0,2,3,5,"chr3",1,0.0205110173464604
"4843","chr3.13315000.13320000","chr3.13490000.13495000",175000,17,3.432161e-05,13315000,13490000,13320000,13495000,"chr3",155570,0,0,2,2,"chr3",1,0.00398499765588373
"4844","chr3.48030000.48035000","chr3.48135000.48140000",105000,20,3.833446e-05,48030000,48135000,48035000,48140000,"chr3",155573,7,19,24,50,"chr3",1,0.117205813408345
"4845","chr3.71015000.71020000","chr3.71565000.71570000",550000,11,0.0001116535,71015000,71565000,71020000,71570000,"chr3",155577,0,2,2,4,"chr3",1,0.00515705578996718
"4846","chr3.107970000.107975000","chr3.108010000.108015000",40000,25,0.006186759,107970000,108010000,107975000,108015000,"chr3",155582,0,2,0,2,"chr3",1,0.00586029067041725
"4847","chr3.48300000.48305000","chr3.48965000.48970000",665000,8,0.005775488,48300000,48965000,48305000,48970000,"chr3",155590,2,8,3,13,"chr3",1,0.0121894045944679
"4848","chr3.38160000.38165000","chr3.38520000.38525000",360000,11,0.001326227,38160000,38520000,38165000,38525000,"chr3",155654,0,8,5,13,"chr3",1,0.0167604313173933
"4849","chr3.66450000.66455000","chr3.66535000.66540000",85000,22,2.809741e-05,66450000,66535000,66455000,66540000,"chr3",155684,0,7,1,8,"chr3",1,0.0206282231598687
"4850","chr3.52030000.52035000","chr3.52240000.52245000",210000,14,0.000549876,52030000,52240000,52035000,52245000,"chr3",155690,8,14,13,35,"chr3",1,0.0574308485700891
"4851","chr3.42070000.42075000","chr3.42120000.42125000",50000,39,2.083524e-11,42070000,42120000,42075000,42125000,"chr3",155696,1,7,4,12,"chr3",1,0.0548523206751055
"4852","chr3.39485000.39490000","chr3.40325000.40330000",840000,10,3.776419e-05,39485000,40325000,39490000,40330000,"chr3",155699,1,0,2,3,"chr3",1,0.00351617440225035
"4853","chr3.107695000.107700000","chr3.108155000.108160000",460000,9,0.007212873,107695000,108155000,107700000,108160000,"chr3",155701,0,1,1,2,"chr3",1,0.00210970464135021
"4854","chr3.58175000.58180000","chr3.58285000.58290000",110000,19,9.123936e-05,58175000,58285000,58180000,58290000,"chr3",155733,0,4,0,4,"chr3",1,0.00890764181903422
"4855","chr3.156380000.156385000","chr3.156785000.156790000",405000,12,0.0001438276,156380000,156785000,156385000,156790000,"chr3",155767,0,2,3,5,"chr3",1,0.0070323488045007
"4856","chr3.9045000.9050000","chr3.9245000.9250000",200000,13,0.002787948,9045000,9245000,9050000,9250000,"chr3",155843,0,3,2,5,"chr3",1,0.00761837787154243
"4857","chr3.4525000.4530000","chr3.5050000.5055000",525000,9,0.003908625,4525000,5050000,4530000,5055000,"chr3",155898,1,2,1,4,"chr3",1,0.00421940928270042
"4858","chr3.170325000.170330000","chr3.170485000.170490000",160000,15,0.000990646,170325000,170485000,170330000,170490000,"chr3",155899,0,1,0,1,"chr3",1,0.00175808720112518
"4859","chr3.57995000.58000000","chr3.58290000.58295000",295000,14,4.244858e-05,57995000,58290000,5.8e+07,58295000,"chr3",155922,5,27,25,57,"chr3",1,0.0935302390998594
"4860","chr3.128495000.128500000","chr3.128605000.128610000",110000,16,0.003064209,128495000,128605000,128500000,128610000,"chr3",155949,2,0,2,4,"chr3",1,0.00750117205813408
"4861","chr3.185685000.185690000","chr3.186265000.186270000",580000,14,1.885982e-07,185685000,186265000,185690000,186270000,"chr3",155957,0,7,6,13,"chr3",1,0.0213314580403188
"4862","chr3.196770000.196775000","chr3.196975000.196980000",205000,14,0.0006595812,196770000,196975000,196775000,196980000,"chr3",156023,5,12,13,30,"chr3",1,0.0492264416315049
"4863","chr3.123375000.123380000","chr3.123435000.123440000",60000,21,0.003322656,123375000,123435000,123380000,123440000,"chr3",156109,3,3,5,11,"chr3",1,0.0270745428973277
"4864","chr3.188240000.188245000","chr3.188265000.188270000",25000,34,0.006479597,188240000,188265000,188245000,188270000,"chr3",156150,0,3,1,4,"chr3",1,0.0159399906235349
"4865","chr3.170415000.170420000","chr3.170525000.170530000",110000,21,6.270054e-06,170415000,170525000,170420000,170530000,"chr3",156348,1,6,1,8,"chr3",1,0.019690576652602
"4866","chr3.16135000.16140000","chr3.16265000.16270000",130000,14,0.009475458,16135000,16265000,16140000,16270000,"chr3",156385,0,3,3,6,"chr3",1,0.00984528832630099
"4867","chr3.52040000.52045000","chr3.52150000.52155000",110000,17,0.001012851,52040000,52150000,52045000,52155000,"chr3",156430,0,9,11,20,"chr3",1,0.0398499765588373
"4868","chr3.183635000.183640000","chr3.183695000.183700000",60000,21,0.003322656,183635000,183695000,183640000,183700000,"chr3",156498,4,19,7,30,"chr3",1,0.0738396624472574
"4869","chr3.48605000.48610000","chr3.48745000.48750000",140000,14,0.006633655,48605000,48745000,48610000,48750000,"chr3",156539,3,14,26,43,"chr3",1,0.0705578996718237
"4870","chr3.69235000.69240000","chr3.69305000.69310000",70000,21,0.0006845089,69235000,69305000,69240000,69310000,"chr3",156561,3,9,3,15,"chr3",1,0.0369198312236287
"4871","chr3.47910000.47915000","chr3.48190000.48195000",280000,20,1.11437e-09,47910000,48190000,47915000,48195000,"chr3",156620,1,3,3,7,"chr3",1,0.0164088138771683
"4872","chr3.170415000.170420000","chr3.170520000.170525000",105000,16,0.004113739,170415000,170520000,170420000,170525000,"chr3",156676,0,1,4,5,"chr3",1,0.00937646507266761
"4873","chr3.48035000.48040000","chr3.48190000.48195000",155000,23,7.924264e-09,48035000,48190000,48040000,48195000,"chr3",156678,5,9,14,28,"chr3",1,0.0754805438349742
"4874","chr3.185935000.185940000","chr3.186265000.186270000",330000,15,3.188832e-06,185935000,186265000,185940000,186270000,"chr3",156766,0,5,6,11,"chr3",1,0.0193389592123769
"4875","chr3.9120000.9125000","chr3.9345000.9350000",225000,12,0.004617662,9120000,9345000,9125000,9350000,"chr3",156775,0,8,7,15,"chr3",1,0.0210970464135021
"4876","chr3.149480000.149485000","chr3.149665000.149670000",185000,19,9.263421e-07,149480000,149665000,149485000,149670000,"chr3",156800,0,8,3,11,"chr3",1,0.0244960150023441
"4877","chr3.52445000.52450000","chr3.52705000.52710000",260000,13,0.0004923911,52445000,52705000,52450000,52710000,"chr3",156902,1,1,2,4,"chr3",1,0.00609470229723394
"4878","chr3.42640000.42645000","chr3.42680000.42685000",40000,41,2.271736e-10,42640000,42680000,42645000,42685000,"chr3",156932,0,2,1,3,"chr3",1,0.0144163150492264
"4879","chr3.4740000.4745000","chr3.5050000.5055000",310000,15,5.320668e-06,4740000,5050000,4745000,5055000,"chr3",156950,6,15,8,29,"chr3",1,0.0509845288326301
"4880","chr3.25695000.25700000","chr3.25830000.25835000",135000,14,0.00790472,25695000,25830000,25700000,25835000,"chr3",157127,0,4,7,11,"chr3",1,0.0180496952648851
"4881","chr3.141050000.141055000","chr3.141260000.141265000",210000,14,0.000549876,141050000,141260000,141055000,141265000,"chr3",157163,0,0,6,6,"chr3",1,0.00984528832630099
"4882","chr3.171615000.171620000","chr3.171955000.171960000",340000,10,0.006827181,171615000,171955000,171620000,171960000,"chr3",157208,0,6,2,8,"chr3",1,0.00937646507266761
"4883","chr3.179345000.179350000","chr3.180115000.180120000",770000,10,7.238585e-05,179345000,180115000,179350000,180120000,"chr3",157214,1,2,3,6,"chr3",1,0.0070323488045007
"4884","chr3.186010000.186015000","chr3.186265000.186270000",255000,12,0.002195056,186010000,186265000,186015000,186270000,"chr3",157216,0,7,3,10,"chr3",1,0.0140646976090014
"4885","chr3.129400000.129405000","chr3.129480000.129485000",80000,21,0.0001777811,129400000,129480000,129405000,129485000,"chr3",157242,3,10,9,22,"chr3",1,0.0541490857946554
"4886","chr3.149270000.149275000","chr3.149330000.149335000",60000,20,0.00785248,149270000,149330000,149275000,149335000,"chr3",157249,0,4,3,7,"chr3",1,0.0164088138771683
"4887","chr3.11465000.11470000","chr3.11665000.11670000",200000,17,1.030296e-05,11465000,11665000,11470000,11670000,"chr3",157314,2,5,10,17,"chr3",1,0.0338724800750117
"4888","chr3.107150000.107155000","chr3.107235000.107240000",85000,26,1.256139e-07,107150000,107235000,107155000,107240000,"chr3",157398,0,1,2,3,"chr3",1,0.00914205344585091
"4889","chr3.171580000.171585000","chr3.171955000.171960000",375000,14,7.455936e-06,171580000,171955000,171585000,171960000,"chr3",157412,0,5,2,7,"chr3",1,0.0114861697140178
"4890","chr3.196410000.196415000","chr3.196440000.196445000",30000,32,0.001484935,196410000,196440000,196415000,196445000,"chr3",157425,0,15,11,26,"chr3",1,0.0975152367557431
"4891","chr3.69235000.69240000","chr3.69270000.69275000",35000,30,0.000645626,69235000,69270000,69240000,69275000,"chr3",157490,2,9,3,14,"chr3",1,0.0492264416315049
"4892","chr3.129380000.129385000","chr3.129535000.129540000",155000,26,3.488857e-11,129380000,129535000,129385000,129540000,"chr3",157528,2,6,5,13,"chr3",1,0.0396155649320206
"4893","chr3.15860000.15865000","chr3.16265000.16270000",405000,14,4.235862e-06,15860000,16265000,15865000,16270000,"chr3",157572,0,5,3,8,"chr3",1,0.0131270511017346
"4894","chr3.155850000.155855000","chr3.156790000.156795000",940000,7,0.005059498,155850000,156790000,155855000,156795000,"chr3",157615,3,9,4,16,"chr3",1,0.0131270511017346
"4895","chr3.195150000.195155000","chr3.195260000.195265000",110000,18,0.0003132279,195150000,195260000,195155000,195265000,"chr3",157656,0,3,1,4,"chr3",1,0.00843881856540084
"4896","chr3.9805000.9810000","chr3.9945000.9950000",140000,14,0.006633655,9805000,9945000,9810000,9950000,"chr3",157671,2,1,3,6,"chr3",1,0.00984528832630099
"4897","chr3.65440000.65445000","chr3.65620000.65625000",180000,20,2.357379e-07,65440000,65620000,65445000,65625000,"chr3",157693,0,3,4,7,"chr3",1,0.0164088138771683
"4898","chr3.65440000.65445000","chr3.65575000.65580000",135000,19,1.666711e-05,65440000,65575000,65445000,65580000,"chr3",157781,0,3,0,3,"chr3",1,0.00668073136427567
"4899","chr3.194395000.194400000","chr3.195260000.195265000",865000,7,0.008031451,194395000,195260000,194400000,195265000,"chr3",157834,0,3,1,4,"chr3",1,0.00328176277543366
"4900","chr3.15860000.15865000","chr3.16270000.16275000",410000,15,5.662223e-07,15860000,16270000,15865000,16275000,"chr3",157837,2,5,2,9,"chr3",1,0.0158227848101266
"4901","chr3.58430000.58435000","chr3.58495000.58500000",65000,22,0.000549876,58430000,58495000,58435000,58500000,"chr3",157844,4,14,8,26,"chr3",1,0.0670417252695734
"4902","chr3.150005000.150010000","chr3.150095000.150100000",90000,19,0.000549876,150005000,150095000,150010000,150100000,"chr3",157846,0,2,0,2,"chr3",1,0.00445382090951711
"4903","chr3.183245000.183250000","chr3.183285000.183290000",40000,25,0.006186759,183245000,183285000,183250000,183290000,"chr3",157862,0,2,3,5,"chr3",1,0.0146507266760431
"4904","chr3.62045000.62050000","chr3.62090000.62095000",45000,25,0.00175765,62045000,62090000,62050000,62095000,"chr3",157934,0,1,1,2,"chr3",1,0.00586029067041725
"4905","chr3.72010000.72015000","chr3.72845000.72850000",835000,9,0.0002891737,72010000,72845000,72015000,72850000,"chr3",157956,0,7,12,19,"chr3",1,0.020042194092827
"4906","chr3.124510000.124515000","chr3.125120000.125125000",610000,8,0.008490973,124510000,125120000,124515000,125125000,"chr3",157980,0,2,2,4,"chr3",1,0.00375058602906704
"4907","chr3.64020000.64025000","chr3.64435000.64440000",415000,10,0.002831847,64020000,64435000,64025000,64440000,"chr3",157993,0,3,4,7,"chr3",1,0.00820440693858415
"4908","chr3.196070000.196075000","chr3.196175000.196180000",105000,25,2.831442e-08,196070000,196175000,196075000,196180000,"chr3",158003,5,14,19,38,"chr3",1,0.111345522737928
"4909","chr3.66470000.66475000","chr3.66535000.66540000",65000,30,3.204772e-08,66470000,66535000,66475000,66540000,"chr3",158028,1,2,1,4,"chr3",1,0.0140646976090014
"4910","chr3.47600000.47605000","chr3.47800000.47805000",200000,19,3.964533e-07,47600000,47800000,47605000,47805000,"chr3",158036,2,10,4,16,"chr3",1,0.0356305672761369
"4911","chr3.49780000.49785000","chr3.49800000.49805000",20000,43,7.137249e-05,49780000,49800000,49785000,49805000,"chr3",158055,2,2,5,9,"chr3",1,0.0453586497890295
"4912","chr3.124660000.124665000","chr3.125125000.125130000",465000,10,0.001576659,124660000,125125000,124665000,125130000,"chr3",158114,1,8,11,20,"chr3",1,0.023441162681669
"4913","chr3.15270000.15275000","chr3.15425000.15430000",155000,14,0.003881213,15270000,15425000,15275000,15430000,"chr3",158225,4,14,6,24,"chr3",1,0.0393811533052039
"4914","chr3.149270000.149275000","chr3.149370000.149375000",100000,18,0.0006749162,149270000,149370000,149275000,149375000,"chr3",158247,1,5,3,9,"chr3",1,0.0189873417721519
"4915","chr3.15670000.15675000","chr3.16290000.16295000",620000,8,0.00790447,15670000,16290000,15675000,16295000,"chr3",158274,1,3,3,7,"chr3",1,0.00656352555086732
"4916","chr3.179560000.179565000","chr3.180280000.180285000",720000,8,0.003937474,179560000,180280000,179565000,180285000,"chr3",158294,3,5,6,14,"chr3",1,0.0131270511017346
"4917","chr3.66470000.66475000","chr3.66840000.66845000",370000,10,0.004741344,66470000,66840000,66475000,66845000,"chr3",158308,1,2,1,4,"chr3",1,0.0046882325363338
"4918","chr3.177340000.177345000","chr3.177490000.177495000",150000,20,1.523212e-06,177340000,177490000,177345000,177495000,"chr3",158332,0,3,3,6,"chr3",1,0.0140646976090014
"4919","chr3.149490000.149495000","chr3.149530000.149535000",40000,27,0.001256406,149490000,149530000,149495000,149535000,"chr3",158400,2,1,1,4,"chr3",1,0.0126582278481013
"4920","chr3.50270000.50275000","chr3.50300000.50305000",30000,40,1.22161e-06,50270000,50300000,50275000,50305000,"chr3",158428,3,11,7,21,"chr3",1,0.0984528832630098
"4921","chr3.182900000.182905000","chr3.183110000.183115000",210000,26,3.105922e-13,182900000,183110000,182905000,183115000,"chr3",158431,4,18,16,38,"chr3",1,0.115799343647445
"4922","chr3.58205000.58210000","chr3.58285000.58290000",80000,30,7.847368e-10,58205000,58285000,58210000,58290000,"chr3",158444,3,10,3,16,"chr3",1,0.0562587904360056
"4923","chr3.72010000.72015000","chr3.72275000.72280000",265000,12,0.001725161,72010000,72275000,72015000,72280000,"chr3",158487,3,7,8,18,"chr3",1,0.0253164556962025
"4924","chr3.11460000.11465000","chr3.11710000.11715000",250000,13,0.0006444882,11460000,11710000,11465000,11715000,"chr3",158567,2,2,6,10,"chr3",1,0.0152367557430849
"4925","chr3.47570000.47575000","chr3.47800000.47805000",230000,17,2.647193e-06,47570000,47800000,47575000,47805000,"chr3",158576,2,10,4,16,"chr3",1,0.0318799812470699
"4926","chr3.170305000.170310000","chr3.170525000.170530000",220000,18,7.779629e-07,170305000,170525000,170310000,170530000,"chr3",158610,1,6,1,8,"chr3",1,0.0168776371308017
"4927","chr3.107150000.107155000","chr3.107265000.107270000",115000,19,6.249718e-05,107150000,107265000,107155000,107270000,"chr3",158634,1,1,0,2,"chr3",1,0.00445382090951711
"4928","chr3.63340000.63345000","chr3.63790000.63795000",450000,12,7.311888e-05,63340000,63790000,63345000,63795000,"chr3",158641,0,0,4,4,"chr3",1,0.00562587904360056
"4929","chr3.52030000.52035000","chr3.52150000.52155000",120000,33,2.056782e-15,52030000,52150000,52035000,52155000,"chr3",158650,6,14,13,33,"chr3",1,0.127637130801688
"4930","chr3.195130000.195135000","chr3.195150000.195155000",20000,40,0.0006722116,195130000,195150000,195135000,195155000,"chr3",158669,0,3,4,7,"chr3",1,0.0328176277543366
"4931","chr3.47510000.47515000","chr3.47825000.47830000",315000,15,4.657615e-06,47510000,47825000,47515000,47830000,"chr3",158710,2,7,9,18,"chr3",1,0.0316455696202532
"4932","chr3.48040000.48045000","chr3.48960000.48965000",920000,7,0.005790329,48040000,48960000,48045000,48965000,"chr3",158769,2,20,2,24,"chr3",1,0.019690576652602
"4933","chr3.149245000.149250000","chr3.149370000.149375000",125000,19,3.118809e-05,149245000,149370000,149250000,149375000,"chr3",158791,1,3,0,4,"chr3",1,0.00890764181903422
"4934","chr3.138360000.138365000","chr3.138415000.138420000",55000,21,0.007608433,138360000,138415000,138365000,138420000,"chr3",158795,3,1,6,10,"chr3",1,0.0246132208157525
"4935","chr3.184015000.184020000","chr3.184035000.184040000",20000,56,3.035982e-10,184015000,184035000,184020000,184040000,"chr3",158822,0,6,3,9,"chr3",1,0.0590717299578059
"4936","chr3.9045000.9050000","chr3.9300000.9305000",255000,11,0.007772406,9045000,9300000,9050000,9305000,"chr3",158858,0,4,3,7,"chr3",1,0.00902484763244257
"4937","chr3.42650000.42655000","chr3.42805000.42810000",155000,14,0.003881213,42650000,42805000,42655000,42810000,"chr3",158875,1,5,4,10,"chr3",1,0.0164088138771683
"4938","chr3.9195000.9200000","chr3.9300000.9305000",105000,19,0.000136608,9195000,9300000,9200000,9305000,"chr3",158942,0,2,3,5,"chr3",1,0.0111345522737928
"4939","chr3.47615000.47620000","chr3.47820000.47825000",205000,13,0.002384877,47615000,47820000,47620000,47825000,"chr3",158960,2,6,6,14,"chr3",1,0.0213314580403188
"4940","chr3.52035000.52040000","chr3.52160000.52165000",125000,40,3.490133e-22,52035000,52160000,52040000,52165000,"chr3",159023,1,1,3,5,"chr3",1,0.023441162681669
"4941","chr3.190860000.190865000","chr3.190880000.190885000",20000,38,0.002618443,190860000,190880000,190865000,190885000,"chr3",159066,0,2,3,5,"chr3",1,0.0222691045475856
"4942","chr3.129380000.129385000","chr3.129490000.129495000",110000,19,9.123936e-05,129380000,129490000,129385000,129495000,"chr3",159211,2,3,5,10,"chr3",1,0.0222691045475856
"4943","chr3.47510000.47515000","chr3.47835000.47840000",325000,14,2.07099e-05,47510000,47835000,47515000,47840000,"chr3",159274,2,10,9,21,"chr3",1,0.0344585091420534
"4944","chr3.58320000.58325000","chr3.58420000.58425000",100000,17,0.002026797,58320000,58420000,58325000,58425000,"chr3",159310,0,3,2,5,"chr3",1,0.00996249413970933
"4945","chr3.13135000.13140000","chr3.13330000.13335000",195000,16,5.924665e-05,13135000,13330000,13140000,13335000,"chr3",159345,5,4,9,18,"chr3",1,0.0337552742616034
"4946","chr3.56735000.56740000","chr3.56810000.56815000",75000,20,0.0009906659,56735000,56810000,56740000,56815000,"chr3",159451,0,4,3,7,"chr3",1,0.0164088138771683
"4947","chr3.58165000.58170000","chr3.58285000.58290000",120000,31,1.046501e-13,58165000,58285000,58170000,58290000,"chr3",159513,3,7,4,14,"chr3",1,0.0508673230192218
"4948","chr3.58010000.58015000","chr3.58205000.58210000",195000,13,0.003248518,58010000,58205000,58015000,58210000,"chr3",159537,0,8,3,11,"chr3",1,0.0167604313173933
"4949","chr3.52035000.52040000","chr3.52140000.52145000",105000,31,1.021541e-12,52035000,52140000,52040000,52145000,"chr3",159561,2,1,2,5,"chr3",1,0.0181669010782935
"4950","chr3.47865000.47870000","chr3.48040000.48045000",175000,18,7.722424e-06,47865000,48040000,47870000,48045000,"chr3",159641,0,4,3,7,"chr3",1,0.0147679324894515
"4951","chr3.184295000.184300000","chr3.184445000.184450000",150000,16,0.0004339232,184295000,184445000,184300000,184450000,"chr3",159649,3,19,15,37,"chr3",1,0.0693858415377403
"4952","chr3.42680000.42685000","chr3.42830000.42835000",150000,14,0.004648401,42680000,42830000,42685000,42835000,"chr3",159721,1,13,5,19,"chr3",1,0.0311767463666198
"4953","chr3.51970000.51975000","chr3.52025000.52030000",55000,22,0.003264775,51970000,52025000,51975000,52030000,"chr3",159747,0,5,4,9,"chr3",1,0.0232067510548523
"4954","chr3.195990000.195995000","chr3.196250000.196255000",260000,13,0.0004923911,195990000,196250000,195995000,196255000,"chr3",159752,6,13,10,29,"chr3",1,0.0441865916549461
"4955","chr3.15240000.15245000","chr3.15375000.15380000",135000,20,3.976439e-06,15240000,15375000,15245000,15380000,"chr3",159756,2,1,1,4,"chr3",1,0.00937646507266761
"4956","chr3.11380000.11385000","chr3.11805000.11810000",425000,10,0.00254534,11380000,11805000,11385000,11810000,"chr3",159869,1,2,4,7,"chr3",1,0.00820440693858415
"4957","chr3.23970000.23975000","chr3.23990000.23995000",20000,38,0.002618443,23970000,23990000,23975000,23995000,"chr3",159888,3,7,4,14,"chr3",1,0.0623534927332396
"4958","chr3.58320000.58325000","chr3.58340000.58345000",20000,50,1.470923e-07,58320000,58340000,58325000,58345000,"chr3",159899,3,13,18,34,"chr3",1,0.199249882794187
"4959","chr3.47890000.47895000","chr3.48035000.48040000",145000,17,0.0001510112,47890000,48035000,47895000,48040000,"chr3",159924,0,0,3,3,"chr3",1,0.0059774964838256
"4960","chr3.36765000.36770000","chr3.36990000.36995000",225000,12,0.004617662,36765000,36990000,36770000,36995000,"chr3",159964,0,1,1,2,"chr3",1,0.00281293952180028
"4961","chr3.194405000.194410000","chr3.194985000.194990000",580000,21,8.455136e-15,194405000,194985000,194410000,194990000,"chr3",159975,2,1,3,6,"chr3",1,0.0147679324894515
"4962","chr3.112785000.112790000","chr3.113010000.113015000",225000,18,6.095713e-07,112785000,113010000,112790000,113015000,"chr3",160014,0,0,4,4,"chr3",1,0.00843881856540084
"4963","chr3.72405000.72410000","chr3.72845000.72850000",440000,12,8.472501e-05,72405000,72845000,72410000,72850000,"chr3",160063,0,1,1,2,"chr3",1,0.00281293952180028
"4964","chr3.15655000.15660000","chr3.15765000.15770000",110000,15,0.008416159,15655000,15765000,15660000,15770000,"chr3",160074,2,8,3,13,"chr3",1,0.0228551336146273
"4965","chr3.9045000.9050000","chr3.9105000.9110000",60000,28,1.80414e-06,9045000,9105000,9050000,9110000,"chr3",160096,2,0,0,2,"chr3",1,0.00656352555086732
"4966","chr3.52070000.52075000","chr3.52140000.52145000",70000,23,7.897084e-05,52070000,52140000,52075000,52145000,"chr3",160171,1,2,1,4,"chr3",1,0.0107829348335677
"4967","chr3.66465000.66470000","chr3.66535000.66540000",70000,29,3.504729e-08,66465000,66535000,66470000,66540000,"chr3",160173,3,5,9,17,"chr3",1,0.0577824660103141
"4968","chr3.129400000.129405000","chr3.129490000.129495000",90000,27,1.178217e-08,129400000,129490000,129405000,129495000,"chr3",160203,7,3,15,25,"chr3",1,0.0791139240506329
"4969","chr3.51970000.51975000","chr3.52005000.52010000",35000,27,0.006592248,51970000,52005000,51975000,52010000,"chr3",160256,4,14,17,35,"chr3",1,0.110759493670886
"4970","chr3.24045000.24050000","chr3.24225000.24230000",180000,16,0.0001126944,24045000,24225000,24050000,24230000,"chr3",160257,2,9,8,19,"chr3",1,0.0356305672761369
"4971","chr3.72155000.72160000","chr3.72175000.72180000",20000,40,0.0006722116,72155000,72175000,72160000,72180000,"chr3",160286,0,4,1,5,"chr3",1,0.023441162681669
"4972","chr3.170870000.170875000","chr3.171180000.171185000",310000,18,1.948513e-08,170870000,171180000,170875000,171185000,"chr3",160302,2,4,2,8,"chr3",1,0.0168776371308017
"4973","chr3.170415000.170420000","chr3.170485000.170490000",70000,21,0.0006845089,170415000,170485000,170420000,170490000,"chr3",160311,0,1,0,1,"chr3",1,0.00246132208157525
"4974","chr3.58215000.58220000","chr3.58285000.58290000",70000,34,1.785319e-11,58215000,58285000,58220000,58290000,"chr3",160351,3,19,11,33,"chr3",1,0.131504922644163
"4975","chr3.149350000.149355000","chr3.149370000.149375000",20000,37,0.004863644,149350000,149370000,149355000,149375000,"chr3",160388,1,2,3,6,"chr3",1,0.0260196905766526
"4976","chr3.37030000.37035000","chr3.37210000.37215000",180000,19,1.215125e-06,37030000,37210000,37035000,37215000,"chr3",160400,4,12,6,22,"chr3",1,0.0489920300046882
"4977","chr3.42740000.42745000","chr3.42770000.42775000",30000,41,4.387275e-07,42740000,42770000,42745000,42775000,"chr3",160414,4,11,11,26,"chr3",1,0.124941397093296
"4978","chr3.42805000.42810000","chr3.42830000.42835000",25000,49,1.800369e-08,42805000,42830000,42810000,42835000,"chr3",160503,1,14,18,33,"chr3",1,0.189521800281294
"4979","chr3.193590000.193595000","chr3.193610000.193615000",20000,39,0.001340184,193590000,193610000,193595000,193615000,"chr3",160507,0,3,3,6,"chr3",1,0.0274261603375527
"4980","chr3.47780000.47785000","chr3.47800000.47805000",20000,39,0.001340184,47780000,47800000,47785000,47805000,"chr3",160508,2,10,4,16,"chr3",1,0.0731364275668073
"4981","chr3.9055000.9060000","chr3.9170000.9175000",115000,23,2.060607e-07,9055000,9170000,9060000,9175000,"chr3",160536,0,2,3,5,"chr3",1,0.0134786685419597
"4982","chr3.157335000.157340000","chr3.158110000.158115000",775000,9,0.0004687944,157335000,158110000,157340000,158115000,"chr3",160701,0,0,1,1,"chr3",1,0.00105485232067511
"4983","chr3.159625000.159630000","chr3.160220000.160225000",595000,8,0.009475458,159625000,160220000,159630000,160225000,"chr3",160713,0,2,0,2,"chr3",1,0.00187529301453352
"4984","chr3.71955000.71960000","chr3.72820000.72825000",865000,12,3.524155e-07,71955000,72820000,71960000,72825000,"chr3",160725,0,0,3,3,"chr3",1,0.00421940928270042
"4985","chr3.149550000.149555000","chr3.149580000.149585000",30000,32,0.001484935,149550000,149580000,149555000,149585000,"chr3",160737,0,2,3,5,"chr3",1,0.0187529301453352
"4986","chr3.47570000.47575000","chr3.47825000.47830000",255000,35,3.122688e-24,47570000,47825000,47575000,47830000,"chr3",160784,4,7,15,26,"chr3",1,0.106657290201594
"4987","chr3.4740000.4745000","chr3.5070000.5075000",330000,14,1.851616e-05,4740000,5070000,4745000,5075000,"chr3",160834,3,11,10,24,"chr3",1,0.0393811533052039
"4988","chr3.185975000.185980000","chr3.186220000.186225000",245000,17,1.406173e-06,185975000,186220000,185980000,186225000,"chr3",160918,0,5,6,11,"chr3",1,0.0219174871073605
"4989","chr3.11695000.11700000","chr3.11835000.11840000",140000,15,0.002219268,11695000,11835000,11700000,11840000,"chr3",160937,0,8,2,10,"chr3",1,0.0175808720112518
"4990","chr3.115900000.115905000","chr3.116095000.116100000",195000,13,0.003248518,115900000,116095000,115905000,116100000,"chr3",160955,0,2,0,2,"chr3",1,0.00304735114861697
"4991","chr3.9120000.9125000","chr3.9280000.9285000",160000,18,1.707842e-05,9120000,9280000,9125000,9285000,"chr3",160970,0,5,6,11,"chr3",1,0.0232067510548523
"4992","chr3.149610000.149615000","chr3.149895000.149900000",285000,14,5.542697e-05,149610000,149895000,149615000,149900000,"chr3",161002,2,7,4,13,"chr3",1,0.0213314580403188
"4993","chr3.183245000.183250000","chr3.183425000.183430000",180000,13,0.005183894,183245000,183425000,183250000,183430000,"chr3",161072,1,2,4,7,"chr3",1,0.0106657290201594
"4994","chr3.129535000.129540000","chr3.129650000.129655000",115000,17,0.0007311562,129535000,129650000,129540000,129655000,"chr3",161107,0,0,6,6,"chr3",1,0.0119549929676512
"4995","chr3.13135000.13140000","chr3.13495000.13500000",360000,17,3.345532e-08,13135000,13495000,13140000,13500000,"chr3",161203,0,4,4,8,"chr3",1,0.0159399906235349
"4996","chr3.11480000.11485000","chr3.11665000.11670000",185000,18,4.582831e-06,11480000,11665000,11485000,11670000,"chr3",161245,4,5,6,15,"chr3",1,0.0316455696202532
"4997","chr3.15685000.15690000","chr3.15815000.15820000",130000,18,8.835065e-05,15685000,15815000,15690000,15820000,"chr3",161271,3,3,8,14,"chr3",1,0.029535864978903
"4998","chr3.155860000.155865000","chr3.156180000.156185000",320000,12,0.0005595817,155860000,156180000,155865000,156185000,"chr3",161339,0,2,0,2,"chr3",1,0.00281293952180028
"4999","chr3.107150000.107155000","chr3.107370000.107375000",220000,13,0.001492164,107150000,107370000,107155000,107375000,"chr3",161415,1,1,2,4,"chr3",1,0.00609470229723394
"5000","chr3.42640000.42645000","chr3.42760000.42765000",120000,21,2.640948e-06,42640000,42760000,42645000,42765000,"chr3",161508,0,2,1,3,"chr3",1,0.00738396624472574
"5001","chr3.185555000.185560000","chr3.185605000.185610000",50000,24,0.001456577,185555000,185605000,185560000,185610000,"chr3",161590,3,13,13,29,"chr3",1,0.0815752461322082
"5002","chr3.9070000.9075000","chr3.9280000.9285000",210000,14,0.000549876,9070000,9280000,9075000,9285000,"chr3",161608,1,2,2,5,"chr3",1,0.00820440693858415
"5003","chr3.69405000.69410000","chr3.69430000.69435000",25000,59,1.630693e-13,69405000,69430000,69410000,69435000,"chr3",161658,0,1,1,2,"chr3",1,0.0138302859821847
"5004","chr3.20070000.20075000","chr3.20185000.20190000",115000,15,0.006587037,20070000,20185000,20075000,20190000,"chr3",161721,0,2,6,8,"chr3",1,0.0140646976090014
"5005","chr3.107760000.107765000","chr3.108220000.108225000",460000,9,0.007212873,107760000,108220000,107765000,108225000,"chr3",161733,2,3,6,11,"chr3",1,0.0116033755274262
"5006","chr3.58175000.58180000","chr3.58215000.58220000",40000,28,0.0005285764,58175000,58215000,58180000,58220000,"chr3",161765,0,4,0,4,"chr3",1,0.0131270511017346
"5007","chr3.129400000.129405000","chr3.129560000.129565000",160000,19,3.883486e-06,129400000,129560000,129405000,129565000,"chr3",161834,6,3,3,12,"chr3",1,0.0267229254571027
"5008","chr3.47610000.47615000","chr3.47825000.47830000",215000,17,5.243294e-06,47610000,47825000,47615000,47830000,"chr3",161870,0,1,3,4,"chr3",1,0.00796999531176746
"5009","chr3.129440000.129445000","chr3.129460000.129465000",20000,38,0.002618443,129440000,129460000,129445000,129465000,"chr3",161921,0,4,2,6,"chr3",1,0.0267229254571027
"5010","chr3.11430000.11435000","chr3.11700000.11705000",270000,11,0.005745101,11430000,11700000,11435000,11705000,"chr3",161951,3,4,5,12,"chr3",1,0.0154711673699015
"5011","chr3.118945000.118950000","chr3.119195000.119200000",250000,12,0.002492257,118945000,119195000,118950000,119200000,"chr3",162075,0,3,5,8,"chr3",1,0.0112517580872011
"5012","chr3.184275000.184280000","chr3.184440000.184445000",165000,18,1.326087e-05,184275000,184440000,184280000,184445000,"chr3",162087,0,4,2,6,"chr3",1,0.0126582278481013
"5013","chr3.51350000.51355000","chr3.51385000.51390000",35000,28,0.003176334,51350000,51385000,51355000,51390000,"chr3",162139,0,5,1,6,"chr3",1,0.019690576652602
"5014","chr3.69385000.69390000","chr3.69430000.69435000",45000,24,0.004086146,69385000,69430000,69390000,69435000,"chr3",162142,0,3,1,4,"chr3",1,0.0112517580872011
"5015","chr3.15670000.15675000","chr3.15855000.15860000",185000,21,3.108764e-08,15670000,15855000,15675000,15860000,"chr3",162225,0,3,1,4,"chr3",1,0.00984528832630099
"5016","chr3.197530000.197535000","chr3.197555000.197560000",25000,34,0.006479597,197530000,197555000,197535000,197560000,"chr3",162244,0,7,3,10,"chr3",1,0.0398499765588373
"5017","chr3.71890000.71895000","chr3.72830000.72835000",940000,8,0.0008253607,71890000,72830000,71895000,72835000,"chr3",162256,1,1,2,4,"chr3",1,0.00375058602906704
"5018","chr3.107280000.107285000","chr3.107385000.107390000",105000,22,2.510629e-06,107280000,107385000,107285000,107390000,"chr3",162257,0,1,2,3,"chr3",1,0.00773558368495077
"5019","chr3.185730000.185735000","chr3.186325000.186330000",595000,8,0.009475458,185730000,186325000,185735000,186330000,"chr3",162314,4,8,7,19,"chr3",1,0.0178152836380684
"5020","chr3.185980000.185985000","chr3.186235000.186240000",255000,12,0.002195056,185980000,186235000,185985000,186240000,"chr3",162338,1,4,2,7,"chr3",1,0.00984528832630099
"5021","chr3.5015000.5020000","chr3.5070000.5075000",55000,30,6.465395e-07,5015000,5070000,5020000,5075000,"chr3",162350,3,11,6,20,"chr3",1,0.070323488045007
"5022","chr3.107390000.107395000","chr3.107450000.107455000",60000,43,2.775421e-16,107390000,107450000,107395000,107455000,"chr3",162358,1,3,4,8,"chr3",1,0.0403187998124707
"5023","chr3.197530000.197535000","chr3.197550000.197555000",20000,36,0.008858162,197530000,197550000,197535000,197555000,"chr3",162363,0,6,2,8,"chr3",1,0.0337552742616034
"5024","chr3.72990000.72995000","chr3.73115000.73120000",125000,24,1.65902e-08,72990000,73115000,72995000,73120000,"chr3",162374,4,11,8,23,"chr3",1,0.0646976090014065
"5025","chr3.72010000.72015000","chr3.72435000.72440000",425000,14,2.88045e-06,72010000,72435000,72015000,72440000,"chr3",162448,1,4,5,10,"chr3",1,0.0164088138771683
"5026","chr3.52770000.52775000","chr3.53110000.53115000",340000,12,0.0003959698,52770000,53110000,52775000,53115000,"chr3",162500,1,6,3,10,"chr3",1,0.0140646976090014
"5027","chr3.129400000.129405000","chr3.129650000.129655000",250000,14,0.0001508008,129400000,129650000,129405000,129655000,"chr3",162529,0,0,6,6,"chr3",1,0.00984528832630099
"5028","chr3.40300000.40305000","chr3.40325000.40330000",25000,35,0.003377467,40300000,40325000,40305000,40330000,"chr3",162586,1,0,2,3,"chr3",1,0.0123066104078762
"5029","chr3.149480000.149485000","chr3.149525000.149530000",45000,64,1.255191e-28,149480000,149525000,149485000,149530000,"chr3",162668,1,3,2,6,"chr3",1,0.0450070323488045
"5030","chr3.48035000.48040000","chr3.48130000.48135000",95000,18,0.001035316,48035000,48130000,48040000,48135000,"chr3",162673,5,9,14,28,"chr3",1,0.0590717299578059
"5031","chr3.171785000.171790000","chr3.171825000.171830000",40000,26,0.002831847,171785000,171825000,171790000,171830000,"chr3",162706,0,0,3,3,"chr3",1,0.00914205344585091
"5032","chr3.170325000.170330000","chr3.170410000.170415000",85000,24,2.056909e-06,170325000,170410000,170330000,170415000,"chr3",162849,1,10,2,13,"chr3",1,0.0365682137834037
"5033","chr3.42025000.42030000","chr3.42050000.42055000",25000,51,2.105832e-09,42025000,42050000,42030000,42055000,"chr3",162886,1,7,6,14,"chr3",1,0.0836849507735584
"5034","chr3.170765000.170770000","chr3.170870000.170875000",105000,21,1.00882e-05,170765000,170870000,170770000,170875000,"chr3",162943,0,10,6,16,"chr3",1,0.0393811533052039
"5035","chr3.15375000.15380000","chr3.15405000.15410000",30000,31,0.003143375,15375000,15405000,15380000,15410000,"chr3",162955,2,10,4,16,"chr3",1,0.0581340834505391
"5036","chr3.107150000.107155000","chr3.107390000.107395000",240000,15,4.539127e-05,107150000,107390000,107155000,107395000,"chr3",162987,1,1,2,4,"chr3",1,0.0070323488045007
"5037","chr3.52070000.52075000","chr3.52150000.52155000",80000,24,4.499634e-06,52070000,52150000,52075000,52155000,"chr3",163162,1,2,1,4,"chr3",1,0.0112517580872011
"5038","chr3.179545000.179550000","chr3.180115000.180120000",570000,9,0.002618443,179545000,180115000,179550000,180120000,"chr3",163173,1,2,2,5,"chr3",1,0.00527426160337553
"5039","chr3.196600000.196605000","chr3.196665000.196670000",65000,20,0.0037657,196600000,196665000,196605000,196670000,"chr3",163205,1,8,11,20,"chr3",1,0.046882325363338
"5040","chr3.129440000.129445000","chr3.129480000.129485000",40000,26,0.002831847,129440000,129480000,129445000,129485000,"chr3",163315,0,4,4,8,"chr3",1,0.0243788091889358
"5041","chr3.23940000.23945000","chr3.24680000.24685000",740000,10,9.519939e-05,23940000,24680000,23945000,24685000,"chr3",163333,1,1,1,3,"chr3",1,0.00351617440225035
"5042","chr3.173135000.173140000","chr3.173265000.173270000",130000,19,2.272219e-05,173135000,173265000,173140000,173270000,"chr3",163342,0,1,1,2,"chr3",1,0.00445382090951711
"5043","chr3.141460000.141465000","chr3.141940000.141945000",480000,14,1.050256e-06,141460000,141940000,141465000,141945000,"chr3",163353,1,4,7,12,"chr3",1,0.019690576652602
"5044","chr3.56735000.56740000","chr3.57010000.57015000",275000,17,4.387275e-07,56735000,57010000,56740000,57015000,"chr3",163379,1,5,12,18,"chr3",1,0.0358649789029536
"5045","chr3.184740000.184745000","chr3.184770000.184775000",30000,32,0.001484935,184740000,184770000,184745000,184775000,"chr3",163419,0,6,9,15,"chr3",1,0.0562587904360056
"5046","chr3.11380000.11385000","chr3.11700000.11705000",320000,13,0.0001192932,11380000,11700000,11385000,11705000,"chr3",163424,1,2,4,7,"chr3",1,0.0106657290201594
"5047","chr3.72435000.72440000","chr3.72720000.72725000",285000,11,0.00429647,72435000,72720000,72440000,72725000,"chr3",163503,1,4,5,10,"chr3",1,0.012892639474918
"5048","chr3.138300000.138305000","chr3.138625000.138630000",325000,17,8.590473e-08,138300000,138625000,138305000,138630000,"chr3",163518,0,4,1,5,"chr3",1,0.00996249413970933
"5049","chr3.188550000.188555000","chr3.188585000.188590000",35000,28,0.003176334,188550000,188585000,188555000,188590000,"chr3",163531,0,2,2,4,"chr3",1,0.0131270511017346
"5050","chr3.48740000.48745000","chr3.48945000.48950000",205000,13,0.002384877,48740000,48945000,48745000,48950000,"chr3",163534,0,5,10,15,"chr3",1,0.0228551336146273
"5051","chr3.52235000.52240000","chr3.52365000.52370000",130000,14,0.009475458,52235000,52365000,52240000,52370000,"chr3",163596,0,4,5,9,"chr3",1,0.0147679324894515
"5052","chr3.156415000.156420000","chr3.156790000.156795000",375000,21,3.771913e-12,156415000,156790000,156420000,156795000,"chr3",163679,0,1,4,5,"chr3",1,0.0123066104078762
"5053","chr3.129440000.129445000","chr3.129550000.129555000",110000,24,7.423412e-08,129440000,129550000,129445000,129555000,"chr3",163688,0,4,4,8,"chr3",1,0.0225035161744023
"5054","chr3.129400000.129405000","chr3.129535000.129540000",135000,31,1.621123e-14,129400000,129535000,129405000,129540000,"chr3",163694,3,8,9,20,"chr3",1,0.0726676043131739
"5055","chr3.58430000.58435000","chr3.58455000.58460000",25000,41,3.6592e-05,58430000,58455000,58435000,58460000,"chr3",163713,1,14,8,23,"chr3",1,0.110525082044069
"5056","chr3.115820000.115825000","chr3.116165000.116170000",345000,16,3.463314e-07,115820000,116165000,115825000,116170000,"chr3",163728,0,0,2,2,"chr3",1,0.00375058602906704
"5057","chr3.57995000.58000000","chr3.58215000.58220000",220000,16,2.051686e-05,57995000,58215000,5.8e+07,58220000,"chr3",163750,8,19,11,38,"chr3",1,0.0712611345522738
"5058","chr3.72990000.72995000","chr3.73040000.73045000",50000,22,0.007850461,72990000,73040000,72995000,73045000,"chr3",163757,0,6,3,9,"chr3",1,0.0232067510548523
"5059","chr3.47825000.47830000","chr3.48190000.48195000",365000,11,0.001237832,47825000,48190000,47830000,48195000,"chr3",163793,4,7,15,26,"chr3",1,0.0335208626347867
"5060","chr3.64480000.64485000","chr3.65440000.65445000",960000,9,9.41052e-05,64480000,65440000,64485000,65445000,"chr3",163798,0,3,4,7,"chr3",1,0.00738396624472574
"5061","chr3.179645000.179650000","chr3.180280000.180285000",635000,14,7.856016e-08,179645000,180280000,179650000,180285000,"chr3",163818,3,9,6,18,"chr3",1,0.029535864978903
"5062","chr3.185395000.185400000","chr3.186265000.186270000",870000,8,0.00141416,185395000,186265000,185400000,186270000,"chr3",163852,0,7,6,13,"chr3",1,0.0121894045944679
"5063","chr3.107150000.107155000","chr3.107260000.107265000",110000,17,0.001012851,107150000,107260000,107155000,107265000,"chr3",163895,1,1,2,4,"chr3",1,0.00796999531176746
"5064","chr3.50235000.50240000","chr3.50350000.50355000",115000,15,0.006587037,50235000,50350000,50240000,50355000,"chr3",163950,0,2,0,2,"chr3",1,0.00351617440225035
"5065","chr3.149270000.149275000","chr3.149390000.149395000",120000,15,0.005183894,149270000,149390000,149275000,149395000,"chr3",163999,2,5,8,15,"chr3",1,0.0263713080168776
"5066","chr3.58305000.58310000","chr3.58470000.58475000",165000,20,5.933518e-07,58305000,58470000,58310000,58475000,"chr3",164027,2,7,2,11,"chr3",1,0.0257852789498359
"5067","chr3.171115000.171120000","chr3.171145000.171150000",30000,34,0.0003107272,171115000,171145000,171120000,171150000,"chr3",164034,0,2,6,8,"chr3",1,0.0318799812470699
"5068","chr3.170960000.170965000","chr3.171180000.171185000",220000,12,0.005236669,170960000,171180000,170965000,171185000,"chr3",164058,0,1,0,1,"chr3",1,0.00140646976090014
"5069","chr3.42740000.42745000","chr3.42760000.42765000",20000,48,9.712232e-07,42740000,42760000,42745000,42765000,"chr3",164083,6,11,11,28,"chr3",1,0.157524613220816
"5070","chr3.23240000.23245000","chr3.23480000.23485000",240000,17,1.743866e-06,23240000,23480000,23245000,23485000,"chr3",164099,1,1,1,3,"chr3",1,0.0059774964838256
"5071","chr3.58320000.58325000","chr3.58470000.58475000",150000,18,2.972189e-05,58320000,58470000,58325000,58475000,"chr3",164159,2,7,2,11,"chr3",1,0.0232067510548523
"5072","chr3.15240000.15245000","chr3.15680000.15685000",440000,10,0.002112808,15240000,15680000,15245000,15685000,"chr3",164190,2,1,1,4,"chr3",1,0.0046882325363338
"5073","chr3.39255000.39260000","chr3.39290000.39295000",35000,27,0.006592248,39255000,39290000,39260000,39295000,"chr3",164225,0,0,2,2,"chr3",1,0.00632911392405063
"5074","chr3.148790000.148795000","chr3.148990000.148995000",200000,17,1.030296e-05,148790000,148990000,148795000,148995000,"chr3",164229,1,5,11,17,"chr3",1,0.0338724800750117
"5075","chr3.170145000.170150000","chr3.170525000.170530000",380000,17,2.044618e-08,170145000,170525000,170150000,170530000,"chr3",164268,1,6,1,8,"chr3",1,0.0159399906235349
"5076","chr3.9055000.9060000","chr3.9350000.9355000",295000,14,4.244858e-05,9055000,9350000,9060000,9355000,"chr3",164277,0,3,2,5,"chr3",1,0.00820440693858415
"5077","chr3.52595000.52600000","chr3.52685000.52690000",90000,20,0.0001738686,52595000,52685000,52600000,52690000,"chr3",164286,3,11,9,23,"chr3",1,0.0539146741678387
"5078","chr3.184280000.184285000","chr3.184440000.184445000",160000,24,8.985973e-10,184280000,184440000,184285000,184445000,"chr3",164296,1,12,19,32,"chr3",1,0.090014064697609
"5079","chr3.42070000.42075000","chr3.42135000.42140000",65000,29,1.275795e-07,42070000,42135000,42075000,42140000,"chr3",164300,3,7,4,14,"chr3",1,0.0475855602437881
"5080","chr3.129460000.129465000","chr3.129485000.129490000",25000,45,9.853478e-07,129460000,129485000,129465000,129490000,"chr3",164309,0,0,2,2,"chr3",1,0.0105485232067511
"5081","chr3.52605000.52610000","chr3.52705000.52710000",100000,16,0.005731548,52605000,52705000,52610000,52710000,"chr3",164312,4,6,7,17,"chr3",1,0.0318799812470699
"5082","chr3.72010000.72015000","chr3.72170000.72175000",160000,13,0.009664013,72010000,72170000,72015000,72175000,"chr3",164567,0,2,1,3,"chr3",1,0.00457102672292546
"5083","chr3.143770000.143775000","chr3.144380000.144385000",610000,8,0.008490973,143770000,144380000,143775000,144385000,"chr3",164584,0,2,1,3,"chr3",1,0.00281293952180028
"5084","chr3.11770000.11775000","chr3.11830000.11835000",60000,20,0.00785248,11770000,11830000,11775000,11835000,"chr3",164611,4,5,8,17,"chr3",1,0.0398499765588373
"5085","chr3.194405000.194410000","chr3.194870000.194875000",465000,11,0.0003236447,194405000,194870000,194410000,194875000,"chr3",164628,1,1,1,3,"chr3",1,0.00386779184247539
"5086","chr3.5015000.5020000","chr3.5135000.5140000",120000,16,0.001733304,5015000,5135000,5020000,5140000,"chr3",164665,3,11,6,20,"chr3",1,0.0375058602906704
"5087","chr3.47575000.47580000","chr3.47825000.47830000",250000,12,0.002492257,47575000,47825000,47580000,47830000,"chr3",164713,0,5,3,8,"chr3",1,0.0112517580872011
"5088","chr3.107280000.107285000","chr3.107370000.107375000",90000,17,0.004470148,107280000,107370000,107285000,107375000,"chr3",164722,3,3,4,10,"chr3",1,0.0199249882794187
"5089","chr3.69410000.69415000","chr3.69430000.69435000",20000,40,0.0006722116,69410000,69430000,69415000,69435000,"chr3",164724,0,3,1,4,"chr3",1,0.0187529301453352
"5090","chr3.45040000.45045000","chr3.45510000.45515000",470000,9,0.006587037,45040000,45510000,45045000,45515000,"chr3",164751,2,6,9,17,"chr3",1,0.0179324894514768
"5091","chr3.181450000.181455000","chr3.182210000.182215000",760000,9,0.0005305804,181450000,182210000,181455000,182215000,"chr3",164782,0,2,0,2,"chr3",1,0.00210970464135021
"5092","chr3.51535000.51540000","chr3.51700000.51705000",165000,66,2.399099e-55,51535000,51700000,51540000,51705000,"chr3",164783,2,2,3,7,"chr3",1,0.0541490857946554
"5093","chr3.9170000.9175000","chr3.9225000.9230000",55000,21,0.007608433,9170000,9225000,9175000,9230000,"chr3",164820,0,0,3,3,"chr3",1,0.00738396624472574
"5094","chr3.11000000.11005000","chr3.11060000.11065000",60000,28,1.80414e-06,1.1e+07,11060000,11005000,11065000,"chr3",164864,3,2,9,14,"chr3",1,0.0459446788560713
"5095","chr3.69235000.69240000","chr3.69280000.69285000",45000,36,1.167668e-08,69235000,69280000,69240000,69285000,"chr3",164880,1,9,3,13,"chr3",1,0.0548523206751055
"5096","chr3.171420000.171425000","chr3.171555000.171560000",135000,16,0.0008448135,171420000,171555000,171425000,171560000,"chr3",164895,0,2,1,3,"chr3",1,0.00562587904360056
"5097","chr3.72935000.72940000","chr3.72955000.72960000",20000,37,0.004863644,72935000,72955000,72940000,72960000,"chr3",164900,9,17,8,34,"chr3",1,0.147444913267698
"5098","chr3.47580000.47585000","chr3.47825000.47830000",245000,14,0.0001754053,47580000,47825000,47585000,47830000,"chr3",164963,4,7,9,20,"chr3",1,0.0328176277543366
"5099","chr3.177195000.177200000","chr3.177805000.177810000",610000,8,0.008490973,177195000,177805000,177200000,177810000,"chr3",165058,0,2,0,2,"chr3",1,0.00187529301453352
"5100","chr3.11700000.11705000","chr3.11845000.11850000",145000,15,0.001788894,11700000,11845000,11705000,11850000,"chr3",165116,3,9,8,20,"chr3",1,0.0351617440225035
"5101","chr3.196740000.196745000","chr3.197220000.197225000",480000,14,1.050256e-06,196740000,197220000,196745000,197225000,"chr3",165175,1,3,9,13,"chr3",1,0.0213314580403188
"5102","chr3.42640000.42645000","chr3.42775000.42780000",135000,14,0.00790472,42640000,42775000,42645000,42780000,"chr3",165197,0,2,1,3,"chr3",1,0.00492264416315049
"5103","chr3.72995000.73000000","chr3.73055000.73060000",60000,21,0.003322656,72995000,73055000,7.3e+07,73060000,"chr3",165200,1,3,5,9,"chr3",1,0.0221518987341772
"5104","chr3.170325000.170330000","chr3.170525000.170530000",200000,17,1.030296e-05,170325000,170525000,170330000,170530000,"chr3",165284,1,6,1,8,"chr3",1,0.0159399906235349
"5105","chr3.11430000.11435000","chr3.11695000.11700000",265000,15,1.96712e-05,11430000,11695000,11435000,11700000,"chr3",165295,3,4,5,12,"chr3",1,0.0210970464135021
"5106","chr3.42050000.42055000","chr3.42120000.42125000",70000,49,2.341577e-23,42050000,42120000,42055000,42125000,"chr3",165331,1,7,8,16,"chr3",1,0.0918893577121425
"5107","chr3.129395000.129400000","chr3.129485000.129490000",90000,20,0.0001738686,129395000,129485000,129400000,129490000,"chr3",165339,0,0,3,3,"chr3",1,0.0070323488045007
"5108","chr3.71925000.71930000","chr3.72830000.72835000",905000,10,1.996027e-05,71925000,72830000,71930000,72835000,"chr3",165347,1,0,1,2,"chr3",1,0.0023441162681669
"5109","chr3.42570000.42575000","chr3.42830000.42835000",260000,13,0.0004923911,42570000,42830000,42575000,42835000,"chr3",165356,17,29,23,69,"chr3",1,0.105133614627286
"5110","chr3.48740000.48745000","chr3.48990000.48995000",250000,11,0.008540868,48740000,48990000,48745000,48995000,"chr3",165357,1,15,7,23,"chr3",1,0.0296530707923113
"5111","chr3.42050000.42055000","chr3.42095000.42100000",45000,34,1.417964e-07,42050000,42095000,42055000,42100000,"chr3",165402,0,2,2,4,"chr3",1,0.0159399906235349
"5112","chr3.8995000.9000000","chr3.9280000.9285000",285000,14,5.542697e-05,8995000,9280000,9e+06,9285000,"chr3",165608,1,1,0,2,"chr3",1,0.00328176277543366
"5113","chr3.51555000.51560000","chr3.52160000.52165000",605000,8,0.008849446,51555000,52160000,51560000,52165000,"chr3",165623,1,28,20,49,"chr3",1,0.0459446788560713
"5114","chr3.42085000.42090000","chr3.42135000.42140000",50000,24,0.001456577,42085000,42135000,42090000,42140000,"chr3",165635,2,6,2,10,"chr3",1,0.0281293952180028
"5115","chr3.156615000.156620000","chr3.156790000.156795000",175000,16,0.0001417511,156615000,156790000,156620000,156795000,"chr3",165646,1,3,2,6,"chr3",1,0.0112517580872011
"5116","chr3.44105000.44110000","chr3.44235000.44240000",130000,20,5.546654e-06,44105000,44235000,44110000,44240000,"chr3",165647,0,0,5,5,"chr3",1,0.0117205813408345
"5117","chr3.42740000.42745000","chr3.42775000.42780000",35000,35,6.094511e-06,42740000,42775000,42745000,42780000,"chr3",165653,6,11,11,28,"chr3",1,0.114861697140178
"5118","chr3.44510000.44515000","chr3.44550000.44555000",40000,26,0.002831847,44510000,44550000,44515000,44555000,"chr3",165673,2,1,1,4,"chr3",1,0.0121894045944679
"5119","chr3.15310000.15315000","chr3.15405000.15410000",95000,20,0.0001018023,15310000,15405000,15315000,15410000,"chr3",165684,3,11,4,18,"chr3",1,0.0421940928270042
"5120","chr3.106965000.106970000","chr3.107245000.107250000",280000,14,6.335105e-05,106965000,107245000,106970000,107250000,"chr3",165697,2,6,4,12,"chr3",1,0.019690576652602
"5121","chr3.149245000.149250000","chr3.149480000.149485000",235000,15,5.480045e-05,149245000,149480000,149250000,149485000,"chr3",165736,4,3,0,7,"chr3",1,0.0123066104078762
"5122","chr3.150350000.150355000","chr3.150450000.150455000",100000,16,0.005731548,150350000,150450000,150355000,150455000,"chr3",165738,0,2,1,3,"chr3",1,0.00562587904360056
"5123","chr4.108645000.108650000","chr4.108830000.108835000",185000,14,0.0006989227,108645000,108830000,108650000,108835000,"chr4",165829,0,2,1,3,"chr4",1,0.00492264416315049
"5124","chr4.55865000.55870000","chr4.56405000.56410000",540000,9,0.002807034,55865000,56405000,55870000,56410000,"chr4",165846,0,4,3,7,"chr4",1,0.00738396624472574
"5125","chr4.26230000.26235000","chr4.26330000.26335000",100000,15,0.008803662,26230000,26330000,26235000,26335000,"chr4",165894,7,20,31,58,"chr4",1,0.10196905766526
"5126","chr4.40985000.40990000","chr4.41155000.41160000",170000,23,6.17459e-10,40985000,41155000,40990000,41160000,"chr4",165902,1,8,3,12,"chr4",1,0.0323488045007032
"5127","chr4.7205000.7210000","chr4.7380000.7385000",175000,16,6.40107e-05,7205000,7380000,7210000,7385000,"chr4",165955,0,2,1,3,"chr4",1,0.00562587904360056
"5128","chr4.15475000.15480000","chr4.16000000.16005000",525000,16,3.553353e-09,15475000,1.6e+07,15480000,16005000,"chr4",165984,0,4,2,6,"chr4",1,0.0112517580872011
"5129","chr4.3190000.3195000","chr4.3345000.3350000",155000,17,3.892084e-05,3190000,3345000,3195000,3350000,"chr4",166030,4,3,4,11,"chr4",1,0.0219174871073605
"5130","chr4.38175000.38180000","chr4.38320000.38325000",145000,22,2.493235e-08,38175000,38320000,38180000,38325000,"chr4",166047,0,2,1,3,"chr4",1,0.00773558368495077
"5131","chr4.40925000.40930000","chr4.41255000.41260000",330000,18,3.735644e-09,40925000,41255000,40930000,41260000,"chr4",166062,4,9,11,24,"chr4",1,0.0506329113924051
"5132","chr4.38200000.38205000","chr4.38265000.38270000",65000,25,7.657239e-06,38200000,38265000,38205000,38270000,"chr4",166083,2,10,13,25,"chr4",1,0.0732536333802157
"5133","chr4.38200000.38205000","chr4.38490000.38495000",290000,11,0.002523411,38200000,38490000,38205000,38495000,"chr4",166093,2,11,12,25,"chr4",1,0.0322315986872949
"5134","chr4.41060000.41065000","chr4.41210000.41215000",150000,23,2.926157e-09,41060000,41210000,41065000,41215000,"chr4",166124,3,8,6,17,"chr4",1,0.0458274730426629
"5135","chr4.38175000.38180000","chr4.38790000.38795000",615000,8,0.007301881,38175000,38790000,38180000,38795000,"chr4",166148,4,11,11,26,"chr4",1,0.0243788091889358
"5136","chr4.88590000.88595000","chr4.88755000.88760000",165000,29,5.092071e-15,88590000,88755000,88595000,88760000,"chr4",166180,1,5,7,13,"chr4",1,0.0441865916549461
"5137","chr4.6710000.6715000","chr4.6905000.6910000",195000,17,5.265738e-06,6710000,6905000,6715000,6910000,"chr4",166216,1,3,3,7,"chr4",1,0.0139474917955931
"5138","chr4.185180000.185185000","chr4.185425000.185430000",245000,14,8.718848e-05,185180000,185425000,185185000,185430000,"chr4",166251,1,10,3,14,"chr4",1,0.0229723394280356
"5139","chr4.7000000.7005000","chr4.7070000.7075000",70000,18,0.006903724,7e+06,7070000,7005000,7075000,"chr4",166257,0,2,2,4,"chr4",1,0.00843881856540084
"5140","chr4.153770000.153775000","chr4.154030000.154035000",260000,13,0.0002645832,153770000,154030000,153775000,154035000,"chr4",166262,2,6,1,9,"chr4",1,0.0137130801687764
"5141","chr4.38265000.38270000","chr4.38315000.38320000",50000,27,3.184208e-05,38265000,38315000,38270000,38320000,"chr4",166344,0,7,1,8,"chr4",1,0.0253164556962025
"5142","chr4.38085000.38090000","chr4.38675000.38680000",590000,9,0.001804209,38085000,38675000,38090000,38680000,"chr4",166378,1,1,0,2,"chr4",1,0.00210970464135021
"5143","chr4.140645000.140650000","chr4.141155000.141160000",510000,11,0.0001283409,140645000,141155000,140650000,141160000,"chr4",166379,2,1,1,4,"chr4",1,0.00515705578996718
"5144","chr4.17545000.17550000","chr4.17810000.17815000",265000,24,1.045461e-13,17545000,17810000,17550000,17815000,"chr4",166457,3,8,4,15,"chr4",1,0.0421940928270042
"5145","chr4.40925000.40930000","chr4.41210000.41215000",285000,32,5.594318e-23,40925000,41210000,40930000,41215000,"chr4",166471,3,8,6,17,"chr4",1,0.0637599624941397
"5146","chr4.153320000.153325000","chr4.153550000.153555000",230000,12,0.002441934,153320000,153550000,153325000,153555000,"chr4",166475,3,10,8,21,"chr4",1,0.029535864978903
"5147","chr4.38920000.38925000","chr4.39180000.39185000",260000,11,0.004550564,38920000,39180000,38925000,39185000,"chr4",166492,1,8,6,15,"chr4",1,0.0193389592123769
"5148","chr4.7800000.7805000","chr4.7960000.7965000",160000,14,0.001784832,7800000,7960000,7805000,7965000,"chr4",166522,1,5,7,13,"chr4",1,0.0213314580403188
"5149","chr4.20305000.20310000","chr4.20415000.20420000",110000,27,1.133834e-10,20305000,20415000,20310000,20420000,"chr4",166538,1,6,9,16,"chr4",1,0.0506329113924051
"5150","chr4.95440000.95445000","chr4.95470000.95475000",30000,29,0.006694967,95440000,95470000,95445000,95475000,"chr4",166561,0,3,4,7,"chr4",1,0.023792780121894
"5151","chr4.6905000.6910000","chr4.7070000.7075000",165000,34,6.941424e-20,6905000,7070000,6910000,7075000,"chr4",166576,0,3,3,6,"chr4",1,0.0239099859353024
"5152","chr4.113020000.113025000","chr4.113105000.113110000",85000,17,0.003828938,113020000,113105000,113025000,113110000,"chr4",166582,0,3,3,6,"chr4",1,0.0119549929676512
"5153","chr4.163700000.163705000","chr4.164250000.164255000",550000,11,8.098171e-05,163700000,164250000,163705000,164255000,"chr4",166614,0,3,3,6,"chr4",1,0.00773558368495077
"5154","chr4.17585000.17590000","chr4.17610000.17615000",25000,35,0.001648449,17585000,17610000,17590000,17615000,"chr4",166644,9,15,18,42,"chr4",1,0.172292545710267
"5155","chr4.82345000.82350000","chr4.82385000.82390000",40000,37,8.537963e-09,82345000,82385000,82350000,82390000,"chr4",166666,2,10,12,24,"chr4",1,0.10407876230661
"5156","chr4.7805000.7810000","chr4.7925000.7930000",120000,25,1.1607e-09,7805000,7925000,7810000,7930000,"chr4",166742,4,11,8,23,"chr4",1,0.0673933427097984
"5157","chr4.4260000.4265000","chr4.4285000.4290000",25000,35,0.001648449,4260000,4285000,4265000,4290000,"chr4",166785,0,2,7,9,"chr4",1,0.0369198312236287
"5158","chr4.48785000.48790000","chr4.48830000.48835000",45000,36,2.598643e-09,48785000,48830000,48790000,48835000,"chr4",166788,2,8,12,22,"chr4",1,0.0928270042194093
"5159","chr4.113020000.113025000","chr4.113090000.113095000",70000,21,0.0003234734,113020000,113090000,113025000,113095000,"chr4",166793,0,3,1,4,"chr4",1,0.00984528832630099
"5160","chr4.15010000.15015000","chr4.15130000.15135000",120000,24,6.545412e-09,15010000,15130000,15015000,15135000,"chr4",166799,2,7,3,12,"chr4",1,0.0337552742616034
"5161","chr4.107970000.107975000","chr4.107990000.107995000",20000,35,0.008449866,107970000,107990000,107975000,107995000,"chr4",166862,0,5,3,8,"chr4",1,0.0328176277543366
"5162","chr4.40930000.40935000","chr4.41210000.41215000",280000,35,2.568639e-26,40930000,41210000,40935000,41215000,"chr4",166928,1,5,6,12,"chr4",1,0.0492264416315049
"5163","chr4.84565000.84570000","chr4.85420000.85425000",855000,11,3.304194e-06,84565000,85420000,84570000,85425000,"chr4",167029,0,4,1,5,"chr4",1,0.00644631973745898
"5164","chr4.158915000.158920000","chr4.159060000.159065000",145000,17,6.487187e-05,158915000,159060000,158920000,159065000,"chr4",167030,7,16,15,38,"chr4",1,0.0757149554617909
"5165","chr4.41045000.41050000","chr4.41070000.41075000",25000,51,4.162818e-10,41045000,41070000,41050000,41075000,"chr4",167033,5,7,15,27,"chr4",1,0.161392405063291
"5166","chr4.41470000.41475000","chr4.41670000.41675000",200000,12,0.00560976,41470000,41670000,41475000,41675000,"chr4",167074,2,8,4,14,"chr4",1,0.019690576652602
"5167","chr4.38205000.38210000","chr4.38305000.38310000",100000,24,6.863208e-08,38205000,38305000,38210000,38310000,"chr4",167078,2,7,5,14,"chr4",1,0.0393811533052039
"5168","chr4.184015000.184020000","chr4.184165000.184170000",150000,17,5.040901e-05,184015000,184165000,184020000,184170000,"chr4",167088,0,0,1,1,"chr4",1,0.00199249882794187
"5169","chr4.41145000.41150000","chr4.41210000.41215000",65000,45,5.348513e-20,41145000,41210000,41150000,41215000,"chr4",167095,3,8,6,17,"chr4",1,0.089662447257384
"5170","chr4.38200000.38205000","chr4.38675000.38680000",475000,11,0.0001999033,38200000,38675000,38205000,38680000,"chr4",167097,1,5,1,7,"chr4",1,0.00902484763244257
"5171","chr4.38315000.38320000","chr4.38665000.38670000",350000,11,0.0009682555,38315000,38665000,38320000,38670000,"chr4",167120,0,1,0,1,"chr4",1,0.0012892639474918
"5172","chr4.25165000.25170000","chr4.25310000.25315000",145000,14,0.003172908,25165000,25310000,25170000,25315000,"chr4",167197,2,5,10,17,"chr4",1,0.0278949835911861
"5173","chr4.152230000.152235000","chr4.153210000.153215000",980000,9,7.845729e-05,152230000,153210000,152235000,153215000,"chr4",167265,0,6,0,6,"chr4",1,0.00632911392405063
"5174","chr4.185140000.185145000","chr4.185170000.185175000",30000,29,0.006694967,185140000,185170000,185145000,185175000,"chr4",167340,0,3,1,4,"chr4",1,0.013595874355368
"5175","chr4.112285000.112290000","chr4.112345000.112350000",60000,24,7.77048e-05,112285000,112345000,112290000,112350000,"chr4",167349,0,4,0,4,"chr4",1,0.0112517580872011
"5176","chr4.138955000.138960000","chr4.139565000.139570000",610000,10,0.0002659333,138955000,139565000,138960000,139570000,"chr4",167356,1,9,10,20,"chr4",1,0.023441162681669
"5177","chr4.36265000.36270000","chr4.36350000.36355000",85000,20,0.0001308003,36265000,36350000,36270000,36355000,"chr4",167371,2,3,3,8,"chr4",1,0.0187529301453352
"5178","chr4.2755000.2760000","chr4.2875000.2880000",120000,14,0.008449866,2755000,2875000,2760000,2880000,"chr4",167403,4,7,8,19,"chr4",1,0.0311767463666198
"5179","chr4.41080000.41085000","chr4.41135000.41140000",55000,25,8.146509e-05,41080000,41135000,41085000,41140000,"chr4",167411,2,16,7,25,"chr4",1,0.0732536333802157
"5180","chr4.37450000.37455000","chr4.37600000.37605000",150000,13,0.008281143,37450000,37600000,37455000,37605000,"chr4",167451,2,1,5,8,"chr4",1,0.0121894045944679
"5181","chr4.1285000.1290000","chr4.1725000.1730000",440000,9,0.006903724,1285000,1725000,1290000,1730000,"chr4",167587,0,3,2,5,"chr4",1,0.00527426160337553
"5182","chr4.82345000.82350000","chr4.83280000.83285000",935000,8,0.0008563966,82345000,83280000,82350000,83285000,"chr4",167588,5,5,4,14,"chr4",1,0.0131270511017346
"5183","chr4.2220000.2225000","chr4.2535000.2540000",315000,13,7.220628e-05,2220000,2535000,2225000,2540000,"chr4",167655,3,9,5,17,"chr4",1,0.0259024847632443
"5184","chr4.16640000.16645000","chr4.16765000.16770000",125000,25,6.891935e-10,16640000,16765000,16645000,16770000,"chr4",167772,0,2,2,4,"chr4",1,0.0117205813408345
"5185","chr4.37800000.37805000","chr4.38035000.38040000",235000,44,3.524465e-35,37800000,38035000,37805000,38040000,"chr4",167774,2,0,5,7,"chr4",1,0.0360993905297703
"5186","chr4.38175000.38180000","chr4.38730000.38735000",555000,23,2.936944e-17,38175000,38730000,38180000,38735000,"chr4",167804,4,11,16,31,"chr4",1,0.08356774496015
"5187","chr4.41365000.41370000","chr4.41425000.41430000",60000,20,0.004550564,41365000,41425000,41370000,41430000,"chr4",167811,0,0,2,2,"chr4",1,0.0046882325363338
"5188","chr4.15880000.15885000","chr4.16000000.16005000",120000,17,0.0002511079,15880000,1.6e+07,15885000,16005000,"chr4",167814,0,2,2,4,"chr4",1,0.00796999531176746
"5189","chr4.139030000.139035000","chr4.139095000.139100000",65000,19,0.005280554,139030000,139095000,139035000,139100000,"chr4",167851,7,28,24,59,"chr4",1,0.131387716830755
"5190","chr4.41080000.41085000","chr4.41115000.41120000",35000,27,0.00338735,41080000,41115000,41085000,41120000,"chr4",167885,2,12,5,19,"chr4",1,0.060126582278481
"5191","chr4.56835000.56840000","chr4.57160000.57165000",325000,12,0.0002999215,56835000,57160000,56840000,57165000,"chr4",167907,4,9,7,20,"chr4",1,0.0281293952180028
"5192","chr4.40735000.40740000","chr4.40840000.40845000",105000,23,1.734702e-07,40735000,40840000,40740000,40845000,"chr4",167925,0,2,1,3,"chr4",1,0.00808720112517581
"5193","chr4.15010000.15015000","chr4.15040000.15045000",30000,37,7.678841e-06,15010000,15040000,15015000,15045000,"chr4",167942,0,2,4,6,"chr4",1,0.0260196905766526
"5194","chr4.1925000.1930000","chr4.1965000.1970000",40000,31,1.022096e-05,1925000,1965000,1930000,1970000,"chr4",167995,1,10,14,25,"chr4",1,0.0908345053914674
"5195","chr4.152550000.152555000","chr4.153345000.153350000",795000,9,0.0003528555,152550000,153345000,152555000,153350000,"chr4",168020,2,2,1,5,"chr4",1,0.00527426160337553
"5196","chr4.20425000.20430000","chr4.20680000.20685000",255000,15,1.231074e-05,20425000,20680000,20430000,20685000,"chr4",168029,0,3,1,4,"chr4",1,0.0070323488045007
"5197","chr4.185215000.185220000","chr4.186035000.186040000",820000,9,0.0002926953,185215000,186035000,185220000,186040000,"chr4",168042,1,2,3,6,"chr4",1,0.00632911392405063
"5198","chr4.40855000.40860000","chr4.40895000.40900000",40000,32,3.420304e-06,40855000,40895000,40860000,40900000,"chr4",168078,0,14,11,25,"chr4",1,0.093764650726676
"5199","chr4.75190000.75195000","chr4.75590000.75595000",400000,12,9.483929e-05,75190000,75590000,75195000,75595000,"chr4",168115,1,3,0,4,"chr4",1,0.00562587904360056
"5200","chr4.25170000.25175000","chr4.25310000.25315000",140000,21,1.925107e-07,25170000,25310000,25175000,25315000,"chr4",168140,2,4,3,9,"chr4",1,0.0221518987341772
"5201","chr4.6720000.6725000","chr4.7040000.7045000",320000,11,0.001526724,6720000,7040000,6725000,7045000,"chr4",168162,0,1,1,2,"chr4",1,0.00257852789498359
"5202","chr4.40930000.40935000","chr4.41145000.41150000",215000,12,0.003707713,40930000,41145000,40935000,41150000,"chr4",168171,1,5,7,13,"chr4",1,0.0182841068917018
"5203","chr4.26025000.26030000","chr4.27010000.27015000",985000,8,0.0005930542,26025000,27010000,26030000,27015000,"chr4",168181,0,1,2,3,"chr4",1,0.00281293952180028
"5204","chr4.2240000.2245000","chr4.2430000.2435000",190000,12,0.007388988,2240000,2430000,2245000,2435000,"chr4",168184,0,1,0,1,"chr4",1,0.00140646976090014
"5205","chr4.4485000.4490000","chr4.4835000.4840000",350000,10,0.004283184,4485000,4835000,4490000,4840000,"chr4",168218,1,0,0,1,"chr4",1,0.00117205813408345
"5206","chr4.15020000.15025000","chr4.15195000.15200000",175000,14,0.001014832,15020000,15195000,15025000,15200000,"chr4",168251,0,3,3,6,"chr4",1,0.00984528832630099
"5207","chr4.40985000.40990000","chr4.41115000.41120000",130000,17,0.0001400532,40985000,41115000,40990000,41120000,"chr4",168266,2,8,5,15,"chr4",1,0.029887482419128
"5208","chr4.40985000.40990000","chr4.41255000.41260000",270000,15,7.657239e-06,40985000,41255000,40990000,41260000,"chr4",168277,2,8,6,16,"chr4",1,0.0281293952180028
"5209","chr4.38320000.38325000","chr4.38610000.38615000",290000,15,4.145606e-06,38320000,38610000,38325000,38615000,"chr4",168294,0,2,1,3,"chr4",1,0.00527426160337553
"5210","chr4.38200000.38205000","chr4.38315000.38320000",115000,17,0.0003386994,38200000,38315000,38205000,38320000,"chr4",168363,0,7,1,8,"chr4",1,0.0159399906235349
"5211","chr4.48560000.48565000","chr4.48895000.48900000",335000,15,1.332623e-06,48560000,48895000,48565000,48900000,"chr4",168378,4,2,6,12,"chr4",1,0.0210970464135021
"5212","chr4.139015000.139020000","chr4.139600000.139605000",585000,9,0.001890662,139015000,139600000,139020000,139605000,"chr4",168421,0,7,10,17,"chr4",1,0.0179324894514768
"5213","chr4.82470000.82475000","chr4.82650000.82655000",180000,15,0.0002165588,82470000,82650000,82475000,82655000,"chr4",168511,4,13,12,29,"chr4",1,0.0509845288326301
"5214","chr4.6840000.6845000","chr4.7005000.7010000",165000,14,0.001489251,6840000,7005000,6845000,7010000,"chr4",168513,2,9,7,18,"chr4",1,0.029535864978903
"5215","chr4.185170000.185175000","chr4.185395000.185400000",225000,14,0.0001674137,185170000,185395000,185175000,185400000,"chr4",168523,0,3,0,3,"chr4",1,0.00492264416315049
"5216","chr4.38265000.38270000","chr4.38675000.38680000",410000,11,0.0004484418,38265000,38675000,38270000,38680000,"chr4",168525,1,5,1,7,"chr4",1,0.00902484763244257
"5217","chr4.40735000.40740000","chr4.40990000.40995000",255000,14,6.454855e-05,40735000,40990000,40740000,40995000,"chr4",168588,5,8,11,24,"chr4",1,0.0393811533052039
"5218","chr4.7800000.7805000","chr4.7965000.7970000",165000,17,2.354783e-05,7800000,7965000,7805000,7970000,"chr4",168589,3,5,3,11,"chr4",1,0.0219174871073605
"5219","chr4.36215000.36220000","chr4.36330000.36335000",115000,15,0.003689618,36215000,36330000,36220000,36335000,"chr4",168603,0,6,3,9,"chr4",1,0.0158227848101266
"5220","chr4.7800000.7805000","chr4.8015000.8020000",215000,12,0.003707713,7800000,8015000,7805000,8020000,"chr4",168607,0,5,7,12,"chr4",1,0.0168776371308017
"5221","chr4.102025000.102030000","chr4.102230000.102235000",205000,12,0.004843706,102025000,102230000,102030000,102235000,"chr4",168647,0,2,0,2,"chr4",1,0.00281293952180028
"5222","chr4.26330000.26335000","chr4.26410000.26415000",80000,60,1.270826e-37,26330000,26410000,26335000,26415000,"chr4",168651,5,6,11,22,"chr4",1,0.154711673699015
"5223","chr4.38185000.38190000","chr4.38780000.38785000",595000,18,6.780811e-12,38185000,38780000,38190000,38785000,"chr4",168673,7,8,10,25,"chr4",1,0.0527426160337553
"5224","chr4.151205000.151210000","chr4.151740000.151745000",535000,13,2.004386e-06,151205000,151740000,151210000,151745000,"chr4",168689,1,1,6,8,"chr4",1,0.0121894045944679
"5225","chr4.113045000.113050000","chr4.113090000.113095000",45000,24,0.002080527,113045000,113090000,113050000,113095000,"chr4",168721,0,1,1,2,"chr4",1,0.00562587904360056
"5226","chr4.40930000.40935000","chr4.41080000.41085000",150000,13,0.008281143,40930000,41080000,40935000,41085000,"chr4",168741,1,5,7,13,"chr4",1,0.0198077824660103
"5227","chr4.139095000.139100000","chr4.139855000.139860000",760000,10,6.723069e-05,139095000,139855000,139100000,139860000,"chr4",168807,3,1,1,5,"chr4",1,0.00586029067041725
"5228","chr4.38620000.38625000","chr4.38660000.38665000",40000,39,6.063462e-10,38620000,38660000,38625000,38665000,"chr4",168820,1,8,7,16,"chr4",1,0.0731364275668073
"5229","chr4.108985000.108990000","chr4.109495000.109500000",510000,12,2.047868e-05,108985000,109495000,108990000,109500000,"chr4",168862,0,3,0,3,"chr4",1,0.00421940928270042
"5230","chr4.4255000.4260000","chr4.4335000.4340000",80000,31,3.090158e-11,4255000,4335000,4260000,4340000,"chr4",169016,1,7,2,10,"chr4",1,0.036333802156587
"5231","chr4.38165000.38170000","chr4.38490000.38495000",325000,11,0.001414564,38165000,38490000,38170000,38495000,"chr4",169030,1,2,1,4,"chr4",1,0.00515705578996718
"5232","chr4.39475000.39480000","chr4.39975000.39980000",500000,13,3.374691e-06,39475000,39975000,39480000,39980000,"chr4",169036,0,15,13,28,"chr4",1,0.0426629160806376
"5233","chr4.4260000.4265000","chr4.4335000.4340000",75000,22,4.658568e-05,4260000,4335000,4265000,4340000,"chr4",169048,2,13,3,18,"chr4",1,0.0464135021097046
"5234","chr4.6985000.6990000","chr4.7070000.7075000",85000,33,2.664886e-13,6985000,7070000,6990000,7075000,"chr4",169087,0,6,2,8,"chr4",1,0.0309423347398031
"5235","chr4.89155000.89160000","chr4.89430000.89435000",275000,15,6.536325e-06,89155000,89430000,89160000,89435000,"chr4",169099,2,6,5,13,"chr4",1,0.0228551336146273
"5236","chr4.17795000.17800000","chr4.18590000.18595000",795000,8,0.002222925,17795000,18590000,17800000,18595000,"chr4",169111,1,6,6,13,"chr4",1,0.0121894045944679
"5237","chr4.140325000.140330000","chr4.140370000.140375000",45000,23,0.004843706,140325000,140370000,140330000,140375000,"chr4",169123,2,5,7,14,"chr4",1,0.0377402719174871
"5238","chr4.37600000.37605000","chr4.38035000.38040000",435000,10,0.001645817,37600000,38035000,37605000,38040000,"chr4",169127,2,0,5,7,"chr4",1,0.00820440693858415
"5239","chr4.41070000.41075000","chr4.41145000.41150000",75000,33,3.834517e-12,41070000,41145000,41075000,41150000,"chr4",169154,5,7,15,27,"chr4",1,0.104430379746835
"5240","chr4.38190000.38195000","chr4.38675000.38680000",485000,16,7.83295e-09,38190000,38675000,38195000,38680000,"chr4",169164,1,5,1,7,"chr4",1,0.0131270511017346
"5241","chr4.26785000.26790000","chr4.27010000.27015000",225000,12,0.002816769,26785000,27010000,26790000,27015000,"chr4",169214,0,1,2,3,"chr4",1,0.00421940928270042
"5242","chr4.40870000.40875000","chr4.40895000.40900000",25000,49,3.976813e-09,40870000,40895000,40875000,40900000,"chr4",169227,1,5,3,9,"chr4",1,0.0516877637130802
"5243","chr4.6905000.6910000","chr4.7000000.7005000",95000,17,0.001551464,6905000,7e+06,6910000,7005000,"chr4",169265,0,2,2,4,"chr4",1,0.00796999531176746
"5244","chr4.26025000.26030000","chr4.26340000.26345000",315000,10,0.006694967,26025000,26340000,26030000,26345000,"chr4",169309,2,5,4,11,"chr4",1,0.012892639474918
"5245","chr4.38185000.38190000","chr4.38730000.38735000",545000,23,3.974499e-17,38185000,38730000,38190000,38735000,"chr4",169339,9,17,10,36,"chr4",1,0.0970464135021097
"5246","chr4.152555000.152560000","chr4.153315000.153320000",760000,8,0.0027977,152555000,153315000,152560000,153320000,"chr4",169403,1,4,1,6,"chr4",1,0.00562587904360056
"5247","chr4.39525000.39530000","chr4.39695000.39700000",170000,19,7.568237e-07,39525000,39695000,39530000,39700000,"chr4",169408,0,8,10,18,"chr4",1,0.040084388185654
"5248","chr4.158910000.158915000","chr4.159100000.159105000",190000,20,3.981406e-08,158910000,159100000,158915000,159105000,"chr4",169415,2,1,1,4,"chr4",1,0.00937646507266761
"5249","chr4.40985000.40990000","chr4.41080000.41085000",95000,20,4.087143e-05,40985000,41080000,40990000,41085000,"chr4",169423,2,8,6,16,"chr4",1,0.0375058602906704
"5250","chr4.48490000.48495000","chr4.48960000.48965000",470000,9,0.005250471,48490000,48960000,48495000,48965000,"chr4",169442,1,2,3,6,"chr4",1,0.00632911392405063
"5251","chr4.7310000.7315000","chr4.7360000.7365000",50000,23,0.001802977,7310000,7360000,7315000,7365000,"chr4",169448,1,7,4,12,"chr4",1,0.0323488045007032
"5252","chr4.17615000.17620000","chr4.17810000.17815000",195000,26,1.908878e-13,17615000,17810000,17620000,17815000,"chr4",169464,2,8,4,14,"chr4",1,0.0426629160806376
"5253","chr4.40735000.40740000","chr4.40905000.40910000",170000,19,7.568237e-07,40735000,40905000,40740000,40910000,"chr4",169495,2,5,6,13,"chr4",1,0.0289498359118612
"5254","chr4.185200000.185205000","chr4.185395000.185400000",195000,29,2.446187e-16,185200000,185395000,185205000,185400000,"chr4",169521,0,3,0,3,"chr4",1,0.010196905766526
"5255","chr4.38200000.38205000","chr4.38560000.38565000",360000,15,7.66819e-07,38200000,38560000,38205000,38565000,"chr4",169597,0,0,2,2,"chr4",1,0.00351617440225035
"5256","chr4.48575000.48580000","chr4.48785000.48790000",210000,14,0.0002805808,48575000,48785000,48580000,48790000,"chr4",169655,5,10,15,30,"chr4",1,0.0492264416315049
"5257","chr4.7100000.7105000","chr4.7800000.7805000",700000,9,0.0007381464,7100000,7800000,7105000,7805000,"chr4",169709,1,5,3,9,"chr4",1,0.00949367088607595
"5258","chr4.25235000.25240000","chr4.25310000.25315000",75000,29,2.672947e-09,25235000,25310000,25240000,25315000,"chr4",169739,5,5,16,26,"chr4",1,0.0883731833098922
"5259","chr4.38575000.38580000","chr4.38610000.38615000",35000,32,4.087143e-05,38575000,38610000,38580000,38615000,"chr4",169742,0,2,2,4,"chr4",1,0.0150023441162682
"5260","chr4.138955000.138960000","chr4.139015000.139020000",60000,26,7.54015e-06,138955000,139015000,138960000,139020000,"chr4",169787,1,9,10,20,"chr4",1,0.0609470229723394
"5261","chr4.82345000.82350000","chr4.82380000.82385000",35000,35,1.846444e-06,82345000,82380000,82350000,82385000,"chr4",169823,1,7,2,10,"chr4",1,0.0410220346929208
"5262","chr4.40905000.40910000","chr4.41215000.41220000",310000,15,2.422558e-06,40905000,41215000,40910000,41220000,"chr4",169837,2,5,4,11,"chr4",1,0.0193389592123769
"5263","chr4.185210000.185215000","chr4.185470000.185475000",260000,11,0.004550564,185210000,185470000,185215000,185475000,"chr4",169841,1,9,12,22,"chr4",1,0.0283638068448195
"5264","chr4.38200000.38205000","chr4.38610000.38615000",410000,12,8.183911e-05,38200000,38610000,38205000,38615000,"chr4",169855,1,2,4,7,"chr4",1,0.00984528832630099
"5265","chr4.14880000.14885000","chr4.14915000.14920000",35000,38,6.116234e-08,14880000,14915000,14885000,14920000,"chr4",169863,2,3,7,12,"chr4",1,0.0534458509142053
"5266","chr4.138955000.138960000","chr4.139855000.139860000",900000,9,0.0001565947,138955000,139855000,138960000,139860000,"chr4",169865,1,1,1,3,"chr4",1,0.00316455696202532
"5267","chr4.2865000.2870000","chr4.2890000.2895000",25000,35,0.001648449,2865000,2890000,2870000,2895000,"chr4",169892,1,3,4,8,"chr4",1,0.0328176277543366
"5268","chr4.102050000.102055000","chr4.102230000.102235000",180000,12,0.009964357,102050000,102230000,102055000,102235000,"chr4",169966,0,2,0,2,"chr4",1,0.00281293952180028
"5269","chr4.38200000.38205000","chr4.38320000.38325000",120000,14,0.008449866,38200000,38320000,38205000,38325000,"chr4",170074,0,2,1,3,"chr4",1,0.00492264416315049
"5270","chr4.48580000.48585000","chr4.48775000.48780000",195000,18,1.009808e-06,48580000,48775000,48585000,48780000,"chr4",170133,1,2,4,7,"chr4",1,0.0147679324894515
"5271","chr4.40925000.40930000","chr4.41150000.41155000",225000,20,5.172686e-09,40925000,41150000,40930000,41155000,"chr4",170168,0,3,3,6,"chr4",1,0.0140646976090014
"5272","chr4.38490000.38495000","chr4.38660000.38665000",170000,18,3.836827e-06,38490000,38660000,38495000,38665000,"chr4",170228,1,8,9,18,"chr4",1,0.0379746835443038
"5273","chr4.14885000.14890000","chr4.14915000.14920000",30000,35,5.120994e-05,14885000,14915000,14890000,14920000,"chr4",170229,3,13,5,21,"chr4",1,0.0861462728551336
"5274","chr4.6905000.6910000","chr4.7100000.7105000",195000,15,0.0001168053,6905000,7100000,6910000,7105000,"chr4",170398,1,3,3,7,"chr4",1,0.0123066104078762
"5275","chr4.6710000.6715000","chr4.7100000.7105000",390000,11,0.0005791038,6710000,7100000,6715000,7105000,"chr4",170403,1,8,3,12,"chr4",1,0.0154711673699015
"5276","chr4.82515000.82520000","chr4.82740000.82745000",225000,11,0.009908284,82515000,82740000,82520000,82745000,"chr4",170460,0,8,2,10,"chr4",1,0.012892639474918
"5277","chr4.139095000.139100000","chr4.139585000.139590000",490000,10,0.000899509,139095000,139585000,139100000,139590000,"chr4",170465,0,3,1,4,"chr4",1,0.0046882325363338
"5278","chr4.38060000.38065000","chr4.38755000.38760000",695000,11,1.652672e-05,38060000,38755000,38065000,38760000,"chr4",170504,1,6,3,10,"chr4",1,0.012892639474918
"5279","chr4.7805000.7810000","chr4.7945000.7950000",140000,15,0.001162659,7805000,7945000,7810000,7950000,"chr4",170573,3,11,8,22,"chr4",1,0.0386779184247539
"5280","chr4.7360000.7365000","chr4.7380000.7385000",20000,46,1.678798e-06,7360000,7380000,7365000,7385000,"chr4",170618,1,3,3,7,"chr4",1,0.0377402719174871
"5281","chr4.26320000.26325000","chr4.26410000.26415000",90000,40,7.447737e-20,26320000,26410000,26325000,26415000,"chr4",170644,0,2,2,4,"chr4",1,0.0187529301453352
"5282","chr4.7200000.7205000","chr4.7750000.7755000",550000,11,8.098171e-05,7200000,7750000,7205000,7755000,"chr4",170683,0,3,1,4,"chr4",1,0.00515705578996718
"5283","chr4.48560000.48565000","chr4.48775000.48780000",215000,16,1.065583e-05,48560000,48775000,48565000,48780000,"chr4",170694,4,2,4,10,"chr4",1,0.0187529301453352
"5284","chr4.17605000.17610000","chr4.18590000.18595000",985000,7,0.003953515,17605000,18590000,17610000,18595000,"chr4",170739,1,6,6,13,"chr4",1,0.0106657290201594
"5285","chr4.48640000.48645000","chr4.48780000.48785000",140000,15,0.001162659,48640000,48780000,48645000,48785000,"chr4",170754,0,3,1,4,"chr4",1,0.0070323488045007
"5286","chr4.39475000.39480000","chr4.39635000.39640000",160000,22,8.335474e-09,39475000,39635000,39480000,39640000,"chr4",170800,3,7,7,17,"chr4",1,0.0438349742147211
"5287","chr4.6915000.6920000","chr4.7065000.7070000",150000,16,0.0002035185,6915000,7065000,6920000,7070000,"chr4",170816,1,4,11,16,"chr4",1,0.0300046882325363
"5288","chr4.7800000.7805000","chr4.7935000.7940000",135000,21,2.752524e-07,7800000,7935000,7805000,7940000,"chr4",170855,3,5,12,20,"chr4",1,0.0492264416315049
"5289","chr4.38780000.38785000","chr4.38900000.38905000",120000,16,0.0008632511,38780000,38900000,38785000,38905000,"chr4",170895,3,3,1,7,"chr4",1,0.0131270511017346
"5290","chr4.153425000.153430000","chr4.153560000.153565000",135000,25,2.719537e-10,153425000,153560000,153430000,153565000,"chr4",170906,1,3,4,8,"chr4",1,0.023441162681669
"5291","chr4.17615000.17620000","chr4.18590000.18595000",975000,9,8.17014e-05,17615000,18590000,17620000,18595000,"chr4",170912,1,6,6,13,"chr4",1,0.0137130801687764
"5292","chr4.48640000.48645000","chr4.48775000.48780000",135000,34,3.212046e-18,48640000,48775000,48645000,48780000,"chr4",170926,0,2,1,3,"chr4",1,0.0119549929676512
"5293","chr4.38265000.38270000","chr4.38610000.38615000",345000,11,0.001039228,38265000,38610000,38270000,38615000,"chr4",170934,1,2,4,7,"chr4",1,0.00902484763244257
"5294","chr4.48695000.48700000","chr4.48775000.48780000",80000,31,3.090158e-11,48695000,48775000,48700000,48780000,"chr4",170979,0,1,4,5,"chr4",1,0.0181669010782935
"5295","chr4.39475000.39480000","chr4.39660000.39665000",185000,12,0.00854755,39475000,39660000,39480000,39665000,"chr4",171032,8,22,17,47,"chr4",1,0.0661040787623066
"5296","chr4.39365000.39370000","chr4.39455000.39460000",90000,17,0.002386154,39365000,39455000,39370000,39460000,"chr4",171042,6,13,11,30,"chr4",1,0.059774964838256
"5297","chr4.82385000.82390000","chr4.82785000.82790000",400000,15,3.48458e-07,82385000,82785000,82390000,82790000,"chr4",171044,2,8,9,19,"chr4",1,0.0334036568213783
"5298","chr4.41365000.41370000","chr4.41670000.41675000",305000,13,8.824146e-05,41365000,41670000,41370000,41675000,"chr4",171062,0,0,2,2,"chr4",1,0.00304735114861697
"5299","chr4.41280000.41285000","chr4.41660000.41665000",380000,16,6.83554e-08,41280000,41660000,41285000,41665000,"chr4",171081,3,5,5,13,"chr4",1,0.0243788091889358
"5300","chr4.7800000.7805000","chr4.7975000.7980000",175000,18,2.905485e-06,7800000,7975000,7805000,7980000,"chr4",171094,0,2,1,3,"chr4",1,0.00632911392405063
"5301","chr4.85745000.85750000","chr4.85840000.85845000",95000,18,0.0004958028,85745000,85840000,85750000,85845000,"chr4",171168,0,3,0,3,"chr4",1,0.00632911392405063
"5302","chr4.2760000.2765000","chr4.2845000.2850000",85000,19,0.0004332178,2760000,2845000,2765000,2850000,"chr4",171179,0,9,5,14,"chr4",1,0.0311767463666198
"5303","chr4.84690000.84695000","chr4.85420000.85425000",730000,11,1.142951e-05,84690000,85420000,84695000,85425000,"chr4",171188,1,4,1,6,"chr4",1,0.00773558368495077
"5304","chr4.40990000.40995000","chr4.41210000.41215000",220000,25,2.259071e-13,40990000,41210000,40995000,41215000,"chr4",171206,3,8,6,17,"chr4",1,0.0498124706985466
"5305","chr4.185210000.185215000","chr4.185355000.185360000",145000,13,0.00980022,185210000,185355000,185215000,185360000,"chr4",171239,1,2,2,5,"chr4",1,0.00761837787154243
"5306","chr4.17815000.17820000","chr4.18590000.18595000",775000,23,9.157598e-20,17815000,18590000,17820000,18595000,"chr4",171369,0,6,6,12,"chr4",1,0.0323488045007032
"5307","chr4.41415000.41420000","chr4.41640000.41645000",225000,15,3.614279e-05,41415000,41640000,41420000,41645000,"chr4",171377,2,2,2,6,"chr4",1,0.0105485232067511
"5308","chr4.38560000.38565000","chr4.38620000.38625000",60000,20,0.004550564,38560000,38620000,38565000,38625000,"chr4",171414,0,0,2,2,"chr4",1,0.0046882325363338
"5309","chr4.15040000.15045000","chr4.15160000.15165000",120000,26,1.943778e-10,15040000,15160000,15045000,15165000,"chr4",171416,0,2,0,2,"chr4",1,0.00609470229723394
"5310","chr4.185555000.185560000","chr4.185600000.185605000",45000,24,0.002080527,185555000,185600000,185560000,185605000,"chr4",171443,0,4,1,5,"chr4",1,0.0140646976090014
"5311","chr4.138955000.138960000","chr4.139600000.139605000",645000,36,3.924618e-36,138955000,139600000,138960000,139605000,"chr4",171444,0,7,10,17,"chr4",1,0.0717299578059072
"5312","chr4.20320000.20325000","chr4.20425000.20430000",105000,26,1.300324e-09,20320000,20425000,20325000,20430000,"chr4",171448,1,1,1,3,"chr4",1,0.00914205344585091
"5313","chr4.152230000.152235000","chr4.152935000.152940000",705000,8,0.004026175,152230000,152935000,152235000,152940000,"chr4",171471,0,6,0,6,"chr4",1,0.00562587904360056
"5314","chr4.16455000.16460000","chr4.17445000.17450000",990000,8,0.0005728756,16455000,17445000,16460000,17450000,"chr4",171538,0,3,0,3,"chr4",1,0.00281293952180028
"5315","chr4.24390000.24395000","chr4.24415000.24420000",25000,35,0.001648449,24390000,24415000,24395000,24420000,"chr4",171589,1,3,2,6,"chr4",1,0.0246132208157525
"5316","chr4.90755000.90760000","chr4.90790000.90795000",35000,30,0.0002659333,90755000,90790000,90760000,90795000,"chr4",171653,0,0,4,4,"chr4",1,0.0140646976090014
"5317","chr4.6715000.6720000","chr4.6900000.6905000",185000,14,0.0006989227,6715000,6900000,6720000,6905000,"chr4",171668,1,7,14,22,"chr4",1,0.0360993905297703
"5318","chr4.158910000.158915000","chr4.159175000.159180000",265000,21,8.133282e-11,158910000,159175000,158915000,159180000,"chr4",171673,2,8,2,12,"chr4",1,0.029535864978903
"5319","chr4.82385000.82390000","chr4.82675000.82680000",290000,13,0.0001234153,82385000,82675000,82390000,82680000,"chr4",171757,0,2,0,2,"chr4",1,0.00304735114861697
"5320","chr4.6325000.6330000","chr4.6570000.6575000",245000,11,0.006328824,6325000,6570000,6330000,6575000,"chr4",171794,0,3,2,5,"chr4",1,0.00644631973745898
"5321","chr4.77105000.77110000","chr4.77165000.77170000",60000,32,2.32875e-09,77105000,77165000,77110000,77170000,"chr4",171845,2,4,2,8,"chr4",1,0.0300046882325363
"5322","chr4.41155000.41160000","chr4.41215000.41220000",60000,24,7.77048e-05,41155000,41215000,41160000,41220000,"chr4",171919,1,10,3,14,"chr4",1,0.0393811533052039
"5323","chr4.6915000.6920000","chr4.6985000.6990000",70000,23,3.184208e-05,6915000,6985000,6920000,6990000,"chr4",171943,1,6,2,9,"chr4",1,0.0242616033755274
"5324","chr4.16025000.16030000","chr4.16195000.16200000",170000,19,7.568237e-07,16025000,16195000,16030000,16200000,"chr4",171949,2,5,2,9,"chr4",1,0.020042194092827
"5325","chr4.145095000.145100000","chr4.145675000.145680000",580000,9,0.001978736,145095000,145675000,145100000,145680000,"chr4",171951,2,5,11,18,"chr4",1,0.0189873417721519
"5326","chr4.16025000.16030000","chr4.16205000.16210000",180000,23,2.92555e-10,16025000,16205000,16030000,16210000,"chr4",171975,3,5,4,12,"chr4",1,0.0323488045007032
"5327","chr4.185180000.185185000","chr4.185395000.185400000",215000,13,0.0009762063,185180000,185395000,185185000,185400000,"chr4",171997,0,3,0,3,"chr4",1,0.00457102672292546
"5328","chr4.38305000.38310000","chr4.38675000.38680000",370000,15,6.347533e-07,38305000,38675000,38310000,38680000,"chr4",172042,1,5,1,7,"chr4",1,0.0123066104078762
"5329","chr4.6715000.6720000","chr4.7070000.7075000",355000,21,2.097898e-12,6715000,7070000,6720000,7075000,"chr4",172052,0,6,3,9,"chr4",1,0.0221518987341772
"5330","chr4.40990000.40995000","chr4.41080000.41085000",90000,18,0.0007898527,40990000,41080000,40995000,41085000,"chr4",172096,2,8,11,21,"chr4",1,0.0443037974683544
"5331","chr4.38175000.38180000","chr4.38620000.38625000",445000,9,0.006656722,38175000,38620000,38180000,38625000,"chr4",172097,1,11,7,19,"chr4",1,0.020042194092827
"5332","chr4.17575000.17580000","chr4.17615000.17620000",40000,51,8.157296e-18,17575000,17615000,17580000,17620000,"chr4",172247,2,16,13,31,"chr4",1,0.185302390998594
"5333","chr4.40915000.40920000","chr4.41210000.41215000",295000,15,3.611319e-06,40915000,41210000,40920000,41215000,"chr4",172250,3,0,1,4,"chr4",1,0.0070323488045007
"5334","chr4.24005000.24010000","chr4.24415000.24420000",410000,10,0.002169033,24005000,24415000,24010000,24420000,"chr4",172252,1,3,2,6,"chr4",1,0.0070323488045007
"5335","chr4.138915000.138920000","chr4.139600000.139605000",685000,8,0.004550564,138915000,139600000,138920000,139605000,"chr4",172301,0,4,1,5,"chr4",1,0.0046882325363338
"5336","chr4.36245000.36250000","chr4.36290000.36295000",45000,37,6.545978e-10,36245000,36290000,36250000,36295000,"chr4",172310,0,3,1,4,"chr4",1,0.0173464603844351
"5337","chr4.82470000.82475000","chr4.82760000.82765000",290000,20,2.15181e-10,82470000,82760000,82475000,82765000,"chr4",172326,4,10,9,23,"chr4",1,0.0539146741678387
"5338","chr4.113090000.113095000","chr4.113145000.113150000",55000,33,3.362283e-09,113090000,113145000,113095000,113150000,"chr4",172340,0,0,1,1,"chr4",1,0.00386779184247539
"5339","chr4.48580000.48585000","chr4.48875000.48880000",295000,10,0.008892622,48580000,48875000,48585000,48880000,"chr4",172366,1,1,5,7,"chr4",1,0.00820440693858415
"5340","chr4.82385000.82390000","chr4.82695000.82700000",310000,14,1.441447e-05,82385000,82695000,82390000,82700000,"chr4",172426,2,10,12,24,"chr4",1,0.0393811533052039
"5341","chr4.140100000.140105000","chr4.140325000.140330000",225000,12,0.002816769,140100000,140325000,140105000,140330000,"chr4",172433,6,9,7,22,"chr4",1,0.0309423347398031
"5342","chr4.40910000.40915000","chr4.41210000.41215000",300000,11,0.002123289,40910000,41210000,40915000,41215000,"chr4",172450,3,8,6,17,"chr4",1,0.0219174871073605
"5343","chr4.6720000.6725000","chr4.6875000.6880000",155000,21,6.799155e-08,6720000,6875000,6725000,6880000,"chr4",172556,0,1,0,1,"chr4",1,0.00246132208157525
"5344","chr4.158145000.158150000","chr4.158210000.158215000",65000,22,0.0002562114,158145000,158210000,158150000,158215000,"chr4",172595,1,2,0,3,"chr4",1,0.00773558368495077
"5345","chr4.48560000.48565000","chr4.48785000.48790000",225000,15,3.614279e-05,48560000,48785000,48565000,48790000,"chr4",172606,4,2,6,12,"chr4",1,0.0210970464135021
"5346","chr4.41340000.41345000","chr4.41670000.41675000",330000,10,0.005455783,41340000,41670000,41345000,41675000,"chr4",172610,2,2,2,6,"chr4",1,0.0070323488045007
"5347","chr4.38220000.38225000","chr4.38315000.38320000",95000,20,4.087143e-05,38220000,38315000,38225000,38320000,"chr4",172617,0,0,1,1,"chr4",1,0.0023441162681669
"5348","chr4.25985000.25990000","chr4.26315000.26320000",330000,12,0.0002730954,25985000,26315000,25990000,26320000,"chr4",172623,0,0,3,3,"chr4",1,0.00421940928270042
"5349","chr4.82385000.82390000","chr4.82720000.82725000",335000,11,0.001203365,82385000,82720000,82390000,82725000,"chr4",172629,2,10,8,20,"chr4",1,0.0257852789498359
"5350","chr4.100080000.100085000","chr4.100360000.100365000",280000,11,0.003078506,100080000,100360000,100085000,100365000,"chr4",172687,0,1,1,2,"chr4",1,0.00257852789498359
"5351","chr4.40990000.40995000","chr4.41150000.41155000",160000,13,0.00593113,40990000,41150000,40995000,41155000,"chr4",172739,0,3,3,6,"chr4",1,0.00914205344585091
"5352","chr4.169610000.169615000","chr4.169900000.169905000",290000,10,0.009730762,169610000,169900000,169615000,169905000,"chr4",172767,0,2,0,2,"chr4",1,0.0023441162681669
"5353","chr4.36245000.36250000","chr4.36345000.36350000",100000,17,0.001018581,36245000,36345000,36250000,36350000,"chr4",172768,2,8,6,16,"chr4",1,0.0318799812470699
"5354","chr4.48580000.48585000","chr4.48830000.48835000",250000,11,0.005623245,48580000,48830000,48585000,48835000,"chr4",172839,1,4,10,15,"chr4",1,0.0193389592123769
"5355","chr4.108985000.108990000","chr4.109425000.109430000",440000,9,0.006903724,108985000,109425000,108990000,109430000,"chr4",172842,0,3,0,3,"chr4",1,0.00316455696202532
"5356","chr4.6985000.6990000","chr4.7100000.7105000",115000,15,0.003689618,6985000,7100000,6990000,7105000,"chr4",172920,1,6,2,9,"chr4",1,0.0158227848101266
"5357","chr4.37685000.37690000","chr4.37800000.37805000",115000,17,0.0003386994,37685000,37800000,37690000,37805000,"chr4",172956,0,0,4,4,"chr4",1,0.00796999531176746
"5358","chr4.41060000.41065000","chr4.41145000.41150000",85000,22,1.033023e-05,41060000,41145000,41065000,41150000,"chr4",172972,3,20,18,41,"chr4",1,0.105719643694327
"5359","chr4.41070000.41075000","chr4.41215000.41220000",145000,40,8.011505e-25,41070000,41215000,41075000,41220000,"chr4",172990,3,7,4,14,"chr4",1,0.0656352555086732
"5360","chr4.16640000.16645000","chr4.17510000.17515000",870000,10,2.536085e-05,16640000,17510000,16645000,17515000,"chr4",173060,0,2,2,4,"chr4",1,0.0046882325363338
"5361","chr4.17560000.17565000","chr4.17810000.17815000",250000,17,4.502448e-07,17560000,17810000,17565000,17815000,"chr4",173090,4,8,4,16,"chr4",1,0.0318799812470699
"5362","chr4.6730000.6735000","chr4.6985000.6990000",255000,19,8.063084e-09,6730000,6985000,6735000,6990000,"chr4",173101,0,6,1,7,"chr4",1,0.0155883731833099
"5363","chr4.26000000.26005000","chr4.26315000.26320000",315000,10,0.006694967,2.6e+07,26315000,26005000,26320000,"chr4",173212,0,0,1,1,"chr4",1,0.00117205813408345
"5364","chr4.38265000.38270000","chr4.38665000.38670000",400000,11,0.0005107894,38265000,38665000,38270000,38670000,"chr4",173228,1,1,0,2,"chr4",1,0.00257852789498359
"5365","chr4.40985000.40990000","chr4.41210000.41215000",225000,50,3.824806e-42,40985000,41210000,40990000,41215000,"chr4",173323,2,8,6,16,"chr4",1,0.093764650726676
"5366","chr4.37600000.37605000","chr4.37800000.37805000",200000,40,2.524025e-28,37600000,37800000,37605000,37805000,"chr4",173358,2,3,7,12,"chr4",1,0.0562587904360056
"5367","chr4.6720000.6725000","chr4.6885000.6890000",165000,32,6.785194e-18,6720000,6885000,6725000,6890000,"chr4",173515,0,2,1,3,"chr4",1,0.0112517580872011
"5368","chr4.185215000.185220000","chr4.185565000.185570000",350000,13,3.671792e-05,185215000,185565000,185220000,185570000,"chr4",173573,2,6,2,10,"chr4",1,0.0152367557430849
"5369","chr4.26340000.26345000","chr4.26410000.26415000",70000,36,1.056956e-13,26340000,26410000,26345000,26415000,"chr4",173653,5,6,11,22,"chr4",1,0.0928270042194093
"5370","chr4.40985000.40990000","chr4.41135000.41140000",150000,17,5.040901e-05,40985000,41135000,40990000,41140000,"chr4",173663,2,8,6,16,"chr4",1,0.0318799812470699
"5371","chr4.48575000.48580000","chr4.48900000.48905000",325000,15,1.678798e-06,48575000,48900000,48580000,48905000,"chr4",173664,5,10,16,31,"chr4",1,0.0545007032348805
"5372","chr4.26235000.26240000","chr4.26315000.26320000",80000,21,7.55126e-05,26235000,26315000,26240000,26320000,"chr4",173711,0,0,5,5,"chr4",1,0.0123066104078762
"5373","chr4.3275000.3280000","chr4.3345000.3350000",70000,22,0.0001049317,3275000,3345000,3280000,3350000,"chr4",173717,1,3,4,8,"chr4",1,0.0206282231598687
"5374","chr4.84560000.84565000","chr4.85420000.85425000",860000,12,3.16575e-07,84560000,85420000,84565000,85425000,"chr4",173754,1,4,1,6,"chr4",1,0.00843881856540084
"5375","chr4.6730000.6735000","chr4.7070000.7075000",340000,14,7.589e-06,6730000,7070000,6735000,7075000,"chr4",173762,0,6,1,7,"chr4",1,0.0114861697140178
"5376","chr4.15040000.15045000","chr4.15195000.15200000",155000,14,0.002169033,15040000,15195000,15045000,15200000,"chr4",173805,0,2,3,5,"chr4",1,0.00820440693858415
"5377","chr4.82345000.82350000","chr4.82755000.82760000",410000,17,4.21305e-09,82345000,82755000,82350000,82760000,"chr4",173817,6,25,21,52,"chr4",1,0.103609939052977
"5378","chr4.139965000.139970000","chr4.139985000.139990000",20000,47,6.601839e-07,139965000,139985000,139970000,139990000,"chr4",173840,0,8,5,13,"chr4",1,0.0716127519924988
"5379","chr4.108980000.108985000","chr4.109420000.109425000",440000,12,5.387588e-05,108980000,109420000,108985000,109425000,"chr4",173853,0,2,5,7,"chr4",1,0.00984528832630099
"5380","chr4.41365000.41370000","chr4.41640000.41645000",275000,19,3.3151e-09,41365000,41640000,41370000,41645000,"chr4",173856,0,0,2,2,"chr4",1,0.00445382090951711
"5381","chr4.158915000.158920000","chr4.159100000.159105000",185000,12,0.00854755,158915000,159100000,158920000,159105000,"chr4",173879,2,1,1,4,"chr4",1,0.00562587904360056
"5382","chr4.82345000.82350000","chr4.82720000.82725000",375000,10,0.003192291,82345000,82720000,82350000,82725000,"chr4",173896,6,13,8,27,"chr4",1,0.0316455696202532
"5383","chr4.38320000.38325000","chr4.38575000.38580000",255000,14,6.454855e-05,38320000,38575000,38325000,38580000,"chr4",173924,0,2,1,3,"chr4",1,0.00492264416315049
"5384","chr4.48575000.48580000","chr4.48875000.48880000",300000,19,1.228628e-09,48575000,48875000,48580000,48880000,"chr4",173984,3,1,5,9,"chr4",1,0.020042194092827
"5385","chr4.2585000.2590000","chr4.2620000.2625000",35000,29,0.000660382,2585000,2620000,2590000,2625000,"chr4",173993,4,16,14,34,"chr4",1,0.115564932020628
"5386","chr4.38320000.38325000","chr4.38660000.38665000",340000,22,3.343078e-13,38320000,38660000,38325000,38665000,"chr4",174025,0,2,1,3,"chr4",1,0.00773558368495077
"5387","chr4.82385000.82390000","chr4.82755000.82760000",370000,16,8.534755e-08,82385000,82755000,82390000,82760000,"chr4",174047,2,10,12,24,"chr4",1,0.0450070323488045
"5388","chr4.140010000.140015000","chr4.140100000.140105000",90000,16,0.006739992,140010000,140100000,140015000,140105000,"chr4",174083,0,2,3,5,"chr4",1,0.00937646507266761
"5389","chr4.41070000.41075000","chr4.41210000.41215000",140000,50,2.324202e-35,41070000,41210000,41075000,41215000,"chr4",174096,3,7,6,16,"chr4",1,0.093764650726676
"5390","chr4.145095000.145100000","chr4.145530000.145535000",435000,15,1.766361e-07,145095000,145530000,145100000,145535000,"chr4",174098,3,4,4,11,"chr4",1,0.0193389592123769
"5391","chr4.26340000.26345000","chr4.26395000.26400000",55000,31,5.310745e-08,26340000,26395000,26345000,26400000,"chr4",174128,1,9,3,13,"chr4",1,0.0472339428035631
"5392","chr4.7805000.7810000","chr4.7960000.7965000",155000,15,0.0006195244,7805000,7960000,7810000,7965000,"chr4",174284,1,9,7,17,"chr4",1,0.029887482419128
"5393","chr4.38315000.38320000","chr4.38730000.38735000",415000,9,0.008726884,38315000,38730000,38320000,38735000,"chr4",174296,0,7,1,8,"chr4",1,0.00843881856540084
"5394","chr4.151675000.151680000","chr4.151695000.151700000",20000,45,4.145606e-06,151675000,151695000,151680000,151700000,"chr4",174310,0,2,0,2,"chr4",1,0.0105485232067511
"5395","chr4.185200000.185205000","chr4.185565000.185570000",365000,17,1.20374e-08,185200000,185565000,185205000,185570000,"chr4",174311,2,6,2,10,"chr4",1,0.0199249882794187
"5396","chr4.185320000.185325000","chr4.185370000.185375000",50000,23,0.001802977,185320000,185370000,185325000,185375000,"chr4",174374,0,0,4,4,"chr4",1,0.0107829348335677
"5397","chr4.41425000.41430000","chr4.41640000.41645000",215000,12,0.003707713,41425000,41640000,41430000,41645000,"chr4",174408,1,1,2,4,"chr4",1,0.00562587904360056
"5398","chr4.39465000.39470000","chr4.39975000.39980000",510000,14,3.731045e-07,39465000,39975000,39470000,39980000,"chr4",174436,0,15,13,28,"chr4",1,0.0459446788560713
"5399","chr4.48695000.48700000","chr4.48785000.48790000",90000,18,0.0007898527,48695000,48785000,48700000,48790000,"chr4",174446,0,1,12,13,"chr4",1,0.0274261603375527
"5400","chr4.38315000.38320000","chr4.38560000.38565000",245000,16,3.230702e-06,38315000,38560000,38320000,38565000,"chr4",174462,0,0,1,1,"chr4",1,0.00187529301453352
"5401","chr4.6730000.6735000","chr4.6925000.6930000",195000,12,0.006527429,6730000,6925000,6735000,6930000,"chr4",174473,0,5,1,6,"chr4",1,0.00843881856540084
"5402","chr4.38900000.38905000","chr4.39180000.39185000",280000,16,9.3315e-07,38900000,39180000,38905000,39185000,"chr4",174538,3,3,1,7,"chr4",1,0.0131270511017346
"5403","chr4.7785000.7790000","chr4.7935000.7940000",150000,13,0.008281143,7785000,7935000,7790000,7940000,"chr4",174595,2,2,0,4,"chr4",1,0.00609470229723394
"5404","chr4.16640000.16645000","chr4.17470000.17475000",830000,7,0.009843543,16640000,17470000,16645000,17475000,"chr4",174599,0,2,2,4,"chr4",1,0.00328176277543366
"5405","chr4.40930000.40935000","chr4.41070000.41075000",140000,18,2.030757e-05,40930000,41070000,40935000,41075000,"chr4",174604,1,5,7,13,"chr4",1,0.0274261603375527
"5406","chr4.4250000.4255000","chr4.4290000.4295000",40000,29,8.137866e-05,4250000,4290000,4255000,4295000,"chr4",174642,2,9,3,14,"chr4",1,0.0475855602437881
"5407","chr4.38165000.38170000","chr4.38610000.38615000",445000,11,0.0002842954,38165000,38610000,38170000,38615000,"chr4",174643,1,2,1,4,"chr4",1,0.00515705578996718
"5408","chr4.38315000.38320000","chr4.38575000.38580000",260000,14,5.484466e-05,38315000,38575000,38320000,38580000,"chr4",174677,0,6,1,7,"chr4",1,0.0114861697140178
"5409","chr4.140735000.140740000","chr4.140755000.140760000",20000,59,1.383596e-12,140735000,140755000,140740000,140760000,"chr4",174702,2,6,10,18,"chr4",1,0.124472573839662
"5410","chr4.41045000.41050000","chr4.41210000.41215000",165000,18,5.038288e-06,41045000,41210000,41050000,41215000,"chr4",174715,3,8,6,17,"chr4",1,0.0358649789029536
"5411","chr4.87975000.87980000","chr4.88015000.88020000",40000,29,8.137866e-05,87975000,88015000,87980000,88020000,"chr4",174741,0,1,7,8,"chr4",1,0.0271917487107361
"5412","chr4.2220000.2225000","chr4.2405000.2410000",185000,12,0.00854755,2220000,2405000,2225000,2410000,"chr4",174760,4,15,10,29,"chr4",1,0.0407876230661041
"5413","chr4.16640000.16645000","chr4.16755000.16760000",115000,19,2.40575e-05,16640000,16755000,16645000,16760000,"chr4",174795,0,2,2,4,"chr4",1,0.00890764181903422
"5414","chr4.38185000.38190000","chr4.38660000.38665000",475000,12,3.277296e-05,38185000,38660000,38190000,38665000,"chr4",174814,1,8,9,18,"chr4",1,0.0253164556962025
"5415","chr4.6710000.6715000","chr4.6985000.6990000",275000,16,1.09922e-06,6710000,6985000,6715000,6990000,"chr4",174877,1,6,2,9,"chr4",1,0.0168776371308017
"5416","chr4.86320000.86325000","chr4.86890000.86895000",570000,10,0.0003965299,86320000,86890000,86325000,86895000,"chr4",174914,1,3,4,8,"chr4",1,0.00937646507266761
"5417","chr4.151205000.151210000","chr4.151745000.151750000",540000,9,0.002807034,151205000,151745000,151210000,151750000,"chr4",174918,0,0,2,2,"chr4",1,0.00210970464135021
"5418","chr4.40735000.40740000","chr4.41210000.41215000",475000,13,4.950074e-06,40735000,41210000,40740000,41215000,"chr4",174926,3,8,6,17,"chr4",1,0.0259024847632443
"5419","chr4.82385000.82390000","chr4.82795000.82800000",410000,14,2.072198e-06,82385000,82795000,82390000,82800000,"chr4",174982,2,3,7,12,"chr4",1,0.019690576652602
"5420","chr4.2760000.2765000","chr4.2975000.2980000",215000,19,5.897813e-08,2760000,2975000,2765000,2980000,"chr4",175008,0,9,5,14,"chr4",1,0.0311767463666198
"5421","chr4.151100000.151105000","chr4.151675000.151680000",575000,8,0.009843543,151100000,151675000,151105000,151680000,"chr4",175045,0,2,0,2,"chr4",1,0.00187529301453352
"5422","chr4.164935000.164940000","chr4.165300000.165305000",365000,13,2.839845e-05,164935000,165300000,164940000,165305000,"chr4",175086,1,9,2,12,"chr4",1,0.0182841068917018
"5423","chr4.38190000.38195000","chr4.38660000.38665000",470000,14,7.326104e-07,38190000,38660000,38195000,38665000,"chr4",175097,1,8,9,18,"chr4",1,0.029535864978903
"5424","chr4.40985000.40990000","chr4.41120000.41125000",135000,41,3.574104e-25,40985000,41120000,40990000,41125000,"chr4",175099,2,2,6,10,"chr4",1,0.0480543834974215
"5425","chr4.41670000.41675000","chr4.41690000.41695000",20000,38,0.001166429,41670000,41690000,41675000,41695000,"chr4",175133,0,2,2,4,"chr4",1,0.0178152836380684
"5426","chr4.48780000.48785000","chr4.48875000.48880000",95000,17,0.001551464,48780000,48875000,48785000,48880000,"chr4",175142,3,1,5,9,"chr4",1,0.0179324894514768
"5427","chr4.88290000.88295000","chr4.88755000.88760000",465000,9,0.005519264,88290000,88755000,88295000,88760000,"chr4",175194,5,8,7,20,"chr4",1,0.0210970464135021
"5428","chr4.100315000.100320000","chr4.100360000.100365000",45000,24,0.002080527,100315000,100360000,100320000,100365000,"chr4",175204,0,2,2,4,"chr4",1,0.0112517580872011
"5429","chr4.36290000.36295000","chr4.36350000.36355000",60000,39,3.469088e-14,36290000,36350000,36295000,36355000,"chr4",175217,0,3,1,4,"chr4",1,0.0182841068917018
"5430","chr4.6640000.6645000","chr4.7065000.7070000",425000,10,0.001816415,6640000,7065000,6645000,7070000,"chr4",175232,1,4,14,19,"chr4",1,0.0222691045475856
"5431","chr4.70685000.70690000","chr4.70720000.70725000",35000,29,0.000660382,70685000,70720000,70690000,70725000,"chr4",175294,5,15,11,31,"chr4",1,0.105368026254102
"5432","chr4.185205000.185210000","chr4.185565000.185570000",360000,19,1.772769e-10,185205000,185565000,185210000,185570000,"chr4",175370,0,6,2,8,"chr4",1,0.0178152836380684
"5433","chr4.154590000.154595000","chr4.154625000.154630000",35000,30,0.0002659333,154590000,154625000,154595000,154630000,"chr4",175393,4,3,2,9,"chr4",1,0.0316455696202532
"5434","chr4.40985000.40990000","chr4.41070000.41075000",85000,43,7.031838e-22,40985000,41070000,40990000,41075000,"chr4",175401,2,7,6,15,"chr4",1,0.0755977496483826
"5435","chr4.152165000.152170000","chr4.152230000.152235000",65000,19,0.005280554,152165000,152230000,152170000,152235000,"chr4",175628,0,1,0,1,"chr4",1,0.00222691045475856
"5436","chr4.38175000.38180000","chr4.38805000.38810000",630000,12,4.358519e-06,38175000,38805000,38180000,38810000,"chr4",175661,4,11,16,31,"chr4",1,0.0436005625879044
"5437","chr4.138950000.138955000","chr4.139600000.139605000",650000,11,2.644056e-05,138950000,139600000,138955000,139605000,"chr4",175690,0,7,3,10,"chr4",1,0.012892639474918
"5438","chr4.20415000.20420000","chr4.20685000.20690000",270000,15,7.657239e-06,20415000,20685000,20420000,20690000,"chr4",175716,0,0,5,5,"chr4",1,0.00879043600562588
"5439","chr4.169175000.169180000","chr4.169435000.169440000",260000,11,0.004550564,169175000,169435000,169180000,169440000,"chr4",175734,2,2,1,5,"chr4",1,0.00644631973745898
"5440","chr4.36185000.36190000","chr4.36350000.36355000",165000,17,2.354783e-05,36185000,36350000,36190000,36355000,"chr4",175737,1,3,3,7,"chr4",1,0.0139474917955931
"5441","chr4.38755000.38760000","chr4.38855000.38860000",100000,27,4.985373e-10,38755000,38855000,38760000,38860000,"chr4",175751,1,4,2,7,"chr4",1,0.0221518987341772
"5442","chr4.185315000.185320000","chr4.185370000.185375000",55000,26,2.670857e-05,185315000,185370000,185320000,185375000,"chr4",175849,0,0,3,3,"chr4",1,0.00914205344585091
"5443","chr4.162640000.162645000","chr4.163075000.163080000",435000,12,5.751699e-05,162640000,163075000,162645000,163080000,"chr4",175865,0,2,0,2,"chr4",1,0.00281293952180028
"5444","chr4.88375000.88380000","chr4.88590000.88595000",215000,12,0.003707713,88375000,88590000,88380000,88595000,"chr4",175920,1,5,7,13,"chr4",1,0.0182841068917018
"5445","chr4.140930000.140935000","chr4.141155000.141160000",225000,15,3.614279e-05,140930000,141155000,140935000,141160000,"chr4",175925,0,2,2,4,"chr4",1,0.0070323488045007
"5446","chr4.48725000.48730000","chr4.48775000.48780000",50000,56,4.436745e-25,48725000,48775000,48730000,48780000,"chr4",175942,3,2,2,7,"chr4",1,0.0459446788560713
"5447","chr4.6710000.6715000","chr4.6885000.6890000",175000,16,6.40107e-05,6710000,6885000,6715000,6890000,"chr4",176008,1,8,3,12,"chr4",1,0.0225035161744023
"5448","chr4.41080000.41085000","chr4.41150000.41155000",70000,18,0.006903724,41080000,41150000,41085000,41155000,"chr4",176039,0,3,3,6,"chr4",1,0.0126582278481013
"5449","chr4.55865000.55870000","chr4.56420000.56425000",555000,12,1.11321e-05,55865000,56420000,55870000,56425000,"chr4",176043,0,4,3,7,"chr4",1,0.00984528832630099
"5450","chr4.38780000.38785000","chr4.39040000.39045000",260000,15,1.039127e-05,38780000,39040000,38785000,39045000,"chr4",176123,2,8,6,16,"chr4",1,0.0281293952180028
"5451","chr4.41280000.41285000","chr4.41620000.41625000",340000,10,0.00478668,41280000,41620000,41285000,41625000,"chr4",176185,0,12,8,20,"chr4",1,0.023441162681669
"5452","chr4.41215000.41220000","chr4.41930000.41935000",715000,9,0.0006645293,41215000,41930000,41220000,41935000,"chr4",176223,1,5,3,9,"chr4",1,0.00949367088607595
"5453","chr4.82385000.82390000","chr4.82760000.82765000",375000,59,3.690421e-63,82385000,82760000,82390000,82765000,"chr4",176252,2,10,9,21,"chr4",1,0.14521800281294
"5454","chr4.76585000.76590000","chr4.76640000.76645000",55000,21,0.00436154,76585000,76640000,76590000,76645000,"chr4",176266,0,1,1,2,"chr4",1,0.00492264416315049
"5455","chr4.40930000.40935000","chr4.40985000.40990000",55000,24,0.0002397778,40930000,40985000,40935000,40990000,"chr4",176314,1,5,6,12,"chr4",1,0.0337552742616034
"5456","chr4.6730000.6735000","chr4.7065000.7070000",335000,20,4.038419e-11,6730000,7065000,6735000,7070000,"chr4",176370,0,4,1,5,"chr4",1,0.0117205813408345
"5457","chr4.2845000.2850000","chr4.2875000.2880000",30000,36,2.025413e-05,2845000,2875000,2850000,2880000,"chr4",176375,5,14,17,36,"chr4",1,0.151898734177215
"5458","chr4.82610000.82615000","chr4.82740000.82745000",130000,15,0.001777197,82610000,82740000,82615000,82745000,"chr4",176378,5,11,7,23,"chr4",1,0.040436005625879
"5459","chr4.38780000.38785000","chr4.38855000.38860000",75000,24,3.611319e-06,38780000,38855000,38785000,38860000,"chr4",176392,3,4,2,9,"chr4",1,0.0253164556962025
"5460","chr4.82385000.82390000","chr4.82610000.82615000",225000,16,7.179803e-06,82385000,82610000,82390000,82615000,"chr4",176393,2,10,7,19,"chr4",1,0.0356305672761369
"5461","chr4.38175000.38180000","chr4.38560000.38565000",385000,13,2.050693e-05,38175000,38560000,38180000,38565000,"chr4",176396,0,0,2,2,"chr4",1,0.00304735114861697
"5462","chr4.185565000.185570000","chr4.185655000.185660000",90000,16,0.006739992,185565000,185655000,185570000,185660000,"chr4",176540,0,2,2,4,"chr4",1,0.00750117205813408
"5463","chr4.108980000.108985000","chr4.109470000.109475000",490000,9,0.004419244,108980000,109470000,108985000,109475000,"chr4",176550,0,2,3,5,"chr4",1,0.00527426160337553
"5464","chr4.185315000.185320000","chr4.185355000.185360000",40000,29,8.137866e-05,185315000,185355000,185320000,185360000,"chr4",176572,0,2,2,4,"chr4",1,0.013595874355368
"5465","chr4.25230000.25235000","chr4.25305000.25310000",75000,29,2.672947e-09,25230000,25305000,25235000,25310000,"chr4",176594,1,4,6,11,"chr4",1,0.0373886544772621
"5466","chr4.6720000.6725000","chr4.7070000.7075000",350000,24,1.729849e-15,6720000,7070000,6725000,7075000,"chr4",176595,0,2,1,3,"chr4",1,0.00843881856540084
"5467","chr4.185730000.185735000","chr4.186065000.186070000",335000,10,0.005070592,185730000,186065000,185735000,186070000,"chr4",176608,1,0,3,4,"chr4",1,0.0046882325363338
"5468","chr4.185180000.185185000","chr4.185530000.185535000",350000,10,0.004283184,185180000,185530000,185185000,185535000,"chr4",176696,0,4,1,5,"chr4",1,0.00586029067041725
"5469","chr4.6885000.6890000","chr4.6990000.6995000",105000,21,3.481329e-06,6885000,6990000,6890000,6995000,"chr4",176823,0,6,0,6,"chr4",1,0.0147679324894515
"5470","chr4.6715000.6720000","chr4.6985000.6990000",270000,21,6.29909e-11,6715000,6985000,6720000,6990000,"chr4",176911,1,6,2,9,"chr4",1,0.0221518987341772
"5471","chr4.108980000.108985000","chr4.109425000.109430000",445000,12,5.040901e-05,108980000,109425000,108985000,109430000,"chr4",176925,0,2,5,7,"chr4",1,0.00984528832630099
"5472","chr4.7935000.7940000","chr4.7960000.7965000",25000,33,0.006527429,7935000,7960000,7940000,7965000,"chr4",176955,1,9,7,17,"chr4",1,0.0657524613220816
"5473","chr4.48560000.48565000","chr4.48875000.48880000",315000,18,5.893866e-09,48560000,48875000,48565000,48880000,"chr4",176962,3,1,5,9,"chr4",1,0.0189873417721519
"5474","chr4.185180000.185185000","chr4.185565000.185570000",385000,15,4.689981e-07,185180000,185565000,185185000,185570000,"chr4",177064,1,6,2,9,"chr4",1,0.0158227848101266
"5475","chr4.76500000.76505000","chr4.76640000.76645000",140000,16,0.0003216699,76500000,76640000,76505000,76645000,"chr4",177072,0,8,3,11,"chr4",1,0.0206282231598687
"5476","chr4.37890000.37895000","chr4.38780000.38785000",890000,7,0.006971492,37890000,38780000,37895000,38785000,"chr4",177097,3,8,9,20,"chr4",1,0.0164088138771683
"5477","chr4.41045000.41050000","chr4.41135000.41140000",90000,17,0.002386154,41045000,41135000,41050000,41140000,"chr4",177104,3,16,7,26,"chr4",1,0.0518049695264885
"5478","chr4.40910000.40915000","chr4.41215000.41220000",305000,22,1.331468e-12,40910000,41215000,40915000,41220000,"chr4",177238,3,10,4,17,"chr4",1,0.0438349742147211
"5479","chr4.183840000.183845000","chr4.184165000.184170000",325000,15,1.678798e-06,183840000,184165000,183845000,184170000,"chr4",177259,0,4,1,5,"chr4",1,0.00879043600562588
"5480","chr4.112865000.112870000","chr4.112955000.112960000",90000,16,0.006739992,112865000,112955000,112870000,112960000,"chr4",177264,4,11,16,31,"chr4",1,0.0581340834505391
"5481","chr4.82710000.82715000","chr4.82760000.82765000",50000,24,0.0007062953,82710000,82760000,82715000,82765000,"chr4",177339,1,3,3,7,"chr4",1,0.019690576652602
"5482","chr4.39325000.39330000","chr4.39365000.39370000",40000,28,0.0002171694,39325000,39365000,39330000,39370000,"chr4",177340,6,20,11,37,"chr4",1,0.121425222691045
"5483","chr4.103930000.103935000","chr4.104015000.104020000",85000,17,0.003828938,103930000,104015000,103935000,104020000,"chr4",177378,0,1,2,3,"chr4",1,0.0059774964838256
"5484","chr4.40990000.40995000","chr4.41070000.41075000",80000,33,9.683903e-13,40990000,41070000,40995000,41075000,"chr4",177385,5,7,11,23,"chr4",1,0.0889592123769339
"5485","chr4.40985000.40990000","chr4.41215000.41220000",230000,41,3.40192e-31,40985000,41215000,40990000,41220000,"chr4",177408,2,8,4,14,"chr4",1,0.0672761368963901
"5486","chr4.40990000.40995000","chr4.41215000.41220000",225000,26,1.660492e-14,40990000,41215000,40995000,41220000,"chr4",177453,3,8,4,15,"chr4",1,0.0457102672292546
"5487","chr4.6900000.6905000","chr4.7065000.7070000",165000,15,0.0004009824,6900000,7065000,6905000,7070000,"chr4",177513,1,4,14,19,"chr4",1,0.0334036568213783
"5488","chr4.41415000.41420000","chr4.41590000.41595000",175000,13,0.003610271,41415000,41590000,41420000,41595000,"chr4",177602,4,11,7,22,"chr4",1,0.0335208626347867
"5489","chr4.82710000.82715000","chr4.82730000.82735000",20000,39,0.0005731573,82710000,82730000,82715000,82735000,"chr4",177606,1,3,3,7,"chr4",1,0.0319971870604782
"5490","chr4.185205000.185210000","chr4.185465000.185470000",260000,12,0.001162659,185205000,185465000,185210000,185470000,"chr4",177633,0,8,5,13,"chr4",1,0.0182841068917018
"5491","chr4.40920000.40925000","chr4.41150000.41155000",230000,11,0.008757037,40920000,41150000,40925000,41155000,"chr4",177645,0,3,3,6,"chr4",1,0.00773558368495077
"5492","chr4.38220000.38225000","chr4.38660000.38665000",440000,10,0.001551464,38220000,38660000,38225000,38665000,"chr4",177696,0,0,3,3,"chr4",1,0.00351617440225035
"5493","chr4.41365000.41370000","chr4.41470000.41475000",105000,23,1.734702e-07,41365000,41470000,41370000,41475000,"chr4",177710,0,0,2,2,"chr4",1,0.00539146741678387
"5494","chr4.41070000.41075000","chr4.41120000.41125000",50000,56,4.436745e-25,41070000,41120000,41075000,41125000,"chr4",177748,4,2,6,12,"chr4",1,0.0787623066104079
"5495","chr4.139015000.139020000","chr4.139575000.139580000",560000,12,1.043663e-05,139015000,139575000,139020000,139580000,"chr4",177863,2,11,8,21,"chr4",1,0.029535864978903
"5496","chr4.6985000.6990000","chr4.7065000.7070000",80000,19,0.0007657421,6985000,7065000,6990000,7070000,"chr4",177932,1,4,2,7,"chr4",1,0.0155883731833099
"5497","chr4.169115000.169120000","chr4.169385000.169390000",270000,11,0.003727033,169115000,169385000,169120000,169390000,"chr4",177951,0,9,4,13,"chr4",1,0.0167604313173933
"5498","chr4.6250000.6255000","chr4.6320000.6325000",70000,19,0.002657082,6250000,6320000,6255000,6325000,"chr4",178036,2,6,0,8,"chr4",1,0.0178152836380684
"5499","chr4.39635000.39640000","chr4.39695000.39700000",60000,25,2.453446e-05,39635000,39695000,39640000,39700000,"chr4",178077,3,7,7,17,"chr4",1,0.0498124706985466
"5500","chr4.38465000.38470000","chr4.38610000.38615000",145000,13,0.00980022,38465000,38610000,38470000,38615000,"chr4",178082,0,2,2,4,"chr4",1,0.00609470229723394
"5501","chr4.24620000.24625000","chr4.24975000.24980000",355000,10,0.004026175,24620000,24975000,24625000,24980000,"chr4",178130,0,0,4,4,"chr4",1,0.0046882325363338
"5502","chr4.4250000.4255000","chr4.4335000.4340000",85000,39,2.672958e-18,4250000,4335000,4255000,4340000,"chr4",178147,2,9,3,14,"chr4",1,0.0639943741209564
"5503","chr4.15020000.15025000","chr4.15160000.15165000",140000,26,2.641488e-11,15020000,15160000,15025000,15165000,"chr4",178150,0,3,0,3,"chr4",1,0.00914205344585091
"5504","chr4.82470000.82475000","chr4.82695000.82700000",225000,12,0.002816769,82470000,82695000,82475000,82700000,"chr4",178158,7,13,19,39,"chr4",1,0.0548523206751055
"5505","chr4.38755000.38760000","chr4.38800000.38805000",45000,28,4.262726e-05,38755000,38800000,38760000,38805000,"chr4",178208,0,2,1,3,"chr4",1,0.00984528832630099
"5506","chr4.48580000.48585000","chr4.48900000.48905000",320000,10,0.006278928,48580000,48900000,48585000,48905000,"chr4",178288,1,4,10,15,"chr4",1,0.0175808720112518
"5507","chr4.17545000.17550000","chr4.17635000.17640000",90000,23,1.28862e-06,17545000,17635000,17550000,17640000,"chr4",178391,3,9,3,15,"chr4",1,0.040436005625879
"5508","chr4.48640000.48645000","chr4.48895000.48900000",255000,12,0.001310915,48640000,48895000,48645000,48900000,"chr4",178416,0,3,1,4,"chr4",1,0.00562587904360056
"5509","chr4.6260000.6265000","chr4.6320000.6325000",60000,26,7.54015e-06,6260000,6320000,6265000,6325000,"chr4",178460,3,6,4,13,"chr4",1,0.0396155649320206
"5510","chr4.9150000.9155000","chr4.9690000.9695000",540000,30,7.035128e-26,9150000,9690000,9155000,9695000,"chr4",178596,0,2,0,2,"chr4",1,0.0070323488045007
"5511","chr4.40845000.40850000","chr4.41215000.41220000",370000,10,0.003370595,40845000,41215000,40850000,41220000,"chr4",178631,3,9,4,16,"chr4",1,0.0187529301453352
"5512","chr4.108980000.108985000","chr4.109560000.109565000",580000,8,0.00949152,108980000,109560000,108985000,109565000,"chr4",178671,0,2,5,7,"chr4",1,0.00656352555086732
"5513","chr4.1690000.1695000","chr4.1725000.1730000",35000,39,1.850329e-08,1690000,1725000,1695000,1730000,"chr4",178680,0,5,2,7,"chr4",1,0.0319971870604782
"5514","chr4.38035000.38040000","chr4.38805000.38810000",770000,8,0.002605252,38035000,38805000,38040000,38810000,"chr4",178708,2,0,5,7,"chr4",1,0.00656352555086732
"5515","chr4.41080000.41085000","chr4.41145000.41150000",65000,34,1.782665e-11,41080000,41145000,41085000,41150000,"chr4",178789,2,17,18,37,"chr4",1,0.147444913267698
"5516","chr4.6720000.6725000","chr4.6960000.6965000",240000,16,3.890551e-06,6720000,6960000,6725000,6965000,"chr4",178830,0,2,1,3,"chr4",1,0.00562587904360056
"5517","chr4.16205000.16210000","chr4.16225000.16230000",20000,55,1.534565e-10,16205000,16225000,16210000,16230000,"chr4",178845,0,2,1,3,"chr4",1,0.0193389592123769
"5518","chr4.6505000.6510000","chr4.6525000.6530000",20000,37,0.002313332,6505000,6525000,6510000,6530000,"chr4",178853,0,7,4,11,"chr4",1,0.0477027660571964
"5519","chr4.2220000.2225000","chr4.2430000.2435000",210000,16,1.324785e-05,2220000,2430000,2225000,2435000,"chr4",178895,11,26,24,61,"chr4",1,0.114392873886545
"5520","chr4.38800000.38805000","chr4.39180000.39185000",380000,11,0.0006618018,38800000,39180000,38805000,39185000,"chr4",179022,0,2,1,3,"chr4",1,0.00386779184247539
"5521","chr4.48780000.48785000","chr4.48830000.48835000",50000,36,3.229267e-10,48780000,48830000,48785000,48835000,"chr4",179061,2,8,12,22,"chr4",1,0.0928270042194093
"5522","chr4.41390000.41395000","chr4.41470000.41475000",80000,19,0.0007657421,41390000,41470000,41395000,41475000,"chr4",179079,1,3,1,5,"chr4",1,0.0111345522737928
"5523","chr4.88600000.88605000","chr4.88755000.88760000",155000,45,6.455413e-31,88600000,88755000,88605000,88760000,"chr4",179108,3,7,7,17,"chr4",1,0.089662447257384
"5524","chr4.38085000.38090000","chr4.38315000.38320000",230000,15,2.998205e-05,38085000,38315000,38090000,38320000,"chr4",179152,0,1,0,1,"chr4",1,0.00175808720112518
"5525","chr4.40930000.40935000","chr4.41150000.41155000",220000,12,0.003230708,40930000,41150000,40935000,41155000,"chr4",179164,0,3,3,6,"chr4",1,0.00843881856540084
"5526","chr4.7765000.7770000","chr4.7800000.7805000",35000,29,0.000660382,7765000,7800000,7770000,7805000,"chr4",179222,2,0,3,5,"chr4",1,0.01699484294421
"5527","chr4.41080000.41085000","chr4.41155000.41160000",75000,19,0.001414564,41080000,41155000,41085000,41160000,"chr4",179243,1,10,3,14,"chr4",1,0.0311767463666198
"5528","chr4.99755000.99760000","chr4.99805000.99810000",50000,24,0.0007062953,99755000,99805000,99760000,99810000,"chr4",179265,3,4,8,15,"chr4",1,0.0421940928270042
"5529","chr4.82630000.82635000","chr4.82760000.82765000",130000,19,8.491114e-06,82630000,82760000,82635000,82765000,"chr4",179267,1,3,9,13,"chr4",1,0.0289498359118612
"5530","chr4.40735000.40740000","chr4.40895000.40900000",160000,32,1.211971e-17,40735000,40895000,40740000,40900000,"chr4",179268,1,15,14,30,"chr4",1,0.112517580872011
"5531","chr4.7805000.7810000","chr4.7935000.7940000",130000,19,8.491114e-06,7805000,7935000,7810000,7940000,"chr4",179276,4,11,8,23,"chr4",1,0.0512189404594468
"5532","chr4.145095000.145100000","chr4.145680000.145685000",585000,9,0.001890662,145095000,145680000,145100000,145685000,"chr4",179311,0,0,3,3,"chr4",1,0.00316455696202532
"5533","chr4.86005000.86010000","chr4.86890000.86895000",885000,8,0.001229214,86005000,86890000,86010000,86895000,"chr4",179321,0,1,1,2,"chr4",1,0.00187529301453352
"5534","chr4.185370000.185375000","chr4.185565000.185570000",195000,12,0.006527429,185370000,185565000,185375000,185570000,"chr4",179403,0,0,2,2,"chr4",1,0.00281293952180028
"5535","chr4.38175000.38180000","chr4.38660000.38665000",485000,15,6.900577e-08,38175000,38660000,38180000,38665000,"chr4",179445,1,8,9,18,"chr4",1,0.0316455696202532
"5536","chr4.7200000.7205000","chr4.7805000.7810000",605000,9,0.001599606,7200000,7805000,7205000,7810000,"chr4",179560,2,10,4,16,"chr4",1,0.0168776371308017
"5537","chr4.82385000.82390000","chr4.82470000.82475000",85000,32,1.591933e-12,82385000,82470000,82390000,82475000,"chr4",179593,2,10,12,24,"chr4",1,0.090014064697609
"5538","chr4.140000000.140005000","chr4.140090000.140095000",90000,21,2.004482e-05,1.4e+08,140090000,140005000,140095000,"chr4",179658,0,2,1,3,"chr4",1,0.00738396624472574
"5539","chr4.103930000.103935000","chr4.104020000.104025000",90000,22,5.155818e-06,103930000,104020000,103935000,104025000,"chr4",179736,0,2,5,7,"chr4",1,0.0180496952648851
"5540","chr4.56260000.56265000","chr4.56410000.56415000",150000,16,0.0002035185,56260000,56410000,56265000,56415000,"chr4",179739,0,4,0,4,"chr4",1,0.00750117205813408
"5541","chr4.184000000.184005000","chr4.184165000.184170000",165000,14,0.001489251,1.84e+08,184165000,184005000,184170000,"chr4",179781,0,0,1,1,"chr4",1,0.00164088138771683
"5542","chr4.38185000.38190000","chr4.38755000.38760000",570000,9,0.002169033,38185000,38755000,38190000,38760000,"chr4",179786,1,13,6,20,"chr4",1,0.0210970464135021
"5543","chr4.2865000.2870000","chr4.2920000.2925000",55000,24,0.0002397778,2865000,2920000,2870000,2925000,"chr4",179855,0,0,3,3,"chr4",1,0.00843881856540084
"5544","chr4.16640000.16645000","chr4.17230000.17235000",590000,8,0.008757037,16640000,17230000,16645000,17235000,"chr4",179875,0,2,2,4,"chr4",1,0.00375058602906704
"5545","chr4.17575000.17580000","chr4.17810000.17815000",235000,21,4.09567e-10,17575000,17810000,17580000,17815000,"chr4",180025,5,8,4,17,"chr4",1,0.0418424753867792
"5546","chr4.6990000.6995000","chr4.7070000.7075000",80000,22,2.159617e-05,6990000,7070000,6995000,7075000,"chr4",180033,0,6,0,6,"chr4",1,0.0154711673699015
"5547","chr4.17585000.17590000","chr4.17615000.17620000",30000,38,2.818996e-06,17585000,17615000,17590000,17620000,"chr4",180074,2,16,15,33,"chr4",1,0.146976090014065
"5548","chr4.41070000.41075000","chr4.41115000.41120000",45000,24,0.002080527,41070000,41115000,41075000,41120000,"chr4",180124,4,7,5,16,"chr4",1,0.0450070323488045
"5549","chr4.140000000.140005000","chr4.140185000.140190000",185000,13,0.002566915,1.4e+08,140185000,140005000,140190000,"chr4",180157,0,1,1,2,"chr4",1,0.00304735114861697
"5550","chr4.7205000.7210000","chr4.7805000.7810000",600000,8,0.008224129,7205000,7805000,7210000,7810000,"chr4",180224,0,2,1,3,"chr4",1,0.00281293952180028
"5551","chr4.82385000.82390000","chr4.82650000.82655000",265000,14,4.775545e-05,82385000,82650000,82390000,82655000,"chr4",180237,2,10,12,24,"chr4",1,0.0393811533052039
"5552","chr4.40950000.40955000","chr4.41215000.41220000",265000,26,9.36668e-16,40950000,41215000,40955000,41220000,"chr4",180274,3,10,4,17,"chr4",1,0.0518049695264885
"5553","chr4.153330000.153335000","chr4.153570000.153575000",240000,12,0.001890662,153330000,153570000,153335000,153575000,"chr4",180287,3,5,2,10,"chr4",1,0.0140646976090014
"5554","chr4.41120000.41125000","chr4.41210000.41215000",90000,39,5.92736e-19,41120000,41210000,41125000,41215000,"chr4",180294,3,2,6,11,"chr4",1,0.05028129395218
"5555","chr4.7805000.7810000","chr4.7955000.7960000",150000,18,1.143719e-05,7805000,7955000,7810000,7960000,"chr4",180343,6,11,8,25,"chr4",1,0.0527426160337553
"5556","chr4.48575000.48580000","chr4.48960000.48965000",385000,11,0.0006195244,48575000,48960000,48580000,48965000,"chr4",180354,3,10,7,20,"chr4",1,0.0257852789498359
"5557","chr4.39325000.39330000","chr4.39350000.39355000",25000,54,1.1579e-11,39325000,39350000,39330000,39355000,"chr4",180361,3,14,16,33,"chr4",1,0.208860759493671
"5558","chr4.16515000.16520000","chr4.16640000.16645000",125000,18,4.85684e-05,16515000,16640000,16520000,16645000,"chr4",180383,0,1,2,3,"chr4",1,0.00632911392405063
"5559","chr4.26025000.26030000","chr4.26330000.26335000",305000,10,0.007654517,26025000,26330000,26030000,26335000,"chr4",180398,2,5,4,11,"chr4",1,0.012892639474918
"5560","chr4.2840000.2845000","chr4.2875000.2880000",35000,30,0.0002659333,2840000,2875000,2845000,2880000,"chr4",180413,4,6,11,21,"chr4",1,0.0738396624472574
"5561","chr4.169970000.169975000","chr4.170410000.170415000",440000,9,0.006903724,169970000,170410000,169975000,170415000,"chr4",180455,2,0,1,3,"chr4",1,0.00316455696202532
"5562","chr4.38560000.38565000","chr4.38610000.38615000",50000,41,1.58709e-13,38560000,38610000,38565000,38615000,"chr4",180476,0,0,2,2,"chr4",1,0.00961087669948429
"5563","chr4.185210000.185215000","chr4.185555000.185560000",345000,10,0.004538753,185210000,185555000,185215000,185560000,"chr4",180553,0,6,1,7,"chr4",1,0.00820440693858415
"5564","chr4.153320000.153325000","chr4.153560000.153565000",240000,15,2.085928e-05,153320000,153560000,153325000,153565000,"chr4",180613,1,3,4,8,"chr4",1,0.0140646976090014
"5565","chr4.82470000.82475000","chr4.82740000.82745000",270000,15,7.657239e-06,82470000,82740000,82475000,82745000,"chr4",180621,6,13,15,34,"chr4",1,0.059774964838256
"5566","chr4.41120000.41125000","chr4.41135000.41140000",15000,46,1.678798e-06,41120000,41135000,41125000,41140000,"chr4",180670,3,2,6,11,"chr4",1,0.0593061415846226
"5567","chr4.38925000.38930000","chr4.39040000.39045000",115000,20,5.82773e-06,38925000,39040000,38930000,39045000,"chr4",180679,0,8,6,14,"chr4",1,0.0328176277543366
"5568","chr4.140735000.140740000","chr4.140790000.140795000",55000,22,0.001735711,140735000,140790000,140740000,140795000,"chr4",180696,3,9,10,22,"chr4",1,0.056727613689639
"5569","chr4.156350000.156355000","chr4.156695000.156700000",345000,14,6.828935e-06,156350000,156695000,156355000,156700000,"chr4",180826,1,2,2,5,"chr4",1,0.00820440693858415
"5570","chr4.40920000.40925000","chr4.41215000.41220000",295000,28,9.939467e-19,40920000,41215000,40925000,41220000,"chr4",180836,2,4,4,10,"chr4",1,0.0328176277543366
"5571","chr4.40925000.40930000","chr4.41120000.41125000",195000,23,9.677792e-11,40925000,41120000,40930000,41125000,"chr4",180837,4,2,6,12,"chr4",1,0.0323488045007032
"5572","chr4.38780000.38785000","chr4.38800000.38805000",20000,36,0.004538753,38780000,38800000,38785000,38805000,"chr4",180855,0,2,1,3,"chr4",1,0.0126582278481013
"5573","chr4.20305000.20310000","chr4.20425000.20430000",120000,45,4.1477e-28,20305000,20425000,20310000,20430000,"chr4",180911,3,4,7,14,"chr4",1,0.0738396624472574
"5574","chr4.2350000.2355000","chr4.2400000.2405000",50000,22,0.004429918,2350000,2400000,2355000,2405000,"chr4",180914,0,4,4,8,"chr4",1,0.0206282231598687
"5575","chr4.183870000.183875000","chr4.184165000.184170000",295000,10,0.008892622,183870000,184165000,183875000,184170000,"chr4",180961,0,4,1,5,"chr4",1,0.00586029067041725
"5576","chr4.6640000.6645000","chr4.6710000.6715000",70000,35,5.883386e-13,6640000,6710000,6645000,6715000,"chr4",180963,1,8,3,12,"chr4",1,0.0492264416315049
"5577","chr4.15475000.15480000","chr4.15960000.15965000",485000,9,0.004552512,15475000,15960000,15480000,15965000,"chr4",181027,0,2,2,4,"chr4",1,0.00421940928270042
"5578","chr4.184815000.184820000","chr4.185140000.185145000",325000,12,0.0002999215,184815000,185140000,184820000,185145000,"chr4",181036,0,3,1,4,"chr4",1,0.00562587904360056
"5579","chr4.26990000.26995000","chr4.27010000.27015000",20000,36,0.004538753,26990000,27010000,26995000,27015000,"chr4",181108,0,1,2,3,"chr4",1,0.0126582278481013
"5580","chr4.15235000.15240000","chr4.15420000.15425000",185000,13,0.002566915,15235000,15420000,15240000,15425000,"chr4",181262,0,3,2,5,"chr4",1,0.00761837787154243
"5581","chr4.185210000.185215000","chr4.185370000.185375000",160000,17,3.004874e-05,185210000,185370000,185215000,185375000,"chr4",181265,0,0,4,4,"chr4",1,0.00796999531176746
"5582","chr4.26965000.26970000","chr4.26990000.26995000",25000,42,5.038288e-06,26965000,26990000,26970000,26995000,"chr4",181266,2,2,2,6,"chr4",1,0.029535864978903
"5583","chr4.16065000.16070000","chr4.16205000.16210000",140000,17,8.307011e-05,16065000,16205000,16070000,16210000,"chr4",181386,0,3,1,4,"chr4",1,0.00796999531176746
"5584","chr4.152105000.152110000","chr4.152165000.152170000",60000,20,0.004550564,152105000,152165000,152110000,152170000,"chr4",181400,0,1,1,2,"chr4",1,0.0046882325363338
"5585","chr4.6730000.6735000","chr4.6960000.6965000",230000,14,0.0001412678,6730000,6960000,6735000,6965000,"chr4",181402,0,3,1,4,"chr4",1,0.00656352555086732
"5586","chr4.140000000.140005000","chr4.140095000.140100000",95000,23,6.347533e-07,1.4e+08,140095000,140005000,140100000,"chr4",181407,0,2,1,3,"chr4",1,0.00808720112517581
"5587","chr4.15010000.15015000","chr4.15160000.15165000",150000,16,0.0002035185,15010000,15160000,15015000,15165000,"chr4",181444,0,3,0,3,"chr4",1,0.00562587904360056
"5588","chr4.182070000.182075000","chr4.182445000.182450000",375000,12,0.0001353943,182070000,182445000,182075000,182450000,"chr4",181448,2,5,12,19,"chr4",1,0.0267229254571027
"5589","chr4.38755000.38760000","chr4.38780000.38785000",25000,38,0.0001633744,38755000,38780000,38760000,38785000,"chr4",181454,1,8,6,15,"chr4",1,0.0668073136427567
"5590","chr4.40925000.40930000","chr4.41155000.41160000",230000,12,0.002441934,40925000,41155000,40930000,41160000,"chr4",181497,1,10,3,14,"chr4",1,0.019690576652602
"5591","chr4.36265000.36270000","chr4.36290000.36295000",25000,66,1.192752e-18,36265000,36290000,36270000,36295000,"chr4",181500,0,3,1,4,"chr4",1,0.0309423347398031
"5592","chr4.38190000.38195000","chr4.38780000.38785000",590000,10,0.0003234734,38190000,38780000,38195000,38785000,"chr4",181504,7,8,12,27,"chr4",1,0.0316455696202532
"5593","chr4.40925000.40930000","chr4.41215000.41220000",290000,90,2.491264e-107,40925000,41215000,40930000,41220000,"chr4",181515,3,10,4,17,"chr4",1,0.179324894514768
"5594","chr4.7190000.7195000","chr4.7800000.7805000",610000,8,0.007592571,7190000,7800000,7195000,7805000,"chr4",181519,1,5,2,8,"chr4",1,0.00750117205813408
"5595","chr4.39475000.39480000","chr4.40320000.40325000",845000,8,0.001608585,39475000,40320000,39480000,40325000,"chr4",181549,0,7,6,13,"chr4",1,0.0121894045944679
"5596","chr4.41080000.41085000","chr4.41120000.41125000",40000,47,5.114256e-15,41080000,41120000,41085000,41125000,"chr4",181603,2,2,6,10,"chr4",1,0.0550867323019222
"5597","chr4.89155000.89160000","chr4.89485000.89490000",330000,10,0.005455783,89155000,89485000,89160000,89490000,"chr4",181618,1,6,7,14,"chr4",1,0.0164088138771683
"5598","chr4.38805000.38810000","chr4.38855000.38860000",50000,29,3.251132e-06,38805000,38855000,38810000,38860000,"chr4",181661,3,4,2,9,"chr4",1,0.0305907172995781
"5599","chr4.36245000.36250000","chr4.36350000.36355000",105000,21,3.481329e-06,36245000,36350000,36250000,36355000,"chr4",181713,2,3,3,8,"chr4",1,0.019690576652602
"5600","chr4.99590000.99595000","chr4.99895000.99900000",305000,14,1.631605e-05,99590000,99895000,99595000,99900000,"chr4",181727,0,1,1,2,"chr4",1,0.00328176277543366
"5601","chr4.2240000.2245000","chr4.2960000.2965000",720000,8,0.00364919,2240000,2960000,2245000,2965000,"chr4",181818,0,1,0,1,"chr4",1,0.00093764650726676
"5602","chr4.185655000.185660000","chr4.185730000.185735000",75000,27,5.450458e-08,185655000,185730000,185660000,185735000,"chr4",181842,0,0,3,3,"chr4",1,0.00949367088607595
"5603","chr4.36290000.36295000","chr4.36345000.36350000",55000,33,3.362283e-09,36290000,36345000,36295000,36350000,"chr4",181872,0,3,1,4,"chr4",1,0.0154711673699015
"5604","chr4.14215000.14220000","chr4.14865000.14870000",650000,11,2.644056e-05,14215000,14865000,14220000,14870000,"chr4",181897,0,2,0,2,"chr4",1,0.00257852789498359
"5605","chr4.184415000.184420000","chr4.184525000.184530000",110000,15,0.004794022,184415000,184525000,184420000,184530000,"chr4",181941,2,4,4,10,"chr4",1,0.0175808720112518
"5606","chr4.17510000.17515000","chr4.17545000.17550000",35000,47,4.615062e-13,17510000,17545000,17515000,17550000,"chr4",181972,3,5,8,16,"chr4",1,0.0881387716830755
"5607","chr4.48775000.48780000","chr4.48875000.48880000",100000,16,0.003160859,48775000,48875000,48780000,48880000,"chr4",182003,3,1,4,8,"chr4",1,0.0150023441162682
"5608","chr4.41280000.41285000","chr4.41885000.41890000",605000,8,0.007881705,41280000,41885000,41285000,41890000,"chr4",182015,0,2,1,3,"chr4",1,0.00281293952180028
"5609","chr4.6915000.6920000","chr4.6970000.6975000",55000,23,0.0006645293,6915000,6970000,6920000,6975000,"chr4",182024,1,11,5,17,"chr4",1,0.0458274730426629
"5610","chr4.139975000.139980000","chr4.140090000.140095000",115000,15,0.003689618,139975000,140090000,139980000,140095000,"chr4",182082,0,2,1,3,"chr4",1,0.00527426160337553
"5611","chr4.15680000.15685000","chr4.16000000.16005000",320000,10,0.006278928,15680000,1.6e+07,15685000,16005000,"chr4",182133,0,2,1,3,"chr4",1,0.00351617440225035
"5612","chr4.38490000.38495000","chr4.38610000.38615000",120000,20,3.886494e-06,38490000,38610000,38495000,38615000,"chr4",182160,1,2,4,7,"chr4",1,0.0164088138771683
"5613","chr4.185320000.185325000","chr4.185565000.185570000",245000,12,0.001665824,185320000,185565000,185325000,185570000,"chr4",182201,1,4,2,7,"chr4",1,0.00984528832630099
"5614","chr4.2055000.2060000","chr4.2090000.2095000",35000,27,0.00338735,2055000,2090000,2060000,2095000,"chr4",182261,0,4,2,6,"chr4",1,0.0189873417721519
"5615","chr4.15650000.15655000","chr4.15680000.15685000",30000,30,0.003263113,15650000,15680000,15655000,15685000,"chr4",182374,0,2,1,3,"chr4",1,0.0105485232067511
"5616","chr4.55405000.55410000","chr4.55425000.55430000",20000,42,5.484466e-05,55405000,55425000,55410000,55430000,"chr4",182571,1,5,7,13,"chr4",1,0.0639943741209564
"5617","chr4.38490000.38495000","chr4.38560000.38565000",70000,29,9.331514e-09,38490000,38560000,38495000,38565000,"chr4",182617,0,0,2,2,"chr4",1,0.00679793717768401
"5618","chr4.145530000.145535000","chr4.145675000.145680000",145000,34,8.816652e-19,145530000,145675000,145535000,145680000,"chr4",182630,2,4,4,10,"chr4",1,0.0398499765588373
"5619","chr4.41390000.41395000","chr4.41670000.41675000",280000,13,0.0001572461,41390000,41670000,41395000,41675000,"chr4",182728,1,3,1,5,"chr4",1,0.00761837787154243
"5620","chr4.41365000.41370000","chr4.41660000.41665000",295000,13,0.0001104095,41365000,41660000,41370000,41665000,"chr4",182737,0,0,2,2,"chr4",1,0.00304735114861697
"5621","chr4.38780000.38785000","chr4.38805000.38810000",25000,41,1.243909e-05,38780000,38805000,38785000,38810000,"chr4",182859,6,8,12,26,"chr4",1,0.124941397093296
"5622","chr4.39465000.39470000","chr4.39635000.39640000",170000,15,0.0003234734,39465000,39635000,39470000,39640000,"chr4",182959,3,7,7,17,"chr4",1,0.029887482419128
"5623","chr4.88975000.88980000","chr4.89100000.89105000",125000,14,0.006822125,88975000,89100000,88980000,89105000,"chr4",182969,0,5,5,10,"chr4",1,0.0164088138771683
"5624","chr4.82385000.82390000","chr4.82740000.82745000",355000,20,2.134233e-11,82385000,82740000,82390000,82745000,"chr4",182989,2,10,12,24,"chr4",1,0.0562587904360056
"5625","chr4.40950000.40955000","chr4.41045000.41050000",95000,16,0.004550564,40950000,41045000,40955000,41050000,"chr4",183057,6,16,14,36,"chr4",1,0.0675105485232067
"5626","chr4.152550000.152555000","chr4.153170000.153175000",620000,9,0.00141724,152550000,153170000,152555000,153175000,"chr4",183083,3,8,1,12,"chr4",1,0.0126582278481013
"5627","chr4.57255000.57260000","chr4.57300000.57305000",45000,30,4.72919e-06,57255000,57300000,57260000,57305000,"chr4",183087,0,2,0,2,"chr4",1,0.0070323488045007
"5628","chr4.48640000.48645000","chr4.48785000.48790000",145000,24,7.103897e-10,48640000,48785000,48645000,48790000,"chr4",183139,0,3,1,4,"chr4",1,0.0112517580872011
"5629","chr4.6905000.6910000","chr4.6990000.6995000",85000,27,7.195407e-09,6905000,6990000,6910000,6995000,"chr4",183162,0,3,0,3,"chr4",1,0.00949367088607595
"5630","chr4.76500000.76505000","chr4.76685000.76690000",185000,12,0.00854755,76500000,76685000,76505000,76690000,"chr4",183193,2,3,5,10,"chr4",1,0.0140646976090014
"5631","chr4.6720000.6725000","chr4.6870000.6875000",150000,16,0.0002035185,6720000,6870000,6725000,6875000,"chr4",183271,0,2,0,2,"chr4",1,0.00375058602906704
"5632","chr4.37905000.37910000","chr4.38035000.38040000",130000,14,0.005609128,37905000,38035000,37910000,38040000,"chr4",183274,0,0,5,5,"chr4",1,0.00820440693858415
"5633","chr4.153425000.153430000","chr4.153550000.153555000",125000,14,0.006822125,153425000,153550000,153430000,153555000,"chr4",183361,3,14,9,26,"chr4",1,0.0426629160806376
"5634","chr4.37450000.37455000","chr4.37565000.37570000",115000,16,0.001166429,37450000,37565000,37455000,37570000,"chr4",183374,2,1,5,8,"chr4",1,0.0150023441162682
"5635","chr4.38490000.38495000","chr4.38570000.38575000",80000,22,2.159617e-05,38490000,38570000,38495000,38575000,"chr4",183382,0,3,3,6,"chr4",1,0.0154711673699015
"5636","chr4.164935000.164940000","chr4.164955000.164960000",20000,36,0.004538753,164935000,164955000,164940000,164960000,"chr4",183414,6,14,15,35,"chr4",1,0.147679324894515
"5637","chr4.38200000.38205000","chr4.38755000.38760000",555000,12,1.11321e-05,38200000,38755000,38205000,38760000,"chr4",183456,1,12,6,19,"chr4",1,0.0267229254571027
"5638","chr4.128715000.128720000","chr4.128860000.128865000",145000,16,0.0002562114,128715000,128860000,128720000,128865000,"chr4",183465,3,4,1,8,"chr4",1,0.0150023441162682
"5639","chr4.16690000.16695000","chr4.16755000.16760000",65000,19,0.005280554,16690000,16755000,16695000,16760000,"chr4",183492,0,3,3,6,"chr4",1,0.0133614627285513
"5640","chr4.2220000.2225000","chr4.2415000.2420000",195000,12,0.006527429,2220000,2415000,2225000,2420000,"chr4",183562,1,5,7,13,"chr4",1,0.0182841068917018
"5641","chr4.40925000.40930000","chr4.41070000.41075000",145000,17,6.487187e-05,40925000,41070000,40930000,41075000,"chr4",183563,5,7,12,24,"chr4",1,0.0478199718706048
"5642","chr4.40990000.40995000","chr4.41135000.41140000",145000,19,3.374691e-06,40990000,41135000,40995000,41140000,"chr4",183597,3,8,7,18,"chr4",1,0.040084388185654
"5643","chr4.38035000.38040000","chr4.38620000.38625000",585000,8,0.009094286,38035000,38620000,38040000,38625000,"chr4",183626,1,0,5,6,"chr4",1,0.00562587904360056
"5644","chr4.82360000.82365000","chr4.82760000.82765000",400000,14,2.478326e-06,82360000,82760000,82365000,82765000,"chr4",183632,4,8,5,17,"chr4",1,0.0278949835911861
"5645","chr4.38185000.38190000","chr4.38665000.38670000",480000,11,0.0001861794,38185000,38665000,38190000,38670000,"chr4",183641,1,1,0,2,"chr4",1,0.00257852789498359
"5646","chr4.139450000.139455000","chr4.139485000.139490000",35000,27,0.00338735,139450000,139485000,139455000,139490000,"chr4",183704,0,6,9,15,"chr4",1,0.0474683544303797
"5647","chr4.1925000.1930000","chr4.2620000.2625000",695000,8,0.00430327,1925000,2620000,1930000,2625000,"chr4",183728,6,16,21,43,"chr4",1,0.0403187998124707
"5648","chr4.38175000.38180000","chr4.38855000.38860000",680000,8,0.004702813,38175000,38855000,38180000,38860000,"chr4",183804,3,4,2,9,"chr4",1,0.00843881856540084
"5649","chr4.139600000.139605000","chr4.139855000.139860000",255000,12,0.001310915,139600000,139855000,139605000,139860000,"chr4",183820,0,1,1,2,"chr4",1,0.00281293952180028
"5650","chr4.39695000.39700000","chr4.39975000.39980000",280000,45,6.915255e-39,39695000,39975000,39700000,39980000,"chr4",183874,0,15,13,28,"chr4",1,0.147679324894515
"5651","chr4.38200000.38205000","chr4.38305000.38310000",105000,22,7.984806e-07,38200000,38305000,38205000,38310000,"chr4",183884,2,12,5,19,"chr4",1,0.0489920300046882
"5652","chr4.48775000.48780000","chr4.48830000.48835000",55000,46,2.146452e-18,48775000,48830000,48780000,48835000,"chr4",183983,2,2,4,8,"chr4",1,0.043131739334271
"5653","chr4.16000000.16005000","chr4.16195000.16200000",195000,22,6.833299e-10,1.6e+07,16195000,16005000,16200000,"chr4",183990,2,5,2,9,"chr4",1,0.0232067510548523
"5654","chr4.48695000.48700000","chr4.48725000.48730000",30000,34,0.0001249039,48695000,48725000,48700000,48730000,"chr4",184143,0,1,2,3,"chr4",1,0.0119549929676512
"5655","chr4.82675000.82680000","chr4.82695000.82700000",20000,44,1.009978e-05,82675000,82695000,82680000,82700000,"chr4",184182,0,2,0,2,"chr4",1,0.0103141115799344
"5656","chr4.17510000.17515000","chr4.17615000.17620000",105000,21,3.481329e-06,17510000,17615000,17515000,17620000,"chr4",184192,2,5,8,15,"chr4",1,0.0369198312236287
"5657","chr4.139015000.139020000","chr4.139095000.139100000",80000,17,0.006174132,139015000,139095000,139020000,139100000,"chr4",184194,7,32,10,49,"chr4",1,0.0976324425691514
"5658","chr4.15020000.15025000","chr4.15040000.15045000",20000,53,1.410643e-09,15020000,15040000,15025000,15045000,"chr4",184263,0,2,4,6,"chr4",1,0.0372714486638537
"5659","chr4.48505000.48510000","chr4.48900000.48905000",395000,10,0.002535378,48505000,48900000,48510000,48905000,"chr4",184390,3,2,9,14,"chr4",1,0.0164088138771683
"5660","chr4.70990000.70995000","chr4.71295000.71300000",305000,10,0.007654517,70990000,71295000,70995000,71300000,"chr4",184392,0,5,2,7,"chr4",1,0.00820440693858415
"5661","chr4.7770000.7775000","chr4.7800000.7805000",30000,33,0.0002977039,7770000,7800000,7775000,7805000,"chr4",184401,3,5,4,12,"chr4",1,0.0464135021097046
"5662","chr4.24580000.24585000","chr4.24855000.24860000",275000,12,0.0008090771,24580000,24855000,24585000,24860000,"chr4",184456,0,2,2,4,"chr4",1,0.00562587904360056
"5663","chr4.41120000.41125000","chr4.41215000.41220000",95000,20,4.087143e-05,41120000,41215000,41125000,41220000,"chr4",184487,3,2,4,9,"chr4",1,0.0210970464135021
"5664","chr4.40990000.40995000","chr4.41145000.41150000",155000,17,3.892084e-05,40990000,41145000,40995000,41150000,"chr4",184511,5,8,11,24,"chr4",1,0.0478199718706048
"5665","chr4.6325000.6330000","chr4.6460000.6465000",135000,14,0.004563962,6325000,6460000,6330000,6465000,"chr4",184536,0,3,2,5,"chr4",1,0.00820440693858415
"5666","chr4.6715000.6720000","chr4.6885000.6890000",170000,18,3.836827e-06,6715000,6885000,6720000,6890000,"chr4",184562,1,7,9,17,"chr4",1,0.0358649789029536
"5667","chr4.48725000.48730000","chr4.48875000.48880000",150000,13,0.008281143,48725000,48875000,48730000,48880000,"chr4",184625,3,1,2,6,"chr4",1,0.00914205344585091
"5668","chr4.21765000.21770000","chr4.22385000.22390000",620000,14,6.568896e-08,21765000,22385000,21770000,22390000,"chr4",184628,2,0,1,3,"chr4",1,0.00492264416315049
"5669","chr4.140755000.140760000","chr4.140790000.140795000",35000,29,0.000660382,140755000,140790000,140760000,140795000,"chr4",184653,2,6,13,21,"chr4",1,0.0713783403656821
"5670","chr4.163420000.163425000","chr4.164250000.164255000",830000,9,0.0002686165,163420000,164250000,163425000,164255000,"chr4",184671,0,5,7,12,"chr4",1,0.0126582278481013
"5671","chr4.6915000.6920000","chr4.7040000.7045000",125000,16,0.0006700293,6915000,7040000,6920000,7045000,"chr4",184710,0,1,4,5,"chr4",1,0.00937646507266761
"5672","chr4.41070000.41075000","chr4.41155000.41160000",85000,21,3.817526e-05,41070000,41155000,41075000,41160000,"chr4",184731,1,7,3,11,"chr4",1,0.0270745428973277
"5673","chr4.99590000.99595000","chr4.99805000.99810000",215000,13,0.0009762063,99590000,99805000,99595000,99810000,"chr4",184736,0,3,2,5,"chr4",1,0.00761837787154243
"5674","chr4.40845000.40850000","chr4.40895000.40900000",50000,36,3.229267e-10,40845000,40895000,40850000,40900000,"chr4",184742,1,9,8,18,"chr4",1,0.0759493670886076
"5675","chr4.56280000.56285000","chr4.56405000.56410000",125000,28,2.637826e-12,56280000,56405000,56285000,56410000,"chr4",184750,0,5,6,11,"chr4",1,0.0360993905297703
"5676","chr4.40735000.40740000","chr4.40885000.40890000",150000,16,0.0002035185,40735000,40885000,40740000,40890000,"chr4",184772,0,2,2,4,"chr4",1,0.00750117205813408
"5677","chr4.140000000.140005000","chr4.140100000.140105000",100000,35,1.523027e-16,1.4e+08,140100000,140005000,140105000,"chr4",184774,0,2,1,3,"chr4",1,0.0123066104078762
"5678","chr4.152065000.152070000","chr4.152695000.152700000",630000,8,0.006674129,152065000,152695000,152070000,152700000,"chr4",184787,0,3,5,8,"chr4",1,0.00750117205813408
"5679","chr4.139985000.139990000","chr4.140090000.140095000",105000,17,0.000692597,139985000,140090000,139990000,140095000,"chr4",184795,0,3,5,8,"chr4",1,0.0159399906235349
"5680","chr4.15020000.15025000","chr4.15420000.15425000",400000,11,0.0005107894,15020000,15420000,15025000,15425000,"chr4",184854,1,3,4,8,"chr4",1,0.0103141115799344
"5681","chr4.86090000.86095000","chr4.86920000.86925000",830000,7,0.009843543,86090000,86920000,86095000,86925000,"chr4",184914,0,2,2,4,"chr4",1,0.00328176277543366
"5682","chr4.41135000.41140000","chr4.41210000.41215000",75000,33,3.834517e-12,41135000,41210000,41140000,41215000,"chr4",184921,3,8,6,17,"chr4",1,0.0657524613220816
"5683","chr4.40735000.40740000","chr4.40920000.40925000",185000,22,1.373695e-09,40735000,40920000,40740000,40925000,"chr4",184940,2,4,7,13,"chr4",1,0.0335208626347867
"5684","chr4.123700000.123705000","chr4.123830000.123835000",130000,18,3.581882e-05,123700000,123830000,123705000,123835000,"chr4",184942,0,3,1,4,"chr4",1,0.00843881856540084
"5685","chr4.12850000.12855000","chr4.13545000.13550000",695000,25,1.573667e-21,12850000,13545000,12855000,13550000,"chr4",184944,0,4,3,7,"chr4",1,0.0205110173464604
"5686","chr4.56280000.56285000","chr4.56410000.56415000",130000,19,8.491114e-06,56280000,56410000,56285000,56415000,"chr4",184960,3,5,6,14,"chr4",1,0.0311767463666198
"5687","chr4.40735000.40740000","chr4.40925000.40930000",190000,28,3.78745e-15,40735000,40925000,40740000,40930000,"chr4",185021,5,14,12,31,"chr4",1,0.101734646038444
"5688","chr4.17810000.17815000","chr4.18590000.18595000",780000,18,1.89333e-13,17810000,18590000,17815000,18595000,"chr4",185030,1,6,4,11,"chr4",1,0.0232067510548523
"5689","chr4.123645000.123650000","chr4.123830000.123835000",185000,24,2.751571e-11,123645000,123830000,123650000,123835000,"chr4",185056,0,3,1,4,"chr4",1,0.0112517580872011
"5690","chr4.153330000.153335000","chr4.153550000.153555000",220000,13,0.0008345189,153330000,153550000,153335000,153555000,"chr4",185089,3,14,9,26,"chr4",1,0.0396155649320206
"5691","chr4.185315000.185320000","chr4.185395000.185400000",80000,18,0.002238378,185315000,185395000,185320000,185400000,"chr4",185113,0,3,0,3,"chr4",1,0.00632911392405063
"5692","chr4.15040000.15045000","chr4.15130000.15135000",90000,31,2.974488e-12,15040000,15130000,15045000,15135000,"chr4",185180,0,2,3,5,"chr4",1,0.0181669010782935
"5693","chr4.26235000.26240000","chr4.26320000.26325000",85000,18,0.001331801,26235000,26320000,26240000,26325000,"chr4",185188,0,2,2,4,"chr4",1,0.00843881856540084
"5694","chr4.48575000.48580000","chr4.48640000.48645000",65000,20,0.002052456,48575000,48640000,48580000,48645000,"chr4",185239,0,3,1,4,"chr4",1,0.00937646507266761
"5695","chr4.8685000.8690000","chr4.8885000.8890000",200000,15,9.483929e-05,8685000,8885000,8690000,8890000,"chr4",185264,0,2,0,2,"chr4",1,0.00351617440225035
"5696","chr4.82345000.82350000","chr4.82760000.82765000",415000,15,2.600595e-07,82345000,82760000,82350000,82765000,"chr4",185269,4,10,9,23,"chr4",1,0.040436005625879
"5697","chr4.41215000.41220000","chr4.41255000.41260000",40000,31,1.022096e-05,41215000,41255000,41220000,41260000,"chr4",185282,3,9,4,16,"chr4",1,0.0581340834505391
"5698","chr4.154580000.154585000","chr4.154625000.154630000",45000,27,0.0001209249,154580000,154625000,154585000,154630000,"chr4",185317,4,3,2,9,"chr4",1,0.0284810126582278
"5699","chr4.82385000.82390000","chr4.82750000.82755000",365000,15,6.932761e-07,82385000,82750000,82390000,82755000,"chr4",185327,2,4,4,10,"chr4",1,0.0175808720112518
"5700","chr4.6900000.6905000","chr4.6990000.6995000",90000,17,0.002386154,6900000,6990000,6905000,6995000,"chr4",185362,0,6,0,6,"chr4",1,0.0119549929676512
"5701","chr4.185200000.185205000","chr4.185465000.185470000",265000,19,5.071027e-09,185200000,185465000,185205000,185470000,"chr4",185382,2,8,5,15,"chr4",1,0.0334036568213783
"5702","chr4.56260000.56265000","chr4.56405000.56410000",145000,13,0.00980022,56260000,56405000,56265000,56410000,"chr4",185448,0,4,0,4,"chr4",1,0.00609470229723394
"5703","chr4.6720000.6725000","chr4.6900000.6905000",180000,21,1.231355e-08,6720000,6900000,6725000,6905000,"chr4",185472,0,2,1,3,"chr4",1,0.00738396624472574
"5704","chr4.138955000.138960000","chr4.139100000.139105000",145000,21,1.357606e-07,138955000,139100000,138960000,139105000,"chr4",185531,1,9,10,20,"chr4",1,0.0492264416315049
"5705","chr4.6990000.6995000","chr4.7065000.7070000",75000,19,0.001414564,6990000,7065000,6995000,7070000,"chr4",185536,0,4,0,4,"chr4",1,0.00890764181903422
"5706","chr4.2055000.2060000","chr4.2220000.2225000",165000,16,0.0001005476,2055000,2220000,2060000,2225000,"chr4",185548,6,12,10,28,"chr4",1,0.0525082044069386
"5707","chr4.21785000.21790000","chr4.22355000.22360000",570000,12,9.272218e-06,21785000,22355000,21790000,22360000,"chr4",185551,0,2,1,3,"chr4",1,0.00421940928270042
"5708","chr4.6720000.6725000","chr4.6985000.6990000",265000,14,4.775545e-05,6720000,6985000,6725000,6990000,"chr4",185622,0,2,1,3,"chr4",1,0.00492264416315049
"5709","chr4.40840000.40845000","chr4.40895000.40900000",55000,27,8.484416e-06,40840000,40895000,40845000,40900000,"chr4",185734,0,2,1,3,"chr4",1,0.00949367088607595
"5710","chr4.185465000.185470000","chr4.185565000.185570000",100000,19,8.840977e-05,185465000,185565000,185470000,185570000,"chr4",185735,2,6,2,10,"chr4",1,0.0222691045475856
"5711","chr4.38320000.38325000","chr4.38675000.38680000",355000,28,4.351938e-20,38320000,38675000,38325000,38680000,"chr4",185745,0,2,1,3,"chr4",1,0.00984528832630099
"5712","chr4.8185000.8190000","chr4.8425000.8430000",240000,11,0.006961906,8185000,8425000,8190000,8430000,"chr4",185786,0,7,2,9,"chr4",1,0.0116033755274262
"5713","chr4.139095000.139100000","chr4.139600000.139605000",505000,17,5.229313e-10,139095000,139600000,139100000,139605000,"chr4",185788,0,7,13,20,"chr4",1,0.0398499765588373
"5714","chr4.82430000.82435000","chr4.82470000.82475000",40000,32,3.420304e-06,82430000,82470000,82435000,82475000,"chr4",185906,7,13,19,39,"chr4",1,0.146272855133615
"5715","chr4.38175000.38180000","chr4.38675000.38680000",500000,11,0.0001447856,38175000,38675000,38180000,38680000,"chr4",185956,1,5,1,7,"chr4",1,0.00902484763244257
"5716","chr4.38485000.38490000","chr4.38660000.38665000",175000,13,0.003610271,38485000,38660000,38490000,38665000,"chr4",185963,1,8,9,18,"chr4",1,0.0274261603375527
"5717","chr4.82385000.82390000","chr4.82780000.82785000",395000,14,2.683951e-06,82385000,82780000,82390000,82785000,"chr4",186005,0,5,1,6,"chr4",1,0.00984528832630099
"5718","chr4.48650000.48655000","chr4.48775000.48780000",125000,18,4.85684e-05,48650000,48775000,48655000,48780000,"chr4",186048,6,2,4,12,"chr4",1,0.0253164556962025
"5719","chr4.38945000.38950000","chr4.39130000.39135000",185000,12,0.00854755,38945000,39130000,38950000,39135000,"chr4",186080,0,3,2,5,"chr4",1,0.0070323488045007
"5720","chr4.41045000.41050000","chr4.41215000.41220000",170000,22,4.001648e-09,41045000,41215000,41050000,41220000,"chr4",186157,3,10,4,17,"chr4",1,0.0438349742147211
"5721","chr4.39525000.39530000","chr4.39975000.39980000",450000,26,2.258043e-19,39525000,39975000,39530000,39980000,"chr4",186185,0,8,10,18,"chr4",1,0.0548523206751055
"5722","chr4.40735000.40740000","chr4.41215000.41220000",480000,15,7.619367e-08,40735000,41215000,40740000,41220000,"chr4",186198,3,10,4,17,"chr4",1,0.029887482419128
"5723","chr4.17575000.17580000","chr4.17635000.17640000",60000,20,0.004550564,17575000,17635000,17580000,17640000,"chr4",186216,4,9,3,16,"chr4",1,0.0375058602906704
"5724","chr4.55425000.55430000","chr4.55455000.55460000",30000,29,0.006694967,55425000,55455000,55430000,55460000,"chr4",186218,1,5,7,13,"chr4",1,0.0441865916549461
"5725","chr4.24565000.24570000","chr4.24980000.24985000",415000,10,0.002052456,24565000,24980000,24570000,24985000,"chr4",186220,0,2,1,3,"chr4",1,0.00351617440225035
"5726","chr4.2760000.2765000","chr4.2920000.2925000",160000,17,3.004874e-05,2760000,2920000,2765000,2925000,"chr4",186237,0,0,3,3,"chr4",1,0.0059774964838256
"5727","chr4.152165000.152170000","chr4.152265000.152270000",100000,16,0.003160859,152165000,152265000,152170000,152270000,"chr4",186241,0,1,1,2,"chr4",1,0.00375058602906704
"5728","chr4.26190000.26195000","chr4.26235000.26240000",45000,24,0.002080527,26190000,26235000,26195000,26240000,"chr4",186293,2,3,1,6,"chr4",1,0.0168776371308017
"5729","chr4.6985000.6990000","chr4.7040000.7045000",55000,35,1.800766e-10,6985000,7040000,6990000,7045000,"chr4",186302,0,1,2,3,"chr4",1,0.0123066104078762
"5730","chr4.40950000.40955000","chr4.41070000.41075000",120000,14,0.008449866,40950000,41070000,40955000,41075000,"chr4",186316,5,7,14,26,"chr4",1,0.0426629160806376
"5731","chr4.48470000.48475000","chr4.48490000.48495000",20000,38,0.001166429,48470000,48490000,48475000,48495000,"chr4",186335,1,2,3,6,"chr4",1,0.0267229254571027
"5732","chr4.39320000.39325000","chr4.39365000.39370000",45000,24,0.002080527,39320000,39365000,39325000,39370000,"chr4",186361,6,13,11,30,"chr4",1,0.0843881856540084
"5733","chr4.38220000.38225000","chr4.38305000.38310000",85000,23,2.671598e-06,38220000,38305000,38225000,38310000,"chr4",186403,0,0,3,3,"chr4",1,0.00808720112517581
"5734","chr4.83260000.83265000","chr4.83280000.83285000",20000,37,0.002313332,83260000,83280000,83265000,83285000,"chr4",186410,5,5,4,14,"chr4",1,0.0607126113455227
"5735","chr4.38185000.38190000","chr4.38265000.38270000",80000,23,5.85225e-06,38185000,38265000,38190000,38270000,"chr4",186487,2,10,10,22,"chr4",1,0.0593061415846226
"5736","chr4.2760000.2765000","chr4.2935000.2940000",175000,14,0.001014832,2760000,2935000,2765000,2940000,"chr4",186496,0,4,5,9,"chr4",1,0.0147679324894515
"5737","chr4.138955000.138960000","chr4.139585000.139590000",630000,8,0.006674129,138955000,139585000,138960000,139590000,"chr4",186530,0,3,1,4,"chr4",1,0.00375058602906704
"5738","chr4.6730000.6735000","chr4.6900000.6905000",170000,17,1.81557e-05,6730000,6900000,6735000,6905000,"chr4",186560,0,7,1,8,"chr4",1,0.0159399906235349
"5739","chr4.38320000.38325000","chr4.38755000.38760000",435000,9,0.007187921,38320000,38755000,38325000,38760000,"chr4",186607,0,2,1,3,"chr4",1,0.00316455696202532
"5740","chr4.158120000.158125000","chr4.159045000.159050000",925000,7,0.005774284,158120000,159045000,158125000,159050000,"chr4",186630,0,4,7,11,"chr4",1,0.00902484763244257
"5741","chr4.38885000.38890000","chr4.39040000.39045000",155000,13,0.006948378,38885000,39040000,38890000,39045000,"chr4",186724,2,8,6,16,"chr4",1,0.0243788091889358
"5742","chr4.40985000.40990000","chr4.41150000.41155000",165000,23,9.098999e-10,40985000,41150000,40990000,41155000,"chr4",186754,0,3,3,6,"chr4",1,0.0161744022503516
"5743","chr4.7805000.7810000","chr4.7985000.7990000",180000,26,6.906508e-13,7805000,7985000,7810000,7990000,"chr4",186844,3,10,8,21,"chr4",1,0.0639943741209564
"5744","chr4.38490000.38495000","chr4.38575000.38580000",85000,19,0.0004332178,38490000,38575000,38495000,38580000,"chr4",186854,0,6,2,8,"chr4",1,0.0178152836380684
"5745","chr4.185210000.185215000","chr4.185315000.185320000",105000,19,5.54876e-05,185210000,185315000,185215000,185320000,"chr4",186867,0,5,3,8,"chr4",1,0.0178152836380684
"5746","chr4.38065000.38070000","chr4.38755000.38760000",690000,9,0.0007910126,38065000,38755000,38070000,38760000,"chr4",186879,1,7,6,14,"chr4",1,0.0147679324894515
"5747","chr4.48875000.48880000","chr4.48895000.48900000",20000,54,4.720626e-10,48875000,48895000,48880000,48900000,"chr4",186907,3,1,5,9,"chr4",1,0.0569620253164557
"5748","chr4.70555000.70560000","chr4.70740000.70745000",185000,14,0.0006989227,70555000,70740000,70560000,70745000,"chr4",186918,1,6,12,19,"chr4",1,0.0311767463666198
"5749","chr4.41340000.41345000","chr4.41660000.41665000",320000,10,0.006278928,41340000,41660000,41345000,41665000,"chr4",186947,2,2,2,6,"chr4",1,0.0070323488045007
"5750","chr4.153320000.153325000","chr4.153640000.153645000",320000,12,0.0003255735,153320000,153640000,153325000,153645000,"chr4",187116,5,10,8,23,"chr4",1,0.0323488045007032
"5751","chr4.48585000.48590000","chr4.48875000.48880000",290000,10,0.009730762,48585000,48875000,48590000,48880000,"chr4",187147,0,1,0,1,"chr4",1,0.00117205813408345
"5752","chr4.185200000.185205000","chr4.185320000.185325000",120000,18,6.671259e-05,185200000,185320000,185205000,185325000,"chr4",187152,1,4,4,9,"chr4",1,0.0189873417721519
"5753","chr4.26025000.26030000","chr4.26410000.26415000",385000,18,8.537645e-10,26025000,26410000,26030000,26415000,"chr4",187167,2,5,4,11,"chr4",1,0.0232067510548523
"5754","chr4.40735000.40740000","chr4.40915000.40920000",180000,17,1.084155e-05,40735000,40915000,40740000,40920000,"chr4",187193,3,0,1,4,"chr4",1,0.00796999531176746
"5755","chr4.7800000.7805000","chr4.7945000.7950000",145000,17,6.487187e-05,7800000,7945000,7805000,7950000,"chr4",187243,3,5,12,20,"chr4",1,0.0398499765588373
"5756","chr4.38575000.38580000","chr4.38675000.38680000",100000,15,0.008803662,38575000,38675000,38580000,38680000,"chr4",187253,0,5,1,6,"chr4",1,0.0105485232067511
"5757","chr4.2840000.2845000","chr4.2890000.2895000",50000,30,9.804746e-07,2840000,2890000,2845000,2895000,"chr4",187255,4,6,10,20,"chr4",1,0.070323488045007
"5758","chr4.138955000.138960000","chr4.139095000.139100000",140000,22,3.601415e-08,138955000,139095000,138960000,139100000,"chr4",187266,1,9,10,20,"chr4",1,0.0515705578996718
"5759","chr4.38590000.38595000","chr4.38610000.38615000",20000,39,0.0005731573,38590000,38610000,38595000,38615000,"chr4",187274,1,1,2,4,"chr4",1,0.0182841068917018
"5760","chr4.25440000.25445000","chr4.25765000.25770000",325000,36,5.244709e-29,25440000,25765000,25445000,25770000,"chr4",187282,1,6,1,8,"chr4",1,0.0337552742616034
"5761","chr4.40735000.40740000","chr4.40910000.40915000",175000,21,1.730294e-08,40735000,40910000,40740000,40915000,"chr4",187293,6,15,14,35,"chr4",1,0.0861462728551336
"5762","chr4.95440000.95445000","chr4.95510000.95515000",70000,21,0.0003234734,95440000,95510000,95445000,95515000,"chr4",187328,0,3,2,5,"chr4",1,0.0123066104078762
"5763","chr4.21510000.21515000","chr4.21765000.21770000",255000,39,4.478062e-30,21510000,21765000,21515000,21770000,"chr4",187378,1,6,1,8,"chr4",1,0.0365682137834037
"5764","chr4.183985000.183990000","chr4.184165000.184170000",180000,22,1.951577e-09,183985000,184165000,183990000,184170000,"chr4",187406,0,4,1,5,"chr4",1,0.012892639474918
"5765","chr4.2280000.2285000","chr4.2400000.2405000",120000,21,8.584776e-07,2280000,2400000,2285000,2405000,"chr4",187418,4,6,10,20,"chr4",1,0.0492264416315049
"5766","chr4.38320000.38325000","chr4.38665000.38670000",345000,15,1.055447e-06,38320000,38665000,38325000,38670000,"chr4",187458,0,1,0,1,"chr4",1,0.00175808720112518
"5767","chr4.38925000.38930000","chr4.39045000.39050000",120000,16,0.0008632511,38925000,39045000,38930000,39050000,"chr4",187460,0,7,6,13,"chr4",1,0.0243788091889358
"5768","chr4.38575000.38580000","chr4.38660000.38665000",85000,19,0.0004332178,38575000,38660000,38580000,38665000,"chr4",187469,0,6,2,8,"chr4",1,0.0178152836380684
"5769","chr4.41080000.41085000","chr4.41215000.41220000",135000,22,5.262525e-08,41080000,41215000,41085000,41220000,"chr4",187497,2,10,4,16,"chr4",1,0.0412564463197375
"5770","chr4.36215000.36220000","chr4.36290000.36295000",75000,21,0.000151715,36215000,36290000,36220000,36295000,"chr4",187531,0,3,1,4,"chr4",1,0.00984528832630099
"5771","chr4.152640000.152645000","chr4.153315000.153320000",675000,8,0.004843706,152640000,153315000,152645000,153320000,"chr4",187540,1,1,1,3,"chr4",1,0.00281293952180028
"5772","chr4.38320000.38325000","chr4.38465000.38470000",145000,13,0.00980022,38320000,38465000,38325000,38470000,"chr4",187554,0,2,1,3,"chr4",1,0.00457102672292546
"5773","chr4.41340000.41345000","chr4.41675000.41680000",335000,13,4.85684e-05,41340000,41675000,41345000,41680000,"chr4",187617,1,2,2,5,"chr4",1,0.00761837787154243
"5774","chr4.82650000.82655000","chr4.82755000.82760000",105000,20,1.433934e-05,82650000,82755000,82655000,82760000,"chr4",187649,4,22,12,38,"chr4",1,0.0890764181903422
"5775","chr4.41365000.41370000","chr4.41620000.41625000",255000,13,0.0003005208,41365000,41620000,41370000,41625000,"chr4",187890,0,0,2,2,"chr4",1,0.00304735114861697
"5776","chr4.2535000.2540000","chr4.2875000.2880000",340000,10,0.00478668,2535000,2875000,2540000,2880000,"chr4",187912,3,9,5,17,"chr4",1,0.0199249882794187
"5777","chr4.2890000.2895000","chr4.2920000.2925000",30000,36,2.025413e-05,2890000,2920000,2895000,2925000,"chr4",187942,0,0,3,3,"chr4",1,0.0126582278481013
"5778","chr4.185205000.185210000","chr4.185395000.185400000",190000,14,0.0005878188,185205000,185395000,185210000,185400000,"chr4",187953,0,3,0,3,"chr4",1,0.00492264416315049
"5779","chr4.17680000.17685000","chr4.18590000.18595000",910000,9,0.0001434996,17680000,18590000,17685000,18595000,"chr4",187955,1,3,5,9,"chr4",1,0.00949367088607595
"5780","chr4.14215000.14220000","chr4.15130000.15135000",915000,10,1.66827e-05,14215000,15130000,14220000,15135000,"chr4",187968,0,2,0,2,"chr4",1,0.0023441162681669
"5781","chr4.6725000.6730000","chr4.7070000.7075000",345000,13,4.045343e-05,6725000,7070000,6730000,7075000,"chr4",188005,0,4,1,5,"chr4",1,0.00761837787154243
"5782","chr4.70555000.70560000","chr4.71380000.71385000",825000,13,4.360174e-08,70555000,71380000,70560000,71385000,"chr4",188027,1,6,10,17,"chr4",1,0.0259024847632443
"5783","chr4.56905000.56910000","chr4.57160000.57165000",255000,16,2.202373e-06,56905000,57160000,56910000,57165000,"chr4",188038,0,6,7,13,"chr4",1,0.0243788091889358
"5784","chr4.165360000.165365000","chr4.165435000.165440000",75000,23,1.3195e-05,165360000,165435000,165365000,165440000,"chr4",188159,1,3,2,6,"chr4",1,0.0161744022503516
"5785","chr4.151695000.151700000","chr4.151715000.151720000",20000,37,0.002313332,151695000,151715000,151700000,151720000,"chr4",188160,3,8,3,14,"chr4",1,0.0607126113455227
"5786","chr4.47460000.47465000","chr4.47480000.47485000",20000,36,0.004538753,47460000,47480000,47465000,47485000,"chr4",188186,2,1,5,8,"chr4",1,0.0337552742616034
"5787","chr4.41060000.41065000","chr4.41215000.41220000",155000,19,1.851358e-06,41060000,41215000,41065000,41220000,"chr4",188208,3,10,4,17,"chr4",1,0.0378574777308955
"5788","chr4.38265000.38270000","chr4.38660000.38665000",395000,10,0.002535378,38265000,38660000,38270000,38665000,"chr4",188213,1,8,9,18,"chr4",1,0.0210970464135021
"5789","chr4.40920000.40925000","chr4.41210000.41215000",290000,11,0.002523411,40920000,41210000,40925000,41215000,"chr4",188215,2,4,6,12,"chr4",1,0.0154711673699015
"5790","chr4.185170000.185175000","chr4.185465000.185470000",295000,11,0.002304142,185170000,185465000,185175000,185470000,"chr4",188342,2,8,5,15,"chr4",1,0.0193389592123769
"5791","chr4.41365000.41370000","chr4.41415000.41420000",50000,35,1.331695e-09,41365000,41415000,41370000,41420000,"chr4",188365,0,0,2,2,"chr4",1,0.00820440693858415
"5792","chr4.6905000.6910000","chr4.7065000.7070000",160000,15,0.0004994001,6905000,7065000,6910000,7070000,"chr4",188375,1,3,6,10,"chr4",1,0.0175808720112518
"5793","chr4.39040000.39045000","chr4.39180000.39185000",140000,18,2.030757e-05,39040000,39180000,39045000,39185000,"chr4",188380,2,12,6,20,"chr4",1,0.0421940928270042
"5794","chr4.185180000.185185000","chr4.185465000.185470000",285000,14,2.697308e-05,185180000,185465000,185185000,185470000,"chr4",188438,1,8,5,14,"chr4",1,0.0229723394280356
"5795","chr4.4245000.4250000","chr4.4335000.4340000",90000,17,0.002386154,4245000,4335000,4250000,4340000,"chr4",188465,1,6,3,10,"chr4",1,0.0199249882794187
"5796","chr4.39475000.39480000","chr4.40315000.40320000",840000,7,0.009284182,39475000,40315000,39480000,40320000,"chr4",188469,1,10,8,19,"chr4",1,0.0155883731833099
"5797","chr4.4255000.4260000","chr4.4290000.4295000",35000,26,0.007187921,4255000,4290000,4260000,4295000,"chr4",188593,1,7,2,10,"chr4",1,0.0304735114861697
"5798","chr4.6900000.6905000","chr4.7070000.7075000",170000,16,7.980661e-05,6900000,7070000,6905000,7075000,"chr4",188670,0,6,3,9,"chr4",1,0.0168776371308017
"5799","chr4.39320000.39325000","chr4.39350000.39355000",30000,30,0.003263113,39320000,39350000,39325000,39355000,"chr4",188683,3,13,18,34,"chr4",1,0.119549929676512
"5800","chr4.36215000.36220000","chr4.36350000.36355000",135000,15,0.001434469,36215000,36350000,36220000,36355000,"chr4",188701,2,3,3,8,"chr4",1,0.0140646976090014
"5801","chr4.152065000.152070000","chr4.152640000.152645000",575000,8,0.009843543,152065000,152640000,152070000,152645000,"chr4",188723,0,1,1,2,"chr4",1,0.00187529301453352
"5802","chr4.82740000.82745000","chr4.82760000.82765000",20000,42,5.484466e-05,82740000,82760000,82745000,82765000,"chr4",188725,4,10,9,23,"chr4",1,0.113220815752461
"5803","chr4.17575000.17580000","chr4.17610000.17615000",35000,31,0.0001063325,17575000,17610000,17580000,17615000,"chr4",188752,9,15,13,37,"chr4",1,0.134435067979372
"5804","chr4.39635000.39640000","chr4.39975000.39980000",340000,10,0.00478668,39635000,39975000,39640000,39980000,"chr4",188772,0,7,7,14,"chr4",1,0.0164088138771683
"5805","chr4.14880000.14885000","chr4.15195000.15200000",315000,11,0.001648449,14880000,15195000,14885000,15200000,"chr4",188787,0,3,3,6,"chr4",1,0.00773558368495077
"5806","chr4.88595000.88600000","chr4.88755000.88760000",160000,22,8.335474e-09,88595000,88755000,88600000,88760000,"chr4",188837,0,0,4,4,"chr4",1,0.0103141115799344
"5807","chr4.38220000.38225000","chr4.38675000.38680000",455000,12,4.355405e-05,38220000,38675000,38225000,38680000,"chr4",188845,0,0,1,1,"chr4",1,0.00140646976090014
"5808","chr4.2800000.2805000","chr4.2840000.2845000",40000,24,0.006961906,2800000,2840000,2805000,2845000,"chr4",188850,0,3,2,5,"chr4",1,0.0140646976090014
"5809","chr4.6725000.6730000","chr4.6885000.6890000",160000,17,3.004874e-05,6725000,6885000,6730000,6890000,"chr4",188875,0,4,1,5,"chr4",1,0.00996249413970933
"5810","chr4.41070000.41075000","chr4.41150000.41155000",80000,37,6.299036e-16,41070000,41150000,41075000,41155000,"chr4",188896,0,3,3,6,"chr4",1,0.0260196905766526
"5811","chr4.6905000.6910000","chr4.7040000.7045000",135000,22,5.262525e-08,6905000,7040000,6910000,7045000,"chr4",188911,0,1,4,5,"chr4",1,0.012892639474918
"5812","chr4.40990000.40995000","chr4.41045000.41050000",55000,31,5.310745e-08,40990000,41045000,40995000,41050000,"chr4",188950,5,8,11,24,"chr4",1,0.0872011251758087
"5813","chr4.154415000.154420000","chr4.154505000.154510000",90000,16,0.006739992,154415000,154505000,154420000,154510000,"chr4",188993,1,2,0,3,"chr4",1,0.00562587904360056
"5814","chr4.140030000.140035000","chr4.140050000.140055000",20000,35,0.008449866,140030000,140050000,140035000,140055000,"chr4",189037,0,2,0,2,"chr4",1,0.00820440693858415
"5815","chr4.38060000.38065000","chr4.38730000.38735000",670000,23,1.24575e-18,38060000,38730000,38065000,38735000,"chr4",189049,1,6,3,10,"chr4",1,0.0269573370839194
"5816","chr4.7805000.7810000","chr4.7975000.7980000",170000,20,1.392862e-07,7805000,7975000,7810000,7980000,"chr4",189109,0,2,1,3,"chr4",1,0.0070323488045007
"5817","chr4.36245000.36250000","chr4.36265000.36270000",20000,58,4.609169e-12,36245000,36265000,36250000,36270000,"chr4",189131,3,11,6,20,"chr4",1,0.13595874355368
"5818","chr4.40930000.40935000","chr4.41215000.41220000",285000,59,1.277828e-58,40930000,41215000,40935000,41220000,"chr4",189215,1,5,4,10,"chr4",1,0.0691514299109236
"5819","chr4.88280000.88285000","chr4.89155000.89160000",875000,9,0.0001927121,88280000,89155000,88285000,89160000,"chr4",189224,7,25,23,55,"chr4",1,0.0580168776371308
"5820","chr4.70555000.70560000","chr4.70735000.70740000",180000,17,1.084155e-05,70555000,70735000,70560000,70740000,"chr4",189227,1,6,16,23,"chr4",1,0.0458274730426629
"5821","chr4.185215000.185220000","chr4.185315000.185320000",100000,15,0.008803662,185215000,185315000,185220000,185320000,"chr4",189240,0,5,3,8,"chr4",1,0.0140646976090014
"5822","chr4.38175000.38180000","chr4.38755000.38760000",580000,11,5.716024e-05,38175000,38755000,38180000,38760000,"chr4",189388,1,11,6,18,"chr4",1,0.0232067510548523
"5823","chr4.24580000.24585000","chr4.24975000.24980000",395000,10,0.002535378,24580000,24975000,24585000,24980000,"chr4",189401,2,3,4,9,"chr4",1,0.0105485232067511
"5824","chr4.25440000.25445000","chr4.25910000.25915000",470000,9,0.005250471,25440000,25910000,25445000,25915000,"chr4",189430,1,1,3,5,"chr4",1,0.00527426160337553
"5825","chr4.15130000.15135000","chr4.15160000.15165000",30000,33,0.0002977039,15130000,15160000,15135000,15165000,"chr4",189483,0,3,0,3,"chr4",1,0.0116033755274262
"5826","chr4.152065000.152070000","chr4.152165000.152170000",100000,16,0.003160859,152065000,152165000,152070000,152170000,"chr4",189507,0,1,1,2,"chr4",1,0.00375058602906704
"5827","chr4.13880000.13885000","chr4.14865000.14870000",985000,7,0.003953515,13880000,14865000,13885000,14870000,"chr4",189521,0,2,0,2,"chr4",1,0.00164088138771683
"5828","chr4.40985000.40990000","chr4.41060000.41065000",75000,24,3.611319e-06,40985000,41060000,40990000,41065000,"chr4",189529,2,8,6,16,"chr4",1,0.0450070323488045
"5829","chr4.6250000.6255000","chr4.6325000.6330000",75000,48,1.022557e-24,6250000,6325000,6255000,6330000,"chr4",189530,0,3,0,3,"chr4",1,0.0168776371308017
"5830","chr4.82470000.82475000","chr4.82750000.82755000",280000,11,0.003078506,82470000,82750000,82475000,82755000,"chr4",189579,2,4,4,10,"chr4",1,0.012892639474918
"5831","chr4.185215000.185220000","chr4.185320000.185325000",105000,17,0.000692597,185215000,185320000,185220000,185325000,"chr4",189608,1,4,4,9,"chr4",1,0.0179324894514768
"5832","chr4.142515000.142520000","chr4.142550000.142555000",35000,28,0.001526724,142515000,142550000,142520000,142555000,"chr4",189662,0,2,0,2,"chr4",1,0.00656352555086732
"5833","chr4.16765000.16770000","chr4.17315000.17320000",550000,10,0.0004894285,16765000,17315000,16770000,17320000,"chr4",189682,1,4,3,8,"chr4",1,0.00937646507266761
"5834","chr4.185565000.185570000","chr4.185730000.185735000",165000,14,0.001489251,185565000,185730000,185570000,185735000,"chr4",189696,1,0,2,3,"chr4",1,0.00492264416315049
"5835","chr4.38900000.38905000","chr4.39130000.39135000",230000,29,1.001088e-17,38900000,39130000,38905000,39135000,"chr4",189698,3,3,1,7,"chr4",1,0.023792780121894
"5836","chr4.2280000.2285000","chr4.2435000.2440000",155000,17,3.892084e-05,2280000,2435000,2285000,2440000,"chr4",189706,5,21,18,44,"chr4",1,0.0876699484294421
"5837","chr4.48585000.48590000","chr4.48775000.48780000",190000,30,4.187397e-17,48585000,48775000,48590000,48780000,"chr4",189764,0,2,0,2,"chr4",1,0.0070323488045007
"5838","chr4.2280000.2285000","chr4.2430000.2435000",150000,13,0.008281143,2280000,2430000,2285000,2435000,"chr4",189782,5,21,18,44,"chr4",1,0.0670417252695734
"5839","chr4.40905000.40910000","chr4.41155000.41160000",250000,12,0.001484097,40905000,41155000,40910000,41160000,"chr4",189816,1,5,3,9,"chr4",1,0.0126582278481013
"5840","chr4.6640000.6645000","chr4.7070000.7075000",430000,9,0.007573226,6640000,7070000,6645000,7075000,"chr4",189831,0,6,3,9,"chr4",1,0.00949367088607595
"5841","chr4.13880000.13885000","chr4.14455000.14460000",575000,8,0.009843543,13880000,14455000,13885000,14460000,"chr4",189852,0,2,2,4,"chr4",1,0.00375058602906704
"5842","chr4.38190000.38195000","chr4.38315000.38320000",125000,30,5.292769e-14,38190000,38315000,38195000,38320000,"chr4",189977,0,7,1,8,"chr4",1,0.0281293952180028
"5843","chr4.17585000.17590000","chr4.17810000.17815000",225000,17,1.317737e-06,17585000,17810000,17590000,17815000,"chr4",190036,5,8,4,17,"chr4",1,0.0338724800750117
"5844","chr4.14865000.14870000","chr4.14915000.14920000",50000,35,1.331695e-09,14865000,14915000,14870000,14920000,"chr4",190042,0,2,0,2,"chr4",1,0.00820440693858415
"5845","chr4.185705000.185710000","chr4.185730000.185735000",25000,33,0.006527429,185705000,185730000,185710000,185735000,"chr4",190076,0,0,2,2,"chr4",1,0.00773558368495077
"5846","chr4.6900000.6905000","chr4.7005000.7010000",105000,18,0.0002037834,6900000,7005000,6905000,7010000,"chr4",190085,3,21,17,41,"chr4",1,0.0864978902953586
"5847","chr4.26205000.26210000","chr4.26410000.26415000",205000,14,0.000335132,26205000,26410000,26210000,26415000,"chr4",190284,4,6,11,21,"chr4",1,0.0344585091420534
"5848","chr4.2055000.2060000","chr4.2240000.2245000",185000,13,0.002566915,2055000,2240000,2060000,2245000,"chr4",190329,0,1,0,1,"chr4",1,0.00152367557430849
"5849","chr4.40735000.40740000","chr4.40855000.40860000",120000,17,0.0002511079,40735000,40855000,40740000,40860000,"chr4",190412,0,14,11,25,"chr4",1,0.0498124706985466
"5850","chr4.77105000.77110000","chr4.77120000.77125000",15000,36,0.004538753,77105000,77120000,77110000,77125000,"chr4",190413,3,9,3,15,"chr4",1,0.0632911392405063
"5851","chr4.38755000.38760000","chr4.38790000.38795000",35000,29,0.000660382,38755000,38790000,38760000,38795000,"chr4",190423,1,13,6,20,"chr4",1,0.0679793717768401
"5852","chr4.38175000.38180000","chr4.38590000.38595000",415000,9,0.008726884,38175000,38590000,38180000,38595000,"chr4",190513,1,1,2,4,"chr4",1,0.00421940928270042
"5853","chr4.26230000.26235000","chr4.26320000.26325000",90000,17,0.002386154,26230000,26320000,26235000,26325000,"chr4",190525,0,2,2,4,"chr4",1,0.00796999531176746
"5854","chr4.88280000.88285000","chr4.88755000.88760000",475000,9,0.004990637,88280000,88755000,88285000,88760000,"chr4",190575,6,15,7,28,"chr4",1,0.029535864978903
"5855","chr4.140645000.140650000","chr4.140925000.140930000",280000,13,0.0001572461,140645000,140925000,140650000,140930000,"chr4",190584,0,1,1,2,"chr4",1,0.00304735114861697
"5856","chr4.6730000.6735000","chr4.6905000.6910000",175000,17,1.405149e-05,6730000,6905000,6735000,6910000,"chr4",190622,0,3,1,4,"chr4",1,0.00796999531176746
"5857","chr4.20305000.20310000","chr4.20685000.20690000",380000,14,3.516439e-06,20305000,20685000,20310000,20690000,"chr4",190667,0,0,5,5,"chr4",1,0.00820440693858415
"5858","chr4.48560000.48565000","chr4.48900000.48905000",340000,13,4.399252e-05,48560000,48900000,48565000,48905000,"chr4",190704,4,2,6,12,"chr4",1,0.0182841068917018
"5859","chr4.56950000.56955000","chr4.57160000.57165000",210000,14,0.0002805808,56950000,57160000,56955000,57165000,"chr4",190749,2,9,7,18,"chr4",1,0.029535864978903
"5860","chr4.15020000.15025000","chr4.15130000.15135000",110000,27,1.133834e-10,15020000,15130000,15025000,15135000,"chr4",190751,1,4,3,8,"chr4",1,0.0253164556962025
"5861","chr4.7820000.7825000","chr4.7935000.7940000",115000,16,0.001166429,7820000,7935000,7825000,7940000,"chr4",190831,0,3,6,9,"chr4",1,0.0168776371308017
"5862","chr4.38490000.38495000","chr4.38675000.38680000",185000,12,0.00854755,38490000,38675000,38495000,38680000,"chr4",190869,1,5,1,7,"chr4",1,0.00984528832630099
"5863","chr4.17545000.17550000","chr4.17815000.17820000",270000,13,0.0002037834,17545000,17815000,17550000,17820000,"chr4",190870,0,8,8,16,"chr4",1,0.0243788091889358
"5864","chr4.152680000.152685000","chr4.153320000.153325000",640000,9,0.001193149,152680000,153320000,152685000,153325000,"chr4",190873,0,4,0,4,"chr4",1,0.00421940928270042
"5865","chr4.56300000.56305000","chr4.56405000.56410000",105000,19,5.54876e-05,56300000,56405000,56305000,56410000,"chr4",190874,0,4,2,6,"chr4",1,0.0133614627285513
"5866","chr4.3105000.3110000","chr4.3345000.3350000",240000,14,0.0001024776,3105000,3345000,3110000,3350000,"chr4",190939,4,3,4,11,"chr4",1,0.0180496952648851
"5867","chr4.41415000.41420000","chr4.41620000.41625000",205000,15,7.814403e-05,41415000,41620000,41420000,41625000,"chr4",190941,0,11,7,18,"chr4",1,0.0316455696202532
"5868","chr4.185210000.185215000","chr4.185465000.185470000",255000,16,2.202373e-06,185210000,185465000,185215000,185470000,"chr4",190942,2,8,5,15,"chr4",1,0.0281293952180028
"5869","chr4.41045000.41050000","chr4.41120000.41125000",75000,22,4.658568e-05,41045000,41120000,41050000,41125000,"chr4",190999,4,2,6,12,"chr4",1,0.0309423347398031
"5870","chr4.38185000.38190000","chr4.38315000.38320000",130000,23,1.424046e-08,38185000,38315000,38190000,38320000,"chr4",191095,0,7,1,8,"chr4",1,0.0215658696671355
"5871","chr4.36330000.36335000","chr4.36350000.36355000",20000,43,2.396659e-05,36330000,36350000,36335000,36355000,"chr4",191159,0,3,3,6,"chr4",1,0.030239099859353
"5872","chr4.21785000.21790000","chr4.22385000.22390000",600000,18,6.107659e-12,21785000,22385000,21790000,22390000,"chr4",191178,1,0,1,2,"chr4",1,0.00421940928270042
"5873","chr4.16665000.16670000","chr4.16685000.16690000",20000,35,0.008449866,16665000,16685000,16670000,16690000,"chr4",191180,0,1,1,2,"chr4",1,0.00820440693858415
"5874","chr4.185465000.185470000","chr4.185555000.185560000",90000,16,0.006739992,185465000,185555000,185470000,185560000,"chr4",191343,0,6,1,7,"chr4",1,0.0131270511017346
"5875","chr4.40885000.40890000","chr4.41215000.41220000",330000,10,0.005455783,40885000,41215000,40890000,41220000,"chr4",191348,0,2,2,4,"chr4",1,0.0046882325363338
"5876","chr4.185215000.185220000","chr4.185465000.185470000",250000,12,0.001484097,185215000,185465000,185220000,185470000,"chr4",191356,2,8,5,15,"chr4",1,0.0210970464135021
"5877","chr4.17510000.17515000","chr4.17575000.17580000",65000,27,5.846143e-07,17510000,17575000,17515000,17580000,"chr4",191370,3,5,8,16,"chr4",1,0.0506329113924051
"5878","chr4.82630000.82635000","chr4.82695000.82700000",65000,20,0.002052456,82630000,82695000,82635000,82700000,"chr4",191388,1,3,9,13,"chr4",1,0.0304735114861697
"5879","chr4.140090000.140095000","chr4.140185000.140190000",95000,16,0.004550564,140090000,140185000,140095000,140190000,"chr4",191404,1,1,2,4,"chr4",1,0.00750117205813408
"5880","chr4.48785000.48790000","chr4.48905000.48910000",120000,15,0.002829843,48785000,48905000,48790000,48910000,"chr4",191406,1,3,11,15,"chr4",1,0.0263713080168776
"5881","chr4.2240000.2245000","chr4.2415000.2420000",175000,30,1.984862e-16,2240000,2415000,2245000,2420000,"chr4",191415,0,1,0,1,"chr4",1,0.00351617440225035
"5882","chr4.82710000.82715000","chr4.82740000.82745000",30000,36,2.025413e-05,82710000,82740000,82715000,82745000,"chr4",191442,1,3,3,7,"chr4",1,0.029535864978903
"5883","chr4.38085000.38090000","chr4.38730000.38735000",645000,9,0.001160255,38085000,38730000,38090000,38735000,"chr4",191476,1,1,0,2,"chr4",1,0.00210970464135021
"5884","chr4.38560000.38565000","chr4.38660000.38665000",100000,25,1.382609e-08,38560000,38660000,38565000,38665000,"chr4",191493,0,0,2,2,"chr4",1,0.00586029067041725
"5885","chr4.185955000.185960000","chr4.186035000.186040000",80000,25,3.71214e-07,185955000,186035000,185960000,186040000,"chr4",191516,1,2,3,6,"chr4",1,0.0175808720112518
"5886","chr4.158915000.158920000","chr4.159070000.159075000",155000,17,3.892084e-05,158915000,159070000,158920000,159075000,"chr4",191541,4,11,3,18,"chr4",1,0.0358649789029536
"5887","chr4.6915000.6920000","chr4.6990000.6995000",75000,19,0.001414564,6915000,6990000,6920000,6995000,"chr4",191679,0,6,0,6,"chr4",1,0.0133614627285513
"5888","chr4.85780000.85785000","chr4.85840000.85845000",60000,21,0.001784832,85780000,85840000,85785000,85845000,"chr4",191680,0,3,0,3,"chr4",1,0.00738396624472574
"5889","chr4.82385000.82390000","chr4.83280000.83285000",895000,9,0.0001629006,82385000,83280000,82390000,83285000,"chr4",191686,2,5,4,11,"chr4",1,0.0116033755274262
"5890","chr4.6720000.6725000","chr4.6905000.6910000",185000,17,8.593394e-06,6720000,6905000,6725000,6910000,"chr4",191784,0,2,1,3,"chr4",1,0.0059774964838256
"5891","chr4.82380000.82385000","chr4.82650000.82655000",270000,11,0.003727033,82380000,82650000,82385000,82655000,"chr4",191801,1,7,2,10,"chr4",1,0.012892639474918
"5892","chr4.41145000.41150000","chr4.41215000.41220000",70000,34,3.247866e-12,41145000,41215000,41150000,41220000,"chr4",191839,3,10,4,17,"chr4",1,0.0677449601500234
"5893","chr4.9690000.9695000","chr4.10060000.10065000",370000,10,0.003370595,9690000,10060000,9695000,10065000,"chr4",191853,0,2,0,2,"chr4",1,0.0023441162681669
"5894","chr4.41255000.41260000","chr4.41640000.41645000",385000,12,0.00011848,41255000,41640000,41260000,41645000,"chr4",191886,2,2,2,6,"chr4",1,0.00843881856540084
"5895","chr4.7325000.7330000","chr4.7375000.7380000",50000,24,0.0007062953,7325000,7375000,7330000,7380000,"chr4",191932,0,1,1,2,"chr4",1,0.00562587904360056
"5896","chr4.113050000.113055000","chr4.113145000.113150000",95000,17,0.001551464,113050000,113145000,113055000,113150000,"chr4",191937,1,0,1,2,"chr4",1,0.00398499765588373
"5897","chr4.76500000.76505000","chr4.76760000.76765000",260000,16,1.848463e-06,76500000,76760000,76505000,76765000,"chr4",191938,5,11,9,25,"chr4",1,0.046882325363338
"5898","chr4.82515000.82520000","chr4.82650000.82655000",135000,15,0.001434469,82515000,82650000,82520000,82655000,"chr4",191968,0,8,2,10,"chr4",1,0.0175808720112518
"5899","chr4.6730000.6735000","chr4.6840000.6845000",110000,23,9.745801e-08,6730000,6840000,6735000,6845000,"chr4",192150,0,7,1,8,"chr4",1,0.0215658696671355
"5900","chr4.88975000.88980000","chr4.89020000.89025000",45000,23,0.004843706,88975000,89020000,88980000,89025000,"chr4",192219,0,1,0,1,"chr4",1,0.00269573370839194
"5901","chr4.82610000.82615000","chr4.82760000.82765000",150000,16,0.0002035185,82610000,82760000,82615000,82765000,"chr4",192249,4,10,7,21,"chr4",1,0.0393811533052039
"5902","chr4.6730000.6735000","chr4.6760000.6765000",30000,32,0.0006905319,6730000,6760000,6735000,6765000,"chr4",192270,0,6,1,7,"chr4",1,0.0262541022034693
"5903","chr4.40325000.40330000","chr4.40715000.40720000",390000,11,0.0005791038,40325000,40715000,40330000,40720000,"chr4",192332,3,9,6,18,"chr4",1,0.0232067510548523
"5904","chr4.2220000.2225000","chr4.2435000.2440000",215000,17,2.049637e-06,2220000,2435000,2225000,2440000,"chr4",192337,11,26,24,61,"chr4",1,0.121542428504454
"5905","chr4.38185000.38190000","chr4.38560000.38565000",375000,10,0.003192291,38185000,38560000,38190000,38565000,"chr4",192379,0,0,2,2,"chr4",1,0.0023441162681669
"5906","chr4.99995000.100000000","chr4.100315000.100320000",320000,10,0.006278928,99995000,100315000,1e+08,100320000,"chr4",192384,0,1,0,1,"chr4",1,0.00117205813408345
"5907","chr4.55865000.55870000","chr4.56430000.56435000",565000,9,0.002238378,55865000,56430000,55870000,56435000,"chr4",192401,0,4,3,7,"chr4",1,0.00738396624472574
"5908","chr4.48585000.48590000","chr4.48785000.48790000",200000,14,0.0004042722,48585000,48785000,48590000,48790000,"chr4",192458,0,3,0,3,"chr4",1,0.00492264416315049
"5909","chr4.38065000.38070000","chr4.38675000.38680000",610000,8,0.007592571,38065000,38675000,38070000,38680000,"chr4",192464,1,5,1,7,"chr4",1,0.00656352555086732
"5910","chr4.163415000.163420000","chr4.164250000.164255000",835000,16,1.759177e-11,163415000,164250000,163420000,164255000,"chr4",192469,0,2,3,5,"chr4",1,0.00937646507266761
"5911","chr4.185395000.185400000","chr4.185425000.185430000",30000,29,0.006694967,185395000,185425000,185400000,185430000,"chr4",192574,0,3,0,3,"chr4",1,0.010196905766526
"5912","chr4.75885000.75890000","chr4.75915000.75920000",30000,32,0.0006905319,75885000,75915000,75890000,75920000,"chr4",192599,4,15,15,34,"chr4",1,0.127519924988279
"5913","chr4.37800000.37805000","chr4.37980000.37985000",180000,13,0.003066762,37800000,37980000,37805000,37985000,"chr4",192653,0,6,6,12,"chr4",1,0.0182841068917018
"5914","chr4.39475000.39480000","chr4.39525000.39530000",50000,23,0.001802977,39475000,39525000,39480000,39530000,"chr4",192675,0,8,10,18,"chr4",1,0.0485232067510548
"5915","chr4.108980000.108985000","chr4.109495000.109500000",515000,41,1.137742e-40,108980000,109495000,108985000,109500000,"chr4",192687,0,2,5,7,"chr4",1,0.033638068448195
"5916","chr4.6710000.6715000","chr4.7070000.7075000",360000,17,1.345107e-08,6710000,7070000,6715000,7075000,"chr4",192718,0,6,3,9,"chr4",1,0.0179324894514768
"5917","chr4.185210000.185215000","chr4.185320000.185325000",110000,18,0.000135303,185210000,185320000,185215000,185325000,"chr4",192720,1,4,4,9,"chr4",1,0.0189873417721519
"5918","chr4.20425000.20430000","chr4.20685000.20690000",260000,23,1.331468e-12,20425000,20685000,20430000,20690000,"chr4",192749,0,0,5,5,"chr4",1,0.0134786685419597
"5919","chr4.77105000.77110000","chr4.77195000.77200000",90000,20,7.250045e-05,77105000,77195000,77110000,77200000,"chr4",192755,1,2,3,6,"chr4",1,0.0140646976090014
"5920","chr4.158915000.158920000","chr4.159175000.159180000",260000,20,8.398925e-10,158915000,159175000,158920000,159180000,"chr4",192763,2,8,2,12,"chr4",1,0.0281293952180028
"5921","chr4.17785000.17790000","chr4.18590000.18595000",805000,8,0.00208894,17785000,18590000,17790000,18595000,"chr4",192796,1,6,6,13,"chr4",1,0.0121894045944679
"5922","chr4.48575000.48580000","chr4.48830000.48835000",255000,12,0.001310915,48575000,48830000,48580000,48835000,"chr4",192800,2,8,12,22,"chr4",1,0.0309423347398031
"5923","chr4.2220000.2225000","chr4.2465000.2470000",245000,16,3.230702e-06,2220000,2465000,2225000,2470000,"chr4",192829,8,6,13,27,"chr4",1,0.0506329113924051
"5924","chr4.21790000.21795000","chr4.22385000.22390000",595000,13,8.492077e-07,21790000,22385000,21795000,22390000,"chr4",192864,1,0,1,2,"chr4",1,0.00304735114861697
"5925","chr4.82460000.82465000","chr4.82760000.82765000",300000,11,0.002123289,82460000,82760000,82465000,82765000,"chr4",192876,0,5,0,5,"chr4",1,0.00644631973745898
"5926","chr4.48640000.48645000","chr4.48830000.48835000",190000,12,0.007388988,48640000,48830000,48645000,48835000,"chr4",192903,0,3,1,4,"chr4",1,0.00562587904360056
"5927","chr4.113105000.113110000","chr4.113145000.113150000",40000,35,1.02781e-07,113105000,113145000,113110000,113150000,"chr4",192913,0,0,2,2,"chr4",1,0.00820440693858415
"5928","chr4.26160000.26165000","chr4.26235000.26240000",75000,19,0.001414564,26160000,26235000,26165000,26240000,"chr4",192982,0,0,5,5,"chr4",1,0.0111345522737928
"5929","chr4.26215000.26220000","chr4.26235000.26240000",20000,51,1.20374e-08,26215000,26235000,26220000,26240000,"chr4",193026,3,4,6,13,"chr4",1,0.0777074542897328
"5930","chr4.169370000.169375000","chr4.169900000.169905000",530000,9,0.003081668,169370000,169900000,169375000,169905000,"chr4",193064,0,2,0,2,"chr4",1,0.00210970464135021
"5931","chr4.86320000.86325000","chr4.86390000.86395000",70000,20,0.0009558107,86320000,86390000,86325000,86395000,"chr4",193085,0,6,3,9,"chr4",1,0.0210970464135021
"5932","chr4.41150000.41155000","chr4.41210000.41215000",60000,23,0.0002342,41150000,41210000,41155000,41215000,"chr4",193156,0,3,3,6,"chr4",1,0.0161744022503516
"5933","chr4.54230000.54235000","chr4.54925000.54930000",695000,9,0.0007657421,54230000,54925000,54235000,54930000,"chr4",193177,0,4,1,5,"chr4",1,0.00527426160337553
"5934","chr4.140100000.140105000","chr4.140425000.140430000",325000,10,0.005833274,140100000,140425000,140105000,140430000,"chr4",193218,3,2,2,7,"chr4",1,0.00820440693858415
"5935","chr4.47665000.47670000","chr4.47930000.47935000",265000,11,0.004144918,47665000,47930000,47670000,47935000,"chr4",193227,0,1,5,6,"chr4",1,0.00773558368495077
"5936","chr4.165100000.165105000","chr4.165300000.165305000",200000,13,0.001582008,165100000,165300000,165105000,165305000,"chr4",193243,1,9,2,12,"chr4",1,0.0182841068917018
"5937","chr4.39660000.39665000","chr4.39905000.39910000",245000,11,0.006328824,39660000,39905000,39665000,39910000,"chr4",193293,14,22,17,53,"chr4",1,0.0683309892170652
"5938","chr4.185205000.185210000","chr4.185730000.185735000",525000,9,0.003211129,185205000,185730000,185210000,185735000,"chr4",193352,0,0,4,4,"chr4",1,0.00421940928270042
"5939","chr4.40950000.40955000","chr4.41155000.41160000",205000,12,0.004843706,40950000,41155000,40955000,41160000,"chr4",193420,1,10,3,14,"chr4",1,0.019690576652602
"5940","chr4.38190000.38195000","chr4.38610000.38615000",420000,9,0.008369101,38190000,38610000,38195000,38615000,"chr4",193466,1,2,4,7,"chr4",1,0.00738396624472574
"5941","chr4.41155000.41160000","chr4.41210000.41215000",55000,34,7.943263e-10,41155000,41210000,41160000,41215000,"chr4",193470,1,8,3,12,"chr4",1,0.0478199718706048
"5942","chr4.41120000.41125000","chr4.41155000.41160000",35000,39,1.850329e-08,41120000,41155000,41125000,41160000,"chr4",193485,1,2,3,6,"chr4",1,0.0274261603375527
"5943","chr4.38900000.38905000","chr4.39040000.39045000",140000,23,6.458722e-09,38900000,39040000,38905000,39045000,"chr4",193543,2,3,1,6,"chr4",1,0.0161744022503516
"5944","chr4.48575000.48580000","chr4.48895000.48900000",320000,13,6.487187e-05,48575000,48895000,48580000,48900000,"chr4",193551,5,10,9,24,"chr4",1,0.0365682137834037
"5945","chr4.15475000.15480000","chr4.15650000.15655000",175000,20,1.016953e-07,15475000,15650000,15480000,15655000,"chr4",193555,0,4,2,6,"chr4",1,0.0140646976090014
"5946","chr4.140735000.140740000","chr4.140925000.140930000",190000,20,3.981406e-08,140735000,140925000,140740000,140930000,"chr4",193590,0,2,7,9,"chr4",1,0.0210970464135021
"5947","chr4.40950000.40955000","chr4.41210000.41215000",260000,26,1.312177e-15,40950000,41210000,40955000,41215000,"chr4",193652,3,8,6,17,"chr4",1,0.0518049695264885
"5948","chr4.141010000.141015000","chr4.141155000.141160000",145000,16,0.0002562114,141010000,141155000,141015000,141160000,"chr4",193653,0,1,0,1,"chr4",1,0.00187529301453352
"5949","chr4.87420000.87425000","chr4.88015000.88020000",595000,8,0.008449866,87420000,88015000,87425000,88020000,"chr4",193662,2,5,1,8,"chr4",1,0.00750117205813408
"5950","chr4.24580000.24585000","chr4.25310000.25315000",730000,9,0.0005896236,24580000,25310000,24585000,25315000,"chr4",193673,4,5,16,25,"chr4",1,0.0263713080168776
"5951","chr4.184095000.184100000","chr4.184115000.184120000",20000,44,1.009978e-05,184095000,184115000,184100000,184120000,"chr4",193687,0,5,3,8,"chr4",1,0.0412564463197375
"5952","chr4.82385000.82390000","chr4.82560000.82565000",175000,19,5.76631e-07,82385000,82560000,82390000,82565000,"chr4",193748,0,3,7,10,"chr4",1,0.0222691045475856
"5953","chr4.38160000.38165000","chr4.38730000.38735000",570000,16,1.48866e-09,38160000,38730000,38165000,38735000,"chr4",193749,1,5,4,10,"chr4",1,0.0187529301453352
"5954","chr4.145565000.145570000","chr4.145675000.145680000",110000,22,4.69614e-07,145565000,145675000,145570000,145680000,"chr4",193769,0,2,2,4,"chr4",1,0.0103141115799344
"5955","chr4.38160000.38165000","chr4.38780000.38785000",620000,10,0.0002441148,38160000,38780000,38165000,38785000,"chr4",193849,1,5,4,10,"chr4",1,0.0117205813408345
"5956","chr4.38185000.38190000","chr4.38305000.38310000",120000,19,1.658788e-05,38185000,38305000,38190000,38310000,"chr4",193867,2,13,5,20,"chr4",1,0.0445382090951711
"5957","chr4.40735000.40740000","chr4.40930000.40935000",195000,14,0.0004894285,40735000,40930000,40740000,40935000,"chr4",193896,1,5,7,13,"chr4",1,0.0213314580403188
"5958","chr4.16640000.16645000","chr4.17445000.17450000",805000,12,5.9533e-07,16640000,17445000,16645000,17450000,"chr4",193909,0,2,2,4,"chr4",1,0.00562587904360056
"5959","chr4.56280000.56285000","chr4.56420000.56425000",140000,15,0.001162659,56280000,56420000,56285000,56425000,"chr4",193923,3,5,6,14,"chr4",1,0.0246132208157525
"5960","chr4.10015000.10020000","chr4.10060000.10065000",45000,53,4.201704e-21,10015000,10060000,10020000,10065000,"chr4",193991,0,3,0,3,"chr4",1,0.0186357243319269
"5961","chr4.24000000.24005000","chr4.24370000.24375000",370000,10,0.003370595,2.4e+07,24370000,24005000,24375000,"chr4",194125,0,3,1,4,"chr4",1,0.0046882325363338
"5962","chr4.38315000.38320000","chr4.38660000.38665000",345000,14,6.828935e-06,38315000,38660000,38320000,38665000,"chr4",194153,0,7,1,8,"chr4",1,0.0131270511017346
"5963","chr4.6905000.6910000","chr4.6985000.6990000",80000,35,2.668932e-14,6905000,6985000,6910000,6990000,"chr4",194176,1,3,2,6,"chr4",1,0.0246132208157525
"5964","chr4.165095000.165100000","chr4.165300000.165305000",205000,12,0.004843706,165095000,165300000,165100000,165305000,"chr4",194219,1,9,2,12,"chr4",1,0.0168776371308017
"5965","chr4.6885000.6890000","chr4.7070000.7075000",185000,14,0.0006989227,6885000,7070000,6890000,7075000,"chr4",194271,0,6,3,9,"chr4",1,0.0147679324894515
"5966","chr4.99890000.99895000","chr4.99995000.100000000",105000,15,0.006527429,99890000,99995000,99895000,1e+08,"chr4",194302,0,1,0,1,"chr4",1,0.00175808720112518
"5967","chr4.26160000.26165000","chr4.26315000.26320000",155000,14,0.002169033,26160000,26315000,26165000,26320000,"chr4",194317,0,0,5,5,"chr4",1,0.00820440693858415
"5968","chr4.185695000.185700000","chr4.185715000.185720000",20000,36,0.004538753,185695000,185715000,185700000,185720000,"chr4",194318,0,4,2,6,"chr4",1,0.0253164556962025
"5969","chr4.38175000.38180000","chr4.38780000.38785000",605000,20,2.920575e-14,38175000,38780000,38180000,38785000,"chr4",194324,4,8,12,24,"chr4",1,0.0562587904360056
"5970","chr4.44760000.44765000","chr4.45450000.45455000",690000,10,0.0001249039,44760000,45450000,44765000,45455000,"chr4",194341,0,2,2,4,"chr4",1,0.0046882325363338
"5971","chr4.2220000.2225000","chr4.2890000.2895000",670000,8,0.00502128,2220000,2890000,2225000,2895000,"chr4",194350,7,15,10,32,"chr4",1,0.0300046882325363
"5972","chr4.38315000.38320000","chr4.38610000.38615000",295000,18,1.172568e-08,38315000,38610000,38320000,38615000,"chr4",194368,0,2,1,3,"chr4",1,0.00632911392405063
"5973","chr4.82720000.82725000","chr4.82740000.82745000",20000,39,0.0005731573,82720000,82740000,82725000,82745000,"chr4",194486,6,13,8,27,"chr4",1,0.123417721518987
"5974","chr4.1680000.1685000","chr4.1725000.1730000",45000,25,0.0008345189,1680000,1725000,1685000,1730000,"chr4",194510,0,5,2,7,"chr4",1,0.0205110173464604
"5975","chr4.139015000.139020000","chr4.139745000.139750000",730000,9,0.0005896236,139015000,139745000,139020000,139750000,"chr4",194537,0,5,1,6,"chr4",1,0.00632911392405063
"5976","chr4.38185000.38190000","chr4.38675000.38680000",490000,23,2.048157e-16,38185000,38675000,38190000,38680000,"chr4",194551,1,5,1,7,"chr4",1,0.0188701359587436
"5977","chr4.82470000.82475000","chr4.82515000.82520000",45000,24,0.002080527,82470000,82515000,82475000,82520000,"chr4",194560,0,8,2,10,"chr4",1,0.0281293952180028
"5978","chr4.38315000.38320000","chr4.38620000.38625000",305000,12,0.000438113,38315000,38620000,38320000,38625000,"chr4",194596,0,7,1,8,"chr4",1,0.0112517580872011
"5979","chr4.48575000.48580000","chr4.48775000.48780000",200000,26,1.242094e-13,48575000,48775000,48580000,48780000,"chr4",194665,5,2,4,11,"chr4",1,0.0335208626347867
"5980","chr4.38175000.38180000","chr4.38610000.38615000",435000,10,0.001645817,38175000,38610000,38180000,38615000,"chr4",194690,1,2,4,7,"chr4",1,0.00820440693858415
"5981","chr4.82675000.82680000","chr4.82740000.82745000",65000,22,0.0002562114,82675000,82740000,82680000,82745000,"chr4",194721,0,2,0,2,"chr4",1,0.00515705578996718
"5982","chr4.48725000.48730000","chr4.48785000.48790000",60000,23,0.0002342,48725000,48785000,48730000,48790000,"chr4",194767,3,2,2,7,"chr4",1,0.0188701359587436
"5983","chr4.140235000.140240000","chr4.140325000.140330000",90000,17,0.002386154,140235000,140325000,140240000,140330000,"chr4",194772,2,4,5,11,"chr4",1,0.0219174871073605
"5984","chr4.40925000.40930000","chr4.41145000.41150000",220000,15,4.356812e-05,40925000,41145000,40930000,41150000,"chr4",194791,5,14,12,31,"chr4",1,0.0545007032348805
"5985","chr4.38320000.38325000","chr4.38560000.38565000",240000,17,6.771667e-07,38320000,38560000,38325000,38565000,"chr4",194827,0,0,1,1,"chr4",1,0.00199249882794187
"5986","chr4.77950000.77955000","chr4.78130000.78135000",180000,13,0.003066762,77950000,78130000,77955000,78135000,"chr4",194904,1,2,2,5,"chr4",1,0.00761837787154243
"5987","chr4.88455000.88460000","chr4.88590000.88595000",135000,14,0.004563962,88455000,88590000,88460000,88595000,"chr4",194912,1,5,6,12,"chr4",1,0.019690576652602
"5988","chr4.140100000.140105000","chr4.140250000.140255000",150000,16,0.0002035185,140100000,140250000,140105000,140255000,"chr4",194929,1,2,0,3,"chr4",1,0.00562587904360056
"5989","chr4.7800000.7805000","chr4.7925000.7930000",125000,21,5.846143e-07,7800000,7925000,7805000,7930000,"chr4",194936,3,5,10,18,"chr4",1,0.0443037974683544
"5990","chr4.17545000.17550000","chr4.17615000.17620000",70000,29,9.331514e-09,17545000,17615000,17550000,17620000,"chr4",194944,2,16,15,33,"chr4",1,0.112165963431786
"5991","chr4.14915000.14920000","chr4.15160000.15165000",245000,14,8.718848e-05,14915000,15160000,14920000,15165000,"chr4",194994,0,3,0,3,"chr4",1,0.00492264416315049
"5992","chr4.17780000.17785000","chr4.18590000.18595000",810000,10,4.333596e-05,17780000,18590000,17785000,18595000,"chr4",195033,1,6,6,13,"chr4",1,0.0152367557430849
"5993","chr4.108650000.108655000","chr4.108830000.108835000",180000,12,0.009964357,108650000,108830000,108655000,108835000,"chr4",195059,1,2,1,4,"chr4",1,0.00562587904360056
"5994","chr4.40735000.40740000","chr4.40845000.40850000",110000,16,0.001582008,40735000,40845000,40740000,40850000,"chr4",195065,4,9,8,21,"chr4",1,0.0393811533052039
"5995","chr4.26330000.26335000","chr4.26395000.26400000",65000,21,0.0007403762,26330000,26395000,26335000,26400000,"chr4",195066,1,9,3,13,"chr4",1,0.0319971870604782
"5996","chr4.38065000.38070000","chr4.38730000.38735000",665000,12,2.859849e-06,38065000,38730000,38070000,38735000,"chr4",195072,2,7,7,16,"chr4",1,0.0225035161744023
"5997","chr4.87420000.87425000","chr4.88005000.88010000",585000,9,0.001890662,87420000,88005000,87425000,88010000,"chr4",195185,2,3,1,6,"chr4",1,0.00632911392405063
"5998","chr4.14865000.14870000","chr4.15195000.15200000",330000,10,0.005455783,14865000,15195000,14870000,15200000,"chr4",195192,0,2,0,2,"chr4",1,0.0023441162681669
"5999","chr4.40950000.40955000","chr4.41150000.41155000",200000,14,0.0004042722,40950000,41150000,40955000,41155000,"chr4",195199,0,3,3,6,"chr4",1,0.00984528832630099
"6000","chr4.177310000.177315000","chr4.177965000.177970000",655000,10,0.0001732199,177310000,177965000,177315000,177970000,"chr4",195214,0,1,0,1,"chr4",1,0.00117205813408345
"6001","chr4.164975000.164980000","chr4.165300000.165305000",325000,10,0.005833274,164975000,165300000,164980000,165305000,"chr4",195230,1,9,2,12,"chr4",1,0.0140646976090014
"6002","chr4.138870000.138875000","chr4.139485000.139490000",615000,8,0.007301881,138870000,139485000,138875000,139490000,"chr4",195253,0,6,1,7,"chr4",1,0.00656352555086732
"6003","chr4.38610000.38615000","chr4.38660000.38665000",50000,32,7.769595e-08,38610000,38660000,38615000,38665000,"chr4",195276,1,2,4,7,"chr4",1,0.0262541022034693
"6004","chr4.40990000.40995000","chr4.41120000.41125000",130000,16,0.0005253519,40990000,41120000,40995000,41125000,"chr4",195280,4,2,6,12,"chr4",1,0.0225035161744023
"6005","chr4.100090000.100095000","chr4.100315000.100320000",225000,12,0.002816769,100090000,100315000,100095000,100320000,"chr4",195314,0,2,2,4,"chr4",1,0.00562587904360056
"6006","chr4.38065000.38070000","chr4.38320000.38325000",255000,12,0.001310915,38065000,38320000,38070000,38325000,"chr4",195325,0,2,1,3,"chr4",1,0.00421940928270042
"6007","chr4.74205000.74210000","chr4.74310000.74315000",105000,20,1.433934e-05,74205000,74310000,74210000,74315000,"chr4",195346,0,0,1,1,"chr4",1,0.0023441162681669
"6008","chr4.40930000.40935000","chr4.41120000.41125000",190000,13,0.002185726,40930000,41120000,40935000,41125000,"chr4",195417,1,2,6,9,"chr4",1,0.0137130801687764
"6009","chr4.78290000.78295000","chr4.78610000.78615000",320000,14,1.141554e-05,78290000,78610000,78295000,78615000,"chr4",195418,2,5,2,9,"chr4",1,0.0147679324894515
"6010","chr4.24580000.24585000","chr4.24910000.24915000",330000,11,0.001309974,24580000,24910000,24585000,24915000,"chr4",195454,3,2,2,7,"chr4",1,0.00902484763244257
"6011","chr4.158910000.158915000","chr4.159070000.159075000",160000,13,0.00593113,158910000,159070000,158915000,159075000,"chr4",195498,4,11,3,18,"chr4",1,0.0274261603375527
"6012","chr4.6915000.6920000","chr4.7005000.7010000",90000,20,7.250045e-05,6915000,7005000,6920000,7010000,"chr4",195513,1,12,11,24,"chr4",1,0.0562587904360056
"6013","chr4.108680000.108685000","chr4.108830000.108835000",150000,33,4.337698e-18,108680000,108830000,108685000,108835000,"chr4",195545,0,2,1,3,"chr4",1,0.0116033755274262
"6014","chr4.77075000.77080000","chr4.77105000.77110000",30000,34,0.0001249039,77075000,77105000,77080000,77110000,"chr4",195571,6,11,9,26,"chr4",1,0.103609939052977
"6015","chr4.36290000.36295000","chr4.36330000.36335000",40000,44,5.030099e-13,36290000,36330000,36295000,36335000,"chr4",195580,0,3,1,4,"chr4",1,0.0206282231598687
"6016","chr4.152270000.152275000","chr4.152950000.152955000",680000,8,0.004702813,152270000,152950000,152275000,152955000,"chr4",195582,0,4,3,7,"chr4",1,0.00656352555086732
"6017","chr4.25910000.25915000","chr4.26315000.26320000",405000,10,0.002268256,25910000,26315000,25915000,26320000,"chr4",195587,0,0,5,5,"chr4",1,0.00586029067041725
"6018","chr4.6265000.6270000","chr4.6325000.6330000",60000,21,0.001784832,6265000,6325000,6270000,6330000,"chr4",195667,0,3,2,5,"chr4",1,0.0123066104078762
"6019","chr4.41060000.41065000","chr4.41120000.41125000",60000,22,0.0006645896,41060000,41120000,41065000,41125000,"chr4",195681,3,2,6,11,"chr4",1,0.0283638068448195
"6020","chr4.38885000.38890000","chr4.39180000.39185000",295000,12,0.000539863,38885000,39180000,38890000,39185000,"chr4",195764,3,8,13,24,"chr4",1,0.0337552742616034
"6021","chr4.2785000.2790000","chr4.2890000.2895000",105000,15,0.006527429,2785000,2890000,2790000,2895000,"chr4",195792,7,10,10,27,"chr4",1,0.0474683544303797
"6022","chr4.82620000.82625000","chr4.82755000.82760000",135000,16,0.000407249,82620000,82755000,82625000,82760000,"chr4",195843,2,11,18,31,"chr4",1,0.0581340834505391
"6023","chr4.152550000.152555000","chr4.153245000.153250000",695000,8,0.00430327,152550000,153245000,152555000,153250000,"chr4",195870,1,8,1,10,"chr4",1,0.00937646507266761
"6024","chr4.48775000.48780000","chr4.48895000.48900000",120000,19,1.658788e-05,48775000,48895000,48780000,48900000,"chr4",195876,6,2,4,12,"chr4",1,0.0267229254571027
"6025","chr4.153330000.153335000","chr4.153560000.153565000",230000,12,0.002441934,153330000,153560000,153335000,153565000,"chr4",195952,1,3,4,8,"chr4",1,0.0112517580872011
"6026","chr4.41120000.41125000","chr4.41145000.41150000",25000,73,3.332582e-23,41120000,41145000,41125000,41150000,"chr4",195963,4,2,6,12,"chr4",1,0.10267229254571
"6027","chr4.39525000.39530000","chr4.39635000.39640000",110000,41,4.088579e-23,39525000,39635000,39530000,39640000,"chr4",195998,0,7,7,14,"chr4",1,0.0672761368963901
"6028","chr4.41280000.41285000","chr4.41670000.41675000",390000,18,7.55262e-10,41280000,41670000,41285000,41675000,"chr4",196016,2,8,9,19,"chr4",1,0.040084388185654
"6029","chr4.40950000.40955000","chr4.41145000.41150000",195000,14,0.0004894285,40950000,41145000,40955000,41150000,"chr4",196045,6,16,14,36,"chr4",1,0.0590717299578059
"6030","chr4.14865000.14870000","chr4.15130000.15135000",265000,16,1.553281e-06,14865000,15130000,14870000,15135000,"chr4",196063,0,2,0,2,"chr4",1,0.00375058602906704
"6031","chr4.38165000.38170000","chr4.38800000.38805000",635000,9,0.001247629,38165000,38800000,38170000,38805000,"chr4",196293,0,2,1,3,"chr4",1,0.00316455696202532
"6032","chr4.145095000.145100000","chr4.145565000.145570000",470000,10,0.001129126,145095000,145565000,145100000,145570000,"chr4",196334,0,2,2,4,"chr4",1,0.0046882325363338
"6033","chr4.7800000.7805000","chr4.7985000.7990000",185000,15,0.0001742055,7800000,7985000,7805000,7990000,"chr4",196373,3,5,12,20,"chr4",1,0.0351617440225035
"6034","chr4.2760000.2765000","chr4.2875000.2880000",115000,21,1.335003e-06,2760000,2875000,2765000,2880000,"chr4",196421,0,9,5,14,"chr4",1,0.0344585091420534
"6035","chr4.25230000.25235000","chr4.25310000.25315000",80000,26,8.692283e-08,25230000,25310000,25235000,25315000,"chr4",196438,2,4,6,12,"chr4",1,0.0365682137834037
"6036","chr4.185200000.185205000","chr4.185470000.185475000",270000,12,0.000907358,185200000,185470000,185205000,185475000,"chr4",196451,1,14,12,27,"chr4",1,0.0379746835443038
"6037","chr4.185180000.185185000","chr4.185370000.185375000",190000,12,0.007388988,185180000,185370000,185185000,185375000,"chr4",196452,0,0,4,4,"chr4",1,0.00562587904360056
"6038","chr4.38175000.38180000","chr4.38315000.38320000",140000,20,9.748317e-07,38175000,38315000,38180000,38320000,"chr4",196490,0,7,1,8,"chr4",1,0.0187529301453352
"6039","chr4.2240000.2245000","chr4.2465000.2470000",225000,20,5.172686e-09,2240000,2465000,2245000,2470000,"chr4",196497,0,1,0,1,"chr4",1,0.0023441162681669
"6040","chr4.82345000.82350000","chr4.82750000.82755000",405000,14,2.251043e-06,82345000,82750000,82350000,82755000,"chr4",196502,2,4,4,10,"chr4",1,0.0164088138771683
"6041","chr4.17495000.17500000","chr4.17545000.17550000",50000,22,0.004429918,17495000,17545000,17500000,17550000,"chr4",196547,3,8,7,18,"chr4",1,0.0464135021097046
"6042","chr4.108980000.108985000","chr4.109405000.109410000",425000,10,0.001816415,108980000,109405000,108985000,109410000,"chr4",196564,0,2,2,4,"chr4",1,0.0046882325363338
"6043","chr4.82380000.82385000","chr4.82760000.82765000",380000,18,9.721942e-10,82380000,82760000,82385000,82765000,"chr4",196607,1,7,2,10,"chr4",1,0.0210970464135021
"6044","chr4.6720000.6725000","chr4.7005000.7010000",285000,11,0.00278538,6720000,7005000,6725000,7010000,"chr4",196608,0,2,1,3,"chr4",1,0.00386779184247539
"6045","chr4.158915000.158920000","chr4.159045000.159050000",130000,16,0.0005253519,158915000,159045000,158920000,159050000,"chr4",196631,4,12,7,23,"chr4",1,0.043131739334271
"6046","chr4.6715000.6720000","chr4.7065000.7070000",350000,12,0.0002008627,6715000,7065000,6720000,7070000,"chr4",196647,1,4,14,19,"chr4",1,0.0267229254571027
"6047","chr4.38675000.38680000","chr4.38730000.38735000",55000,29,7.30356e-07,38675000,38730000,38680000,38735000,"chr4",196678,1,5,1,7,"chr4",1,0.023792780121894
"6048","chr4.16065000.16070000","chr4.16195000.16200000",130000,20,1.879849e-06,16065000,16195000,16070000,16200000,"chr4",196691,0,3,1,4,"chr4",1,0.00937646507266761
"6049","chr4.6730000.6735000","chr4.7040000.7045000",310000,13,7.969378e-05,6730000,7040000,6735000,7045000,"chr4",196692,0,1,1,2,"chr4",1,0.00304735114861697
"6050","chr4.20320000.20325000","chr4.20415000.20420000",95000,29,3.736504e-11,20320000,20415000,20325000,20420000,"chr4",196696,1,1,1,3,"chr4",1,0.010196905766526
"6051","chr4.40915000.40920000","chr4.41215000.41220000",300000,18,9.777077e-09,40915000,41215000,40920000,41220000,"chr4",196776,3,0,1,4,"chr4",1,0.00843881856540084
"6052","chr4.39455000.39460000","chr4.39975000.39980000",520000,14,3.168767e-07,39455000,39975000,39460000,39980000,"chr4",196803,0,13,13,26,"chr4",1,0.0426629160806376
"6053","chr4.38190000.38195000","chr4.38305000.38310000",115000,24,1.111803e-08,38190000,38305000,38195000,38310000,"chr4",196829,2,13,5,20,"chr4",1,0.0562587904360056
"6054","chr4.6730000.6735000","chr4.6885000.6890000",155000,25,4.652115e-11,6730000,6885000,6735000,6890000,"chr4",196912,0,7,1,8,"chr4",1,0.023441162681669
"6055","chr4.185315000.185320000","chr4.185555000.185560000",240000,11,0.006961906,185315000,185555000,185320000,185560000,"chr4",197033,0,5,1,6,"chr4",1,0.00773558368495077
"6056","chr4.48830000.48835000","chr4.48895000.48900000",65000,20,0.002052456,48830000,48895000,48835000,48900000,"chr4",197039,2,8,9,19,"chr4",1,0.0445382090951711
"6057","chr4.6260000.6265000","chr4.6325000.6330000",65000,32,4.263664e-10,6260000,6325000,6265000,6330000,"chr4",197041,0,3,2,5,"chr4",1,0.0187529301453352
"6058","chr4.88975000.88980000","chr4.89155000.89160000",180000,15,0.0002165588,88975000,89155000,88980000,89160000,"chr4",197072,0,5,5,10,"chr4",1,0.0175808720112518
"6059","chr4.82675000.82680000","chr4.82750000.82755000",75000,19,0.001414564,82675000,82750000,82680000,82755000,"chr4",197113,0,2,0,2,"chr4",1,0.00445382090951711
"6060","chr4.185200000.185205000","chr4.185315000.185320000",115000,36,8.962909e-19,185200000,185315000,185205000,185320000,"chr4",197115,0,5,3,8,"chr4",1,0.0337552742616034
"6061","chr4.140030000.140035000","chr4.140090000.140095000",60000,23,0.0002342,140030000,140090000,140035000,140095000,"chr4",197132,0,2,0,2,"chr4",1,0.00539146741678387
"6062","chr4.7805000.7810000","chr4.8015000.8020000",210000,14,0.0002805808,7805000,8015000,7810000,8020000,"chr4",197148,0,11,7,18,"chr4",1,0.029535864978903
"6063","chr4.40985000.40990000","chr4.41045000.41050000",60000,22,0.0006645896,40985000,41045000,40990000,41050000,"chr4",197160,2,8,6,16,"chr4",1,0.0412564463197375
"6064","chr4.41080000.41085000","chr4.41210000.41215000",130000,32,4.52167e-16,41080000,41210000,41085000,41215000,"chr4",197245,2,8,6,16,"chr4",1,0.0600093764650727
"6065","chr4.17610000.17615000","chr4.17810000.17815000",200000,14,0.0004042722,17610000,17810000,17615000,17815000,"chr4",197259,5,8,4,17,"chr4",1,0.0278949835911861
"6066","chr4.41690000.41695000","chr4.41885000.41890000",195000,14,0.0004894285,41690000,41885000,41695000,41890000,"chr4",197318,0,2,1,3,"chr4",1,0.00492264416315049
"6067","chr4.41415000.41420000","chr4.41470000.41475000",55000,24,0.0002397778,41415000,41470000,41420000,41475000,"chr4",197344,3,9,4,16,"chr4",1,0.0450070323488045
"6068","chr4.164955000.164960000","chr4.165360000.165365000",405000,10,0.002268256,164955000,165360000,164960000,165365000,"chr4",197373,1,3,2,6,"chr4",1,0.0070323488045007
"6069","chr4.13980000.13985000","chr4.14880000.14885000",900000,7,0.006690648,13980000,14880000,13985000,14885000,"chr4",197391,2,1,0,3,"chr4",1,0.00246132208157525
"6070","chr4.38185000.38190000","chr4.38610000.38615000",425000,12,6.668965e-05,38185000,38610000,38190000,38615000,"chr4",197399,1,2,4,7,"chr4",1,0.00984528832630099
"6071","chr4.38185000.38190000","chr4.38320000.38325000",135000,21,2.752524e-07,38185000,38320000,38190000,38325000,"chr4",197455,0,2,1,3,"chr4",1,0.00738396624472574
"6072","chr4.185200000.185205000","chr4.185370000.185375000",170000,21,2.440396e-08,185200000,185370000,185205000,185375000,"chr4",197520,0,0,4,4,"chr4",1,0.00984528832630099
"6073","chr4.41070000.41075000","chr4.41135000.41140000",65000,32,4.263664e-10,41070000,41135000,41075000,41140000,"chr4",197533,3,7,7,17,"chr4",1,0.0637599624941397
"6074","chr4.38925000.38930000","chr4.38945000.38950000",20000,36,0.004538753,38925000,38945000,38930000,38950000,"chr4",197555,0,4,2,6,"chr4",1,0.0253164556962025
"6075","chr4.2875000.2880000","chr4.2890000.2895000",15000,45,4.145606e-06,2875000,2890000,2880000,2895000,"chr4",197580,5,15,10,30,"chr4",1,0.158227848101266
"6076","chr4.40985000.40990000","chr4.41145000.41150000",160000,27,5.533483e-13,40985000,41145000,40990000,41150000,"chr4",197730,2,8,6,16,"chr4",1,0.0506329113924051
"6077","chr4.6915000.6920000","chr4.7070000.7075000",155000,13,0.006948378,6915000,7070000,6920000,7075000,"chr4",197791,0,6,3,9,"chr4",1,0.0137130801687764
"6078","chr4.24795000.24800000","chr4.24815000.24820000",20000,38,0.001166429,24795000,24815000,24800000,24820000,"chr4",197874,1,0,3,4,"chr4",1,0.0178152836380684
"6079","chr4.38200000.38205000","chr4.38660000.38665000",460000,10,0.001249239,38200000,38660000,38205000,38665000,"chr4",197924,1,8,9,18,"chr4",1,0.0210970464135021
"6080","chr4.36265000.36270000","chr4.36330000.36335000",65000,26,2.134407e-06,36265000,36330000,36270000,36335000,"chr4",197998,0,6,3,9,"chr4",1,0.0274261603375527
"6081","chr4.40925000.40930000","chr4.40985000.40990000",60000,27,2.149692e-06,40925000,40985000,40930000,40990000,"chr4",198019,2,8,6,16,"chr4",1,0.0506329113924051
"6082","chr4.123735000.123740000","chr4.123830000.123835000",95000,27,1.155123e-09,123735000,123830000,123740000,123835000,"chr4",198047,0,3,1,4,"chr4",1,0.0126582278481013
"6083","chr4.38190000.38195000","chr4.38320000.38325000",130000,17,0.0001400532,38190000,38320000,38195000,38325000,"chr4",198054,0,2,1,3,"chr4",1,0.0059774964838256
"6084","chr4.39475000.39480000","chr4.39695000.39700000",220000,20,6.887484e-09,39475000,39695000,39480000,39700000,"chr4",198109,7,24,18,49,"chr4",1,0.114861697140178
"6085","chr4.140425000.140430000","chr4.140555000.140560000",130000,15,0.001777197,140425000,140555000,140430000,140560000,"chr4",198125,1,2,1,4,"chr4",1,0.0070323488045007
"6086","chr4.74095000.74100000","chr4.74115000.74120000",20000,37,0.002313332,74095000,74115000,74100000,74120000,"chr4",198148,0,0,2,2,"chr4",1,0.00867323019221753
"6087","chr4.38265000.38270000","chr4.38305000.38310000",40000,39,6.063462e-10,38265000,38305000,38270000,38310000,"chr4",198156,2,10,5,17,"chr4",1,0.0777074542897328
"6088","chr4.10015000.10020000","chr4.10070000.10075000",55000,25,8.146509e-05,10015000,10070000,10020000,10075000,"chr4",198177,0,3,0,3,"chr4",1,0.00879043600562588
"6089","chr4.24580000.24585000","chr4.24685000.24690000",105000,15,0.006527429,24580000,24685000,24585000,24690000,"chr4",198222,1,1,2,4,"chr4",1,0.0070323488045007
"6090","chr4.139105000.139110000","chr4.139600000.139605000",495000,10,0.0008488785,139105000,139600000,139110000,139605000,"chr4",198290,0,3,1,4,"chr4",1,0.0046882325363338
"6091","chr4.88615000.88620000","chr4.88755000.88760000",140000,14,0.003828938,88615000,88755000,88620000,88760000,"chr4",198307,4,6,7,17,"chr4",1,0.0278949835911861
"6092","chr4.15960000.15965000","chr4.16000000.16005000",40000,27,0.0005582397,15960000,1.6e+07,15965000,16005000,"chr4",198357,3,2,4,9,"chr4",1,0.0284810126582278
"6093","chr4.13725000.13730000","chr4.13965000.13970000",240000,12,0.001890662,13725000,13965000,13730000,13970000,"chr4",198392,0,1,3,4,"chr4",1,0.00562587904360056
"6094","chr4.38160000.38165000","chr4.38610000.38615000",450000,9,0.006366048,38160000,38610000,38165000,38615000,"chr4",198426,1,2,4,7,"chr4",1,0.00738396624472574
"6095","chr4.88590000.88595000","chr4.89430000.89435000",840000,8,0.001658784,88590000,89430000,88595000,89435000,"chr4",198454,1,5,5,11,"chr4",1,0.0103141115799344
"6096","chr4.112325000.112330000","chr4.112345000.112350000",20000,35,0.008449866,112325000,112345000,112330000,112350000,"chr4",198470,0,1,0,1,"chr4",1,0.00410220346929208
"6097","chr4.155625000.155630000","chr4.155655000.155660000",30000,31,0.001526724,155625000,155655000,155630000,155660000,"chr4",198480,1,0,4,5,"chr4",1,0.0181669010782935
"6098","chr4.40735000.40740000","chr4.40835000.40840000",100000,17,0.001018581,40735000,40835000,40740000,40840000,"chr4",198491,4,15,14,33,"chr4",1,0.0657524613220816
"6099","chr4.7100000.7105000","chr4.7375000.7380000",275000,11,0.003370595,7100000,7375000,7105000,7380000,"chr4",198511,1,1,1,3,"chr4",1,0.00386779184247539
"6100","chr4.99055000.99060000","chr4.99950000.99955000",895000,11,2.184587e-06,99055000,99950000,99060000,99955000,"chr4",198565,1,9,8,18,"chr4",1,0.0232067510548523
"6101","chr4.38320000.38325000","chr4.38730000.38735000",410000,20,4.417061e-12,38320000,38730000,38325000,38735000,"chr4",198608,0,2,1,3,"chr4",1,0.0070323488045007
"6102","chr4.82385000.82390000","chr4.82770000.82775000",385000,26,2.581397e-18,82385000,82770000,82390000,82775000,"chr4",198704,1,6,9,16,"chr4",1,0.0487576183778715
"6103","chr4.108980000.108985000","chr4.109430000.109435000",450000,30,2.786181e-24,108980000,109430000,108985000,109435000,"chr4",198723,0,2,0,2,"chr4",1,0.0070323488045007
"6104","chr4.9690000.9695000","chr4.10015000.10020000",325000,14,1.028628e-05,9690000,10015000,9695000,10020000,"chr4",198729,0,2,0,2,"chr4",1,0.00328176277543366
"6105","chr4.113020000.113025000","chr4.113145000.113150000",125000,20,2.671598e-06,113020000,113145000,113025000,113150000,"chr4",198730,1,0,2,3,"chr4",1,0.0070323488045007
"6106","chr4.56795000.56800000","chr4.57160000.57165000",365000,12,0.0001572461,56795000,57160000,56800000,57165000,"chr4",198764,2,9,5,16,"chr4",1,0.0225035161744023
"6107","chr4.38175000.38180000","chr4.38865000.38870000",690000,9,0.0007910126,38175000,38865000,38180000,38870000,"chr4",198830,0,6,4,10,"chr4",1,0.0105485232067511
"6108","chr4.88610000.88615000","chr4.88755000.88760000",145000,15,0.0009291328,88610000,88755000,88615000,88760000,"chr4",198845,0,2,1,3,"chr4",1,0.00527426160337553
"6109","chr4.14880000.14885000","chr4.15160000.15165000",280000,21,3.876375e-11,14880000,15160000,14885000,15165000,"chr4",198873,0,3,0,3,"chr4",1,0.00738396624472574
"6110","chr4.40835000.40840000","chr4.40895000.40900000",60000,28,6.082566e-07,40835000,40895000,40840000,40900000,"chr4",198874,1,16,17,34,"chr4",1,0.111579934364744
"6111","chr4.38315000.38320000","chr4.38675000.38680000",360000,45,5.046237e-42,38315000,38675000,38320000,38680000,"chr4",198887,0,5,1,6,"chr4",1,0.0316455696202532
"6112","chr4.26315000.26320000","chr4.26410000.26415000",95000,17,0.001551464,26315000,26410000,26320000,26415000,"chr4",198919,0,0,5,5,"chr4",1,0.00996249413970933
"6113","chr4.88975000.88980000","chr4.89430000.89435000",455000,9,0.00607434,88975000,89430000,88980000,89435000,"chr4",198998,0,5,5,10,"chr4",1,0.0105485232067511
"6114","chr4.6730000.6735000","chr4.6780000.6785000",50000,26,9.406648e-05,6730000,6780000,6735000,6785000,"chr4",199003,0,2,1,3,"chr4",1,0.00914205344585091
"6115","chr4.88520000.88525000","chr4.88590000.88595000",70000,19,0.002657082,88520000,88590000,88525000,88595000,"chr4",199005,1,5,2,8,"chr4",1,0.0178152836380684
"6116","chr4.139100000.139105000","chr4.139600000.139605000",500000,24,1.001088e-17,139100000,139600000,139105000,139605000,"chr4",199153,0,7,13,20,"chr4",1,0.0562587904360056
"6117","chr4.2240000.2245000","chr4.2535000.2540000",295000,16,5.853291e-07,2240000,2535000,2245000,2540000,"chr4",199172,0,1,0,1,"chr4",1,0.00187529301453352
"6118","chr4.41280000.41285000","chr4.41690000.41695000",410000,9,0.009154536,41280000,41690000,41285000,41695000,"chr4",199181,0,2,2,4,"chr4",1,0.00421940928270042
"6119","chr5.74640000.74645000","chr5.74660000.74665000",20000,35,0.009978941,74640000,74660000,74645000,74665000,"chr5",199185,0,3,3,6,"chr5",1,0.0246132208157525
"6120","chr5.34500000.34505000","chr5.34865000.34870000",365000,15,8.607714e-07,34500000,34865000,34505000,34870000,"chr5",199313,1,5,4,10,"chr5",1,0.0175808720112518
"6121","chr5.14680000.14685000","chr5.15000000.15005000",320000,27,8.034441e-18,14680000,1.5e+07,14685000,15005000,"chr5",199377,1,4,3,8,"chr5",1,0.0253164556962025
"6122","chr5.141990000.141995000","chr5.142020000.142025000",30000,44,6.888777e-09,141990000,142020000,141995000,142025000,"chr5",199395,4,7,3,14,"chr5",1,0.0721987810595406
"6123","chr5.72885000.72890000","chr5.73090000.73095000",205000,49,1.31632e-38,72885000,73090000,72890000,73095000,"chr5",199398,0,6,5,11,"chr5",1,0.063173933427098
"6124","chr5.137880000.137885000","chr5.137900000.137905000",20000,38,0.00150338,137880000,137900000,137885000,137905000,"chr5",199505,3,6,12,21,"chr5",1,0.0935302390998594
"6125","chr5.138695000.138700000","chr5.138945000.138950000",250000,18,1.060314e-07,138695000,138945000,138700000,138950000,"chr5",199522,1,1,2,4,"chr5",1,0.00843881856540084
"6126","chr5.112160000.112165000","chr5.112180000.112185000",20000,45,6.393347e-06,112160000,112180000,112165000,112185000,"chr5",199553,1,3,4,8,"chr5",1,0.0421940928270042
"6127","chr5.133695000.133700000","chr5.133950000.133955000",255000,11,0.005563889,133695000,133950000,133700000,133955000,"chr5",199555,0,0,2,2,"chr5",1,0.00257852789498359
"6128","chr5.142650000.142655000","chr5.142750000.142755000",100000,16,0.00394017,142650000,142750000,142655000,142755000,"chr5",199558,0,2,1,3,"chr5",1,0.00562587904360056
"6129","chr5.16485000.16490000","chr5.16665000.16670000",180000,31,3.970469e-17,16485000,16665000,16490000,16670000,"chr5",199568,0,3,0,3,"chr5",1,0.0109001406469761
"6130","chr5.122850000.122855000","chr5.122895000.122900000",45000,28,6.194802e-05,122850000,122895000,122855000,122900000,"chr5",199586,1,6,2,9,"chr5",1,0.029535864978903
"6131","chr5.79460000.79465000","chr5.79550000.79555000",90000,30,4.219374e-11,79460000,79550000,79465000,79555000,"chr5",199589,5,9,9,23,"chr5",1,0.0808720112517581
"6132","chr5.11545000.11550000","chr5.11915000.11920000",370000,10,0.003460345,11545000,11915000,11550000,11920000,"chr5",199629,2,8,9,19,"chr5",1,0.0222691045475856
"6133","chr5.138630000.138635000","chr5.138655000.138660000",25000,37,0.0004675491,138630000,138655000,138635000,138660000,"chr5",199634,1,13,12,26,"chr5",1,0.112751992498828
"6134","chr5.138030000.138035000","chr5.138050000.138055000",20000,40,0.0003613994,138030000,138050000,138035000,138055000,"chr5",199660,3,7,11,21,"chr5",1,0.0984528832630098
"6135","chr5.149835000.149840000","chr5.149900000.149905000",65000,30,1.614776e-08,149835000,149900000,149840000,149905000,"chr5",199667,4,11,10,25,"chr5",1,0.0879043600562588
"6136","chr5.9055000.9060000","chr5.9315000.9320000",260000,13,0.0003232294,9055000,9315000,9060000,9320000,"chr5",199712,0,5,0,5,"chr5",1,0.00761837787154243
"6137","chr5.151080000.151085000","chr5.151125000.151130000",45000,25,0.001089227,151080000,151125000,151085000,151130000,"chr5",199722,0,3,2,5,"chr5",1,0.0146507266760431
"6138","chr5.138285000.138290000","chr5.138530000.138535000",245000,11,0.006920911,138285000,138530000,138290000,138535000,"chr5",199767,3,13,11,27,"chr5",1,0.0348101265822785
"6139","chr5.173045000.173050000","chr5.173290000.173295000",245000,42,1.475945e-32,173045000,173290000,173050000,173295000,"chr5",199797,5,11,5,21,"chr5",1,0.10337552742616
"6140","chr5.32585000.32590000","chr5.33440000.33445000",855000,11,3.03542e-06,32585000,33440000,32590000,33445000,"chr5",199830,0,0,14,14,"chr5",1,0.0180496952648851
"6141","chr5.138605000.138610000","chr5.138630000.138635000",25000,35,0.002014277,138605000,138630000,138610000,138635000,"chr5",199839,1,5,5,11,"chr5",1,0.0451242381622128
"6142","chr5.16485000.16490000","chr5.16670000.16675000",185000,21,1.581187e-08,16485000,16670000,16490000,16675000,"chr5",199844,0,4,2,6,"chr5",1,0.0147679324894515
"6143","chr5.138955000.138960000","chr5.138990000.138995000",35000,39,3.380182e-08,138955000,138990000,138960000,138995000,"chr5",199845,2,3,3,8,"chr5",1,0.0365682137834037
"6144","chr5.11260000.11265000","chr5.11565000.11570000",305000,12,0.0004968012,11260000,11565000,11265000,11570000,"chr5",199876,2,2,2,6,"chr5",1,0.00843881856540084
"6145","chr5.16455000.16460000","chr5.16690000.16695000",235000,15,3.336175e-05,16455000,16690000,16460000,16695000,"chr5",199892,2,2,1,5,"chr5",1,0.00879043600562588
"6146","chr5.76940000.76945000","chr5.77275000.77280000",335000,12,0.0002889575,76940000,77275000,76945000,77280000,"chr5",199937,1,3,4,8,"chr5",1,0.0112517580872011
"6147","chr5.37665000.37670000","chr5.37765000.37770000",100000,16,0.00394017,37665000,37765000,37670000,37770000,"chr5",199958,0,2,0,2,"chr5",1,0.00375058602906704
"6148","chr5.72155000.72160000","chr5.72280000.72285000",125000,15,0.002826812,72155000,72280000,72160000,72285000,"chr5",199967,1,0,1,2,"chr5",1,0.00351617440225035
"6149","chr5.139785000.139790000","chr5.140045000.140050000",260000,11,0.005013366,139785000,140045000,139790000,140050000,"chr5",199983,7,16,6,29,"chr5",1,0.0373886544772621
"6150","chr5.79460000.79465000","chr5.79505000.79510000",45000,25,0.001089227,79460000,79505000,79465000,79510000,"chr5",200011,2,9,9,20,"chr5",1,0.0586029067041725
"6151","chr5.71620000.71625000","chr5.72245000.72250000",625000,8,0.005995874,71620000,72245000,71625000,72250000,"chr5",200048,0,4,0,4,"chr5",1,0.00375058602906704
"6152","chr5.38670000.38675000","chr5.38710000.38715000",40000,33,1.825492e-06,38670000,38710000,38675000,38715000,"chr5",200103,0,0,1,1,"chr5",1,0.00386779184247539
"6153","chr5.34470000.34475000","chr5.34895000.34900000",425000,16,3.129233e-08,34470000,34895000,34475000,34900000,"chr5",200167,1,3,1,5,"chr5",1,0.00937646507266761
"6154","chr5.137885000.137890000","chr5.138535000.138540000",650000,9,0.000977843,137885000,138535000,137890000,138540000,"chr5",200175,3,3,7,13,"chr5",1,0.0137130801687764
"6155","chr5.10450000.10455000","chr5.10595000.10600000",145000,25,2.454977e-10,10450000,10595000,10455000,10600000,"chr5",200179,3,10,8,21,"chr5",1,0.0615330520393812
"6156","chr5.149995000.150000000","chr5.150020000.150025000",25000,35,0.002014277,149995000,150020000,1.5e+08,150025000,"chr5",200234,3,10,13,26,"chr5",1,0.106657290201594
"6157","chr5.16555000.16560000","chr5.16700000.16705000",145000,18,2.268894e-05,16555000,16700000,16560000,16705000,"chr5",200282,2,7,1,10,"chr5",1,0.0210970464135021
"6158","chr5.172420000.172425000","chr5.172870000.172875000",450000,9,0.005930217,172420000,172870000,172425000,172875000,"chr5",200352,0,6,2,8,"chr5",1,0.00843881856540084
"6159","chr5.14705000.14710000","chr5.14940000.14945000",235000,14,0.0001521422,14705000,14940000,14710000,14945000,"chr5",200389,0,10,5,15,"chr5",1,0.0246132208157525
"6160","chr5.172425000.172430000","chr5.172575000.172580000",150000,15,0.0009720877,172425000,172575000,172430000,172580000,"chr5",200533,0,2,4,6,"chr5",1,0.0105485232067511
"6161","chr5.11165000.11170000","chr5.11615000.11620000",450000,11,0.0002735098,11165000,11615000,11170000,11620000,"chr5",200631,0,2,1,3,"chr5",1,0.00386779184247539
"6162","chr5.16575000.16580000","chr5.16700000.16705000",125000,16,0.0008836393,16575000,16700000,16580000,16705000,"chr5",200641,1,7,1,9,"chr5",1,0.0168776371308017
"6163","chr5.71620000.71625000","chr5.72145000.72150000",525000,10,0.0005917436,71620000,72145000,71625000,72150000,"chr5",200704,0,3,5,8,"chr5",1,0.00937646507266761
"6164","chr5.148525000.148530000","chr5.148615000.148620000",90000,17,0.003066853,148525000,148615000,148530000,148620000,"chr5",200759,0,2,0,2,"chr5",1,0.00398499765588373
"6165","chr5.16545000.16550000","chr5.16665000.16670000",120000,17,0.0003496829,16545000,16665000,16550000,16670000,"chr5",200824,0,3,0,3,"chr5",1,0.0059774964838256
"6166","chr5.9055000.9060000","chr5.9205000.9210000",150000,16,0.0002772004,9055000,9205000,9060000,9210000,"chr5",200827,0,2,2,4,"chr5",1,0.00750117205813408
"6167","chr5.14685000.14690000","chr5.15000000.15005000",315000,36,3.4403e-28,14685000,1.5e+07,14690000,15005000,"chr5",200830,1,4,3,8,"chr5",1,0.0337552742616034
"6168","chr5.142780000.142785000","chr5.143205000.143210000",425000,11,0.0003722366,142780000,143205000,142785000,143210000,"chr5",200842,0,3,0,3,"chr5",1,0.00386779184247539
"6169","chr5.132060000.132065000","chr5.132215000.132220000",155000,14,0.002667135,132060000,132215000,132065000,132220000,"chr5",200847,0,1,0,1,"chr5",1,0.00164088138771683
"6170","chr5.79395000.79400000","chr5.79620000.79625000",225000,14,0.000213167,79395000,79620000,79400000,79625000,"chr5",200861,0,6,2,8,"chr5",1,0.0131270511017346
"6171","chr5.41900000.41905000","chr5.41925000.41930000",25000,43,2.954123e-06,41900000,41925000,41905000,41930000,"chr5",200878,0,0,6,6,"chr5",1,0.030239099859353
"6172","chr5.139025000.139030000","chr5.139085000.139090000",60000,31,1.829962e-08,139025000,139085000,139030000,139090000,"chr5",200954,7,13,10,30,"chr5",1,0.109001406469761
"6173","chr5.137250000.137255000","chr5.137345000.137350000",95000,17,0.002014277,137250000,137345000,137255000,137350000,"chr5",200963,0,2,0,2,"chr5",1,0.00398499765588373
"6174","chr5.142020000.142025000","chr5.142070000.142075000",50000,39,8.452939e-12,142020000,142070000,142025000,142075000,"chr5",200968,6,13,15,34,"chr5",1,0.155414908579466
"6175","chr5.38990000.38995000","chr5.39145000.39150000",155000,16,0.0002166689,38990000,39145000,38995000,39150000,"chr5",201002,0,1,5,6,"chr5",1,0.0112517580872011
"6176","chr5.31595000.31600000","chr5.31820000.31825000",225000,20,8.610556e-09,31595000,31820000,31600000,31825000,"chr5",201083,2,7,9,18,"chr5",1,0.0421940928270042
"6177","chr5.71835000.71840000","chr5.72135000.72140000",300000,16,6.738042e-07,71835000,72135000,71840000,72140000,"chr5",201091,0,1,1,2,"chr5",1,0.00375058602906704
"6178","chr5.79460000.79465000","chr5.79495000.79500000",35000,27,0.004157539,79460000,79495000,79465000,79500000,"chr5",201102,1,9,7,17,"chr5",1,0.0537974683544304
"6179","chr5.137935000.137940000","chr5.138500000.138505000",565000,10,0.0003819035,137935000,138500000,137940000,138505000,"chr5",201118,0,2,1,3,"chr5",1,0.00351617440225035
"6180","chr5.32170000.32175000","chr5.32310000.32315000",140000,16,0.0004323448,32170000,32310000,32175000,32315000,"chr5",201119,4,16,16,36,"chr5",1,0.0675105485232067
"6181","chr5.139775000.139780000","chr5.140010000.140015000",235000,11,0.008554958,139775000,140010000,139780000,140015000,"chr5",201146,0,3,1,4,"chr5",1,0.00515705578996718
"6182","chr5.138500000.138505000","chr5.138530000.138535000",30000,34,0.0001694064,138500000,138530000,138505000,138535000,"chr5",201180,3,13,14,30,"chr5",1,0.119549929676512
"6183","chr5.16485000.16490000","chr5.16700000.16705000",215000,14,0.0003037047,16485000,16700000,16490000,16705000,"chr5",201213,2,7,1,10,"chr5",1,0.0164088138771683
"6184","chr5.34515000.34520000","chr5.34895000.34900000",380000,16,8.59688e-08,34515000,34895000,34520000,34900000,"chr5",201269,2,7,8,17,"chr5",1,0.0318799812470699
"6185","chr5.14010000.14015000","chr5.14105000.14110000",95000,16,0.005568258,14010000,14105000,14015000,14110000,"chr5",201281,0,4,2,6,"chr5",1,0.0112517580872011
"6186","chr5.139415000.139420000","chr5.139540000.139545000",125000,15,0.002826812,139415000,139540000,139420000,139545000,"chr5",201295,3,7,5,15,"chr5",1,0.0263713080168776
"6187","chr5.133745000.133750000","chr5.133845000.133850000",100000,27,1.079267e-09,133745000,133845000,133750000,133850000,"chr5",201357,0,3,1,4,"chr5",1,0.0126582278481013
"6188","chr5.171905000.171910000","chr5.172345000.172350000",440000,13,9.120876e-06,171905000,172345000,171910000,172350000,"chr5",201467,1,4,1,6,"chr5",1,0.00914205344585091
"6189","chr5.41865000.41870000","chr5.41900000.41905000",35000,42,8.805049e-10,41865000,41900000,41870000,41905000,"chr5",201478,0,0,4,4,"chr5",1,0.019690576652602
"6190","chr5.16555000.16560000","chr5.16665000.16670000",110000,19,5.444908e-05,16555000,16665000,16560000,16670000,"chr5",201513,0,3,0,3,"chr5",1,0.00668073136427567
"6191","chr5.14725000.14730000","chr5.14865000.14870000",140000,20,1.576952e-06,14725000,14865000,14730000,14870000,"chr5",201539,2,12,5,19,"chr5",1,0.0445382090951711
"6192","chr5.16455000.16460000","chr5.16785000.16790000",330000,11,0.001416127,16455000,16785000,16460000,16790000,"chr5",201562,3,2,1,6,"chr5",1,0.00773558368495077
"6193","chr5.139965000.139970000","chr5.140010000.140015000",45000,23,0.005883287,139965000,140010000,139970000,140015000,"chr5",201564,0,2,0,2,"chr5",1,0.00539146741678387
"6194","chr5.11380000.11385000","chr5.12015000.12020000",635000,8,0.005576179,11380000,12015000,11385000,12020000,"chr5",201608,0,0,3,3,"chr5",1,0.00281293952180028
"6195","chr5.80275000.80280000","chr5.80365000.80370000",90000,18,0.001051505,80275000,80365000,80280000,80370000,"chr5",201629,3,8,13,24,"chr5",1,0.0506329113924051
"6196","chr5.135245000.135250000","chr5.135550000.135555000",305000,10,0.008090368,135245000,135550000,135250000,135555000,"chr5",201640,2,3,9,14,"chr5",1,0.0164088138771683
"6197","chr5.14685000.14690000","chr5.15010000.15015000",325000,17,4.739136e-08,14685000,15010000,14690000,15015000,"chr5",201676,2,12,7,21,"chr5",1,0.0418424753867792
"6198","chr5.79460000.79465000","chr5.79560000.79565000",100000,21,9.650769e-06,79460000,79560000,79465000,79565000,"chr5",201684,2,8,0,10,"chr5",1,0.0246132208157525
"6199","chr5.14205000.14210000","chr5.14230000.14235000",25000,34,0.003956721,14205000,14230000,14210000,14235000,"chr5",201711,6,10,12,28,"chr5",1,0.111579934364744
"6200","chr5.156820000.156825000","chr5.157130000.157135000",310000,14,1.785992e-05,156820000,157130000,156825000,157135000,"chr5",201739,3,8,10,21,"chr5",1,0.0344585091420534
"6201","chr5.35615000.35620000","chr5.35775000.35780000",160000,15,0.0006514032,35615000,35775000,35620000,35780000,"chr5",201756,5,6,4,15,"chr5",1,0.0263713080168776
"6202","chr5.11265000.11270000","chr5.11490000.11495000",225000,31,4.193496e-19,11265000,11490000,11270000,11495000,"chr5",201781,0,9,4,13,"chr5",1,0.0472339428035631
"6203","chr5.126010000.126015000","chr5.126095000.126100000",85000,31,2.257157e-11,126010000,126095000,126015000,126100000,"chr5",201815,1,2,2,5,"chr5",1,0.0181669010782935
"6204","chr5.59105000.59110000","chr5.59670000.59675000",565000,9,0.00203181,59105000,59670000,59110000,59675000,"chr5",201898,2,5,4,11,"chr5",1,0.0116033755274262
"6205","chr5.14705000.14710000","chr5.14810000.14815000",105000,24,6.723476e-08,14705000,14810000,14710000,14815000,"chr5",201904,4,6,4,14,"chr5",1,0.0393811533052039
"6206","chr5.31925000.31930000","chr5.32090000.32095000",165000,24,2.859318e-10,31925000,32090000,31930000,32095000,"chr5",201977,1,13,9,23,"chr5",1,0.0646976090014065
"6207","chr5.137880000.137885000","chr5.138440000.138445000",560000,9,0.002137716,137880000,138440000,137885000,138445000,"chr5",202000,6,18,12,36,"chr5",1,0.0379746835443038
"6208","chr5.111240000.111245000","chr5.111280000.111285000",40000,30,4.367471e-05,111240000,111280000,111245000,111285000,"chr5",202001,0,0,3,3,"chr5",1,0.0105485232067511
"6209","chr5.37040000.37045000","chr5.37070000.37075000",30000,34,0.0001694064,37040000,37070000,37045000,37075000,"chr5",202006,2,4,7,13,"chr5",1,0.0518049695264885
"6210","chr5.38470000.38475000","chr5.38650000.38655000",180000,13,0.003644277,38470000,38650000,38475000,38655000,"chr5",202017,1,4,3,8,"chr5",1,0.0121894045944679
"6211","chr5.167760000.167765000","chr5.167860000.167865000",100000,16,0.00394017,167760000,167860000,167765000,167865000,"chr5",202019,0,2,1,3,"chr5",1,0.00562587904360056
"6212","chr5.16785000.16790000","chr5.17185000.17190000",400000,30,5.833882e-23,16785000,17185000,16790000,17190000,"chr5",202086,2,4,3,9,"chr5",1,0.0316455696202532
"6213","chr5.32490000.32495000","chr5.32585000.32590000",95000,22,4.388156e-06,32490000,32585000,32495000,32590000,"chr5",202089,2,14,18,34,"chr5",1,0.0876699484294421
"6214","chr5.151030000.151035000","chr5.151125000.151130000",95000,29,8.751973e-11,151030000,151125000,151035000,151130000,"chr5",202117,0,3,2,5,"chr5",1,0.01699484294421
"6215","chr5.172710000.172715000","chr5.173015000.173020000",305000,10,0.008090368,172710000,173015000,172715000,173020000,"chr5",202130,1,8,2,11,"chr5",1,0.012892639474918
"6216","chr5.138075000.138080000","chr5.138630000.138635000",555000,11,7.168454e-05,138075000,138630000,138080000,138635000,"chr5",202169,1,12,11,24,"chr5",1,0.0309423347398031
"6217","chr5.13985000.13990000","chr5.14325000.14330000",340000,13,5.168519e-05,13985000,14325000,13990000,14330000,"chr5",202233,0,2,1,3,"chr5",1,0.00457102672292546
"6218","chr5.150495000.150500000","chr5.151030000.151035000",535000,9,0.002683895,150495000,151030000,150500000,151035000,"chr5",202238,0,3,2,5,"chr5",1,0.00527426160337553
"6219","chr5.16485000.16490000","chr5.16790000.16795000",305000,13,0.0001064071,16485000,16790000,16490000,16795000,"chr5",202309,0,4,1,5,"chr5",1,0.00761837787154243
"6220","chr5.172410000.172415000","chr5.172435000.172440000",25000,39,9.786592e-05,172410000,172435000,172415000,172440000,"chr5",202360,0,5,1,6,"chr5",1,0.0274261603375527
"6221","chr5.80080000.80085000","chr5.80500000.80505000",420000,9,0.008068309,80080000,80500000,80085000,80505000,"chr5",202449,1,4,5,10,"chr5",1,0.0105485232067511
"6222","chr5.137880000.137885000","chr5.138640000.138645000",760000,8,0.002451496,137880000,138640000,137885000,138645000,"chr5",202511,2,6,2,10,"chr5",1,0.00937646507266761
"6223","chr5.138695000.138700000","chr5.138900000.138905000",205000,13,0.001619815,138695000,138900000,138700000,138905000,"chr5",202538,6,9,16,31,"chr5",1,0.0472339428035631
"6224","chr5.71860000.71865000","chr5.72155000.72160000",295000,12,0.0006148647,71860000,72155000,71865000,72160000,"chr5",202572,2,1,2,5,"chr5",1,0.0070323488045007
"6225","chr5.150640000.150645000","chr5.151125000.151130000",485000,9,0.004262891,150640000,151125000,150645000,151130000,"chr5",202703,1,4,0,5,"chr5",1,0.00527426160337553
"6226","chr5.31820000.31825000","chr5.31890000.31895000",70000,19,0.00333549,31820000,31890000,31825000,31895000,"chr5",202714,2,14,7,23,"chr5",1,0.0512189404594468
"6227","chr5.137250000.137255000","chr5.137340000.137345000",90000,20,0.0001064071,137250000,137340000,137255000,137345000,"chr5",202750,0,2,2,4,"chr5",1,0.00937646507266761
"6228","chr5.34515000.34520000","chr5.34775000.34780000",260000,12,0.001331506,34515000,34775000,34520000,34780000,"chr5",202771,6,16,8,30,"chr5",1,0.0421940928270042
"6229","chr5.138175000.138180000","chr5.138575000.138580000",400000,13,1.77653e-05,138175000,138575000,138180000,138580000,"chr5",202786,12,23,34,69,"chr5",1,0.105133614627286
"6230","chr5.43040000.43045000","chr5.43385000.43390000",345000,10,0.004687522,43040000,43385000,43045000,43390000,"chr5",202791,2,3,9,14,"chr5",1,0.0164088138771683
"6231","chr5.16455000.16460000","chr5.16775000.16780000",320000,10,0.006469649,16455000,16775000,16460000,16780000,"chr5",202799,3,2,1,6,"chr5",1,0.0070323488045007
"6232","chr5.34485000.34490000","chr5.34865000.34870000",380000,15,6.222163e-07,34485000,34865000,34490000,34870000,"chr5",202819,0,2,1,3,"chr5",1,0.00527426160337553
"6233","chr5.72145000.72150000","chr5.72205000.72210000",60000,20,0.00547239,72145000,72205000,72150000,72210000,"chr5",202836,0,3,3,6,"chr5",1,0.0140646976090014
"6234","chr5.138440000.138445000","chr5.138460000.138465000",20000,39,0.0007493829,138440000,138460000,138445000,138465000,"chr5",202839,1,5,7,13,"chr5",1,0.0594233473980309
"6235","chr5.16775000.16780000","chr5.17185000.17190000",410000,15,3.344748e-07,16775000,17185000,16780000,17190000,"chr5",202865,2,4,3,9,"chr5",1,0.0158227848101266
"6236","chr5.10460000.10465000","chr5.10600000.10605000",140000,21,3.341261e-07,10460000,10600000,10465000,10605000,"chr5",202907,0,3,1,4,"chr5",1,0.00984528832630099
"6237","chr5.44535000.44540000","chr5.44775000.44780000",240000,24,1.041418e-12,44535000,44775000,44540000,44780000,"chr5",202911,0,0,4,4,"chr5",1,0.0112517580872011
"6238","chr5.10280000.10285000","chr5.10430000.10435000",150000,15,0.0009720877,10280000,10430000,10285000,10435000,"chr5",202931,1,6,1,8,"chr5",1,0.0140646976090014
"6239","chr5.124755000.124760000","chr5.124815000.124820000",60000,31,1.829962e-08,124755000,124815000,124760000,124820000,"chr5",202958,2,2,2,6,"chr5",1,0.0218002812939522
"6240","chr5.127230000.127235000","chr5.127515000.127520000",285000,12,0.0007528658,127230000,127515000,127235000,127520000,"chr5",202975,0,2,3,5,"chr5",1,0.0070323488045007
"6241","chr5.31595000.31600000","chr5.31795000.31800000",200000,18,1.170921e-06,31595000,31795000,31600000,31800000,"chr5",203013,1,7,6,14,"chr5",1,0.029535864978903
"6242","chr5.34655000.34660000","chr5.34865000.34870000",210000,14,0.0003578178,34655000,34865000,34660000,34870000,"chr5",203042,2,6,4,12,"chr5",1,0.019690576652602
"6243","chr5.39005000.39010000","chr5.39080000.39085000",75000,37,9.612146e-15,39005000,39080000,39010000,39085000,"chr5",203051,0,2,0,2,"chr5",1,0.00867323019221753
"6244","chr5.16790000.16795000","chr5.17200000.17205000",410000,26,2.000148e-18,16790000,17200000,16795000,17205000,"chr5",203056,0,4,1,5,"chr5",1,0.0152367557430849
"6245","chr5.177040000.177045000","chr5.177600000.177605000",560000,8,0.009734313,177040000,177600000,177045000,177605000,"chr5",203084,0,2,2,4,"chr5",1,0.00375058602906704
"6246","chr5.14870000.14875000","chr5.15000000.15005000",130000,27,2.466454e-11,14870000,1.5e+07,14875000,15005000,"chr5",203106,1,4,3,8,"chr5",1,0.0253164556962025
"6247","chr5.61605000.61610000","chr5.61645000.61650000",40000,30,4.367471e-05,61605000,61645000,61610000,61650000,"chr5",203166,0,0,1,1,"chr5",1,0.00351617440225035
"6248","chr5.137920000.137925000","chr5.138645000.138650000",725000,10,8.245434e-05,137920000,138645000,137925000,138650000,"chr5",203186,3,1,0,4,"chr5",1,0.0046882325363338
"6249","chr5.142025000.142030000","chr5.142070000.142075000",45000,28,6.194802e-05,142025000,142070000,142030000,142075000,"chr5",203216,3,28,21,52,"chr5",1,0.17065166432255
"6250","chr5.141525000.141530000","chr5.141965000.141970000",440000,9,0.006576473,141525000,141965000,141530000,141970000,"chr5",203326,1,8,8,17,"chr5",1,0.0179324894514768
"6251","chr5.32505000.32510000","chr5.32585000.32590000",80000,18,0.00285359,32505000,32585000,32510000,32590000,"chr5",203354,0,6,7,13,"chr5",1,0.0274261603375527
"6252","chr5.31675000.31680000","chr5.31750000.31755000",75000,20,0.0006514032,31675000,31750000,31680000,31755000,"chr5",203374,4,6,8,18,"chr5",1,0.0421940928270042
"6253","chr5.34500000.34505000","chr5.34655000.34660000",155000,17,5.573084e-05,34500000,34655000,34505000,34660000,"chr5",203401,1,5,4,10,"chr5",1,0.0199249882794187
"6254","chr5.172420000.172425000","chr5.172475000.172480000",55000,22,0.002170212,172420000,172475000,172425000,172480000,"chr5",203420,0,6,2,8,"chr5",1,0.0206282231598687
"6255","chr5.173045000.173050000","chr5.173280000.173285000",235000,17,1.205507e-06,173045000,173280000,173050000,173285000,"chr5",203438,3,9,9,21,"chr5",1,0.0418424753867792
"6256","chr5.142735000.142740000","chr5.142780000.142785000",45000,28,6.194802e-05,142735000,142780000,142740000,142785000,"chr5",203452,0,1,0,1,"chr5",1,0.00328176277543366
"6257","chr5.16535000.16540000","chr5.16625000.16630000",90000,20,0.0001064071,16535000,16625000,16540000,16630000,"chr5",203460,0,5,3,8,"chr5",1,0.0187529301453352
"6258","chr5.16565000.16570000","chr5.16585000.16590000",20000,41,0.0001697672,16565000,16585000,16570000,16590000,"chr5",203498,0,1,2,3,"chr5",1,0.0144163150492264
"6259","chr5.176570000.176575000","chr5.176605000.176610000",35000,32,5.890647e-05,176570000,176605000,176575000,176610000,"chr5",203506,1,11,3,15,"chr5",1,0.0562587904360056
"6260","chr5.145830000.145835000","chr5.146760000.146765000",930000,8,0.0007877273,145830000,146760000,145835000,146765000,"chr5",203508,1,3,0,4,"chr5",1,0.00375058602906704
"6261","chr5.31640000.31645000","chr5.32095000.32100000",455000,10,0.001274391,31640000,32095000,31645000,32100000,"chr5",203511,4,2,5,11,"chr5",1,0.012892639474918
"6262","chr5.95005000.95010000","chr5.95065000.95070000",60000,33,1.062716e-09,95005000,95065000,95010000,95070000,"chr5",203538,0,1,1,2,"chr5",1,0.00773558368495077
"6263","chr5.159615000.159620000","chr5.159770000.159775000",155000,18,1.315893e-05,159615000,159770000,159620000,159775000,"chr5",203649,0,3,1,4,"chr5",1,0.00843881856540084
"6264","chr5.94980000.94985000","chr5.95065000.95070000",85000,39,1.073372e-17,94980000,95065000,94985000,95070000,"chr5",203657,0,1,1,2,"chr5",1,0.00914205344585091
"6265","chr5.38675000.38680000","chr5.38715000.38720000",40000,34,5.893587e-07,38675000,38715000,38680000,38720000,"chr5",203663,0,2,2,4,"chr5",1,0.0159399906235349
"6266","chr5.43005000.43010000","chr5.43040000.43045000",35000,38,1.082313e-07,43005000,43040000,43010000,43045000,"chr5",203669,5,6,10,21,"chr5",1,0.0935302390998594
"6267","chr5.10280000.10285000","chr5.10350000.10355000",70000,23,4.713115e-05,10280000,10350000,10285000,10355000,"chr5",203695,8,5,10,23,"chr5",1,0.0620018752930145
"6268","chr5.138740000.138745000","chr5.138945000.138950000",205000,14,0.0004269174,138740000,138945000,138745000,138950000,"chr5",203741,1,1,2,4,"chr5",1,0.00656352555086732
"6269","chr5.35800000.35805000","chr5.35835000.35840000",35000,29,0.0008610919,35800000,35835000,35805000,35840000,"chr5",203830,0,4,2,6,"chr5",1,0.020393811533052
"6270","chr5.16575000.16580000","chr5.16615000.16620000",40000,25,0.00394017,16575000,16615000,16580000,16620000,"chr5",203857,0,0,5,5,"chr5",1,0.0146507266760431
"6271","chr5.41865000.41870000","chr5.42765000.42770000",900000,7,0.005713412,41865000,42765000,41870000,42770000,"chr5",203880,0,0,4,4,"chr5",1,0.00328176277543366
"6272","chr5.38985000.38990000","chr5.39080000.39085000",95000,24,2.542056e-07,38985000,39080000,38990000,39085000,"chr5",203887,0,8,4,12,"chr5",1,0.0337552742616034
"6273","chr5.141080000.141085000","chr5.141525000.141530000",445000,11,0.0002909332,141080000,141525000,141085000,141530000,"chr5",203911,1,10,8,19,"chr5",1,0.0244960150023441
"6274","chr5.139085000.139090000","chr5.139130000.139135000",45000,29,2.186062e-05,139085000,139130000,139090000,139135000,"chr5",204045,3,7,4,14,"chr5",1,0.0475855602437881
"6275","chr5.77840000.77845000","chr5.77945000.77950000",105000,18,0.0002889183,77840000,77945000,77845000,77950000,"chr5",204092,0,0,1,1,"chr5",1,0.00210970464135021
"6276","chr5.64180000.64185000","chr5.64805000.64810000",625000,9,0.001201387,64180000,64805000,64185000,64810000,"chr5",204132,0,3,4,7,"chr5",1,0.00738396624472574
"6277","chr5.137920000.137925000","chr5.138595000.138600000",675000,16,2.389813e-10,137920000,138595000,137925000,138600000,"chr5",204205,3,8,4,15,"chr5",1,0.0281293952180028
"6278","chr5.138445000.138450000","chr5.138535000.138540000",90000,16,0.008184516,138445000,138535000,138450000,138540000,"chr5",204218,1,6,2,9,"chr5",1,0.0168776371308017
"6279","chr5.31580000.31585000","chr5.32075000.32080000",495000,11,0.0001508161,31580000,32075000,31585000,32080000,"chr5",204247,5,21,10,36,"chr5",1,0.0464135021097046
"6280","chr5.14645000.14650000","chr5.15000000.15005000",355000,10,0.004125752,14645000,1.5e+07,14650000,15005000,"chr5",204272,1,4,3,8,"chr5",1,0.00937646507266761
"6281","chr5.179550000.179555000","chr5.179905000.179910000",355000,12,0.0002050754,179550000,179905000,179555000,179910000,"chr5",204311,1,20,8,29,"chr5",1,0.0407876230661041
"6282","chr5.138740000.138745000","chr5.138900000.138905000",160000,13,0.006937252,138740000,138900000,138745000,138905000,"chr5",204370,6,9,16,31,"chr5",1,0.0472339428035631
"6283","chr5.138210000.138215000","chr5.138440000.138445000",230000,14,0.0001793042,138210000,138440000,138215000,138445000,"chr5",204398,3,13,13,29,"chr5",1,0.0475855602437881
"6284","chr5.31820000.31825000","chr5.32075000.32080000",255000,40,1.185434e-30,31820000,32075000,31825000,32080000,"chr5",204423,2,14,9,25,"chr5",1,0.117205813408345
"6285","chr5.71835000.71840000","chr5.72145000.72150000",310000,12,0.000448807,71835000,72145000,71840000,72150000,"chr5",204437,0,1,1,2,"chr5",1,0.00281293952180028
"6286","chr5.31640000.31645000","chr5.31795000.31800000",155000,18,1.315893e-05,31640000,31795000,31645000,31800000,"chr5",204440,1,2,5,8,"chr5",1,0.0168776371308017
"6287","chr5.79375000.79380000","chr5.79560000.79565000",185000,21,1.581187e-08,79375000,79560000,79380000,79565000,"chr5",204456,2,8,0,10,"chr5",1,0.0246132208157525
"6288","chr5.145915000.145920000","chr5.146760000.146765000",845000,7,0.007834813,145915000,146760000,145920000,146765000,"chr5",204476,1,3,1,5,"chr5",1,0.00410220346929208
"6289","chr5.73215000.73220000","chr5.73950000.73955000",735000,10,7.569066e-05,73215000,73950000,73220000,73955000,"chr5",204598,0,0,3,3,"chr5",1,0.00351617440225035
"6290","chr5.122850000.122855000","chr5.122935000.122940000",85000,19,0.0005917436,122850000,122935000,122855000,122940000,"chr5",204637,1,2,2,5,"chr5",1,0.0111345522737928
"6291","chr5.77680000.77685000","chr5.78295000.78300000",615000,11,3.595069e-05,77680000,78295000,77685000,78300000,"chr5",204660,3,7,4,14,"chr5",1,0.0180496952648851
"6292","chr5.41900000.41905000","chr5.42765000.42770000",865000,7,0.007002446,41900000,42765000,41905000,42770000,"chr5",204701,1,4,8,13,"chr5",1,0.0106657290201594
"6293","chr5.138185000.138190000","chr5.138595000.138600000",410000,9,0.008799507,138185000,138595000,138190000,138600000,"chr5",204734,1,4,5,10,"chr5",1,0.0105485232067511
"6294","chr5.60255000.60260000","chr5.61245000.61250000",990000,10,6.756907e-06,60255000,61245000,60260000,61250000,"chr5",204771,1,2,3,6,"chr5",1,0.0070323488045007
"6295","chr5.137920000.137925000","chr5.138440000.138445000",520000,10,0.0006261203,137920000,138440000,137925000,138445000,"chr5",204777,3,11,4,18,"chr5",1,0.0210970464135021
"6296","chr5.54755000.54760000","chr5.55220000.55225000",465000,9,0.005202139,54755000,55220000,54760000,55225000,"chr5",204787,0,2,2,4,"chr5",1,0.00421940928270042
"6297","chr5.34515000.34520000","chr5.34865000.34870000",350000,10,0.004394792,34515000,34865000,34520000,34870000,"chr5",204803,2,6,4,12,"chr5",1,0.0140646976090014
"6298","chr5.21480000.21485000","chr5.21800000.21805000",320000,19,9.27656e-10,21480000,21800000,21485000,21805000,"chr5",204816,0,5,2,7,"chr5",1,0.0155883731833099
"6299","chr5.32090000.32095000","chr5.32610000.32615000",520000,12,1.743752e-05,32090000,32610000,32095000,32615000,"chr5",204845,1,7,8,16,"chr5",1,0.0225035161744023
"6300","chr5.79375000.79380000","chr5.79710000.79715000",335000,10,0.005327353,79375000,79710000,79380000,79715000,"chr5",204856,2,4,2,8,"chr5",1,0.00937646507266761
"6301","chr5.55405000.55410000","chr5.55440000.55445000",35000,26,0.008554958,55405000,55440000,55410000,55445000,"chr5",204871,0,11,9,20,"chr5",1,0.0609470229723394
"6302","chr5.138945000.138950000","chr5.139140000.139145000",195000,13,0.002223361,138945000,139140000,138950000,139145000,"chr5",204900,1,1,2,4,"chr5",1,0.00609470229723394
"6303","chr5.31925000.31930000","chr5.32080000.32085000",155000,19,2.930222e-06,31925000,32080000,31930000,32085000,"chr5",204979,1,7,9,17,"chr5",1,0.0378574777308955
"6304","chr5.71830000.71835000","chr5.72140000.72145000",310000,10,0.007546877,71830000,72140000,71835000,72145000,"chr5",204982,0,6,7,13,"chr5",1,0.0152367557430849
"6305","chr5.151140000.151145000","chr5.151825000.151830000",685000,8,0.003991226,151140000,151825000,151145000,151830000,"chr5",205030,3,4,6,13,"chr5",1,0.0121894045944679
"6306","chr5.31820000.31825000","chr5.32025000.32030000",205000,13,0.001619815,31820000,32025000,31825000,32030000,"chr5",205044,2,13,3,18,"chr5",1,0.0274261603375527
"6307","chr5.43065000.43070000","chr5.43310000.43315000",245000,11,0.006920911,43065000,43310000,43070000,43315000,"chr5",205055,0,2,1,3,"chr5",1,0.00386779184247539
"6308","chr5.138435000.138440000","chr5.138595000.138600000",160000,15,0.0006514032,138435000,138595000,138440000,138600000,"chr5",205081,2,1,1,4,"chr5",1,0.0070323488045007
"6309","chr5.137900000.137905000","chr5.138575000.138580000",675000,9,0.0008049238,137900000,138575000,137905000,138580000,"chr5",205106,3,6,13,22,"chr5",1,0.0232067510548523
"6310","chr5.34520000.34525000","chr5.34895000.34900000",375000,24,1.242475e-15,34520000,34895000,34525000,34900000,"chr5",205133,2,3,6,11,"chr5",1,0.0309423347398031
"6311","chr5.176540000.176545000","chr5.176620000.176625000",80000,18,0.00285359,176540000,176620000,176545000,176625000,"chr5",205165,0,1,1,2,"chr5",1,0.00421940928270042
"6312","chr5.14725000.14730000","chr5.14810000.14815000",85000,25,2.740968e-07,14725000,14810000,14730000,14815000,"chr5",205169,2,6,4,12,"chr5",1,0.0351617440225035
"6313","chr5.134100000.134105000","chr5.134175000.134180000",75000,19,0.001822093,134100000,134175000,134105000,134180000,"chr5",205204,1,1,1,3,"chr5",1,0.00668073136427567
"6314","chr5.142320000.142325000","chr5.142735000.142740000",415000,10,0.002024146,142320000,142735000,142325000,142740000,"chr5",205253,0,1,0,1,"chr5",1,0.00117205813408345
"6315","chr5.132250000.132255000","chr5.132365000.132370000",115000,16,0.001517047,132250000,132365000,132255000,132370000,"chr5",205274,2,0,2,4,"chr5",1,0.00750117205813408
"6316","chr5.36265000.36270000","chr5.36305000.36310000",40000,38,4.578868e-09,36265000,36305000,36270000,36310000,"chr5",205280,0,11,4,15,"chr5",1,0.0668073136427567
"6317","chr5.67620000.67625000","chr5.67725000.67730000",105000,15,0.007853845,67620000,67725000,67625000,67730000,"chr5",205310,1,2,4,7,"chr5",1,0.0123066104078762
"6318","chr5.9285000.9290000","chr5.9540000.9545000",255000,18,8.471584e-08,9285000,9540000,9290000,9545000,"chr5",205382,0,2,1,3,"chr5",1,0.00632911392405063
"6319","chr5.52870000.52875000","chr5.52945000.52950000",75000,18,0.004787281,52870000,52945000,52875000,52950000,"chr5",205421,4,2,1,7,"chr5",1,0.0147679324894515
"6320","chr5.11380000.11385000","chr5.11600000.11605000",220000,13,0.001008825,11380000,11600000,11385000,11605000,"chr5",205474,0,3,2,5,"chr5",1,0.00761837787154243
"6321","chr5.14265000.14270000","chr5.14660000.14665000",395000,14,3.103259e-06,14265000,14660000,14270000,14665000,"chr5",205488,1,3,1,5,"chr5",1,0.00820440693858415
"6322","chr5.132215000.132220000","chr5.132290000.132295000",75000,26,4.097833e-07,132215000,132290000,132220000,132295000,"chr5",205505,1,0,1,2,"chr5",1,0.00609470229723394
"6323","chr5.59125000.59130000","chr5.59670000.59675000",545000,14,2.117541e-07,59125000,59670000,59130000,59675000,"chr5",205510,2,1,5,8,"chr5",1,0.0131270511017346
"6324","chr5.142815000.142820000","chr5.142980000.142985000",165000,13,0.005863382,142815000,142980000,142820000,142985000,"chr5",205525,0,4,5,9,"chr5",1,0.0137130801687764
"6325","chr5.29365000.29370000","chr5.29695000.29700000",330000,15,1.886243e-06,29365000,29695000,29370000,29700000,"chr5",205550,0,1,0,1,"chr5",1,0.00175808720112518
"6326","chr5.138185000.138190000","chr5.138535000.138540000",350000,11,0.001039796,138185000,138535000,138190000,138540000,"chr5",205552,1,4,5,10,"chr5",1,0.012892639474918
"6327","chr5.34485000.34490000","chr5.34895000.34900000",410000,40,3.965307e-36,34485000,34895000,34490000,34900000,"chr5",205625,0,2,1,3,"chr5",1,0.0140646976090014
"6328","chr5.117160000.117165000","chr5.117775000.117780000",615000,8,0.006459534,117160000,117775000,117165000,117780000,"chr5",205643,1,7,9,17,"chr5",1,0.0159399906235349
"6329","chr5.34595000.34600000","chr5.34865000.34870000",270000,12,0.001045873,34595000,34865000,34600000,34870000,"chr5",205663,0,6,4,10,"chr5",1,0.0140646976090014
"6330","chr5.156835000.156840000","chr5.157130000.157135000",295000,10,0.009425316,156835000,157130000,156840000,157135000,"chr5",205743,1,9,19,29,"chr5",1,0.0339896858884201
"6331","chr5.36075000.36080000","chr5.36150000.36155000",75000,18,0.004787281,36075000,36150000,36080000,36155000,"chr5",205768,1,1,0,2,"chr5",1,0.00421940928270042
"6332","chr5.142025000.142030000","chr5.142075000.142080000",50000,30,1.568348e-06,142025000,142075000,142030000,142080000,"chr5",205783,3,26,18,47,"chr5",1,0.165260196905767
"6333","chr5.136730000.136735000","chr5.136765000.136770000",35000,30,0.0003613994,136730000,136765000,136735000,136770000,"chr5",205809,0,0,6,6,"chr5",1,0.0210970464135021
"6334","chr5.137950000.137955000","chr5.138630000.138635000",680000,10,0.0001238979,137950000,138630000,137955000,138635000,"chr5",205834,1,14,12,27,"chr5",1,0.0316455696202532
"6335","chr5.77215000.77220000","chr5.77275000.77280000",60000,20,0.00547239,77215000,77275000,77220000,77280000,"chr5",205857,1,1,3,5,"chr5",1,0.0117205813408345
"6336","chr5.14790000.14795000","chr5.14810000.14815000",20000,38,0.00150338,14790000,14810000,14795000,14815000,"chr5",205879,2,6,4,12,"chr5",1,0.0534458509142053
"6337","chr5.31530000.31535000","chr5.31635000.31640000",105000,15,0.007853845,31530000,31635000,31535000,31640000,"chr5",205982,0,5,6,11,"chr5",1,0.0193389592123769
"6338","chr5.138410000.138415000","chr5.138435000.138440000",25000,36,0.0009835376,138410000,138435000,138415000,138440000,"chr5",206059,2,1,1,4,"chr5",1,0.0168776371308017
"6339","chr5.138975000.138980000","chr5.139565000.139570000",590000,8,0.00778408,138975000,139565000,138980000,139570000,"chr5",206090,4,19,21,44,"chr5",1,0.0412564463197375
"6340","chr5.137920000.137925000","chr5.138575000.138580000",655000,22,4.072539e-17,137920000,138575000,137925000,138580000,"chr5",206107,3,11,4,18,"chr5",1,0.0464135021097046
"6341","chr5.176615000.176620000","chr5.176655000.176660000",40000,41,8.670125e-11,176615000,176655000,176620000,176660000,"chr5",206115,2,3,4,9,"chr5",1,0.0432489451476793
"6342","chr5.11560000.11565000","chr5.11600000.11605000",40000,24,0.008398761,11560000,11600000,11565000,11605000,"chr5",206167,0,3,1,4,"chr5",1,0.0112517580872011
"6343","chr5.139755000.139760000","chr5.140010000.140015000",255000,16,3.056102e-06,139755000,140010000,139760000,140015000,"chr5",206177,0,3,1,4,"chr5",1,0.00750117205813408
"6344","chr5.176620000.176625000","chr5.176660000.176665000",40000,32,5.474543e-06,176620000,176660000,176625000,176665000,"chr5",206196,0,3,3,6,"chr5",1,0.0225035161744023
"6345","chr5.175030000.175035000","chr5.175060000.175065000",30000,34,0.0001694064,175030000,175060000,175035000,175065000,"chr5",206224,0,4,4,8,"chr5",1,0.0318799812470699
"6346","chr5.38670000.38675000","chr5.38805000.38810000",135000,14,0.005563889,38670000,38805000,38675000,38810000,"chr5",206231,0,2,1,3,"chr5",1,0.00492264416315049
"6347","chr5.133320000.133325000","chr5.133495000.133500000",175000,15,0.0003496829,133320000,133495000,133325000,133500000,"chr5",206240,0,2,1,3,"chr5",1,0.00527426160337553
"6348","chr5.14815000.14820000","chr5.15000000.15005000",185000,22,2.559294e-09,14815000,1.5e+07,14820000,15005000,"chr5",206247,1,4,3,8,"chr5",1,0.0206282231598687
"6349","chr5.133695000.133700000","chr5.133960000.133965000",265000,11,0.004551179,133695000,133960000,133700000,133965000,"chr5",206285,0,0,3,3,"chr5",1,0.00386779184247539
"6350","chr5.139090000.139095000","chr5.139120000.139125000",30000,29,0.00778408,139090000,139120000,139095000,139125000,"chr5",206359,2,2,3,7,"chr5",1,0.023792780121894
"6351","chr5.13985000.13990000","chr5.14265000.14270000",280000,26,8.562152e-16,13985000,14265000,13990000,14270000,"chr5",206364,0,3,1,4,"chr5",1,0.0121894045944679
"6352","chr5.35775000.35780000","chr5.35800000.35805000",25000,42,7.395596e-06,35775000,35800000,35780000,35805000,"chr5",206367,0,4,4,8,"chr5",1,0.0393811533052039
"6353","chr5.31845000.31850000","chr5.32025000.32030000",180000,13,0.003644277,31845000,32025000,31850000,32030000,"chr5",206376,1,8,3,12,"chr5",1,0.0182841068917018
"6354","chr5.138210000.138215000","chr5.138595000.138600000",385000,12,0.0001281495,138210000,138595000,138215000,138600000,"chr5",206385,3,8,5,16,"chr5",1,0.0225035161744023
"6355","chr5.138500000.138505000","chr5.138535000.138540000",35000,35,2.940172e-06,138500000,138535000,138505000,138540000,"chr5",206400,5,13,22,40,"chr5",1,0.164088138771683
"6356","chr5.133695000.133700000","chr5.133845000.133850000",150000,15,0.0009720877,133695000,133845000,133700000,133850000,"chr5",206456,0,0,1,1,"chr5",1,0.00175808720112518
"6357","chr5.14760000.14765000","chr5.14940000.14945000",180000,15,0.0002852068,14760000,14940000,14765000,14945000,"chr5",206461,0,6,1,7,"chr5",1,0.0123066104078762
"6358","chr5.16780000.16785000","chr5.17130000.17135000",350000,17,2.337101e-08,16780000,17130000,16785000,17135000,"chr5",206486,4,14,13,31,"chr5",1,0.0617674636661978
"6359","chr5.11260000.11265000","chr5.11715000.11720000",455000,9,0.005646435,11260000,11715000,11265000,11720000,"chr5",206534,2,2,2,6,"chr5",1,0.00632911392405063
"6360","chr5.32215000.32220000","chr5.32310000.32315000",95000,17,0.002014277,32215000,32310000,32220000,32315000,"chr5",206576,4,26,16,46,"chr5",1,0.0916549460853258
"6361","chr5.77840000.77845000","chr5.78265000.78270000",425000,15,2.467342e-07,77840000,78265000,77845000,78270000,"chr5",206580,2,0,5,7,"chr5",1,0.0123066104078762
"6362","chr5.17115000.17120000","chr5.17185000.17190000",70000,19,0.00333549,17115000,17185000,17120000,17190000,"chr5",206600,1,4,3,8,"chr5",1,0.0178152836380684
"6363","chr5.33435000.33440000","chr5.33965000.33970000",530000,9,0.002826812,33435000,33965000,33440000,33970000,"chr5",206618,3,3,13,19,"chr5",1,0.020042194092827
"6364","chr5.136990000.136995000","chr5.137075000.137080000",85000,20,0.0001877974,136990000,137075000,136995000,137080000,"chr5",206673,0,0,4,4,"chr5",1,0.00937646507266761
"6365","chr5.16785000.16790000","chr5.17200000.17205000",415000,15,3.016993e-07,16785000,17200000,16790000,17205000,"chr5",206694,0,10,6,16,"chr5",1,0.0281293952180028
"6366","chr5.172415000.172420000","chr5.172475000.172480000",60000,26,1.137214e-05,172415000,172475000,172420000,172480000,"chr5",206696,2,5,4,11,"chr5",1,0.0335208626347867
"6367","chr5.139540000.139545000","chr5.139730000.139735000",190000,13,0.002624523,139540000,139730000,139545000,139735000,"chr5",206697,12,28,23,63,"chr5",1,0.0959915611814346
"6368","chr5.176655000.176660000","chr5.176700000.176705000",45000,23,0.005883287,176655000,176700000,176660000,176705000,"chr5",206715,0,2,1,3,"chr5",1,0.00808720112517581
"6369","chr5.138530000.138535000","chr5.138630000.138635000",100000,18,0.0004306289,138530000,138630000,138535000,138635000,"chr5",206771,1,14,12,27,"chr5",1,0.0569620253164557
"6370","chr5.137845000.137850000","chr5.138650000.138655000",805000,7,0.009709423,137845000,138650000,137850000,138655000,"chr5",206788,4,10,10,24,"chr5",1,0.019690576652602
"6371","chr5.147015000.147020000","chr5.147185000.147190000",170000,13,0.005005365,147015000,147185000,147020000,147190000,"chr5",206840,1,1,3,5,"chr5",1,0.00761837787154243
"6372","chr5.142650000.142655000","chr5.143085000.143090000",435000,9,0.006937252,142650000,143085000,142655000,143090000,"chr5",206888,0,2,1,3,"chr5",1,0.00316455696202532
"6373","chr5.148415000.148420000","chr5.148440000.148445000",25000,34,0.003956721,148415000,148440000,148420000,148445000,"chr5",206930,3,8,7,18,"chr5",1,0.0717299578059072
"6374","chr5.14705000.14710000","chr5.15000000.15005000",295000,57,2.207045e-55,14705000,1.5e+07,14710000,15005000,"chr5",206940,1,4,3,8,"chr5",1,0.0534458509142053
"6375","chr5.79435000.79440000","chr5.79460000.79465000",25000,36,0.0009835376,79435000,79460000,79440000,79465000,"chr5",206975,1,1,6,8,"chr5",1,0.0337552742616034
"6376","chr5.79395000.79400000","chr5.79595000.79600000",200000,16,2.874004e-05,79395000,79595000,79400000,79600000,"chr5",207010,1,9,5,15,"chr5",1,0.0281293952180028
"6377","chr5.151030000.151035000","chr5.151115000.151120000",85000,37,4.895936e-16,151030000,151115000,151035000,151120000,"chr5",207018,0,3,2,5,"chr5",1,0.0216830754805438
"6378","chr5.31825000.31830000","chr5.32095000.32100000",270000,11,0.004095601,31825000,32095000,31830000,32100000,"chr5",207061,4,7,9,20,"chr5",1,0.0257852789498359
"6379","chr5.41870000.41875000","chr5.41925000.41930000",55000,23,0.0008610919,41870000,41925000,41875000,41930000,"chr5",207140,0,0,6,6,"chr5",1,0.0161744022503516
"6380","chr5.173045000.173050000","chr5.173750000.173755000",705000,12,1.661307e-06,173045000,173750000,173050000,173755000,"chr5",207145,2,2,1,5,"chr5",1,0.0070323488045007
"6381","chr5.142325000.142330000","chr5.143240000.143245000",915000,9,0.0001229612,142325000,143240000,142330000,143245000,"chr5",207148,0,1,0,1,"chr5",1,0.00105485232067511
"6382","chr5.134180000.134185000","chr5.134240000.134245000",60000,36,1.135013e-11,134180000,134240000,134185000,134245000,"chr5",207235,6,14,11,31,"chr5",1,0.130801687763713
"6383","chr5.14725000.14730000","chr5.14940000.14945000",215000,12,0.004233718,14725000,14940000,14730000,14945000,"chr5",207336,0,10,5,15,"chr5",1,0.0210970464135021
"6384","chr5.16740000.16745000","chr5.16775000.16780000",35000,27,0.004157539,16740000,16775000,16745000,16780000,"chr5",207344,2,8,6,16,"chr5",1,0.0506329113924051
"6385","chr5.76425000.76430000","chr5.76790000.76795000",365000,13,3.297324e-05,76425000,76790000,76430000,76795000,"chr5",207372,1,6,11,18,"chr5",1,0.0274261603375527
"6386","chr5.173045000.173050000","chr5.173420000.173425000",375000,19,1.715219e-10,173045000,173420000,173050000,173425000,"chr5",207374,2,3,3,8,"chr5",1,0.0178152836380684
"6387","chr5.16790000.16795000","chr5.17185000.17190000",395000,65,2.114561e-72,16790000,17185000,16795000,17190000,"chr5",207377,0,4,1,5,"chr5",1,0.0380918893577121
"6388","chr5.14115000.14120000","chr5.14250000.14255000",135000,14,0.005563889,14115000,14250000,14120000,14255000,"chr5",207384,0,3,2,5,"chr5",1,0.00820440693858415
"6389","chr5.8850000.8855000","chr5.9540000.9545000",690000,8,0.003911559,8850000,9540000,8855000,9545000,"chr5",207394,0,2,0,2,"chr5",1,0.00187529301453352
"6390","chr5.36660000.36665000","chr5.36680000.36685000",20000,35,0.009978941,36660000,36680000,36665000,36685000,"chr5",207473,1,5,1,7,"chr5",1,0.0287154242850445
"6391","chr5.16690000.16695000","chr5.16710000.16715000",20000,39,0.0007493829,16690000,16710000,16695000,16715000,"chr5",207515,1,5,10,16,"chr5",1,0.0731364275668073
"6392","chr5.39945000.39950000","chr5.40875000.40880000",930000,7,0.004814262,39945000,40875000,39950000,40880000,"chr5",207521,0,5,3,8,"chr5",1,0.00656352555086732
"6393","chr5.131145000.131150000","chr5.131395000.131400000",250000,11,0.00615903,131145000,131395000,131150000,131400000,"chr5",207543,1,20,9,30,"chr5",1,0.0386779184247539
"6394","chr5.138410000.138415000","chr5.138535000.138540000",125000,19,1.791016e-05,138410000,138535000,138415000,138540000,"chr5",207553,5,24,22,51,"chr5",1,0.113572433192686
"6395","chr5.14760000.14765000","chr5.15000000.15005000",240000,20,3.863961e-09,14760000,1.5e+07,14765000,15005000,"chr5",207559,1,4,1,6,"chr5",1,0.0140646976090014
"6396","chr5.72155000.72160000","chr5.72240000.72245000",85000,17,0.004736201,72155000,72240000,72160000,72245000,"chr5",207594,4,8,10,22,"chr5",1,0.0438349742147211
"6397","chr5.134800000.134805000","chr5.134900000.134905000",100000,26,5.568372e-09,134800000,134900000,134805000,134905000,"chr5",207600,9,21,19,49,"chr5",1,0.149320206282232
"6398","chr5.127090000.127095000","chr5.127405000.127410000",315000,12,0.0004111881,127090000,127405000,127095000,127410000,"chr5",207610,0,2,0,2,"chr5",1,0.00281293952180028
"6399","chr5.172185000.172190000","chr5.172275000.172280000",90000,16,0.008184516,172185000,172275000,172190000,172280000,"chr5",207665,1,7,3,11,"chr5",1,0.0206282231598687
"6400","chr5.71830000.71835000","chr5.72135000.72140000",305000,11,0.002132895,71830000,72135000,71835000,72140000,"chr5",207708,0,6,6,12,"chr5",1,0.0154711673699015
"6401","chr5.10285000.10290000","chr5.10340000.10345000",55000,21,0.005222236,10285000,10340000,10290000,10345000,"chr5",207723,5,15,12,32,"chr5",1,0.0787623066104079
"6402","chr5.82350000.82355000","chr5.82860000.82865000",510000,13,2.93573e-06,82350000,82860000,82355000,82865000,"chr5",207739,0,0,2,2,"chr5",1,0.00304735114861697
"6403","chr5.16790000.16795000","chr5.17105000.17110000",315000,10,0.006964234,16790000,17105000,16795000,17110000,"chr5",207781,0,4,1,5,"chr5",1,0.00586029067041725
"6404","chr5.34485000.34490000","chr5.34515000.34520000",30000,33,0.0003881725,34485000,34515000,34490000,34520000,"chr5",207801,0,2,1,3,"chr5",1,0.0116033755274262
"6405","chr5.137880000.137885000","chr5.138630000.138635000",750000,14,9.841803e-09,137880000,138630000,137885000,138635000,"chr5",207818,1,14,12,27,"chr5",1,0.0443037974683544
"6406","chr5.141555000.141560000","chr5.141880000.141885000",325000,10,0.006021109,141555000,141880000,141560000,141885000,"chr5",207824,0,2,2,4,"chr5",1,0.0046882325363338
"6407","chr5.34955000.34960000","chr5.35000000.35005000",45000,31,2.421324e-06,34955000,3.5e+07,34960000,35005000,"chr5",207878,0,0,1,1,"chr5",1,0.0036333802156587
"6408","chr5.142800000.142805000","chr5.143180000.143185000",380000,10,0.003066853,142800000,143180000,142805000,143185000,"chr5",207903,0,4,0,4,"chr5",1,0.0046882325363338
"6409","chr5.60675000.60680000","chr5.60700000.60705000",25000,43,2.954123e-06,60675000,60700000,60680000,60705000,"chr5",207914,4,9,2,15,"chr5",1,0.0755977496483826
"6410","chr5.5505000.5510000","chr5.6435000.6440000",930000,8,0.0007877273,5505000,6435000,5510000,6440000,"chr5",207943,2,7,2,11,"chr5",1,0.0103141115799344
"6411","chr5.138610000.138615000","chr5.138650000.138655000",40000,24,0.008398761,138610000,138650000,138615000,138655000,"chr5",207968,4,10,6,20,"chr5",1,0.0562587904360056
"6412","chr5.79395000.79400000","chr5.79435000.79440000",40000,24,0.008398761,79395000,79435000,79400000,79440000,"chr5",207977,1,1,6,8,"chr5",1,0.0225035161744023
"6413","chr5.138175000.138180000","chr5.138605000.138610000",430000,9,0.00732104,138175000,138605000,138180000,138610000,"chr5",208030,3,5,5,13,"chr5",1,0.0137130801687764
"6414","chr5.138385000.138390000","chr5.138595000.138600000",210000,12,0.004852777,138385000,138595000,138390000,138600000,"chr5",208045,0,8,5,13,"chr5",1,0.0182841068917018
"6415","chr5.138050000.138055000","chr5.138575000.138580000",525000,12,1.622832e-05,138050000,138575000,138055000,138580000,"chr5",208071,5,7,16,28,"chr5",1,0.0393811533052039
"6416","chr5.142735000.142740000","chr5.142765000.142770000",30000,34,0.0001694064,142735000,142765000,142740000,142770000,"chr5",208088,1,1,0,2,"chr5",1,0.00796999531176746
"6417","chr5.54645000.54650000","chr5.54895000.54900000",250000,11,0.00615903,54645000,54895000,54650000,54900000,"chr5",208129,2,5,2,9,"chr5",1,0.0116033755274262
"6418","chr5.172415000.172420000","chr5.172435000.172440000",20000,36,0.00547239,172415000,172435000,172420000,172440000,"chr5",208166,2,5,2,9,"chr5",1,0.0379746835443038
"6419","chr5.90395000.90400000","chr5.90600000.90605000",205000,13,0.001619815,90395000,90600000,90400000,90605000,"chr5",208187,0,1,3,4,"chr5",1,0.00609470229723394
"6420","chr5.138900000.138905000","chr5.138985000.138990000",85000,18,0.001735721,138900000,138985000,138905000,138990000,"chr5",208212,5,9,13,27,"chr5",1,0.0569620253164557
"6421","chr5.15600000.15605000","chr5.15785000.15790000",185000,17,1.247461e-05,15600000,15785000,15605000,15790000,"chr5",208236,3,3,6,12,"chr5",1,0.0239099859353024
"6422","chr5.14105000.14110000","chr5.14250000.14255000",145000,21,2.359904e-07,14105000,14250000,14110000,14255000,"chr5",208306,0,4,2,6,"chr5",1,0.0147679324894515
"6423","chr5.81935000.81940000","chr5.82860000.82865000",925000,14,8.91866e-10,81935000,82860000,81940000,82865000,"chr5",208321,0,0,5,5,"chr5",1,0.00820440693858415
"6424","chr5.60335000.60340000","chr5.61225000.61230000",890000,8,0.001039796,60335000,61225000,60340000,61230000,"chr5",208342,0,1,1,2,"chr5",1,0.00187529301453352
"6425","chr5.132360000.132365000","chr5.132385000.132390000",25000,46,1.611252e-07,132360000,132385000,132365000,132390000,"chr5",208343,0,3,0,3,"chr5",1,0.0161744022503516
"6426","chr5.11265000.11270000","chr5.11600000.11605000",335000,21,6.88069e-12,11265000,11600000,11270000,11605000,"chr5",208352,0,3,2,5,"chr5",1,0.0123066104078762
"6427","chr5.138150000.138155000","chr5.138490000.138495000",340000,10,0.004990366,138150000,138490000,138155000,138495000,"chr5",208379,3,8,12,23,"chr5",1,0.0269573370839194
"6428","chr5.34485000.34490000","chr5.34920000.34925000",435000,9,0.006937252,34485000,34920000,34490000,34925000,"chr5",208380,0,2,1,3,"chr5",1,0.00316455696202532
"6429","chr5.180290000.180295000","chr5.180600000.180605000",310000,13,9.525402e-05,180290000,180600000,180295000,180605000,"chr5",208606,2,6,2,10,"chr5",1,0.0152367557430849
"6430","chr5.111550000.111555000","chr5.111755000.111760000",205000,19,1.630682e-07,111550000,111755000,111555000,111760000,"chr5",208655,1,2,4,7,"chr5",1,0.0155883731833099
"6431","chr5.150425000.150430000","chr5.150500000.150505000",75000,23,2.029467e-05,150425000,150500000,150430000,150505000,"chr5",208664,0,2,3,5,"chr5",1,0.0134786685419597
"6432","chr5.14350000.14355000","chr5.14405000.14410000",55000,22,0.002170212,14350000,14405000,14355000,14410000,"chr5",208676,0,0,1,1,"chr5",1,0.00257852789498359
"6433","chr5.16485000.16490000","chr5.16545000.16550000",60000,23,0.0003182132,16485000,16545000,16490000,16550000,"chr5",208724,1,3,2,6,"chr5",1,0.0161744022503516
"6434","chr5.77305000.77310000","chr5.77560000.77565000",255000,13,0.0003618047,77305000,77560000,77310000,77565000,"chr5",208781,1,4,2,7,"chr5",1,0.0106657290201594
"6435","chr5.132065000.132070000","chr5.132220000.132225000",155000,13,0.008184516,132065000,132220000,132070000,132225000,"chr5",208818,0,0,1,1,"chr5",1,0.00152367557430849
"6436","chr5.31820000.31825000","chr5.32090000.32095000",270000,44,2.262197e-36,31820000,32090000,31825000,32095000,"chr5",208837,1,13,9,23,"chr5",1,0.118612283169245
"6437","chr5.66805000.66810000","chr5.67495000.67500000",690000,9,0.0007169142,66805000,67495000,66810000,67500000,"chr5",208862,0,2,3,5,"chr5",1,0.00527426160337553
"6438","chr5.16565000.16570000","chr5.16670000.16675000",105000,17,0.0009239472,16565000,16670000,16570000,16675000,"chr5",208874,0,4,2,6,"chr5",1,0.0119549929676512
"6439","chr5.141525000.141530000","chr5.141710000.141715000",185000,14,0.0008746992,141525000,141710000,141530000,141715000,"chr5",208881,0,2,6,8,"chr5",1,0.0131270511017346
"6440","chr5.42905000.42910000","chr5.43005000.43010000",100000,19,0.0001288911,42905000,43005000,42910000,43010000,"chr5",208930,3,4,13,20,"chr5",1,0.0445382090951711
"6441","chr5.77840000.77845000","chr5.77900000.77905000",60000,21,0.002230493,77840000,77900000,77845000,77905000,"chr5",208939,3,0,2,5,"chr5",1,0.0123066104078762
"6442","chr5.137960000.137965000","chr5.138575000.138580000",615000,8,0.006459534,137960000,138575000,137965000,138580000,"chr5",208956,3,16,20,39,"chr5",1,0.0365682137834037
"6443","chr5.33440000.33445000","chr5.33940000.33945000",500000,10,0.0007734491,33440000,33940000,33445000,33945000,"chr5",208973,0,0,7,7,"chr5",1,0.00820440693858415
"6444","chr5.36150000.36155000","chr5.37030000.37035000",880000,7,0.006424098,36150000,37030000,36155000,37035000,"chr5",208988,1,1,1,3,"chr5",1,0.00246132208157525
"6445","chr5.13985000.13990000","chr5.14250000.14255000",265000,11,0.004551179,13985000,14250000,13990000,14255000,"chr5",208994,0,7,2,9,"chr5",1,0.0116033755274262
"6446","chr5.35775000.35780000","chr5.35835000.35840000",60000,21,0.002230493,35775000,35835000,35780000,35840000,"chr5",208996,0,4,2,6,"chr5",1,0.0147679324894515
"6447","chr5.154035000.154040000","chr5.154055000.154060000",20000,41,0.0001697672,154035000,154055000,154040000,154060000,"chr5",209017,3,1,0,4,"chr5",1,0.0192217533989686
"6448","chr5.79825000.79830000","chr5.79845000.79850000",20000,35,0.009978941,79825000,79845000,79830000,79850000,"chr5",209039,0,11,10,21,"chr5",1,0.0861462728551336
"6449","chr5.141525000.141530000","chr5.141975000.141980000",450000,9,0.005930217,141525000,141975000,141530000,141980000,"chr5",209054,3,10,13,26,"chr5",1,0.0274261603375527
"6450","chr5.14105000.14110000","chr5.14265000.14270000",160000,41,3.632455e-26,14105000,14265000,14110000,14270000,"chr5",209065,0,3,1,4,"chr5",1,0.0192217533989686
"6451","chr5.77275000.77280000","chr5.77300000.77305000",25000,41,1.785992e-05,77275000,77300000,77280000,77305000,"chr5",209131,1,6,11,18,"chr5",1,0.0864978902953586
"6452","chr5.42905000.42910000","chr5.43390000.43395000",485000,16,8.481475e-09,42905000,43390000,42910000,43395000,"chr5",209163,3,4,9,16,"chr5",1,0.0300046882325363
"6453","chr5.31850000.31855000","chr5.31925000.31930000",75000,22,6.845682e-05,31850000,31925000,31855000,31930000,"chr5",209195,3,15,9,27,"chr5",1,0.069620253164557
"6454","chr5.55680000.55685000","chr5.56520000.56525000",840000,7,0.008068309,55680000,56520000,55685000,56525000,"chr5",209207,0,3,0,3,"chr5",1,0.00246132208157525
"6455","chr5.80255000.80260000","chr5.80405000.80410000",150000,15,0.0009720877,80255000,80405000,80260000,80410000,"chr5",209208,1,5,3,9,"chr5",1,0.0158227848101266
"6456","chr5.134265000.134270000","chr5.134285000.134290000",20000,39,0.0007493829,134265000,134285000,134270000,134290000,"chr5",209264,3,9,12,24,"chr5",1,0.109704641350211
"6457","chr5.31580000.31585000","chr5.32095000.32100000",515000,15,4.227227e-08,31580000,32095000,31585000,32100000,"chr5",209307,4,11,10,25,"chr5",1,0.0439521800281294
"6458","chr5.31640000.31645000","chr5.31820000.31825000",180000,16,6.982433e-05,31640000,31820000,31645000,31825000,"chr5",209349,2,2,5,9,"chr5",1,0.0168776371308017
"6459","chr5.138945000.138950000","chr5.139560000.139565000",615000,9,0.001315436,138945000,139560000,138950000,139565000,"chr5",209469,1,1,2,4,"chr5",1,0.00421940928270042
"6460","chr5.10440000.10445000","chr5.10625000.10630000",185000,15,0.0002288535,10440000,10625000,10445000,10630000,"chr5",209493,3,10,9,22,"chr5",1,0.0386779184247539
"6461","chr5.31580000.31585000","chr5.32080000.32085000",500000,10,0.0007734491,31580000,32080000,31585000,32085000,"chr5",209583,1,7,10,18,"chr5",1,0.0210970464135021
"6462","chr5.11165000.11170000","chr5.11560000.11565000",395000,12,0.0001098725,11165000,11560000,11170000,11565000,"chr5",209596,0,2,1,3,"chr5",1,0.00421940928270042
"6463","chr5.176540000.176545000","chr5.176730000.176735000",190000,15,0.0001872349,176540000,176730000,176545000,176735000,"chr5",209648,0,1,1,2,"chr5",1,0.00351617440225035
"6464","chr5.139150000.139155000","chr5.139415000.139420000",265000,11,0.004551179,139150000,139415000,139155000,139420000,"chr5",209677,0,4,5,9,"chr5",1,0.0116033755274262
"6465","chr5.124750000.124755000","chr5.124790000.124795000",40000,26,0.001748132,124750000,124790000,124755000,124795000,"chr5",209683,5,8,18,31,"chr5",1,0.0944678856071261
"6466","chr5.78905000.78910000","chr5.79375000.79380000",470000,12,3.591123e-05,78905000,79375000,78910000,79380000,"chr5",209748,4,5,4,13,"chr5",1,0.0182841068917018
"6467","chr5.76400000.76405000","chr5.76715000.76720000",315000,11,0.001810053,76400000,76715000,76405000,76720000,"chr5",209759,1,3,1,5,"chr5",1,0.00644631973745898
"6468","chr5.14760000.14765000","chr5.14810000.14815000",50000,25,0.0003569199,14760000,14810000,14765000,14815000,"chr5",209799,1,6,1,8,"chr5",1,0.023441162681669
"6469","chr5.137950000.137955000","chr5.138500000.138505000",550000,10,0.000446444,137950000,138500000,137955000,138505000,"chr5",209806,5,13,16,34,"chr5",1,0.0398499765588373
"6470","chr5.78320000.78325000","chr5.78745000.78750000",425000,11,0.0003722366,78320000,78745000,78325000,78750000,"chr5",209859,1,7,5,13,"chr5",1,0.0167604313173933
"6471","chr5.141990000.141995000","chr5.142075000.142080000",85000,28,2.9949e-09,141990000,142075000,141995000,142080000,"chr5",209922,4,7,3,14,"chr5",1,0.0459446788560713
"6472","chr5.43065000.43070000","chr5.43395000.43400000",330000,11,0.001416127,43065000,43395000,43070000,43400000,"chr5",209931,4,9,11,24,"chr5",1,0.0309423347398031
"6473","chr5.14105000.14110000","chr5.15000000.15005000",895000,7,0.005883287,14105000,1.5e+07,14110000,15005000,"chr5",209976,0,4,2,6,"chr5",1,0.00492264416315049
"6474","chr5.168795000.168800000","chr5.168825000.168830000",30000,31,0.001884984,168795000,168825000,168800000,168830000,"chr5",210045,2,2,1,5,"chr5",1,0.0181669010782935
"6475","chr5.137885000.137890000","chr5.138720000.138725000",835000,7,0.008233541,137885000,138720000,137890000,138725000,"chr5",210090,1,3,7,11,"chr5",1,0.00902484763244257
"6476","chr5.38650000.38655000","chr5.38670000.38675000",20000,64,7.002632e-15,38650000,38670000,38655000,38675000,"chr5",210141,0,2,1,3,"chr5",1,0.0225035161744023
"6477","chr5.34470000.34475000","chr5.34930000.34935000",460000,12,4.145316e-05,34470000,34930000,34475000,34935000,"chr5",210217,1,3,1,5,"chr5",1,0.0070323488045007
"6478","chr5.16790000.16795000","chr5.17130000.17135000",340000,36,6.136375e-29,16790000,17130000,16795000,17135000,"chr5",210220,0,4,1,5,"chr5",1,0.0210970464135021
"6479","chr5.14105000.14110000","chr5.14230000.14235000",125000,16,0.0008836393,14105000,14230000,14110000,14235000,"chr5",210298,0,4,2,6,"chr5",1,0.0112517580872011
"6480","chr5.31635000.31640000","chr5.31780000.31785000",145000,15,0.001192454,31635000,31780000,31640000,31785000,"chr5",210301,0,5,5,10,"chr5",1,0.0175808720112518
"6481","chr5.176570000.176575000","chr5.176620000.176625000",50000,27,4.616593e-05,176570000,176620000,176575000,176625000,"chr5",210390,1,11,11,23,"chr5",1,0.0727848101265823
"6482","chr5.68405000.68410000","chr5.68430000.68435000",25000,35,0.002014277,68405000,68430000,68410000,68435000,"chr5",210414,2,2,2,6,"chr5",1,0.0246132208157525
"6483","chr5.138460000.138465000","chr5.138530000.138535000",70000,18,0.008249553,138460000,138530000,138465000,138535000,"chr5",210417,1,5,7,13,"chr5",1,0.0274261603375527
"6484","chr5.141505000.141510000","chr5.142050000.142055000",545000,10,0.0004698172,141505000,142050000,141510000,142055000,"chr5",210467,0,2,1,3,"chr5",1,0.00351617440225035
"6485","chr5.14105000.14110000","chr5.14325000.14330000",220000,15,5.781811e-05,14105000,14325000,14110000,14330000,"chr5",210472,0,2,1,3,"chr5",1,0.00527426160337553
"6486","chr5.137920000.137925000","chr5.138655000.138660000",735000,9,0.0004978101,137920000,138655000,137925000,138660000,"chr5",210480,3,11,4,18,"chr5",1,0.0189873417721519
"6487","chr5.132250000.132255000","chr5.132290000.132295000",40000,31,1.573413e-05,132250000,132290000,132255000,132295000,"chr5",210594,2,0,1,3,"chr5",1,0.0109001406469761
"6488","chr5.127230000.127235000","chr5.127395000.127400000",165000,18,7.574846e-06,127230000,127395000,127235000,127400000,"chr5",210603,0,0,3,3,"chr5",1,0.00632911392405063
"6489","chr5.16575000.16580000","chr5.16665000.16670000",90000,27,5.707131e-09,16575000,16665000,16580000,16670000,"chr5",210620,0,3,0,3,"chr5",1,0.00949367088607595
"6490","chr5.37815000.37820000","chr5.38190000.38195000",375000,17,1.24274e-08,37815000,38190000,37820000,38195000,"chr5",210633,1,1,0,2,"chr5",1,0.00398499765588373
"6491","chr5.38515000.38520000","chr5.38805000.38810000",290000,17,1.434119e-07,38515000,38805000,38520000,38810000,"chr5",210638,0,2,1,3,"chr5",1,0.0059774964838256
"6492","chr5.9285000.9290000","chr5.10145000.10150000",860000,7,0.007253608,9285000,10145000,9290000,10150000,"chr5",210649,2,1,3,6,"chr5",1,0.00492264416315049
"6493","chr5.137880000.137885000","chr5.138645000.138650000",765000,8,0.002362434,137880000,138645000,137885000,138650000,"chr5",210656,3,1,0,4,"chr5",1,0.00375058602906704
"6494","chr5.10350000.10355000","chr5.10400000.10405000",50000,22,0.005327353,10350000,10400000,10355000,10405000,"chr5",210661,0,2,0,2,"chr5",1,0.00515705578996718
"6495","chr5.56230000.56235000","chr5.56520000.56525000",290000,11,0.002807229,56230000,56520000,56235000,56525000,"chr5",210672,0,3,0,3,"chr5",1,0.00386779184247539
"6496","chr5.11110000.11115000","chr5.11135000.11140000",25000,35,0.002014277,11110000,11135000,11115000,11140000,"chr5",210680,0,1,5,6,"chr5",1,0.0246132208157525
"6497","chr5.176620000.176625000","chr5.176645000.176650000",25000,36,0.0009835376,176620000,176645000,176625000,176650000,"chr5",210702,0,2,1,3,"chr5",1,0.0126582278481013
"6498","chr5.95015000.95020000","chr5.95120000.95125000",105000,16,0.002826812,95015000,95120000,95020000,95125000,"chr5",210729,0,0,2,2,"chr5",1,0.00375058602906704
"6499","chr5.14405000.14410000","chr5.14660000.14665000",255000,17,5.279076e-07,14405000,14660000,14410000,14665000,"chr5",210761,0,0,3,3,"chr5",1,0.0059774964838256
"6500","chr5.10285000.10290000","chr5.10595000.10600000",310000,10,0.007546877,10285000,10595000,10290000,10600000,"chr5",210830,6,10,8,24,"chr5",1,0.0281293952180028
"6501","chr5.31635000.31640000","chr5.32090000.32095000",455000,12,4.444811e-05,31635000,32090000,31640000,32095000,"chr5",210838,0,5,6,11,"chr5",1,0.0154711673699015
"6502","chr5.142050000.142055000","chr5.142075000.142080000",25000,45,4.357492e-07,142050000,142075000,142055000,142080000,"chr5",210920,5,16,18,39,"chr5",1,0.205696202531646
"6503","chr5.18465000.18470000","chr5.18695000.18700000",230000,14,0.0001793042,18465000,18695000,18470000,18700000,"chr5",210966,0,3,7,10,"chr5",1,0.0164088138771683
"6504","chr5.77230000.77235000","chr5.77275000.77280000",45000,31,2.421324e-06,77230000,77275000,77235000,77280000,"chr5",210980,1,2,3,6,"chr5",1,0.0218002812939522
"6505","chr5.137920000.137925000","chr5.137950000.137955000",30000,32,0.0008726193,137920000,137950000,137925000,137955000,"chr5",210998,3,11,4,18,"chr5",1,0.0675105485232067
"6506","chr5.14680000.14685000","chr5.14705000.14710000",25000,35,0.002014277,14680000,14705000,14685000,14710000,"chr5",211000,4,16,8,28,"chr5",1,0.114861697140178
"6507","chr5.14140000.14145000","chr5.14250000.14255000",110000,18,0.0001935739,14140000,14250000,14145000,14255000,"chr5",211157,0,3,2,5,"chr5",1,0.0105485232067511
"6508","chr5.154035000.154040000","chr5.154185000.154190000",150000,18,1.723612e-05,154035000,154185000,154040000,154190000,"chr5",211167,3,1,0,4,"chr5",1,0.00843881856540084
"6509","chr5.150180000.150185000","chr5.150230000.150235000",50000,24,0.0009179388,150180000,150230000,150185000,150235000,"chr5",211175,0,2,1,3,"chr5",1,0.00843881856540084
"6510","chr5.134090000.134095000","chr5.134240000.134245000",150000,18,1.723612e-05,134090000,134240000,134095000,134245000,"chr5",211184,2,5,8,15,"chr5",1,0.0316455696202532
"6511","chr5.137920000.137925000","chr5.138695000.138700000",775000,13,7.622913e-08,137920000,138695000,137925000,138700000,"chr5",211198,3,11,4,18,"chr5",1,0.0274261603375527
"6512","chr5.139415000.139420000","chr5.139735000.139740000",320000,10,0.006469649,139415000,139735000,139420000,139740000,"chr5",211199,3,7,5,15,"chr5",1,0.0175808720112518
"6513","chr5.141670000.141675000","chr5.141820000.141825000",150000,13,0.009673788,141670000,141820000,141675000,141825000,"chr5",211240,0,3,1,4,"chr5",1,0.00609470229723394
"6514","chr5.31820000.31825000","chr5.32095000.32100000",275000,20,6.964955e-10,31820000,32095000,31825000,32100000,"chr5",211282,2,11,9,22,"chr5",1,0.0515705578996718
"6515","chr5.172410000.172415000","chr5.172575000.172580000",165000,25,4.257816e-11,172410000,172575000,172415000,172580000,"chr5",211315,0,5,1,6,"chr5",1,0.0175808720112518
"6516","chr5.31850000.31855000","chr5.32090000.32095000",240000,18,1.652107e-07,31850000,32090000,31855000,32095000,"chr5",211319,1,13,9,23,"chr5",1,0.0485232067510548
"6517","chr5.38745000.38750000","chr5.38805000.38810000",60000,21,0.002230493,38745000,38805000,38750000,38810000,"chr5",211343,0,2,1,3,"chr5",1,0.00738396624472574
"6518","chr5.168400000.168405000","chr5.168745000.168750000",345000,14,8.243646e-06,168400000,168745000,168405000,168750000,"chr5",211364,1,2,2,5,"chr5",1,0.00820440693858415
"6519","chr5.147820000.147825000","chr5.148415000.148420000",595000,14,9.427604e-08,147820000,148415000,147825000,148420000,"chr5",211396,0,2,3,5,"chr5",1,0.00820440693858415
"6520","chr5.137920000.137925000","chr5.138185000.138190000",265000,13,0.0002831107,137920000,138185000,137925000,138190000,"chr5",211450,1,4,4,9,"chr5",1,0.0137130801687764
"6521","chr5.133705000.133710000","chr5.133740000.133745000",35000,34,8.243646e-06,133705000,133740000,133710000,133745000,"chr5",211463,0,2,1,3,"chr5",1,0.0119549929676512
"6522","chr5.42810000.42815000","chr5.42885000.42890000",75000,24,5.803076e-06,42810000,42885000,42815000,42890000,"chr5",211474,0,3,3,6,"chr5",1,0.0168776371308017
"6523","chr5.38495000.38500000","chr5.38805000.38810000",310000,10,0.007546877,38495000,38805000,38500000,38810000,"chr5",211524,0,2,1,3,"chr5",1,0.00351617440225035
"6524","chr5.56810000.56815000","chr5.57750000.57755000",940000,7,0.004551179,56810000,57750000,56815000,57755000,"chr5",211543,1,0,3,4,"chr5",1,0.00328176277543366
"6525","chr5.60255000.60260000","chr5.61140000.61145000",885000,7,0.006244689,60255000,61140000,60260000,61145000,"chr5",211553,0,2,2,4,"chr5",1,0.00328176277543366
"6526","chr5.39080000.39085000","chr5.39105000.39110000",25000,54,2.38256e-11,39080000,39105000,39085000,39110000,"chr5",211557,0,0,3,3,"chr5",1,0.0189873417721519
"6527","chr5.176620000.176625000","chr5.176655000.176660000",35000,27,0.004157539,176620000,176655000,176625000,176660000,"chr5",211588,2,3,4,9,"chr5",1,0.0284810126582278
"6528","chr5.149340000.149345000","chr5.149370000.149375000",30000,38,4.280784e-06,149340000,149370000,149345000,149375000,"chr5",211614,1,8,4,13,"chr5",1,0.0578996718237225
"6529","chr5.31635000.31640000","chr5.31820000.31825000",185000,13,0.003066853,31635000,31820000,31640000,31825000,"chr5",211634,0,5,6,11,"chr5",1,0.0167604313173933
"6530","chr5.80685000.80690000","chr5.81490000.81495000",805000,7,0.009709423,80685000,81490000,80690000,81495000,"chr5",211637,4,8,5,17,"chr5",1,0.0139474917955931
"6531","chr5.176570000.176575000","chr5.176655000.176660000",85000,17,0.004736201,176570000,176655000,176575000,176660000,"chr5",211643,1,3,4,8,"chr5",1,0.0159399906235349
"6532","chr5.9895000.9900000","chr5.10120000.10125000",225000,13,0.0008726193,9895000,10120000,9900000,10125000,"chr5",211645,0,5,2,7,"chr5",1,0.0106657290201594
"6533","chr5.167085000.167090000","chr5.167550000.167555000",465000,9,0.005202139,167085000,167550000,167090000,167555000,"chr5",211660,0,2,0,2,"chr5",1,0.00210970464135021
"6534","chr5.31640000.31645000","chr5.31725000.31730000",85000,26,6.419697e-08,31640000,31725000,31645000,31730000,"chr5",211671,1,2,5,8,"chr5",1,0.0243788091889358
"6535","chr5.33435000.33440000","chr5.33930000.33935000",495000,18,7.159944e-11,33435000,33930000,33440000,33935000,"chr5",211696,0,6,6,12,"chr5",1,0.0253164556962025
"6536","chr5.16740000.16745000","chr5.17185000.17190000",445000,16,2.031425e-08,16740000,17185000,16745000,17190000,"chr5",211737,2,4,3,9,"chr5",1,0.0168776371308017
"6537","chr5.9360000.9365000","chr5.9540000.9545000",180000,17,1.581331e-05,9360000,9540000,9365000,9545000,"chr5",211749,0,2,1,3,"chr5",1,0.0059774964838256
"6538","chr5.149830000.149835000","chr5.149900000.149905000",70000,19,0.00333549,149830000,149900000,149835000,149905000,"chr5",211791,0,3,2,5,"chr5",1,0.0111345522737928
"6539","chr5.142050000.142055000","chr5.142070000.142075000",20000,70,2.687232e-18,142050000,142070000,142055000,142075000,"chr5",211803,9,16,21,46,"chr5",1,0.377402719174871
"6540","chr5.151125000.151130000","chr5.151755000.151760000",630000,8,0.005805021,151125000,151755000,151130000,151760000,"chr5",211824,2,3,2,7,"chr5",1,0.00656352555086732
"6541","chr5.31640000.31645000","chr5.31735000.31740000",95000,22,4.388156e-06,31640000,31735000,31645000,31740000,"chr5",211907,0,2,5,7,"chr5",1,0.0180496952648851
"6542","chr5.138610000.138615000","chr5.138630000.138635000",20000,44,1.51999e-05,138610000,138630000,138615000,138635000,"chr5",211917,1,10,6,17,"chr5",1,0.0876699484294421
"6543","chr5.146605000.146610000","chr5.146740000.146745000",135000,16,0.0005484592,146605000,146740000,146610000,146745000,"chr5",211939,0,3,3,6,"chr5",1,0.0112517580872011
"6544","chr5.39945000.39950000","chr5.40675000.40680000",730000,8,0.002965283,39945000,40675000,39950000,40680000,"chr5",211953,0,2,1,3,"chr5",1,0.00281293952180028
"6545","chr5.115470000.115475000","chr5.115735000.115740000",265000,11,0.004551179,115470000,115735000,115475000,115740000,"chr5",211981,1,2,4,7,"chr5",1,0.00902484763244257
"6546","chr5.10320000.10325000","chr5.10340000.10345000",20000,40,0.0003613994,10320000,10340000,10325000,10345000,"chr5",211992,4,9,12,25,"chr5",1,0.117205813408345
"6547","chr5.16455000.16460000","chr5.16640000.16645000",185000,13,0.003066853,16455000,16640000,16460000,16645000,"chr5",212012,1,2,1,4,"chr5",1,0.00609470229723394
"6548","chr5.16555000.16560000","chr5.16600000.16605000",45000,24,0.002624523,16555000,16600000,16560000,16605000,"chr5",212078,3,11,11,25,"chr5",1,0.070323488045007
"6549","chr5.146425000.146430000","chr5.146465000.146470000",40000,26,0.001748132,146425000,146465000,146430000,146470000,"chr5",212082,0,2,1,3,"chr5",1,0.00914205344585091
"6550","chr5.42805000.42810000","chr5.42905000.42910000",100000,22,2.421324e-06,42805000,42905000,42810000,42910000,"chr5",212084,0,1,4,5,"chr5",1,0.012892639474918
"6551","chr5.10450000.10455000","chr5.10605000.10610000",155000,20,6.054977e-07,10450000,10605000,10455000,10610000,"chr5",212130,3,11,9,23,"chr5",1,0.0539146741678387
"6552","chr5.172435000.172440000","chr5.172575000.172580000",140000,16,0.0004323448,172435000,172575000,172440000,172580000,"chr5",212139,0,8,2,10,"chr5",1,0.0187529301453352
"6553","chr5.61605000.61610000","chr5.61635000.61640000",30000,37,1.127388e-05,61605000,61635000,61610000,61640000,"chr5",212164,0,0,2,2,"chr5",1,0.00867323019221753
"6554","chr5.37765000.37770000","chr5.37815000.37820000",50000,35,2.59901e-09,37765000,37815000,37770000,37820000,"chr5",212172,0,1,2,3,"chr5",1,0.0123066104078762
"6555","chr5.139090000.139095000","chr5.139125000.139130000",35000,29,0.0008610919,139090000,139125000,139095000,139130000,"chr5",212179,4,5,6,15,"chr5",1,0.0509845288326301
"6556","chr5.32505000.32510000","chr5.32545000.32550000",40000,28,0.0003037047,32505000,32545000,32510000,32550000,"chr5",212210,0,6,7,13,"chr5",1,0.0426629160806376
"6557","chr5.127355000.127360000","chr5.127395000.127400000",40000,30,4.367471e-05,127355000,127395000,127360000,127400000,"chr5",212224,0,0,2,2,"chr5",1,0.0070323488045007
"6558","chr5.172185000.172190000","chr5.172380000.172385000",195000,17,7.598289e-06,172185000,172380000,172190000,172385000,"chr5",212338,1,7,3,11,"chr5",1,0.0219174871073605
"6559","chr5.32490000.32495000","chr5.32600000.32605000",110000,15,0.005883287,32490000,32600000,32495000,32605000,"chr5",212362,0,2,0,2,"chr5",1,0.00351617440225035
"6560","chr5.145905000.145910000","chr5.146565000.146570000",660000,11,2.186062e-05,145905000,146565000,145910000,146570000,"chr5",212376,2,4,2,8,"chr5",1,0.0103141115799344
"6561","chr5.40755000.40760000","chr5.40795000.40800000",40000,50,1.425117e-16,40755000,40795000,40760000,40800000,"chr5",212389,0,2,2,4,"chr5",1,0.023441162681669
"6562","chr5.32240000.32245000","chr5.32600000.32605000",360000,17,1.823796e-08,32240000,32600000,32245000,32605000,"chr5",212420,0,2,0,2,"chr5",1,0.00398499765588373
"6563","chr5.32240000.32245000","chr5.32295000.32300000",55000,21,0.005222236,32240000,32295000,32245000,32300000,"chr5",212504,3,6,7,16,"chr5",1,0.0393811533052039
"6564","chr5.32240000.32245000","chr5.32310000.32315000",70000,18,0.008249553,32240000,32310000,32245000,32315000,"chr5",212519,4,26,7,37,"chr5",1,0.0780590717299578
"6565","chr5.13985000.13990000","chr5.14230000.14235000",245000,11,0.006920911,13985000,14230000,13990000,14235000,"chr5",212534,0,7,4,11,"chr5",1,0.0141819034224098
"6566","chr5.32240000.32245000","chr5.32275000.32280000",35000,37,3.350797e-07,32240000,32275000,32245000,32280000,"chr5",212553,2,6,7,15,"chr5",1,0.0650492264416315
"6567","chr5.133695000.133700000","chr5.133990000.133995000",295000,18,1.727636e-08,133695000,133990000,133700000,133995000,"chr5",212583,0,0,1,1,"chr5",1,0.00210970464135021
"6568","chr5.168085000.168090000","chr5.168995000.169000000",910000,8,0.000906508,168085000,168995000,168090000,1.69e+08,"chr5",212591,2,3,1,6,"chr5",1,0.00562587904360056
"6569","chr5.171905000.171910000","chr5.172120000.172125000",215000,107,3.70096e-123,171905000,172120000,171910000,172125000,"chr5",212598,1,10,13,24,"chr5",1,0.30098452883263
"6570","chr5.172505000.172510000","chr5.172530000.172535000",25000,39,9.786592e-05,172505000,172530000,172510000,172535000,"chr5",212613,0,5,1,6,"chr5",1,0.0274261603375527
"6571","chr5.138630000.138635000","chr5.138665000.138670000",35000,48,2.836974e-13,138630000,138665000,138635000,138670000,"chr5",212659,1,14,12,27,"chr5",1,0.151898734177215
"6572","chr5.76940000.76945000","chr5.77300000.77305000",360000,16,1.370727e-07,76940000,77300000,76945000,77305000,"chr5",212661,1,3,4,8,"chr5",1,0.0150023441162682
"6573","chr5.10280000.10285000","chr5.10625000.10630000",345000,14,8.243646e-06,10280000,10625000,10285000,10630000,"chr5",212750,5,10,9,24,"chr5",1,0.0393811533052039
"6574","chr5.31635000.31640000","chr5.31805000.31810000",170000,21,4.304588e-08,31635000,31805000,31640000,31810000,"chr5",212825,0,5,1,6,"chr5",1,0.0147679324894515
"6575","chr5.138915000.138920000","chr5.138945000.138950000",30000,30,0.003924178,138915000,138945000,138920000,138950000,"chr5",212846,1,1,2,4,"chr5",1,0.0140646976090014
"6576","chr5.139560000.139565000","chr5.139710000.139715000",150000,13,0.009673788,139560000,139710000,139565000,139715000,"chr5",212865,1,4,1,6,"chr5",1,0.00914205344585091
"6577","chr5.16670000.16675000","chr5.16790000.16795000",120000,18,9.7589e-05,16670000,16790000,16675000,16795000,"chr5",212882,0,4,1,5,"chr5",1,0.0105485232067511
"6578","chr5.150435000.150440000","chr5.150495000.150500000",60000,20,0.00547239,150435000,150495000,150440000,150500000,"chr5",213023,5,14,13,32,"chr5",1,0.0750117205813408
"6579","chr5.140555000.140560000","chr5.140795000.140800000",240000,11,0.00773422,140555000,140795000,140560000,140800000,"chr5",213049,0,2,1,3,"chr5",1,0.00386779184247539
"6580","chr5.139560000.139565000","chr5.139735000.139740000",175000,20,1.696131e-07,139560000,139735000,139565000,139740000,"chr5",213068,6,21,22,49,"chr5",1,0.114861697140178
"6581","chr5.124475000.124480000","chr5.124715000.124720000",240000,11,0.00773422,124475000,124715000,124480000,124720000,"chr5",213069,1,7,9,17,"chr5",1,0.0219174871073605
"6582","chr5.31580000.31585000","chr5.31635000.31640000",55000,22,0.002170212,31580000,31635000,31585000,31640000,"chr5",213097,0,5,6,11,"chr5",1,0.0283638068448195
"6583","chr5.43005000.43010000","chr5.43385000.43390000",380000,10,0.003066853,43005000,43385000,43010000,43390000,"chr5",213098,2,3,9,14,"chr5",1,0.0164088138771683
"6584","chr5.80005000.80010000","chr5.80485000.80490000",480000,9,0.004505825,80005000,80485000,80010000,80490000,"chr5",213137,1,5,6,12,"chr5",1,0.0126582278481013
"6585","chr5.10460000.10465000","chr5.10595000.10600000",135000,17,0.0001521422,10460000,10595000,10465000,10600000,"chr5",213140,0,3,1,4,"chr5",1,0.00796999531176746
"6586","chr5.137950000.137955000","chr5.138185000.138190000",235000,11,0.008554958,137950000,138185000,137955000,138190000,"chr5",213149,1,4,5,10,"chr5",1,0.012892639474918
"6587","chr5.77230000.77235000","chr5.77300000.77305000",70000,19,0.00333549,77230000,77300000,77235000,77305000,"chr5",213161,1,2,3,6,"chr5",1,0.0133614627285513
"6588","chr5.10760000.10765000","chr5.11165000.11170000",405000,9,0.009344014,10760000,11165000,10765000,11170000,"chr5",213163,0,1,1,2,"chr5",1,0.00210970464135021
"6589","chr5.41900000.41905000","chr5.42810000.42815000",910000,7,0.005469632,41900000,42810000,41905000,42815000,"chr5",213204,0,3,3,6,"chr5",1,0.00492264416315049
"6590","chr5.138970000.138975000","chr5.139400000.139405000",430000,9,0.00732104,138970000,139400000,138975000,139405000,"chr5",213236,3,9,5,17,"chr5",1,0.0179324894514768
"6591","chr5.156820000.156825000","chr5.157145000.157150000",325000,10,0.006021109,156820000,157145000,156825000,157150000,"chr5",213240,3,8,10,21,"chr5",1,0.0246132208157525
"6592","chr5.139090000.139095000","chr5.139130000.139135000",40000,25,0.00394017,139090000,139130000,139095000,139135000,"chr5",213244,3,7,4,14,"chr5",1,0.0410220346929208
"6593","chr5.138955000.138960000","chr5.138985000.138990000",30000,57,2.924219e-16,138955000,138985000,138960000,138990000,"chr5",213299,2,6,9,17,"chr5",1,0.113572433192686
"6594","chr5.79495000.79500000","chr5.79550000.79555000",55000,29,1.170921e-06,79495000,79550000,79500000,79555000,"chr5",213304,1,9,7,17,"chr5",1,0.0577824660103141
"6595","chr5.42905000.42910000","chr5.43385000.43390000",480000,10,0.0009659294,42905000,43385000,42910000,43390000,"chr5",213327,2,3,9,14,"chr5",1,0.0164088138771683
"6596","chr5.31820000.31825000","chr5.32110000.32115000",290000,12,0.0006828032,31820000,32110000,31825000,32115000,"chr5",213328,2,14,9,25,"chr5",1,0.0351617440225035
"6597","chr5.74040000.74045000","chr5.74980000.74985000",940000,7,0.004551179,74040000,74980000,74045000,74985000,"chr5",213333,0,4,1,5,"chr5",1,0.00410220346929208
"6598","chr5.139085000.139090000","chr5.139140000.139145000",55000,30,3.36297e-07,139085000,139140000,139090000,139145000,"chr5",213388,6,13,10,29,"chr5",1,0.10196905766526
"6599","chr5.139630000.139635000","chr5.139720000.139725000",90000,26,2.686074e-08,139630000,139720000,139635000,139725000,"chr5",213403,4,12,18,34,"chr5",1,0.103609939052977
"6600","chr5.176550000.176555000","chr5.176730000.176735000",180000,13,0.003644277,176550000,176730000,176555000,176735000,"chr5",213419,3,11,7,21,"chr5",1,0.0319971870604782
"6601","chr5.56195000.56200000","chr5.56520000.56525000",325000,13,6.957424e-05,56195000,56520000,56200000,56525000,"chr5",213485,0,3,0,3,"chr5",1,0.00457102672292546
"6602","chr5.34470000.34475000","chr5.34915000.34920000",445000,10,0.001443232,34470000,34915000,34475000,34920000,"chr5",213544,1,3,1,5,"chr5",1,0.00586029067041725
"6603","chr5.108060000.108065000","chr5.108700000.108705000",640000,8,0.005469632,108060000,108700000,108065000,108705000,"chr5",213547,1,2,1,4,"chr5",1,0.00375058602906704
"6604","chr5.138750000.138755000","chr5.138945000.138950000",195000,16,3.575872e-05,138750000,138945000,138755000,138950000,"chr5",213642,1,1,2,4,"chr5",1,0.00750117205813408
"6605","chr5.138150000.138155000","chr5.138530000.138535000",380000,12,0.0001377225,138150000,138530000,138155000,138535000,"chr5",213645,3,17,14,34,"chr5",1,0.0478199718706048
"6606","chr5.14705000.14710000","chr5.14945000.14950000",240000,11,0.00773422,14705000,14945000,14710000,14950000,"chr5",213646,1,4,1,6,"chr5",1,0.00773558368495077
"6607","chr5.137740000.137745000","chr5.138655000.138660000",915000,7,0.005299002,137740000,138655000,137745000,138660000,"chr5",213704,4,3,12,19,"chr5",1,0.0155883731833099
"6608","chr5.171910000.171915000","chr5.172105000.172110000",195000,12,0.007407267,171910000,172105000,171915000,172110000,"chr5",213722,0,5,1,6,"chr5",1,0.00843881856540084
"6609","chr5.14350000.14355000","chr5.14645000.14650000",295000,18,1.727636e-08,14350000,14645000,14355000,14650000,"chr5",213729,0,1,1,2,"chr5",1,0.00421940928270042
"6610","chr5.108760000.108765000","chr5.108785000.108790000",25000,36,0.0009835376,108760000,108785000,108765000,108790000,"chr5",213794,0,5,2,7,"chr5",1,0.029535864978903
"6611","chr5.173055000.173060000","chr5.173330000.173335000",275000,16,1.504054e-06,173055000,173330000,173060000,173335000,"chr5",213825,1,0,0,1,"chr5",1,0.00187529301453352
"6612","chr5.16485000.16490000","chr5.16540000.16545000",55000,26,3.890122e-05,16485000,16540000,16490000,16545000,"chr5",213830,2,7,2,11,"chr5",1,0.0335208626347867
"6613","chr5.41925000.41930000","chr5.42765000.42770000",840000,15,2.347999e-10,41925000,42765000,41930000,42770000,"chr5",213896,0,0,6,6,"chr5",1,0.0105485232067511
"6614","chr5.138630000.138635000","chr5.138695000.138700000",65000,25,1.172009e-05,138630000,138695000,138635000,138700000,"chr5",213907,1,14,12,27,"chr5",1,0.0791139240506329
"6615","chr5.176615000.176620000","chr5.176660000.176665000",45000,25,0.001089227,176615000,176660000,176620000,176665000,"chr5",213922,0,3,3,6,"chr5",1,0.0175808720112518
"6616","chr5.138385000.138390000","chr5.138460000.138465000",75000,19,0.001822093,138385000,138460000,138390000,138465000,"chr5",213956,0,5,7,12,"chr5",1,0.0267229254571027
"6617","chr5.38650000.38655000","chr5.38710000.38715000",60000,28,9.908917e-07,38650000,38710000,38655000,38715000,"chr5",213966,1,0,4,5,"chr5",1,0.0164088138771683
"6618","chr5.11165000.11170000","chr5.11260000.11265000",95000,18,0.0006740207,11165000,11260000,11170000,11265000,"chr5",213967,2,2,2,6,"chr5",1,0.0126582278481013
"6619","chr5.37450000.37455000","chr5.37765000.37770000",315000,11,0.001810053,37450000,37765000,37455000,37770000,"chr5",213975,0,3,2,5,"chr5",1,0.00644631973745898
"6620","chr5.37765000.37770000","chr5.38190000.38195000",425000,11,0.0003722366,37765000,38190000,37770000,38195000,"chr5",214014,0,2,0,2,"chr5",1,0.00257852789498359
"6621","chr5.31605000.31610000","chr5.31820000.31825000",215000,14,0.0003037047,31605000,31820000,31610000,31825000,"chr5",214016,2,14,9,25,"chr5",1,0.0410220346929208
"6622","chr5.16540000.16545000","chr5.16640000.16645000",100000,23,5.686057e-07,16540000,16640000,16545000,16645000,"chr5",214025,1,6,12,19,"chr5",1,0.0512189404594468
"6623","chr5.42905000.42910000","chr5.43105000.43110000",200000,19,2.1564e-07,42905000,43105000,42910000,43110000,"chr5",214034,0,4,13,17,"chr5",1,0.0378574777308955
"6624","chr5.139025000.139030000","chr5.139140000.139145000",115000,29,3.593093e-12,139025000,139140000,139030000,139145000,"chr5",214076,6,16,15,37,"chr5",1,0.125761837787154
"6625","chr5.36725000.36730000","chr5.37030000.37035000",305000,13,0.0001064071,36725000,37030000,36730000,37035000,"chr5",214091,0,0,2,2,"chr5",1,0.00304735114861697
"6626","chr5.37030000.37035000","chr5.37070000.37075000",40000,29,0.0001169636,37030000,37070000,37035000,37075000,"chr5",214171,2,4,7,13,"chr5",1,0.0441865916549461
"6627","chr5.31640000.31645000","chr5.32090000.32095000",450000,13,7.639275e-06,31640000,32090000,31645000,32095000,"chr5",214178,1,2,5,8,"chr5",1,0.0121894045944679
"6628","chr5.134090000.134095000","chr5.134180000.134185000",90000,32,1.291137e-12,134090000,134180000,134095000,134185000,"chr5",214196,2,5,8,15,"chr5",1,0.0562587904360056
"6629","chr5.172165000.172170000","chr5.172185000.172190000",20000,46,2.646006e-06,172165000,172185000,172170000,172190000,"chr5",214260,1,6,3,10,"chr5",1,0.0539146741678387
"6630","chr5.138640000.138645000","chr5.138665000.138670000",25000,46,1.611252e-07,138640000,138665000,138645000,138670000,"chr5",214277,2,6,2,10,"chr5",1,0.0539146741678387
"6631","chr5.65695000.65700000","chr5.65880000.65885000",185000,12,0.00976683,65695000,65880000,65700000,65885000,"chr5",214281,5,12,6,23,"chr5",1,0.0323488045007032
"6632","chr5.124750000.124755000","chr5.125345000.125350000",595000,8,0.007546877,124750000,125345000,124755000,125350000,"chr5",214300,0,5,4,9,"chr5",1,0.00843881856540084
"6633","chr5.31580000.31585000","chr5.32030000.32035000",450000,9,0.005930217,31580000,32030000,31585000,32035000,"chr5",214306,0,5,1,6,"chr5",1,0.00632911392405063
"6634","chr5.95005000.95010000","chr5.95070000.95075000",65000,19,0.006346632,95005000,95070000,95010000,95075000,"chr5",214368,0,3,4,7,"chr5",1,0.0155883731833099
"6635","chr5.80685000.80690000","chr5.81245000.81250000",560000,8,0.009734313,80685000,81245000,80690000,81250000,"chr5",214421,3,9,4,16,"chr5",1,0.0150023441162682
"6636","chr5.37840000.37845000","chr5.38145000.38150000",305000,14,2.029467e-05,37840000,38145000,37845000,38150000,"chr5",214439,0,2,0,2,"chr5",1,0.00328176277543366
"6637","chr5.137935000.137940000","chr5.138595000.138600000",660000,9,0.0009051814,137935000,138595000,137940000,138600000,"chr5",214468,0,2,1,3,"chr5",1,0.00316455696202532
"6638","chr5.32490000.32495000","chr5.32610000.32615000",120000,27,7.312037e-11,32490000,32610000,32495000,32615000,"chr5",214473,3,7,8,18,"chr5",1,0.0569620253164557
"6639","chr5.36265000.36270000","chr5.36690000.36695000",425000,11,0.0003722366,36265000,36690000,36270000,36695000,"chr5",214498,0,13,5,18,"chr5",1,0.0232067510548523
"6640","chr5.35085000.35090000","chr5.35925000.35930000",840000,10,3.019389e-05,35085000,35925000,35090000,35930000,"chr5",214505,0,3,1,4,"chr5",1,0.0046882325363338
"6641","chr5.150625000.150630000","chr5.151115000.151120000",490000,9,0.004085308,150625000,151115000,150630000,151120000,"chr5",214513,4,7,3,14,"chr5",1,0.0147679324894515
"6642","chr5.112405000.112410000","chr5.112665000.112670000",260000,16,2.557758e-06,112405000,112665000,112410000,112670000,"chr5",214515,1,0,4,5,"chr5",1,0.00937646507266761
"6643","chr5.139120000.139125000","chr5.139140000.139145000",20000,43,3.510424e-05,139120000,139140000,139125000,139145000,"chr5",214521,2,2,3,7,"chr5",1,0.0352789498359119
"6644","chr5.180205000.180210000","chr5.180610000.180615000",405000,10,0.002264742,180205000,180610000,180210000,180615000,"chr5",214526,0,0,1,1,"chr5",1,0.00117205813408345
"6645","chr5.172410000.172415000","chr5.172505000.172510000",95000,16,0.005568258,172410000,172505000,172415000,172510000,"chr5",214562,0,5,1,6,"chr5",1,0.0112517580872011
"6646","chr5.14660000.14665000","chr5.15010000.15015000",350000,20,3.896716e-11,14660000,15010000,14665000,15015000,"chr5",214605,1,6,4,11,"chr5",1,0.0257852789498359
"6647","chr5.32500000.32505000","chr5.32585000.32590000",85000,17,0.004736201,32500000,32585000,32505000,32590000,"chr5",214617,2,8,10,20,"chr5",1,0.0398499765588373
"6648","chr5.167695000.167700000","chr5.168005000.168010000",310000,11,0.001948204,167695000,168005000,167700000,168010000,"chr5",214635,0,2,1,3,"chr5",1,0.00386779184247539
"6649","chr5.71830000.71835000","chr5.72240000.72245000",410000,11,0.000456512,71830000,72240000,71835000,72245000,"chr5",214651,0,6,7,13,"chr5",1,0.0167604313173933
"6650","chr5.40795000.40800000","chr5.40830000.40835000",35000,57,3.640177e-19,40795000,40830000,40800000,40835000,"chr5",214741,0,2,2,4,"chr5",1,0.0267229254571027
"6651","chr5.16540000.16545000","chr5.16565000.16570000",25000,43,2.954123e-06,16540000,16565000,16545000,16570000,"chr5",214755,2,6,5,13,"chr5",1,0.0655180496952649
"6652","chr5.72280000.72285000","chr5.72305000.72310000",25000,42,7.395596e-06,72280000,72305000,72285000,72310000,"chr5",214825,1,0,1,2,"chr5",1,0.00984528832630099
"6653","chr5.139560000.139565000","chr5.139580000.139585000",20000,36,0.00547239,139560000,139580000,139565000,139585000,"chr5",214858,6,21,22,49,"chr5",1,0.206751054852321
"6654","chr5.138130000.138135000","chr5.138575000.138580000",445000,13,8.310652e-06,138130000,138575000,138135000,138580000,"chr5",214880,10,23,34,67,"chr5",1,0.102086263478669
"6655","chr5.138945000.138950000","chr5.139025000.139030000",80000,23,9.327401e-06,138945000,139025000,138950000,139030000,"chr5",214883,1,1,2,4,"chr5",1,0.0107829348335677
"6656","chr5.33440000.33445000","chr5.33995000.34000000",555000,11,7.168454e-05,33440000,33995000,33445000,3.4e+07,"chr5",214891,0,0,3,3,"chr5",1,0.00386779184247539
"6657","chr5.138535000.138540000","chr5.138630000.138635000",95000,17,0.002014277,138535000,138630000,138540000,138635000,"chr5",214922,1,14,12,27,"chr5",1,0.0537974683544304
"6658","chr5.146825000.146830000","chr5.146960000.146965000",135000,15,0.001825795,146825000,146960000,146830000,146965000,"chr5",214928,0,3,1,4,"chr5",1,0.0070323488045007
"6659","chr5.139025000.139030000","chr5.139130000.139135000",105000,18,0.0002889183,139025000,139130000,139030000,139135000,"chr5",214936,3,7,4,14,"chr5",1,0.029535864978903
"6660","chr5.137880000.137885000","chr5.138540000.138545000",660000,8,0.004736201,137880000,138540000,137885000,138545000,"chr5",215003,2,1,3,6,"chr5",1,0.00562587904360056
"6661","chr5.16555000.16560000","chr5.16670000.16675000",115000,16,0.001517047,16555000,16670000,16560000,16675000,"chr5",215032,0,4,2,6,"chr5",1,0.0112517580872011
"6662","chr5.180290000.180295000","chr5.180685000.180690000",395000,10,0.002578088,180290000,180685000,180295000,180690000,"chr5",215034,2,6,2,10,"chr5",1,0.0117205813408345
"6663","chr5.31640000.31645000","chr5.31675000.31680000",35000,34,8.243646e-06,31640000,31675000,31645000,31680000,"chr5",215142,4,2,5,11,"chr5",1,0.0438349742147211
"6664","chr5.137885000.137890000","chr5.138610000.138615000",725000,8,0.003066853,137885000,138610000,137890000,138615000,"chr5",215235,3,3,6,12,"chr5",1,0.0112517580872011
"6665","chr5.145830000.145835000","chr5.146740000.146745000",910000,7,0.005469632,145830000,146740000,145835000,146745000,"chr5",215397,0,3,0,3,"chr5",1,0.00246132208157525
"6666","chr5.154055000.154060000","chr5.154180000.154185000",125000,17,0.0002619933,154055000,154180000,154060000,154185000,"chr5",215414,1,7,2,10,"chr5",1,0.0199249882794187
"6667","chr5.32255000.32260000","chr5.32610000.32615000",355000,13,3.890122e-05,32255000,32610000,32260000,32615000,"chr5",215434,3,7,8,18,"chr5",1,0.0274261603375527
"6668","chr5.16805000.16810000","chr5.17185000.17190000",380000,16,8.59688e-08,16805000,17185000,16810000,17190000,"chr5",215462,2,4,3,9,"chr5",1,0.0168776371308017
"6669","chr5.55710000.55715000","chr5.56160000.56165000",450000,11,0.0002735098,55710000,56160000,55715000,56165000,"chr5",215508,3,2,13,18,"chr5",1,0.0232067510548523
"6670","chr5.138900000.138905000","chr5.139150000.139155000",250000,11,0.00615903,138900000,139150000,138905000,139155000,"chr5",215534,0,4,5,9,"chr5",1,0.0116033755274262
"6671","chr5.16805000.16810000","chr5.17115000.17120000",310000,10,0.007546877,16805000,17115000,16810000,17120000,"chr5",215541,1,14,15,30,"chr5",1,0.0351617440225035
"6672","chr5.14780000.14785000","chr5.15000000.15005000",220000,12,0.003736928,14780000,1.5e+07,14785000,15005000,"chr5",215545,0,2,1,3,"chr5",1,0.00421940928270042
"6673","chr5.16665000.16670000","chr5.16690000.16695000",25000,34,0.003956721,16665000,16690000,16670000,16695000,"chr5",215586,0,3,0,3,"chr5",1,0.0119549929676512
"6674","chr5.31580000.31585000","chr5.31820000.31825000",240000,28,1.307163e-16,31580000,31820000,31585000,31825000,"chr5",215594,2,14,9,25,"chr5",1,0.0820440693858415
"6675","chr5.90395000.90400000","chr5.90525000.90530000",130000,14,0.006722729,90395000,90525000,90400000,90530000,"chr5",215641,0,1,0,1,"chr5",1,0.00164088138771683
"6676","chr5.145960000.145965000","chr5.146565000.146570000",605000,10,0.0002576878,145960000,146565000,145965000,146570000,"chr5",215682,2,4,2,8,"chr5",1,0.00937646507266761
"6677","chr5.95025000.95030000","chr5.95660000.95665000",635000,9,0.00110405,95025000,95660000,95030000,95665000,"chr5",215701,0,2,0,2,"chr5",1,0.00210970464135021
"6678","chr5.16485000.16490000","chr5.16740000.16745000",255000,11,0.005563889,16485000,16740000,16490000,16745000,"chr5",215714,2,7,2,11,"chr5",1,0.0141819034224098
"6679","chr5.139090000.139095000","chr5.139150000.139155000",60000,22,0.000864842,139090000,139150000,139095000,139155000,"chr5",215738,0,4,5,9,"chr5",1,0.0232067510548523
"6680","chr5.169855000.169860000","chr5.170045000.170050000",190000,12,0.008402274,169855000,170045000,169860000,170050000,"chr5",215778,3,3,3,9,"chr5",1,0.0126582278481013
"6681","chr5.151050000.151055000","chr5.151115000.151120000",65000,29,6.594718e-08,151050000,151115000,151055000,151120000,"chr5",215813,5,5,4,14,"chr5",1,0.0475855602437881
"6682","chr5.11265000.11270000","chr5.11685000.11690000",420000,12,7.54177e-05,11265000,11685000,11270000,11690000,"chr5",215899,0,1,0,1,"chr5",1,0.00140646976090014
"6683","chr5.58360000.58365000","chr5.58390000.58395000",30000,41,1.944373e-07,58360000,58390000,58365000,58395000,"chr5",215910,0,0,4,4,"chr5",1,0.0192217533989686
"6684","chr5.137935000.137940000","chr5.138535000.138540000",600000,14,8.666342e-08,137935000,138535000,137940000,138540000,"chr5",215920,0,2,1,3,"chr5",1,0.00492264416315049
"6685","chr5.43620000.43625000","chr5.43640000.43645000",20000,38,0.00150338,43620000,43640000,43625000,43645000,"chr5",215985,4,4,4,12,"chr5",1,0.0534458509142053
"6686","chr5.10330000.10335000","chr5.10350000.10355000",20000,44,1.51999e-05,10330000,10350000,10335000,10355000,"chr5",216007,1,5,10,16,"chr5",1,0.0825128926394749
"6687","chr5.172720000.172725000","chr5.173010000.173015000",290000,12,0.0006828032,172720000,173010000,172725000,173015000,"chr5",216097,0,3,1,4,"chr5",1,0.00562587904360056
"6688","chr5.34485000.34490000","chr5.34835000.34840000",350000,14,7.40698e-06,34485000,34835000,34490000,34840000,"chr5",216130,0,2,1,3,"chr5",1,0.00492264416315049
"6689","chr5.32485000.32490000","chr5.32610000.32615000",125000,32,2.812029e-15,32485000,32610000,32490000,32615000,"chr5",216131,3,7,8,18,"chr5",1,0.0675105485232067
"6690","chr5.15795000.15800000","chr5.15820000.15825000",25000,38,0.0002166689,15795000,15820000,15800000,15825000,"chr5",216175,0,1,1,2,"chr5",1,0.00890764181903422
"6691","chr5.16710000.16715000","chr5.17130000.17135000",420000,10,0.001920287,16710000,17130000,16715000,17135000,"chr5",216181,1,5,11,17,"chr5",1,0.0199249882794187
"6692","chr5.177040000.177045000","chr5.177495000.177500000",455000,10,0.001274391,177040000,177495000,177045000,177500000,"chr5",216225,0,2,2,4,"chr5",1,0.0046882325363338
"6693","chr5.16775000.16780000","chr5.17190000.17195000",415000,9,0.008398761,16775000,17190000,16780000,17195000,"chr5",216303,2,8,2,12,"chr5",1,0.0126582278481013
"6694","chr5.79045000.79050000","chr5.79375000.79380000",330000,10,0.005624349,79045000,79375000,79050000,79380000,"chr5",216370,2,4,4,10,"chr5",1,0.0117205813408345
"6695","chr5.142020000.142025000","chr5.142080000.142085000",60000,30,7.129965e-08,142020000,142080000,142025000,142085000,"chr5",216378,4,13,12,29,"chr5",1,0.10196905766526
"6696","chr5.172180000.172185000","chr5.172345000.172350000",165000,13,0.005863382,172180000,172345000,172185000,172350000,"chr5",216391,2,4,1,7,"chr5",1,0.0106657290201594
"6697","chr5.139630000.139635000","chr5.139675000.139680000",45000,28,6.194802e-05,139630000,139675000,139635000,139680000,"chr5",216504,1,1,1,3,"chr5",1,0.00984528832630099
"6698","chr5.36580000.36585000","chr5.36690000.36695000",110000,17,0.0006572664,36580000,36690000,36585000,36695000,"chr5",216533,0,2,5,7,"chr5",1,0.0139474917955931
"6699","chr5.74540000.74545000","chr5.74980000.74985000",440000,10,0.001517047,74540000,74980000,74545000,74985000,"chr5",216566,0,5,3,8,"chr5",1,0.00937646507266761
"6700","chr5.138175000.138180000","chr5.138385000.138390000",210000,15,8.493596e-05,138175000,138385000,138180000,138390000,"chr5",216567,0,20,22,42,"chr5",1,0.0738396624472574
"6701","chr5.167835000.167840000","chr5.167860000.167865000",25000,36,0.0009835376,167835000,167860000,167840000,167865000,"chr5",216594,0,2,1,3,"chr5",1,0.0126582278481013
"6702","chr5.95550000.95555000","chr5.95660000.95665000",110000,18,0.0001935739,95550000,95660000,95555000,95665000,"chr5",216599,0,3,2,5,"chr5",1,0.0105485232067511
"6703","chr5.95005000.95010000","chr5.95025000.95030000",20000,49,1.607547e-07,95005000,95025000,95010000,95030000,"chr5",216701,0,2,0,2,"chr5",1,0.0114861697140178
"6704","chr5.112385000.112390000","chr5.112665000.112670000",280000,13,0.0001890017,112385000,112665000,112390000,112670000,"chr5",216708,1,9,13,23,"chr5",1,0.0350445382090952
"6705","chr5.138945000.138950000","chr5.138985000.138990000",40000,40,3.398542e-10,138945000,138985000,138950000,138990000,"chr5",216709,1,1,2,4,"chr5",1,0.0187529301453352
"6706","chr5.55225000.55230000","chr5.55495000.55500000",270000,13,0.0002459291,55225000,55495000,55230000,55500000,"chr5",216734,0,3,3,6,"chr5",1,0.00914205344585091
"6707","chr5.137700000.137705000","chr5.138640000.138645000",940000,7,0.004551179,137700000,138640000,137705000,138645000,"chr5",216747,0,4,2,6,"chr5",1,0.00492264416315049
"6708","chr5.172720000.172725000","chr5.172980000.172985000",260000,13,0.0003232294,172720000,172980000,172725000,172985000,"chr5",216764,0,3,1,4,"chr5",1,0.00609470229723394
"6709","chr5.31580000.31585000","chr5.31740000.31745000",160000,13,0.006937252,31580000,31740000,31585000,31745000,"chr5",216826,4,0,3,7,"chr5",1,0.0106657290201594
"6710","chr5.10320000.10325000","chr5.10350000.10355000",30000,35,7.074987e-05,10320000,10350000,10325000,10355000,"chr5",216842,4,5,10,19,"chr5",1,0.0779418659165495
"6711","chr5.79395000.79400000","chr5.79610000.79615000",215000,15,7.001277e-05,79395000,79610000,79400000,79615000,"chr5",216846,0,3,0,3,"chr5",1,0.00527426160337553
"6712","chr5.137920000.137925000","chr5.138540000.138545000",620000,8,0.006231724,137920000,138540000,137925000,138545000,"chr5",216862,2,1,3,6,"chr5",1,0.00562587904360056
"6713","chr5.138135000.138140000","chr5.138575000.138580000",440000,10,0.001517047,138135000,138575000,138140000,138580000,"chr5",216886,0,13,16,29,"chr5",1,0.0339896858884201
"6714","chr5.139025000.139030000","chr5.139150000.139155000",125000,15,0.002826812,139025000,139150000,139030000,139155000,"chr5",216906,0,4,5,9,"chr5",1,0.0158227848101266
"6715","chr5.10450000.10455000","chr5.10635000.10640000",185000,12,0.00976683,10450000,10635000,10455000,10640000,"chr5",216907,2,1,2,5,"chr5",1,0.0070323488045007
"6716","chr5.126040000.126045000","chr5.126095000.126100000",55000,28,3.968717e-06,126040000,126095000,126045000,126100000,"chr5",216934,0,2,2,4,"chr5",1,0.0131270511017346
"6717","chr5.32310000.32315000","chr5.32440000.32445000",130000,15,0.002240806,32310000,32440000,32315000,32445000,"chr5",217021,4,10,11,25,"chr5",1,0.0439521800281294
"6718","chr5.14660000.14665000","chr5.14810000.14815000",150000,21,1.66016e-07,14660000,14810000,14665000,14815000,"chr5",217045,1,6,4,11,"chr5",1,0.0270745428973277
"6719","chr5.10280000.10285000","chr5.10400000.10405000",120000,17,0.0003496829,10280000,10400000,10285000,10405000,"chr5",217054,0,2,0,2,"chr5",1,0.00398499765588373
"6720","chr5.95285000.95290000","chr5.95660000.95665000",375000,16,9.65087e-08,95285000,95660000,95290000,95665000,"chr5",217096,1,4,8,13,"chr5",1,0.0243788091889358
"6721","chr5.40795000.40800000","chr5.40835000.40840000",40000,48,3.171043e-15,40795000,40835000,40800000,40840000,"chr5",217162,0,2,2,4,"chr5",1,0.0225035161744023
"6722","chr5.14790000.14795000","chr5.14865000.14870000",75000,22,6.845682e-05,14790000,14865000,14795000,14870000,"chr5",217164,2,12,5,19,"chr5",1,0.0489920300046882
"6723","chr5.95005000.95010000","chr5.95060000.95065000",55000,26,3.890122e-05,95005000,95060000,95010000,95065000,"chr5",217194,4,3,4,11,"chr5",1,0.0335208626347867
"6724","chr5.41870000.41875000","chr5.41900000.41905000",30000,37,1.127388e-05,41870000,41900000,41875000,41905000,"chr5",217222,1,1,9,11,"chr5",1,0.0477027660571964
"6725","chr5.71620000.71625000","chr5.72135000.72140000",515000,9,0.003229532,71620000,72135000,71625000,72140000,"chr5",217231,3,6,6,15,"chr5",1,0.0158227848101266
"6726","chr5.72280000.72285000","chr5.72300000.72305000",20000,49,1.607547e-07,72280000,72300000,72285000,72305000,"chr5",217245,1,0,1,2,"chr5",1,0.0114861697140178
"6727","chr5.124825000.124830000","chr5.125150000.125155000",325000,17,4.739136e-08,124825000,125150000,124830000,125155000,"chr5",217251,0,3,1,4,"chr5",1,0.00796999531176746
"6728","chr5.11265000.11270000","chr5.11380000.11385000",115000,22,4.999022e-07,11265000,11380000,11270000,11385000,"chr5",217253,0,3,4,7,"chr5",1,0.0180496952648851
"6729","chr5.142055000.142060000","chr5.142075000.142080000",20000,48,4.210033e-07,142055000,142075000,142060000,142080000,"chr5",217275,3,6,7,16,"chr5",1,0.090014064697609
"6730","chr5.139110000.139115000","chr5.139140000.139145000",30000,65,1.624858e-21,139110000,139140000,139115000,139145000,"chr5",217393,6,13,13,32,"chr5",1,0.243788091889358
"6731","chr5.14660000.14665000","chr5.15000000.15005000",340000,27,2.956327e-18,14660000,1.5e+07,14665000,15005000,"chr5",217426,1,4,3,8,"chr5",1,0.0253164556962025
"6732","chr5.138445000.138450000","chr5.138630000.138635000",185000,13,0.003066853,138445000,138630000,138450000,138635000,"chr5",217432,1,6,2,9,"chr5",1,0.0137130801687764
"6733","chr5.139260000.139265000","chr5.139415000.139420000",155000,16,0.0002166689,139260000,139415000,139265000,139420000,"chr5",217457,3,7,5,15,"chr5",1,0.0281293952180028
"6734","chr5.138500000.138505000","chr5.138650000.138655000",150000,13,0.009673788,138500000,138650000,138505000,138655000,"chr5",217500,5,13,10,28,"chr5",1,0.0426629160806376
"6735","chr5.172720000.172725000","chr5.173045000.173050000",325000,16,3.308006e-07,172720000,173045000,172725000,173050000,"chr5",217518,0,3,1,4,"chr5",1,0.00750117205813408
"6736","chr5.138075000.138080000","chr5.138640000.138645000",565000,8,0.009382133,138075000,138640000,138080000,138645000,"chr5",217587,1,6,2,9,"chr5",1,0.00843881856540084
"6737","chr5.14370000.14375000","chr5.14660000.14665000",290000,16,9.279125e-07,14370000,14660000,14375000,14665000,"chr5",217589,1,5,4,10,"chr5",1,0.0187529301453352
"6738","chr5.135245000.135250000","chr5.135565000.135570000",320000,12,0.0003715073,135245000,135565000,135250000,135570000,"chr5",217615,2,0,1,3,"chr5",1,0.00421940928270042
"6739","chr5.79460000.79465000","chr5.79515000.79520000",55000,21,0.005222236,79460000,79515000,79465000,79520000,"chr5",217616,1,9,9,19,"chr5",1,0.0467651195499297
"6740","chr5.127230000.127235000","chr5.127340000.127345000",110000,16,0.002032344,127230000,127340000,127235000,127345000,"chr5",217650,0,2,3,5,"chr5",1,0.00937646507266761
"6741","chr5.71860000.71865000","chr5.72145000.72150000",285000,12,0.0007528658,71860000,72145000,71865000,72150000,"chr5",217672,0,1,2,3,"chr5",1,0.00421940928270042
"6742","chr5.137950000.137955000","chr5.138640000.138645000",690000,9,0.0007169142,137950000,138640000,137955000,138645000,"chr5",217730,2,6,2,10,"chr5",1,0.0105485232067511
"6743","chr5.34515000.34520000","chr5.34915000.34920000",400000,12,0.0001026764,34515000,34915000,34520000,34920000,"chr5",217732,3,9,7,19,"chr5",1,0.0267229254571027
"6744","chr5.139745000.139750000","chr5.140010000.140015000",265000,15,1.178151e-05,139745000,140010000,139750000,140015000,"chr5",217736,0,0,1,1,"chr5",1,0.00175808720112518
"6745","chr5.16485000.16490000","chr5.16625000.16630000",140000,14,0.004653114,16485000,16625000,16490000,16630000,"chr5",217756,2,5,2,9,"chr5",1,0.0147679324894515
"6746","chr5.80255000.80260000","chr5.80480000.80485000",225000,13,0.0008726193,80255000,80480000,80260000,80485000,"chr5",217765,2,7,3,12,"chr5",1,0.0182841068917018
"6747","chr5.16690000.16695000","chr5.17185000.17190000",495000,10,0.0008221505,16690000,17185000,16695000,17190000,"chr5",217773,2,4,3,9,"chr5",1,0.0105485232067511
"6748","chr5.74645000.74650000","chr5.74980000.74985000",335000,10,0.005327353,74645000,74980000,74650000,74985000,"chr5",217858,0,5,4,9,"chr5",1,0.0105485232067511
"6749","chr5.95025000.95030000","chr5.95550000.95555000",525000,9,0.002923513,95025000,95550000,95030000,95555000,"chr5",217886,0,2,0,2,"chr5",1,0.00210970464135021
"6750","chr5.31825000.31830000","chr5.32090000.32095000",265000,27,2.122562e-16,31825000,32090000,31830000,32095000,"chr5",217908,1,7,9,17,"chr5",1,0.0537974683544304
"6751","chr5.173470000.173475000","chr5.173730000.173735000",260000,23,2.588804e-12,173470000,173730000,173475000,173735000,"chr5",217922,2,3,3,8,"chr5",1,0.0215658696671355
"6752","chr5.14115000.14120000","chr5.14265000.14270000",150000,15,0.0009720877,14115000,14265000,14120000,14270000,"chr5",217975,0,3,1,4,"chr5",1,0.0070323488045007
"6753","chr5.42810000.42815000","chr5.42870000.42875000",60000,24,0.0001094911,42810000,42870000,42815000,42875000,"chr5",218020,0,1,2,3,"chr5",1,0.00843881856540084
"6754","chr5.32485000.32490000","chr5.32575000.32580000",90000,21,3.05422e-05,32485000,32575000,32490000,32580000,"chr5",218049,3,8,7,18,"chr5",1,0.0443037974683544
"6755","chr5.15515000.15520000","chr5.15820000.15825000",305000,10,0.008090368,15515000,15820000,15520000,15825000,"chr5",218063,1,10,6,17,"chr5",1,0.0199249882794187
"6756","chr5.95015000.95020000","chr5.95680000.95685000",665000,9,0.0008723933,95015000,95680000,95020000,95685000,"chr5",218085,1,0,2,3,"chr5",1,0.00316455696202532
"6757","chr5.16485000.16490000","chr5.17185000.17190000",700000,16,1.551373e-10,16485000,17185000,16490000,17190000,"chr5",218114,2,4,2,8,"chr5",1,0.0150023441162682
"6758","chr5.42950000.42955000","chr5.43015000.43020000",65000,19,0.006346632,42950000,43015000,42955000,43020000,"chr5",218118,0,1,2,3,"chr5",1,0.00668073136427567
"6759","chr5.11505000.11510000","chr5.11565000.11570000",60000,22,0.000864842,11505000,11565000,11510000,11570000,"chr5",218123,1,3,6,10,"chr5",1,0.0257852789498359
"6760","chr5.137695000.137700000","chr5.137740000.137745000",45000,24,0.002624523,137695000,137740000,137700000,137745000,"chr5",218148,0,2,2,4,"chr5",1,0.0112517580872011
"6761","chr5.137885000.137890000","chr5.138660000.138665000",775000,9,0.000365338,137885000,138660000,137890000,138665000,"chr5",218172,3,3,7,13,"chr5",1,0.0137130801687764
"6762","chr5.76330000.76335000","chr5.76370000.76375000",40000,26,0.001748132,76330000,76370000,76335000,76375000,"chr5",218229,1,1,1,3,"chr5",1,0.00914205344585091
"6763","chr5.138435000.138440000","chr5.138530000.138535000",95000,20,6.098894e-05,138435000,138530000,138440000,138535000,"chr5",218238,2,1,1,4,"chr5",1,0.00937646507266761
"6764","chr5.43065000.43070000","chr5.43385000.43390000",320000,12,0.0003715073,43065000,43385000,43070000,43390000,"chr5",218305,2,3,9,14,"chr5",1,0.019690576652602
"6765","chr5.138945000.138950000","chr5.138970000.138975000",25000,34,0.003956721,138945000,138970000,138950000,138975000,"chr5",218344,1,1,2,4,"chr5",1,0.0159399906235349
"6766","chr5.42810000.42815000","chr5.42905000.42910000",95000,22,4.388156e-06,42810000,42905000,42815000,42910000,"chr5",218350,0,3,3,6,"chr5",1,0.0154711673699015
"6767","chr5.172145000.172150000","chr5.172290000.172295000",145000,17,9.237427e-05,172145000,172290000,172150000,172295000,"chr5",218456,2,4,2,8,"chr5",1,0.0159399906235349
"6768","chr5.78295000.78300000","chr5.78815000.78820000",520000,9,0.003066853,78295000,78815000,78300000,78820000,"chr5",218524,0,5,4,9,"chr5",1,0.00949367088607595
"6769","chr5.33435000.33440000","chr5.33995000.34000000",560000,15,1.836382e-08,33435000,33995000,33440000,3.4e+07,"chr5",218583,1,4,3,8,"chr5",1,0.0140646976090014
"6770","chr5.172145000.172150000","chr5.172185000.172190000",40000,26,0.001748132,172145000,172185000,172150000,172190000,"chr5",218672,1,4,2,7,"chr5",1,0.0213314580403188
"6771","chr5.16540000.16545000","chr5.16690000.16695000",150000,13,0.009673788,16540000,16690000,16545000,16695000,"chr5",218680,2,10,10,22,"chr5",1,0.0335208626347867
"6772","chr5.34470000.34475000","chr5.35000000.35005000",530000,9,0.002826812,34470000,3.5e+07,34475000,35005000,"chr5",218693,0,3,1,4,"chr5",1,0.00421940928270042
"6773","chr5.42905000.42910000","chr5.43035000.43040000",130000,17,0.0001970185,42905000,43035000,42910000,43040000,"chr5",218706,3,4,4,11,"chr5",1,0.0219174871073605
"6774","chr5.10455000.10460000","chr5.10625000.10630000",170000,14,0.001517047,10455000,10625000,10460000,10630000,"chr5",218754,0,2,1,3,"chr5",1,0.00492264416315049
"6775","chr5.137950000.137955000","chr5.138595000.138600000",645000,15,4.311297e-09,137950000,138595000,137955000,138600000,"chr5",218787,3,8,5,16,"chr5",1,0.0281293952180028
"6776","chr5.14725000.14730000","chr5.15000000.15005000",275000,89,3.588637e-102,14725000,1.5e+07,14730000,15005000,"chr5",218788,1,4,3,8,"chr5",1,0.0834505391467417
"6777","chr5.32260000.32265000","chr5.32295000.32300000",35000,39,3.380182e-08,32260000,32295000,32265000,32300000,"chr5",218883,1,6,11,18,"chr5",1,0.0822784810126582
"6778","chr5.137845000.137850000","chr5.137865000.137870000",20000,38,0.00150338,137845000,137865000,137850000,137870000,"chr5",218949,1,1,2,4,"chr5",1,0.0178152836380684
"6779","chr5.139025000.139030000","chr5.139110000.139115000",85000,21,5.692649e-05,139025000,139110000,139030000,139115000,"chr5",218952,6,13,13,32,"chr5",1,0.0787623066104079
"6780","chr5.31580000.31585000","chr5.31805000.31810000",225000,57,2.180298e-50,31580000,31805000,31585000,31810000,"chr5",218958,0,5,1,6,"chr5",1,0.040084388185654
"6781","chr5.16700000.16705000","chr5.17185000.17190000",485000,23,3.478632e-16,16700000,17185000,16705000,17190000,"chr5",218963,2,4,1,7,"chr5",1,0.0188701359587436
"6782","chr5.35650000.35655000","chr5.35925000.35930000",275000,21,8.642174e-11,35650000,35925000,35655000,35930000,"chr5",218986,0,3,2,5,"chr5",1,0.0123066104078762
"6783","chr5.43065000.43070000","chr5.43105000.43110000",40000,24,0.008398761,43065000,43105000,43070000,43110000,"chr5",219027,0,10,11,21,"chr5",1,0.0590717299578059
"6784","chr5.16780000.16785000","chr5.17185000.17190000",405000,23,5.097227e-15,16780000,17185000,16785000,17190000,"chr5",219029,2,4,3,9,"chr5",1,0.0242616033755274
"6785","chr5.56195000.56200000","chr5.56455000.56460000",260000,11,0.005013366,56195000,56455000,56200000,56460000,"chr5",219147,1,4,1,6,"chr5",1,0.00773558368495077
"6786","chr5.180205000.180210000","chr5.180290000.180295000",85000,21,5.692649e-05,180205000,180290000,180210000,180295000,"chr5",219164,0,3,1,4,"chr5",1,0.00984528832630099
"6787","chr5.16465000.16470000","chr5.16790000.16795000",325000,13,6.957424e-05,16465000,16790000,16470000,16795000,"chr5",219228,0,4,1,5,"chr5",1,0.00761837787154243
"6788","chr5.10600000.10605000","chr5.10625000.10630000",25000,34,0.003956721,10600000,10625000,10605000,10630000,"chr5",219279,4,10,6,20,"chr5",1,0.0796999531176746
"6789","chr5.88760000.88765000","chr5.88785000.88790000",25000,35,0.002014277,88760000,88785000,88765000,88790000,"chr5",219306,1,4,4,9,"chr5",1,0.0369198312236287
"6790","chr5.141080000.141085000","chr5.141325000.141330000",245000,13,0.0004798947,141080000,141325000,141085000,141330000,"chr5",219329,1,9,8,18,"chr5",1,0.0274261603375527
"6791","chr5.174380000.174385000","chr5.174870000.174875000",490000,19,7.429622e-12,174380000,174870000,174385000,174875000,"chr5",219344,0,0,5,5,"chr5",1,0.0111345522737928
"6792","chr5.138050000.138055000","chr5.138535000.138540000",485000,10,0.0009105998,138050000,138535000,138055000,138540000,"chr5",219378,5,7,16,28,"chr5",1,0.0328176277543366
"6793","chr5.31580000.31585000","chr5.32090000.32095000",510000,28,1.443006e-22,31580000,32090000,31585000,32095000,"chr5",219426,1,13,9,23,"chr5",1,0.0754805438349742
"6794","chr5.176550000.176555000","chr5.176710000.176715000",160000,18,9.981049e-06,176550000,176710000,176555000,176715000,"chr5",219447,4,8,5,17,"chr5",1,0.0358649789029536
"6795","chr5.72135000.72140000","chr5.72155000.72160000",20000,39,0.0007493829,72135000,72155000,72140000,72160000,"chr5",219454,3,6,6,15,"chr5",1,0.0685654008438819
"6796","chr5.176605000.176610000","chr5.176710000.176715000",105000,19,8.241739e-05,176605000,176710000,176610000,176715000,"chr5",219559,4,8,3,15,"chr5",1,0.0334036568213783
"6797","chr5.16555000.16560000","chr5.16585000.16590000",30000,30,0.003924178,16555000,16585000,16560000,16590000,"chr5",219584,0,1,2,3,"chr5",1,0.0105485232067511
"6798","chr5.32400000.32405000","chr5.32610000.32615000",210000,12,0.004852777,32400000,32610000,32405000,32615000,"chr5",219592,3,5,6,14,"chr5",1,0.019690576652602
"6799","chr5.32310000.32315000","chr5.32445000.32450000",135000,24,3.311651e-09,32310000,32445000,32315000,32450000,"chr5",219611,3,11,7,21,"chr5",1,0.0590717299578059
"6800","chr5.159530000.159535000","chr5.159770000.159775000",240000,14,0.0001292118,159530000,159770000,159535000,159775000,"chr5",219638,0,3,1,4,"chr5",1,0.00656352555086732
"6801","chr5.115470000.115475000","chr5.115830000.115835000",360000,13,3.575872e-05,115470000,115830000,115475000,115835000,"chr5",219641,1,2,2,5,"chr5",1,0.00761837787154243
"6802","chr5.79435000.79440000","chr5.79550000.79555000",115000,25,4.136556e-09,79435000,79550000,79440000,79555000,"chr5",219643,1,1,6,8,"chr5",1,0.023441162681669
"6803","chr5.139755000.139760000","chr5.139785000.139790000",30000,40,5.608063e-07,139755000,139785000,139760000,139790000,"chr5",219648,1,7,6,14,"chr5",1,0.0656352555086732
"6804","chr5.39945000.39950000","chr5.40735000.40740000",790000,16,3.631795e-11,39945000,40735000,39950000,40740000,"chr5",219662,0,4,3,7,"chr5",1,0.0131270511017346
"6805","chr5.37840000.37845000","chr5.38190000.38195000",350000,26,2.344556e-17,37840000,38190000,37845000,38195000,"chr5",219687,0,2,0,2,"chr5",1,0.00609470229723394
"6806","chr5.74640000.74645000","chr5.74980000.74985000",340000,13,5.168519e-05,74640000,74980000,74645000,74985000,"chr5",219717,0,3,3,6,"chr5",1,0.00914205344585091
"6807","chr5.176550000.176555000","chr5.176700000.176705000",150000,14,0.003210755,176550000,176700000,176555000,176705000,"chr5",219725,0,2,1,3,"chr5",1,0.00492264416315049
"6808","chr5.59595000.59600000","chr5.59680000.59685000",85000,17,0.004736201,59595000,59680000,59600000,59685000,"chr5",219733,0,0,1,1,"chr5",1,0.00199249882794187
"6809","chr5.38265000.38270000","chr5.38370000.38375000",105000,16,0.002826812,38265000,38370000,38270000,38375000,"chr5",219736,0,2,2,4,"chr5",1,0.00750117205813408
"6810","chr5.79460000.79465000","chr5.79555000.79560000",95000,23,1.080495e-06,79460000,79555000,79465000,79560000,"chr5",219742,3,9,5,17,"chr5",1,0.0458274730426629
"6811","chr5.42805000.42810000","chr5.42870000.42875000",65000,32,8.805049e-10,42805000,42870000,42810000,42875000,"chr5",219800,0,1,2,3,"chr5",1,0.0112517580872011
"6812","chr5.139090000.139095000","chr5.139110000.139115000",20000,50,6.044682e-08,139090000,139110000,139095000,139115000,"chr5",219810,6,11,6,23,"chr5",1,0.134786685419597
"6813","chr5.11265000.11270000","chr5.11465000.11470000",200000,13,0.001898328,11265000,11465000,11270000,11470000,"chr5",219813,0,9,2,11,"chr5",1,0.0167604313173933
"6814","chr5.16540000.16545000","chr5.16700000.16705000",160000,14,0.002211367,16540000,16700000,16545000,16705000,"chr5",219832,2,7,1,10,"chr5",1,0.0164088138771683
"6815","chr5.132065000.132070000","chr5.132215000.132220000",150000,16,0.0002772004,132065000,132215000,132070000,132220000,"chr5",219844,0,0,1,1,"chr5",1,0.00187529301453352
"6816","chr5.61555000.61560000","chr5.61630000.61635000",75000,18,0.004787281,61555000,61630000,61560000,61635000,"chr5",219862,1,0,0,1,"chr5",1,0.00210970464135021
"6817","chr5.43105000.43110000","chr5.43390000.43395000",285000,16,1.078882e-06,43105000,43390000,43110000,43395000,"chr5",219870,0,11,9,20,"chr5",1,0.0375058602906704
"6818","chr5.159455000.159460000","chr5.159615000.159620000",160000,17,4.300376e-05,159455000,159615000,159460000,159620000,"chr5",219989,0,3,3,6,"chr5",1,0.0119549929676512
"6819","chr5.137865000.137870000","chr5.137885000.137890000",20000,38,0.00150338,137865000,137885000,137870000,137890000,"chr5",219994,1,1,2,4,"chr5",1,0.0178152836380684
"6820","chr5.78815000.78820000","chr5.79375000.79380000",560000,9,0.002137716,78815000,79375000,78820000,79380000,"chr5",220008,0,5,4,9,"chr5",1,0.00949367088607595
"6821","chr5.126855000.126860000","chr5.127515000.127520000",660000,8,0.004736201,126855000,127515000,126860000,127520000,"chr5",220014,0,3,3,6,"chr5",1,0.00562587904360056
"6822","chr5.15105000.15110000","chr5.15795000.15800000",690000,14,2.242388e-08,15105000,15795000,15110000,15800000,"chr5",220030,0,1,1,2,"chr5",1,0.00328176277543366
"6823","chr5.20970000.20975000","chr5.21800000.21805000",830000,7,0.00840552,20970000,21800000,20975000,21805000,"chr5",220113,0,2,1,3,"chr5",1,0.00246132208157525
"6824","chr5.56160000.56165000","chr5.56455000.56460000",295000,15,4.718346e-06,56160000,56455000,56165000,56460000,"chr5",220165,1,2,1,4,"chr5",1,0.0070323488045007
"6825","chr5.37045000.37050000","chr5.37070000.37075000",25000,55,7.211743e-12,37045000,37070000,37050000,37075000,"chr5",220191,0,4,3,7,"chr5",1,0.0451242381622128
"6826","chr5.33995000.34000000","chr5.34470000.34475000",475000,18,1.161844e-10,33995000,34470000,3.4e+07,34475000,"chr5",220247,1,3,1,5,"chr5",1,0.0105485232067511
"6827","chr5.166710000.166715000","chr5.167550000.167555000",840000,7,0.008068309,166710000,167550000,166715000,167555000,"chr5",220269,0,1,0,1,"chr5",1,0.000820440693858415
"6828","chr5.38455000.38460000","chr5.38805000.38810000",350000,10,0.004394792,38455000,38805000,38460000,38810000,"chr5",220449,0,2,1,3,"chr5",1,0.00351617440225035
"6829","chr5.31635000.31640000","chr5.31725000.31730000",90000,20,0.0001064071,31635000,31725000,31640000,31730000,"chr5",220451,0,5,6,11,"chr5",1,0.0257852789498359
"6830","chr5.31925000.31930000","chr5.32030000.32035000",105000,31,4.125962e-13,31925000,32030000,31930000,32035000,"chr5",220477,0,5,1,6,"chr5",1,0.0218002812939522
"6831","chr5.10450000.10455000","chr5.10640000.10645000",190000,16,4.425685e-05,10450000,10640000,10455000,10645000,"chr5",220533,1,8,4,13,"chr5",1,0.0243788091889358
"6832","chr5.13985000.13990000","chr5.14140000.14145000",155000,16,0.0002166689,13985000,14140000,13990000,14145000,"chr5",220534,0,3,4,7,"chr5",1,0.0131270511017346
"6833","chr5.7880000.7885000","chr5.8365000.8370000",485000,12,2.883368e-05,7880000,8365000,7885000,8370000,"chr5",220558,1,2,4,7,"chr5",1,0.00984528832630099
"6834","chr5.38675000.38680000","chr5.38710000.38715000",35000,43,2.468754e-10,38675000,38710000,38680000,38715000,"chr5",220583,3,0,5,8,"chr5",1,0.0403187998124707
"6835","chr5.112160000.112165000","chr5.112905000.112910000",745000,11,9.120876e-06,112160000,112905000,112165000,112910000,"chr5",220585,1,4,4,9,"chr5",1,0.0116033755274262
"6836","chr5.172420000.172425000","chr5.172675000.172680000",255000,12,0.00150439,172420000,172675000,172425000,172680000,"chr5",220602,0,6,1,7,"chr5",1,0.00984528832630099
"6837","chr5.138750000.138755000","chr5.138970000.138975000",220000,12,0.003736928,138750000,138970000,138755000,138975000,"chr5",220628,4,18,11,33,"chr5",1,0.0464135021097046
"6838","chr5.171880000.171885000","chr5.172120000.172125000",240000,13,0.0005587827,171880000,172120000,171885000,172125000,"chr5",220649,1,4,3,8,"chr5",1,0.0121894045944679
"6839","chr5.31530000.31535000","chr5.32310000.32315000",780000,11,6.393347e-06,31530000,32310000,31535000,32315000,"chr5",220663,4,24,16,44,"chr5",1,0.056727613689639
"6840","chr5.31650000.31655000","chr5.31725000.31730000",75000,21,0.0002149335,31650000,31725000,31655000,31730000,"chr5",220686,1,14,20,35,"chr5",1,0.0861462728551336
"6841","chr5.157250000.157255000","chr5.157365000.157370000",115000,18,0.0001349849,157250000,157365000,157255000,157370000,"chr5",220693,0,2,0,2,"chr5",1,0.00421940928270042
"6842","chr5.123610000.123615000","chr5.123805000.123810000",195000,13,0.002223361,123610000,123805000,123615000,123810000,"chr5",220720,0,1,2,3,"chr5",1,0.00457102672292546
"6843","chr5.173905000.173910000","chr5.174140000.174145000",235000,11,0.008554958,173905000,174140000,173910000,174145000,"chr5",220724,0,6,4,10,"chr5",1,0.012892639474918
"6844","chr5.14705000.14710000","chr5.14865000.14870000",160000,17,4.300376e-05,14705000,14865000,14710000,14870000,"chr5",220746,4,12,8,24,"chr5",1,0.0478199718706048
"6845","chr5.11260000.11265000","chr5.11705000.11710000",445000,9,0.006248823,11260000,11705000,11265000,11710000,"chr5",220839,2,2,2,6,"chr5",1,0.00632911392405063
"6846","chr5.138630000.138635000","chr5.138645000.138650000",15000,38,0.00150338,138630000,138645000,138635000,138650000,"chr5",220843,1,1,0,2,"chr5",1,0.00890764181903422
"6847","chr5.43065000.43070000","chr5.43390000.43395000",325000,22,1.032633e-12,43065000,43390000,43070000,43395000,"chr5",220856,4,10,9,23,"chr5",1,0.0593061415846226
"6848","chr5.72155000.72160000","chr5.72245000.72250000",90000,23,2.146078e-06,72155000,72245000,72160000,72250000,"chr5",220870,0,4,0,4,"chr5",1,0.0107829348335677
"6849","chr5.77165000.77170000","chr5.77230000.77235000",65000,19,0.006346632,77165000,77230000,77170000,77235000,"chr5",220894,0,2,3,5,"chr5",1,0.0111345522737928
"6850","chr5.138190000.138195000","chr5.138440000.138445000",250000,11,0.00615903,138190000,138440000,138195000,138445000,"chr5",220951,6,25,23,54,"chr5",1,0.069620253164557
"6851","chr5.40795000.40800000","chr5.40875000.40880000",80000,18,0.00285359,40795000,40875000,40800000,40880000,"chr5",220958,0,2,2,4,"chr5",1,0.00843881856540084
"6852","chr5.146825000.146830000","chr5.146940000.146945000",115000,21,2.216769e-06,146825000,146940000,146830000,146945000,"chr5",220972,0,1,1,2,"chr5",1,0.00492264416315049
"6853","chr5.55530000.55535000","chr5.56160000.56165000",630000,8,0.005805021,55530000,56160000,55535000,56165000,"chr5",220974,0,2,9,11,"chr5",1,0.0103141115799344
"6854","chr5.38675000.38680000","chr5.38745000.38750000",70000,21,0.0004404381,38675000,38745000,38680000,38750000,"chr5",220983,0,5,3,8,"chr5",1,0.019690576652602
"6855","chr5.79485000.79490000","chr5.79550000.79555000",65000,23,0.0001176595,79485000,79550000,79490000,79555000,"chr5",221141,5,7,9,21,"chr5",1,0.0566104078762307
"6856","chr5.138535000.138540000","chr5.138595000.138600000",60000,22,0.000864842,138535000,138595000,138540000,138600000,"chr5",221191,3,8,5,16,"chr5",1,0.0412564463197375
"6857","chr5.22895000.22900000","chr5.23135000.23140000",240000,12,0.002189967,22895000,23135000,22900000,23140000,"chr5",221234,0,1,1,2,"chr5",1,0.00281293952180028
"6858","chr5.10285000.10290000","chr5.10350000.10355000",65000,22,0.0003496829,10285000,10350000,10290000,10355000,"chr5",221239,8,5,10,23,"chr5",1,0.0593061415846226
"6859","chr5.16600000.16605000","chr5.16665000.16670000",65000,21,0.0009709862,16600000,16665000,16605000,16670000,"chr5",221242,0,3,0,3,"chr5",1,0.00738396624472574
"6860","chr5.7875000.7880000","chr5.8840000.8845000",965000,9,7.870648e-05,7875000,8840000,7880000,8845000,"chr5",221256,0,6,7,13,"chr5",1,0.0137130801687764
"6861","chr5.139480000.139485000","chr5.139540000.139545000",60000,22,0.000864842,139480000,139540000,139485000,139545000,"chr5",221257,3,13,12,28,"chr5",1,0.0721987810595406
"6862","chr5.173015000.173020000","chr5.173420000.173425000",405000,9,0.009344014,173015000,173420000,173020000,173425000,"chr5",221272,2,3,3,8,"chr5",1,0.00843881856540084
"6863","chr5.132250000.132255000","chr5.133025000.133030000",775000,8,0.002223361,132250000,133025000,132255000,133030000,"chr5",221284,2,0,2,4,"chr5",1,0.00375058602906704
"6864","chr5.14815000.14820000","chr5.14865000.14870000",50000,24,0.0009179388,14815000,14865000,14820000,14870000,"chr5",221295,3,6,4,13,"chr5",1,0.0365682137834037
"6865","chr5.14105000.14110000","chr5.14140000.14145000",35000,41,2.9949e-09,14105000,14140000,14110000,14145000,"chr5",221370,0,3,2,5,"chr5",1,0.0240271917487107
"6866","chr5.138440000.138445000","chr5.138530000.138535000",90000,35,5.481938e-15,138440000,138530000,138445000,138535000,"chr5",221392,3,18,14,35,"chr5",1,0.143577121425223
"6867","chr5.138175000.138180000","chr5.138440000.138445000",265000,13,0.0002831107,138175000,138440000,138180000,138445000,"chr5",221410,6,25,25,56,"chr5",1,0.0853258321612752
"6868","chr5.16780000.16785000","chr5.17200000.17205000",420000,14,1.944323e-06,16780000,17200000,16785000,17205000,"chr5",221417,0,11,13,24,"chr5",1,0.0393811533052039
"6869","chr5.142505000.142510000","chr5.142735000.142740000",230000,13,0.0007493829,142505000,142735000,142510000,142740000,"chr5",221425,0,1,0,1,"chr5",1,0.00152367557430849
"6870","chr5.137920000.137925000","chr5.138535000.138540000",615000,11,3.595069e-05,137920000,138535000,137925000,138540000,"chr5",221429,3,11,4,18,"chr5",1,0.0232067510548523
"6871","chr5.133960000.133965000","chr5.133990000.133995000",30000,29,0.00778408,133960000,133990000,133965000,133995000,"chr5",221543,0,3,1,4,"chr5",1,0.013595874355368
"6872","chr5.173140000.173145000","chr5.173290000.173295000",150000,16,0.0002772004,173140000,173290000,173145000,173295000,"chr5",221554,0,4,5,9,"chr5",1,0.0168776371308017
"6873","chr5.71475000.71480000","chr5.71600000.71605000",125000,16,0.0008836393,71475000,71600000,71480000,71605000,"chr5",221580,9,21,29,59,"chr5",1,0.110642287857478
"6874","chr5.41925000.41930000","chr5.42905000.42910000",980000,10,7.574846e-06,41925000,42905000,41930000,42910000,"chr5",221657,0,0,6,6,"chr5",1,0.0070323488045007
"6875","chr5.31925000.31930000","chr5.32075000.32080000",150000,25,1.564262e-10,31925000,32075000,31930000,32080000,"chr5",221665,3,15,9,27,"chr5",1,0.0791139240506329
"6876","chr5.73215000.73220000","chr5.73970000.73975000",755000,8,0.002544284,73215000,73970000,73220000,73975000,"chr5",221708,2,3,5,10,"chr5",1,0.00937646507266761
"6877","chr5.34500000.34505000","chr5.34955000.34960000",455000,13,7.10669e-06,34500000,34955000,34505000,34960000,"chr5",221743,0,0,3,3,"chr5",1,0.00457102672292546
"6878","chr5.139965000.139970000","chr5.139995000.140000000",30000,36,2.874004e-05,139965000,139995000,139970000,1.4e+08,"chr5",221758,0,2,0,2,"chr5",1,0.00843881856540084
"6879","chr5.35835000.35840000","chr5.35855000.35860000",20000,52,7.794962e-09,35835000,35855000,35840000,35860000,"chr5",221765,0,4,2,6,"chr5",1,0.0365682137834037
"6880","chr5.32240000.32245000","chr5.32260000.32265000",20000,60,9.913537e-13,32240000,32260000,32245000,32265000,"chr5",221827,1,9,7,17,"chr5",1,0.119549929676512
"6881","chr5.76850000.76855000","chr5.77305000.77310000",455000,10,0.001274391,76850000,77305000,76855000,77310000,"chr5",221871,1,8,8,17,"chr5",1,0.0199249882794187
"6882","chr5.16565000.16570000","chr5.16615000.16620000",50000,28,1.565323e-05,16565000,16615000,16570000,16620000,"chr5",221876,0,0,5,5,"chr5",1,0.0164088138771683
"6883","chr5.11265000.11270000","chr5.11615000.11620000",350000,26,2.344556e-17,11265000,11615000,11270000,11620000,"chr5",221902,0,7,1,8,"chr5",1,0.0243788091889358
"6884","chr5.40755000.40760000","chr5.40835000.40840000",80000,37,2.039517e-15,40755000,40835000,40760000,40840000,"chr5",221915,1,6,5,12,"chr5",1,0.0520393811533052
"6885","chr5.80245000.80250000","chr5.80485000.80490000",240000,11,0.00773422,80245000,80485000,80250000,80490000,"chr5",221946,1,6,7,14,"chr5",1,0.0180496952648851
"6886","chr5.137880000.137885000","chr5.138535000.138540000",655000,11,2.284227e-05,137880000,138535000,137885000,138540000,"chr5",221959,5,18,12,35,"chr5",1,0.0451242381622128
"6887","chr5.80005000.80010000","chr5.80240000.80245000",235000,11,0.008554958,80005000,80240000,80010000,80245000,"chr5",222008,1,5,6,12,"chr5",1,0.0154711673699015
"6888","chr5.172865000.172870000","chr5.172980000.172985000",115000,18,0.0001349849,172865000,172980000,172870000,172985000,"chr5",222040,0,3,0,3,"chr5",1,0.00632911392405063
"6889","chr5.137865000.137870000","chr5.138645000.138650000",780000,9,0.0003569199,137865000,138645000,137870000,138650000,"chr5",222061,1,1,0,2,"chr5",1,0.00210970464135021
"6890","chr5.142490000.142495000","chr5.143375000.143380000",885000,7,0.006244689,142490000,143375000,142495000,143380000,"chr5",222064,2,0,2,4,"chr5",1,0.00328176277543366
"6891","chr5.159530000.159535000","chr5.159615000.159620000",85000,21,5.692649e-05,159530000,159615000,159535000,159620000,"chr5",222082,2,11,7,20,"chr5",1,0.0492264416315049
"6892","chr5.86880000.86885000","chr5.87065000.87070000",185000,22,2.559294e-09,86880000,87065000,86885000,87070000,"chr5",222126,0,1,5,6,"chr5",1,0.0154711673699015
"6893","chr5.172425000.172430000","chr5.172475000.172480000",50000,23,0.002254549,172425000,172475000,172430000,172480000,"chr5",222226,2,2,4,8,"chr5",1,0.0215658696671355
"6894","chr5.138900000.138905000","chr5.138945000.138950000",45000,27,0.0001694064,138900000,138945000,138905000,138950000,"chr5",222250,1,1,2,4,"chr5",1,0.0126582278481013
"6895","chr5.34500000.34505000","chr5.34895000.34900000",395000,16,6.166536e-08,34500000,34895000,34505000,34900000,"chr5",222265,1,5,9,15,"chr5",1,0.0281293952180028
"6896","chr5.176570000.176575000","chr5.176700000.176705000",130000,18,5.285156e-05,176570000,176700000,176575000,176705000,"chr5",222310,0,2,1,3,"chr5",1,0.00632911392405063
"6897","chr5.43105000.43110000","chr5.43190000.43195000",85000,18,0.001735721,43105000,43190000,43110000,43195000,"chr5",222326,0,11,12,23,"chr5",1,0.0485232067510548
"6898","chr5.16465000.16470000","chr5.16665000.16670000",200000,18,1.170921e-06,16465000,16665000,16470000,16670000,"chr5",222332,0,3,0,3,"chr5",1,0.00632911392405063
"6899","chr5.67195000.67200000","chr5.67215000.67220000",20000,35,0.009978941,67195000,67215000,67200000,67220000,"chr5",222355,0,0,4,4,"chr5",1,0.0164088138771683
"6900","chr5.171905000.171910000","chr5.172005000.172010000",100000,16,0.00394017,171905000,172005000,171910000,172010000,"chr5",222361,1,10,13,24,"chr5",1,0.0450070323488045
"6901","chr5.138440000.138445000","chr5.138535000.138540000",95000,16,0.005568258,138440000,138535000,138445000,138540000,"chr5",222390,5,25,22,52,"chr5",1,0.0975152367557431
"6902","chr5.112625000.112630000","chr5.112665000.112670000",40000,30,4.367471e-05,112625000,112665000,112630000,112670000,"chr5",222400,2,3,4,9,"chr5",1,0.0316455696202532
"6903","chr5.137920000.137925000","chr5.138515000.138520000",595000,8,0.007546877,137920000,138515000,137925000,138520000,"chr5",222411,3,11,4,18,"chr5",1,0.0168776371308017
"6904","chr5.33440000.33445000","chr5.33930000.33935000",490000,12,2.682383e-05,33440000,33930000,33445000,33935000,"chr5",222421,0,0,6,6,"chr5",1,0.00843881856540084
"6905","chr5.138945000.138950000","chr5.139340000.139345000",395000,10,0.002578088,138945000,139340000,138950000,139345000,"chr5",222422,1,1,2,4,"chr5",1,0.0046882325363338
"6906","chr5.16575000.16580000","chr5.16600000.16605000",25000,41,1.785992e-05,16575000,16600000,16580000,16605000,"chr5",222460,1,13,6,20,"chr5",1,0.0961087669948429
"6907","chr5.172720000.172725000","chr5.172940000.172945000",220000,12,0.003736928,172720000,172940000,172725000,172945000,"chr5",222475,0,3,1,4,"chr5",1,0.00562587904360056
"6908","chr5.137790000.137795000","chr5.137885000.137890000",95000,16,0.005568258,137790000,137885000,137795000,137890000,"chr5",222535,3,3,7,13,"chr5",1,0.0243788091889358
"6909","chr5.80565000.80570000","chr5.80585000.80590000",20000,49,1.607547e-07,80565000,80585000,80570000,80590000,"chr5",222552,1,4,0,5,"chr5",1,0.0287154242850445
"6910","chr5.96565000.96570000","chr5.96865000.96870000",300000,16,6.738042e-07,96565000,96865000,96570000,96870000,"chr5",222568,0,2,1,3,"chr5",1,0.00562587904360056
"6911","chr5.137790000.137795000","chr5.137880000.137885000",90000,16,0.008184516,137790000,137880000,137795000,137885000,"chr5",222667,5,11,12,28,"chr5",1,0.0525082044069386
"6912","chr5.31715000.31720000","chr5.31750000.31755000",35000,26,0.008554958,31715000,31750000,31720000,31755000,"chr5",222687,0,3,2,5,"chr5",1,0.0152367557430849
"6913","chr5.43005000.43010000","chr5.43065000.43070000",60000,23,0.0003182132,43005000,43065000,43010000,43070000,"chr5",222765,4,10,11,25,"chr5",1,0.0673933427097984
"6914","chr5.58360000.58365000","chr5.59065000.59070000",705000,8,0.003527558,58360000,59065000,58365000,59070000,"chr5",222793,0,0,2,2,"chr5",1,0.00187529301453352
"6915","chr5.39005000.39010000","chr5.39050000.39055000",45000,31,2.421324e-06,39005000,39050000,39010000,39055000,"chr5",222803,0,2,0,2,"chr5",1,0.00726676043131739
"6916","chr5.14370000.14375000","chr5.14705000.14710000",335000,10,0.005327353,14370000,14705000,14375000,14710000,"chr5",222815,4,5,4,13,"chr5",1,0.0152367557430849
"6917","chr5.124755000.124760000","chr5.124820000.124825000",65000,34,4.06649e-11,124755000,124820000,124760000,124825000,"chr5",222830,1,3,9,13,"chr5",1,0.0518049695264885
"6918","chr5.54640000.54645000","chr5.54895000.54900000",255000,18,8.471584e-08,54640000,54895000,54645000,54900000,"chr5",222837,0,5,2,7,"chr5",1,0.0147679324894515
"6919","chr5.137950000.137955000","chr5.138530000.138535000",580000,8,0.008342091,137950000,138530000,137955000,138535000,"chr5",222878,3,16,14,33,"chr5",1,0.0309423347398031
"6920","chr5.171520000.171525000","chr5.171625000.171630000",105000,15,0.007853845,171520000,171625000,171525000,171630000,"chr5",222884,0,2,1,3,"chr5",1,0.00527426160337553
"6921","chr5.39080000.39085000","chr5.39145000.39150000",65000,26,3.432456e-06,39080000,39145000,39085000,39150000,"chr5",222948,0,10,12,22,"chr5",1,0.0670417252695734
"6922","chr5.150515000.150520000","chr5.151115000.151120000",600000,8,0.007268889,150515000,151115000,150520000,151120000,"chr5",222979,3,10,9,22,"chr5",1,0.0206282231598687
"6923","chr5.41925000.41930000","chr5.42805000.42810000",880000,7,0.006424098,41925000,42805000,41930000,42810000,"chr5",223073,0,0,4,4,"chr5",1,0.00328176277543366
"6924","chr5.38280000.38285000","chr5.38370000.38375000",90000,17,0.003066853,38280000,38370000,38285000,38375000,"chr5",223083,0,1,2,3,"chr5",1,0.0059774964838256
"6925","chr5.71465000.71470000","chr5.71600000.71605000",135000,17,0.0001521422,71465000,71600000,71470000,71605000,"chr5",223140,9,21,29,59,"chr5",1,0.11755743084857
"6926","chr5.33440000.33445000","chr5.34000000.34005000",560000,11,6.832053e-05,33440000,3.4e+07,33445000,34005000,"chr5",223192,0,0,8,8,"chr5",1,0.0103141115799344
"6927","chr5.138945000.138950000","chr5.138980000.138985000",35000,27,0.004157539,138945000,138980000,138950000,138985000,"chr5",223200,1,1,2,4,"chr5",1,0.0126582278481013
"6928","chr5.33470000.33475000","chr5.33930000.33935000",460000,9,0.005469632,33470000,33930000,33475000,33935000,"chr5",223209,0,6,6,12,"chr5",1,0.0126582278481013
"6929","chr5.124390000.124395000","chr5.124920000.124925000",530000,9,0.002826812,124390000,124920000,124395000,124925000,"chr5",223265,1,5,3,9,"chr5",1,0.00949367088607595
"6930","chr5.38370000.38375000","chr5.38805000.38810000",435000,9,0.006937252,38370000,38805000,38375000,38810000,"chr5",223267,0,2,1,3,"chr5",1,0.00316455696202532
"6931","chr5.43105000.43110000","chr5.43280000.43285000",175000,13,0.00423995,43105000,43280000,43110000,43285000,"chr5",223271,0,2,1,3,"chr5",1,0.00457102672292546
"6932","chr5.32095000.32100000","chr5.32325000.32330000",230000,11,0.009687785,32095000,32325000,32100000,32330000,"chr5",223282,4,11,14,29,"chr5",1,0.0373886544772621
"6933","chr5.13985000.13990000","chr5.14645000.14650000",660000,8,0.004736201,13985000,14645000,13990000,14650000,"chr5",223306,0,7,4,11,"chr5",1,0.0103141115799344
"6934","chr5.167695000.167700000","chr5.167865000.167870000",170000,13,0.005005365,167695000,167865000,167700000,167870000,"chr5",223348,0,3,2,5,"chr5",1,0.00761837787154243
"6935","chr5.31910000.31915000","chr5.32075000.32080000",165000,13,0.005863382,31910000,32075000,31915000,32080000,"chr5",223351,2,14,9,25,"chr5",1,0.0380918893577121
"6936","chr5.41270000.41275000","chr5.41835000.41840000",565000,8,0.009382133,41270000,41835000,41275000,41840000,"chr5",223359,1,1,1,3,"chr5",1,0.00281293952180028
"6937","chr5.10245000.10250000","chr5.10440000.10445000",195000,13,0.002223361,10245000,10440000,10250000,10445000,"chr5",223379,3,14,17,34,"chr5",1,0.0518049695264885
"6938","chr5.14395000.14400000","chr5.14645000.14650000",250000,18,1.060314e-07,14395000,14645000,14400000,14650000,"chr5",223403,1,1,5,7,"chr5",1,0.0147679324894515
"6939","chr5.31635000.31640000","chr5.32095000.32100000",460000,10,0.001201387,31635000,32095000,31640000,32100000,"chr5",223416,0,5,6,11,"chr5",1,0.012892639474918
"6940","chr5.141525000.141530000","chr5.141960000.141965000",435000,9,0.006937252,141525000,141960000,141530000,141965000,"chr5",223450,0,1,2,3,"chr5",1,0.00316455696202532
"6941","chr5.180365000.180370000","chr5.180430000.180435000",65000,24,3.808157e-05,180365000,180430000,180370000,180435000,"chr5",223469,0,9,10,19,"chr5",1,0.0534458509142053
"6942","chr5.32230000.32235000","chr5.32310000.32315000",80000,22,3.301859e-05,32230000,32310000,32235000,32315000,"chr5",223501,0,1,1,2,"chr5",1,0.00515705578996718
"6943","chr5.42905000.42910000","chr5.43060000.43065000",155000,16,0.0002166689,42905000,43060000,42910000,43065000,"chr5",223552,1,4,2,7,"chr5",1,0.0131270511017346
"6944","chr5.156835000.156840000","chr5.157105000.157110000",270000,11,0.004095601,156835000,157105000,156840000,157110000,"chr5",223691,1,9,12,22,"chr5",1,0.0283638068448195
"6945","chr5.126180000.126185000","chr5.126595000.126600000",415000,9,0.008398761,126180000,126595000,126185000,126600000,"chr5",223718,3,6,5,14,"chr5",1,0.0147679324894515
"6946","chr5.132290000.132295000","chr5.132365000.132370000",75000,18,0.004787281,132290000,132365000,132295000,132370000,"chr5",223767,2,0,1,3,"chr5",1,0.00632911392405063
"6947","chr5.72140000.72145000","chr5.72245000.72250000",105000,19,8.241739e-05,72140000,72245000,72145000,72250000,"chr5",223775,0,4,0,4,"chr5",1,0.00890764181903422
"6948","chr5.31580000.31585000","chr5.32310000.32315000",730000,8,0.002965283,31580000,32310000,31585000,32315000,"chr5",223804,4,21,10,35,"chr5",1,0.0328176277543366
"6949","chr5.31635000.31640000","chr5.31795000.31800000",160000,25,6.548888e-11,31635000,31795000,31640000,31800000,"chr5",223887,0,5,6,11,"chr5",1,0.0322315986872949
"6950","chr5.127895000.127900000","chr5.127925000.127930000",30000,35,7.074987e-05,127895000,127925000,127900000,127930000,"chr5",223929,2,8,4,14,"chr5",1,0.0574308485700891
"6951","chr5.127090000.127095000","chr5.127295000.127300000",205000,14,0.0004269174,127090000,127295000,127095000,127300000,"chr5",223954,0,1,0,1,"chr5",1,0.00164088138771683
"6952","chr5.139115000.139120000","chr5.139140000.139145000",25000,37,0.0004675491,139115000,139140000,139120000,139145000,"chr5",223959,4,15,10,29,"chr5",1,0.125761837787154
"6953","chr5.139760000.139765000","chr5.139995000.140000000",235000,12,0.002498581,139760000,139995000,139765000,1.4e+08,"chr5",224010,4,3,4,11,"chr5",1,0.0154711673699015
"6954","chr5.16700000.16705000","chr5.16735000.16740000",35000,28,0.001925293,16700000,16735000,16705000,16740000,"chr5",224016,2,7,1,10,"chr5",1,0.0328176277543366
"6955","chr5.138185000.138190000","chr5.138530000.138535000",345000,10,0.004687522,138185000,138530000,138190000,138535000,"chr5",224020,1,4,5,10,"chr5",1,0.0117205813408345
"6956","chr5.94990000.94995000","chr5.95060000.95065000",70000,18,0.008249553,94990000,95060000,94995000,95065000,"chr5",224034,0,3,2,5,"chr5",1,0.0105485232067511
"6957","chr5.11265000.11270000","chr5.11565000.11570000",300000,11,0.002309599,11265000,11565000,11270000,11570000,"chr5",224038,0,3,4,7,"chr5",1,0.00902484763244257
"6958","chr5.137920000.137925000","chr5.138640000.138645000",720000,9,0.0005622199,137920000,138640000,137925000,138645000,"chr5",224075,2,6,2,10,"chr5",1,0.0105485232067511
"6959","chr5.138500000.138505000","chr5.138575000.138580000",75000,19,0.001822093,138500000,138575000,138505000,138580000,"chr5",224092,5,13,22,40,"chr5",1,0.0890764181903422
"6960","chr5.176615000.176620000","chr5.176710000.176715000",95000,18,0.0006740207,176615000,176710000,176620000,176715000,"chr5",224111,2,4,5,11,"chr5",1,0.0232067510548523
"6961","chr5.94990000.94995000","chr5.95065000.95070000",75000,19,0.001822093,94990000,95065000,94995000,95070000,"chr5",224156,0,1,1,2,"chr5",1,0.00445382090951711
"6962","chr5.159455000.159460000","chr5.159540000.159545000",85000,25,2.740968e-07,159455000,159540000,159460000,159545000,"chr5",224161,0,2,3,5,"chr5",1,0.0146507266760431
"6963","chr5.133495000.133500000","chr5.133695000.133700000",200000,13,0.001898328,133495000,133695000,133500000,133700000,"chr5",224177,0,0,1,1,"chr5",1,0.00152367557430849
"6964","chr5.112665000.112670000","chr5.112905000.112910000",240000,12,0.002189967,112665000,112905000,112670000,112910000,"chr5",224181,3,8,16,27,"chr5",1,0.0379746835443038
"6965","chr5.180285000.180290000","chr5.180610000.180615000",325000,12,0.0003484694,180285000,180610000,180290000,180615000,"chr5",224187,0,0,2,2,"chr5",1,0.00281293952180028
"6966","chr5.139025000.139030000","chr5.139125000.139130000",100000,21,9.650769e-06,139025000,139125000,139030000,139130000,"chr5",224223,4,5,7,16,"chr5",1,0.0393811533052039
"6967","chr5.14350000.14355000","chr5.14395000.14400000",45000,25,0.001089227,14350000,14395000,14355000,14400000,"chr5",224253,0,1,1,2,"chr5",1,0.00586029067041725
"6968","chr5.176645000.176650000","chr5.176700000.176705000",55000,23,0.0008610919,176645000,176700000,176650000,176705000,"chr5",224256,0,2,1,3,"chr5",1,0.00808720112517581
"6969","chr5.11260000.11265000","chr5.11615000.11620000",355000,18,2.587726e-09,11260000,11615000,11265000,11620000,"chr5",224273,0,2,1,3,"chr5",1,0.00632911392405063
"6970","chr5.127490000.127495000","chr5.127515000.127520000",25000,34,0.003956721,127490000,127515000,127495000,127520000,"chr5",224314,0,3,3,6,"chr5",1,0.0239099859353024
"6971","chr5.16540000.16545000","chr5.16585000.16590000",45000,23,0.005883287,16540000,16585000,16545000,16590000,"chr5",224350,0,1,2,3,"chr5",1,0.00808720112517581
"6972","chr5.35615000.35620000","chr5.35925000.35930000",310000,26,1.563434e-16,35615000,35925000,35620000,35930000,"chr5",224357,0,3,2,5,"chr5",1,0.0152367557430849
"6973","chr5.172290000.172295000","chr5.172380000.172385000",90000,16,0.008184516,172290000,172380000,172295000,172385000,"chr5",224380,1,11,11,23,"chr5",1,0.043131739334271
"6974","chr5.176550000.176555000","chr5.176660000.176665000",110000,19,5.444908e-05,176550000,176660000,176555000,176665000,"chr5",224388,0,3,3,6,"chr5",1,0.0133614627285513
"6975","chr5.35650000.35655000","chr5.35775000.35780000",125000,20,4.349319e-06,35650000,35775000,35655000,35780000,"chr5",224405,0,4,3,7,"chr5",1,0.0164088138771683
"6976","chr5.133740000.133745000","chr5.133835000.133840000",95000,17,0.002014277,133740000,133835000,133745000,133840000,"chr5",224426,0,2,1,3,"chr5",1,0.0059774964838256
"6977","chr5.138640000.138645000","chr5.138660000.138665000",20000,49,1.607547e-07,138640000,138660000,138645000,138665000,"chr5",224445,2,6,2,10,"chr5",1,0.0574308485700891
"6978","chr5.72240000.72245000","chr5.72555000.72560000",315000,10,0.006964234,72240000,72555000,72245000,72560000,"chr5",224467,1,2,4,7,"chr5",1,0.00820440693858415
"6979","chr5.76925000.76930000","chr5.77275000.77280000",350000,10,0.004394792,76925000,77275000,76930000,77280000,"chr5",224468,2,4,5,11,"chr5",1,0.012892639474918
"6980","chr5.11380000.11385000","chr5.11615000.11620000",235000,13,0.0006514214,11380000,11615000,11385000,11620000,"chr5",224487,0,3,1,4,"chr5",1,0.00609470229723394
"6981","chr5.72885000.72890000","chr5.73080000.73085000",195000,32,8.45729e-19,72885000,73080000,72890000,73085000,"chr5",224505,0,5,5,10,"chr5",1,0.0375058602906704
"6982","chr5.78805000.78810000","chr5.79130000.79135000",325000,11,0.001517047,78805000,79130000,78810000,79135000,"chr5",224521,0,0,2,2,"chr5",1,0.00257852789498359
"6983","chr5.16700000.16705000","chr5.16740000.16745000",40000,26,0.001748132,16700000,16740000,16705000,16745000,"chr5",224525,2,7,1,10,"chr5",1,0.0304735114861697
"6984","chr5.39945000.39950000","chr5.40715000.40720000",770000,15,6.472829e-10,39945000,40715000,39950000,40720000,"chr5",224533,0,5,3,8,"chr5",1,0.0140646976090014
"6985","chr5.32500000.32505000","chr5.32610000.32615000",110000,15,0.005883287,32500000,32610000,32505000,32615000,"chr5",224555,2,7,8,17,"chr5",1,0.029887482419128
"6986","chr5.138440000.138445000","chr5.138595000.138600000",155000,20,6.054977e-07,138440000,138595000,138445000,138600000,"chr5",224557,3,8,5,16,"chr5",1,0.0375058602906704
"6987","chr5.132225000.132230000","chr5.132290000.132295000",65000,23,0.0001176595,132225000,132290000,132230000,132295000,"chr5",224558,2,0,1,3,"chr5",1,0.00808720112517581
"6988","chr5.14350000.14355000","chr5.14660000.14665000",310000,11,0.001948204,14350000,14660000,14355000,14665000,"chr5",224563,0,1,1,2,"chr5",1,0.00257852789498359
"6989","chr5.173045000.173050000","chr5.173745000.173750000",700000,15,1.796719e-09,173045000,173745000,173050000,173750000,"chr5",224564,2,2,13,17,"chr5",1,0.029887482419128
"6990","chr5.16735000.16740000","chr5.17185000.17190000",450000,10,0.001354037,16735000,17185000,16740000,17190000,"chr5",224572,2,4,3,9,"chr5",1,0.0105485232067511
"6991","chr5.38265000.38270000","chr5.38285000.38290000",20000,35,0.009978941,38265000,38285000,38270000,38290000,"chr5",224579,0,1,1,2,"chr5",1,0.00820440693858415
"6992","chr5.16690000.16695000","chr5.16790000.16795000",100000,18,0.0004306289,16690000,16790000,16695000,16795000,"chr5",224590,0,4,1,5,"chr5",1,0.0105485232067511
"6993","chr5.31820000.31825000","chr5.31925000.31930000",105000,17,0.0009239472,31820000,31925000,31825000,31930000,"chr5",224682,2,14,9,25,"chr5",1,0.0498124706985466
"6994","chr5.171910000.171915000","chr5.172120000.172125000",210000,33,1.532476e-20,171910000,172120000,171915000,172125000,"chr5",224716,0,5,1,6,"chr5",1,0.0232067510548523
"6995","chr5.137950000.137955000","chr5.138575000.138580000",625000,12,4.368188e-06,137950000,138575000,137955000,138580000,"chr5",224728,8,16,16,40,"chr5",1,0.0562587904360056
"6996","chr5.112160000.112165000","chr5.112190000.112195000",30000,36,2.874004e-05,112160000,112190000,112165000,112195000,"chr5",224741,0,3,2,5,"chr5",1,0.0210970464135021
"6997","chr5.38470000.38475000","chr5.38805000.38810000",335000,12,0.0002889575,38470000,38805000,38475000,38810000,"chr5",224744,0,2,1,3,"chr5",1,0.00421940928270042
"6998","chr5.7875000.7880000","chr5.8835000.8840000",960000,9,8.246405e-05,7875000,8835000,7880000,8840000,"chr5",224777,0,2,1,3,"chr5",1,0.00316455696202532
"6999","chr5.10430000.10435000","chr5.10600000.10605000",170000,14,0.001517047,10430000,10600000,10435000,10605000,"chr5",224789,1,6,1,8,"chr5",1,0.0131270511017346
"7000","chr5.133505000.133510000","chr5.133740000.133745000",235000,11,0.008554958,133505000,133740000,133510000,133745000,"chr5",224816,1,2,1,4,"chr5",1,0.00515705578996718
"7001","chr5.167760000.167765000","chr5.167865000.167870000",105000,16,0.002826812,167760000,167865000,167765000,167870000,"chr5",224856,1,2,2,5,"chr5",1,0.00937646507266761
"7002","chr5.133990000.133995000","chr5.134035000.134040000",45000,24,0.002624523,133990000,134035000,133995000,134040000,"chr5",224886,0,3,1,4,"chr5",1,0.0112517580872011
"7003","chr5.168435000.168440000","chr5.168995000.169000000",560000,8,0.009734313,168435000,168995000,168440000,1.69e+08,"chr5",224893,1,3,2,6,"chr5",1,0.00562587904360056
"7004","chr5.31640000.31645000","chr5.32080000.32085000",440000,10,0.001517047,31640000,32080000,31645000,32085000,"chr5",224936,1,2,5,8,"chr5",1,0.00937646507266761
"7005","chr5.31855000.31860000","chr5.31910000.31915000",55000,21,0.005222236,31855000,31910000,31860000,31915000,"chr5",224938,2,12,5,19,"chr5",1,0.0467651195499297
"7006","chr5.31845000.31850000","chr5.32090000.32095000",245000,18,1.326103e-07,31845000,32090000,31850000,32095000,"chr5",224972,1,8,9,18,"chr5",1,0.0379746835443038
"7007","chr5.16540000.16545000","chr5.16665000.16670000",125000,16,0.0008836393,16540000,16665000,16545000,16670000,"chr5",224989,0,3,0,3,"chr5",1,0.00562587904360056
"7008","chr5.154035000.154040000","chr5.154180000.154185000",145000,23,8.226872e-09,154035000,154180000,154040000,154185000,"chr5",225058,1,1,0,2,"chr5",1,0.00539146741678387
"7009","chr5.16455000.16460000","chr5.16670000.16675000",215000,14,0.0003037047,16455000,16670000,16460000,16675000,"chr5",225091,0,2,1,3,"chr5",1,0.00492264416315049
"7010","chr5.43040000.43045000","chr5.43105000.43110000",65000,25,1.172009e-05,43040000,43105000,43045000,43110000,"chr5",225092,0,6,10,16,"chr5",1,0.046882325363338
"7011","chr5.133930000.133935000","chr5.133950000.133955000",20000,39,0.0007493829,133930000,133950000,133935000,133955000,"chr5",225208,0,4,0,4,"chr5",1,0.0182841068917018
"7012","chr5.31640000.31645000","chr5.31730000.31735000",90000,19,0.0003496829,31640000,31730000,31645000,31735000,"chr5",225288,2,2,5,9,"chr5",1,0.020042194092827
"7013","chr5.142650000.142655000","chr5.143180000.143185000",530000,9,0.002826812,142650000,143180000,142655000,143185000,"chr5",225304,0,2,1,3,"chr5",1,0.00316455696202532
"7014","chr5.171905000.171910000","chr5.172720000.172725000",815000,9,0.000276266,171905000,172720000,171910000,172725000,"chr5",225315,0,3,1,4,"chr5",1,0.00421940928270042
"7015","chr5.72145000.72150000","chr5.72245000.72250000",100000,18,0.0004306289,72145000,72245000,72150000,72250000,"chr5",225358,0,3,0,3,"chr5",1,0.00632911392405063
"7016","chr5.16535000.16540000","chr5.16700000.16705000",165000,13,0.005863382,16535000,16700000,16540000,16705000,"chr5",225377,0,7,1,8,"chr5",1,0.0121894045944679
"7017","chr5.33435000.33440000","chr5.33940000.33945000",505000,10,0.0007395159,33435000,33940000,33440000,33945000,"chr5",225391,4,2,7,13,"chr5",1,0.0152367557430849
"7018","chr5.139085000.139090000","chr5.139150000.139155000",65000,22,0.0003496829,139085000,139150000,139090000,139155000,"chr5",225395,0,4,5,9,"chr5",1,0.0232067510548523
"7019","chr5.10250000.10255000","chr5.10440000.10445000",190000,19,3.800734e-07,10250000,10440000,10255000,10445000,"chr5",225400,3,14,16,33,"chr5",1,0.0734880450070323
"7020","chr5.136990000.136995000","chr5.137070000.137075000",80000,29,1.763049e-09,136990000,137070000,136995000,137075000,"chr5",225403,0,0,4,4,"chr5",1,0.013595874355368
"7021","chr5.151055000.151060000","chr5.151125000.151130000",70000,19,0.00333549,151055000,151125000,151060000,151130000,"chr5",225408,0,4,2,6,"chr5",1,0.0133614627285513
"7022","chr5.73200000.73205000","chr5.73950000.73955000",750000,17,4.993282e-12,73200000,73950000,73205000,73955000,"chr5",225452,0,0,3,3,"chr5",1,0.0059774964838256
"7023","chr5.138210000.138215000","chr5.138535000.138540000",325000,12,0.0003484694,138210000,138535000,138215000,138540000,"chr5",225478,3,13,13,29,"chr5",1,0.0407876230661041
"7024","chr5.61245000.61250000","chr5.61500000.61505000",255000,14,8.106275e-05,61245000,61500000,61250000,61505000,"chr5",225515,0,2,3,5,"chr5",1,0.00820440693858415
"7025","chr5.14760000.14765000","chr5.15010000.15015000",250000,12,0.001715355,14760000,15010000,14765000,15015000,"chr5",225529,1,6,1,8,"chr5",1,0.0112517580872011
"7026","chr5.86855000.86860000","chr5.87065000.87070000",210000,12,0.004852777,86855000,87065000,86860000,87070000,"chr5",225613,0,3,3,6,"chr5",1,0.00843881856540084
"7027","chr5.138530000.138535000","chr5.138595000.138600000",65000,32,8.805049e-10,138530000,138595000,138535000,138600000,"chr5",225629,3,8,5,16,"chr5",1,0.0600093764650727
"7028","chr5.134005000.134010000","chr5.134055000.134060000",50000,27,4.616593e-05,134005000,134055000,134010000,134060000,"chr5",225637,5,21,21,47,"chr5",1,0.14873417721519
"7029","chr5.138630000.138635000","chr5.138740000.138745000",110000,17,0.0006572664,138630000,138740000,138635000,138745000,"chr5",225711,1,14,12,27,"chr5",1,0.0537974683544304
"7030","chr5.124750000.124755000","chr5.124815000.124820000",65000,40,1.875292e-15,124750000,124815000,124755000,124820000,"chr5",225714,2,2,2,6,"chr5",1,0.0281293952180028
"7031","chr5.171420000.171425000","chr5.171625000.171630000",205000,12,0.005563889,171420000,171625000,171425000,171630000,"chr5",225729,0,3,1,4,"chr5",1,0.00562587904360056
"7032","chr5.137950000.137955000","chr5.138075000.138080000",125000,16,0.0008836393,137950000,138075000,137955000,138080000,"chr5",225762,1,12,11,24,"chr5",1,0.0450070323488045
"7033","chr5.39945000.39950000","chr5.40685000.40690000",740000,21,9.668306e-17,39945000,40685000,39950000,40690000,"chr5",225782,0,5,3,8,"chr5",1,0.019690576652602
"7034","chr5.16485000.16490000","chr5.16640000.16645000",155000,17,5.573084e-05,16485000,16640000,16490000,16645000,"chr5",225829,1,6,2,9,"chr5",1,0.0179324894514768
"7035","chr5.138630000.138635000","chr5.138660000.138665000",30000,30,0.003924178,138630000,138660000,138635000,138665000,"chr5",225835,1,9,7,17,"chr5",1,0.059774964838256
"7036","chr5.170805000.170810000","chr5.171420000.171425000",615000,9,0.001315436,170805000,171420000,170810000,171425000,"chr5",225844,0,4,3,7,"chr5",1,0.00738396624472574
"7037","chr5.139415000.139420000","chr5.139675000.139680000",260000,12,0.001331506,139415000,139675000,139420000,139680000,"chr5",225866,1,1,1,3,"chr5",1,0.00421940928270042
"7038","chr5.139480000.139485000","chr5.139580000.139585000",100000,17,0.001349023,139480000,139580000,139485000,139585000,"chr5",225902,3,13,12,28,"chr5",1,0.0557899671823722
"7039","chr5.16790000.16795000","chr5.17190000.17195000",400000,41,3.291827e-37,16790000,17190000,16795000,17195000,"chr5",225956,0,4,1,5,"chr5",1,0.0240271917487107
"7040","chr5.60255000.60260000","chr5.61225000.61230000",970000,11,8.553448e-07,60255000,61225000,60260000,61230000,"chr5",225984,2,1,3,6,"chr5",1,0.00773558368495077
"7041","chr5.32230000.32235000","chr5.32610000.32615000",380000,21,1.485752e-12,32230000,32610000,32235000,32615000,"chr5",226010,0,1,1,2,"chr5",1,0.00492264416315049
"7042","chr5.16465000.16470000","chr5.16785000.16790000",320000,11,0.001661806,16465000,16785000,16470000,16790000,"chr5",226025,0,4,1,5,"chr5",1,0.00644631973745898
"7043","chr5.14105000.14110000","chr5.14350000.14355000",245000,15,2.285367e-05,14105000,14350000,14110000,14355000,"chr5",226034,0,1,1,2,"chr5",1,0.00351617440225035
"7044","chr5.139775000.139780000","chr5.140045000.140050000",270000,11,0.004095601,139775000,140045000,139780000,140050000,"chr5",226050,4,5,7,16,"chr5",1,0.0206282231598687
"7045","chr5.137880000.137885000","chr5.138650000.138655000",770000,11,7.10669e-06,137880000,138650000,137885000,138655000,"chr5",226130,6,16,10,32,"chr5",1,0.0412564463197375
"7046","chr5.32505000.32510000","chr5.32575000.32580000",70000,24,1.432929e-05,32505000,32575000,32510000,32580000,"chr5",226159,0,6,7,13,"chr5",1,0.0365682137834037
"7047","chr5.112665000.112670000","chr5.112845000.112850000",180000,14,0.001045873,112665000,112845000,112670000,112850000,"chr5",226166,3,10,11,24,"chr5",1,0.0393811533052039
"7048","chr5.37410000.37415000","chr5.38145000.38150000",735000,8,0.002880043,37410000,38145000,37415000,38150000,"chr5",226179,2,12,4,18,"chr5",1,0.0168776371308017
"7049","chr5.55575000.55580000","chr5.56125000.56130000",550000,12,1.163625e-05,55575000,56125000,55580000,56130000,"chr5",226315,2,3,2,7,"chr5",1,0.00984528832630099
"7050","chr5.142355000.142360000","chr5.143240000.143245000",885000,7,0.006244689,142355000,143240000,142360000,143245000,"chr5",226415,0,2,0,2,"chr5",1,0.00164088138771683
"7051","chr5.141080000.141085000","chr5.141320000.141325000",240000,12,0.002189967,141080000,141320000,141085000,141325000,"chr5",226455,1,14,8,23,"chr5",1,0.0323488045007032
"7052","chr5.173470000.173475000","chr5.173750000.173755000",280000,18,3.023818e-08,173470000,173750000,173475000,173755000,"chr5",226470,2,2,1,5,"chr5",1,0.0105485232067511
"7053","chr5.71835000.71840000","chr5.72205000.72210000",370000,10,0.003460345,71835000,72205000,71840000,72210000,"chr5",226569,0,1,1,2,"chr5",1,0.0023441162681669
"7054","chr5.10460000.10465000","chr5.10615000.10620000",155000,13,0.008184516,10460000,10615000,10465000,10620000,"chr5",226631,0,2,0,2,"chr5",1,0.00304735114861697
"7055","chr5.80065000.80070000","chr5.80485000.80490000",420000,11,0.0004008006,80065000,80485000,80070000,80490000,"chr5",226666,2,9,7,18,"chr5",1,0.0232067510548523
"7056","chr5.138945000.138950000","chr5.139085000.139090000",140000,18,3.015385e-05,138945000,139085000,138950000,139090000,"chr5",226749,1,1,2,4,"chr5",1,0.00843881856540084
"7057","chr5.38650000.38655000","chr5.38805000.38810000",155000,14,0.002667135,38650000,38805000,38655000,38810000,"chr5",226798,0,2,1,3,"chr5",1,0.00492264416315049
"7058","chr5.176630000.176635000","chr5.176660000.176665000",30000,30,0.003924178,176630000,176660000,176635000,176665000,"chr5",226817,0,3,3,6,"chr5",1,0.0210970464135021
"7059","chr5.38990000.38995000","chr5.39080000.39085000",90000,31,7.587145e-12,38990000,39080000,38995000,39085000,"chr5",226868,0,1,5,6,"chr5",1,0.0218002812939522
"7060","chr5.77645000.77650000","chr5.78295000.78300000",650000,9,0.000977843,77645000,78295000,77650000,78300000,"chr5",226902,3,10,4,17,"chr5",1,0.0179324894514768
"7061","chr5.11325000.11330000","chr5.11380000.11385000",55000,24,0.0003232294,11325000,11380000,11330000,11385000,"chr5",226972,1,3,2,6,"chr5",1,0.0168776371308017
"7062","chr5.17295000.17300000","chr5.18150000.18155000",855000,7,0.007470322,17295000,18150000,17300000,18155000,"chr5",227000,1,2,0,3,"chr5",1,0.00246132208157525
"7063","chr5.138185000.138190000","chr5.138330000.138335000",145000,16,0.0003494013,138185000,138330000,138190000,138335000,"chr5",227029,1,4,5,10,"chr5",1,0.0187529301453352
"7064","chr5.79395000.79400000","chr5.79550000.79555000",155000,19,2.930222e-06,79395000,79550000,79400000,79555000,"chr5",227045,3,10,6,19,"chr5",1,0.0423112986404126
"7065","chr5.172410000.172415000","chr5.172705000.172710000",295000,11,0.002554934,172410000,172705000,172415000,172710000,"chr5",227047,0,5,1,6,"chr5",1,0.00773558368495077
"7066","chr5.77680000.77685000","chr5.78265000.78270000",585000,10,0.0003175315,77680000,78265000,77685000,78270000,"chr5",227096,2,4,5,11,"chr5",1,0.012892639474918
"7067","chr5.54850000.54855000","chr5.54895000.54900000",45000,24,0.002624523,54850000,54895000,54855000,54900000,"chr5",227111,1,1,2,4,"chr5",1,0.0112517580872011
"7068","chr5.138330000.138335000","chr5.138575000.138580000",245000,11,0.006920911,138330000,138575000,138335000,138580000,"chr5",227128,5,23,25,53,"chr5",1,0.0683309892170652
"7069","chr5.132220000.132225000","chr5.132290000.132295000",70000,20,0.001245329,132220000,132290000,132225000,132295000,"chr5",227136,1,0,1,2,"chr5",1,0.0046882325363338
"7070","chr5.138740000.138745000","chr5.138955000.138960000",215000,13,0.001177161,138740000,138955000,138745000,138960000,"chr5",227147,2,6,9,17,"chr5",1,0.0259024847632443
"7071","chr5.79395000.79400000","chr5.79555000.79560000",160000,25,6.548888e-11,79395000,79555000,79400000,79560000,"chr5",227156,3,9,5,17,"chr5",1,0.0498124706985466
"7072","chr5.79710000.79715000","chr5.79775000.79780000",65000,20,0.002578088,79710000,79775000,79715000,79780000,"chr5",227184,1,4,2,7,"chr5",1,0.0164088138771683
"7073","chr5.153465000.153470000","chr5.153745000.153750000",280000,15,7.371914e-06,153465000,153745000,153470000,153750000,"chr5",227192,1,2,1,4,"chr5",1,0.0070323488045007
"7074","chr5.137920000.137925000","chr5.138660000.138665000",740000,8,0.002807229,137920000,138660000,137925000,138665000,"chr5",227202,3,9,4,16,"chr5",1,0.0150023441162682
"7075","chr5.141990000.141995000","chr5.142050000.142055000",60000,22,0.000864842,141990000,142050000,141995000,142055000,"chr5",227224,4,7,3,14,"chr5",1,0.0360993905297703
"7076","chr5.122155000.122160000","chr5.122850000.122855000",695000,9,0.0006884068,122155000,122850000,122160000,122855000,"chr5",227314,0,0,5,5,"chr5",1,0.00527426160337553
"7077","chr5.55220000.55225000","chr5.56160000.56165000",940000,7,0.004551179,55220000,56160000,55225000,56165000,"chr5",227341,0,2,2,4,"chr5",1,0.00328176277543366
"7078","chr5.141555000.141560000","chr5.141850000.141855000",295000,10,0.009425316,141555000,141850000,141560000,141855000,"chr5",227412,0,2,2,4,"chr5",1,0.0046882325363338
"7079","chr5.95065000.95070000","chr5.95660000.95665000",595000,9,0.001561195,95065000,95660000,95070000,95665000,"chr5",227441,0,1,1,2,"chr5",1,0.00210970464135021
"7080","chr5.132220000.132225000","chr5.132250000.132255000",30000,29,0.00778408,132220000,132250000,132225000,132255000,"chr5",227469,1,0,1,2,"chr5",1,0.00679793717768401
"7081","chr5.139090000.139095000","chr5.139140000.139145000",50000,36,6.600882e-10,139090000,139140000,139095000,139145000,"chr5",227494,6,11,6,23,"chr5",1,0.0970464135021097
"7082","chr5.10450000.10455000","chr5.10615000.10620000",165000,17,3.375857e-05,10450000,10615000,10455000,10620000,"chr5",227668,0,2,0,2,"chr5",1,0.00398499765588373
"7083","chr5.32485000.32490000","chr5.32600000.32605000",115000,18,0.0001349849,32485000,32600000,32490000,32605000,"chr5",227675,0,2,0,2,"chr5",1,0.00421940928270042
"7084","chr5.16485000.16490000","chr5.17200000.17205000",715000,9,0.0005883452,16485000,17200000,16490000,17205000,"chr5",227681,0,7,2,9,"chr5",1,0.00949367088607595
"7085","chr5.176660000.176665000","chr5.176710000.176715000",50000,31,4.702035e-07,176660000,176710000,176665000,176715000,"chr5",227720,0,3,3,6,"chr5",1,0.0218002812939522
"7086","chr5.10340000.10345000","chr5.10600000.10605000",260000,11,0.005013366,10340000,10600000,10345000,10605000,"chr5",227727,4,14,6,24,"chr5",1,0.0309423347398031
"7087","chr5.112635000.112640000","chr5.112860000.112865000",225000,12,0.003237857,112635000,112860000,112640000,112865000,"chr5",227750,1,7,2,10,"chr5",1,0.0140646976090014
"7088","chr5.34485000.34490000","chr5.34915000.34920000",430000,18,3.634813e-10,34485000,34915000,34490000,34920000,"chr5",227752,0,2,1,3,"chr5",1,0.00632911392405063
"7089","chr5.13985000.13990000","chr5.14370000.14375000",385000,10,0.002887864,13985000,14370000,13990000,14375000,"chr5",227757,0,5,4,9,"chr5",1,0.0105485232067511
"7090","chr5.38920000.38925000","chr5.39080000.39085000",160000,18,9.981049e-06,38920000,39080000,38925000,39085000,"chr5",227778,0,3,6,9,"chr5",1,0.0189873417721519
"7091","chr5.43105000.43110000","chr5.43385000.43390000",280000,27,7.91518e-17,43105000,43385000,43110000,43390000,"chr5",227817,0,3,9,12,"chr5",1,0.0379746835443038
"7092","chr5.124755000.124760000","chr5.124825000.124830000",70000,22,0.0001496213,124755000,124825000,124760000,124830000,"chr5",227836,1,5,5,11,"chr5",1,0.0283638068448195
"7093","chr5.142020000.142025000","chr5.142075000.142080000",55000,26,3.890122e-05,142020000,142075000,142025000,142080000,"chr5",227869,5,13,15,33,"chr5",1,0.10056258790436
"7094","chr5.171905000.171910000","chr5.172105000.172110000",200000,19,2.1564e-07,171905000,172105000,171910000,172110000,"chr5",228027,1,10,8,19,"chr5",1,0.0423112986404126
"7095","chr5.41870000.41875000","chr5.42805000.42810000",935000,7,0.004687522,41870000,42805000,41875000,42810000,"chr5",228029,0,1,4,5,"chr5",1,0.00410220346929208
"7096","chr5.150425000.150430000","chr5.150495000.150500000",70000,26,1.123687e-06,150425000,150495000,150430000,150500000,"chr5",228044,5,15,22,42,"chr5",1,0.127988748241913
"7097","chr5.31855000.31860000","chr5.32075000.32080000",220000,13,0.001008825,31855000,32075000,31860000,32080000,"chr5",228144,3,12,5,20,"chr5",1,0.0304735114861697
"7098","chr5.79375000.79380000","chr5.79610000.79615000",235000,13,0.0006514214,79375000,79610000,79380000,79615000,"chr5",228235,0,3,0,3,"chr5",1,0.00457102672292546
"7099","chr5.14140000.14145000","chr5.14265000.14270000",125000,23,4.21596e-08,14140000,14265000,14145000,14270000,"chr5",228237,0,3,1,4,"chr5",1,0.0107829348335677
"7100","chr5.33435000.33440000","chr5.33970000.33975000",535000,16,3.050906e-09,33435000,33970000,33440000,33975000,"chr5",228261,3,10,6,19,"chr5",1,0.0356305672761369
"7101","chr5.11685000.11690000","chr5.11715000.11720000",30000,31,0.001884984,11685000,11715000,11690000,11720000,"chr5",228296,2,1,0,3,"chr5",1,0.0109001406469761
"7102","chr5.15500000.15505000","chr5.15795000.15800000",295000,12,0.0006148647,15500000,15795000,15505000,15800000,"chr5",228331,0,1,1,2,"chr5",1,0.00281293952180028
"7103","chr5.16455000.16460000","chr5.16665000.16670000",210000,20,2.050958e-08,16455000,16665000,16460000,16670000,"chr5",228345,0,2,0,2,"chr5",1,0.0046882325363338
"7104","chr5.159440000.159445000","chr5.159770000.159775000",330000,14,1.13749e-05,159440000,159770000,159445000,159775000,"chr5",228346,0,3,1,4,"chr5",1,0.00656352555086732
"7105","chr5.34520000.34525000","chr5.34920000.34925000",400000,9,0.009789574,34520000,34920000,34525000,34925000,"chr5",228361,3,3,6,12,"chr5",1,0.0126582278481013
"7106","chr5.132200000.132205000","chr5.132385000.132390000",185000,16,5.573084e-05,132200000,132385000,132205000,132390000,"chr5",228416,0,3,0,3,"chr5",1,0.00562587904360056
"7107","chr5.68025000.68030000","chr5.68185000.68190000",160000,14,0.002211367,68025000,68185000,68030000,68190000,"chr5",228478,2,8,4,14,"chr5",1,0.0229723394280356
"7108","chr5.14810000.14815000","chr5.14865000.14870000",55000,56,5.80087e-26,14810000,14865000,14815000,14870000,"chr5",228484,5,6,4,15,"chr5",1,0.0984528832630098
"7109","chr5.86880000.86885000","chr5.86965000.86970000",85000,21,5.692649e-05,86880000,86965000,86885000,86970000,"chr5",228508,2,1,5,8,"chr5",1,0.019690576652602
"7110","chr5.138955000.138960000","chr5.139410000.139415000",455000,9,0.005646435,138955000,139410000,138960000,139415000,"chr5",228530,1,6,5,12,"chr5",1,0.0126582278481013
"7111","chr5.132410000.132415000","chr5.133320000.133325000",910000,8,0.000906508,132410000,133320000,132415000,133325000,"chr5",228541,0,2,5,7,"chr5",1,0.00656352555086732
"7112","chr5.180610000.180615000","chr5.180685000.180690000",75000,22,6.845682e-05,180610000,180685000,180615000,180690000,"chr5",228595,0,0,2,2,"chr5",1,0.00515705578996718
"7113","chr5.42905000.42910000","chr5.43065000.43070000",160000,25,6.548888e-11,42905000,43065000,42910000,43070000,"chr5",228598,3,4,11,18,"chr5",1,0.0527426160337553
"7114","chr5.176550000.176555000","chr5.176570000.176575000",20000,42,7.832946e-05,176550000,176570000,176555000,176575000,"chr5",228600,1,11,11,23,"chr5",1,0.113220815752461
"7115","chr5.31820000.31825000","chr5.32325000.32330000",505000,9,0.003571312,31820000,32325000,31825000,32330000,"chr5",228684,2,14,9,25,"chr5",1,0.0263713080168776
"7116","chr5.137865000.137870000","chr5.138640000.138645000",775000,11,6.718968e-06,137865000,138640000,137870000,138645000,"chr5",228734,1,1,2,4,"chr5",1,0.00515705578996718
"7117","chr5.31845000.31850000","chr5.32015000.32020000",170000,14,0.001517047,31845000,32015000,31850000,32020000,"chr5",228745,1,6,9,16,"chr5",1,0.0262541022034693
"7118","chr5.40755000.40760000","chr5.40875000.40880000",120000,23,6.594718e-08,40755000,40875000,40760000,40880000,"chr5",228762,1,6,5,12,"chr5",1,0.0323488045007032
"7119","chr5.134900000.134905000","chr5.135550000.135555000",650000,10,0.0001651946,134900000,135550000,134905000,135555000,"chr5",228765,4,14,19,37,"chr5",1,0.0433661509610877
"7120","chr5.32260000.32265000","chr5.32610000.32615000",350000,11,0.001039796,32260000,32610000,32265000,32615000,"chr5",228767,1,7,8,16,"chr5",1,0.0206282231598687
"7121","chr5.76945000.76950000","chr5.77560000.77565000",615000,9,0.001315436,76945000,77560000,76950000,77565000,"chr5",228885,0,2,2,4,"chr5",1,0.00421940928270042
"7122","chr5.139025000.139030000","chr5.139135000.139140000",110000,16,0.002032344,139025000,139135000,139030000,139140000,"chr5",228927,1,11,6,18,"chr5",1,0.0337552742616034
"7123","chr5.34485000.34490000","chr5.34500000.34505000",15000,35,0.009978941,34485000,34500000,34490000,34505000,"chr5",228969,0,2,1,3,"chr5",1,0.0123066104078762
"7124","chr5.77970000.77975000","chr5.78000000.78005000",30000,33,0.0003881725,77970000,7.8e+07,77975000,78005000,"chr5",229032,1,1,4,6,"chr5",1,0.0232067510548523
"7125","chr5.11265000.11270000","chr5.11560000.11565000",295000,13,0.0001316761,11265000,11560000,11270000,11565000,"chr5",229065,0,4,1,5,"chr5",1,0.00761837787154243
"7126","chr5.132215000.132220000","chr5.132365000.132370000",150000,14,0.003210755,132215000,132365000,132220000,132370000,"chr5",229127,1,3,6,10,"chr5",1,0.0164088138771683
"7127","chr5.31675000.31680000","chr5.31795000.31800000",120000,17,0.0003496829,31675000,31795000,31680000,31800000,"chr5",229229,1,6,6,13,"chr5",1,0.0259024847632443
"7128","chr5.36305000.36310000","chr5.36690000.36695000",385000,12,0.0001281495,36305000,36690000,36310000,36695000,"chr5",229247,3,11,4,18,"chr5",1,0.0253164556962025
"7129","chr5.31640000.31645000","chr5.32015000.32020000",375000,10,0.003243079,31640000,32015000,31645000,32020000,"chr5",229266,2,2,5,9,"chr5",1,0.0105485232067511
"7130","chr5.16455000.16460000","chr5.17185000.17190000",730000,9,0.000519804,16455000,17185000,16460000,17190000,"chr5",229280,2,2,1,5,"chr5",1,0.00527426160337553
"7131","chr5.14780000.14785000","chr5.14810000.14815000",30000,42,6.594718e-08,14780000,14810000,14785000,14815000,"chr5",229297,0,2,1,3,"chr5",1,0.0147679324894515
"7132","chr5.151045000.151050000","chr5.151115000.151120000",70000,30,4.071237e-09,151045000,151115000,151050000,151120000,"chr5",229353,0,1,1,2,"chr5",1,0.0070323488045007
"7133","chr5.10520000.10525000","chr5.10595000.10600000",75000,21,0.0002149335,10520000,10595000,10525000,10600000,"chr5",229462,1,10,7,18,"chr5",1,0.0443037974683544
"7134","chr5.61260000.61265000","chr5.61450000.61455000",190000,13,0.002624523,61260000,61450000,61265000,61455000,"chr5",229508,0,0,2,2,"chr5",1,0.00304735114861697
"7135","chr5.132200000.132205000","chr5.132220000.132225000",20000,39,0.0007493829,132200000,132220000,132205000,132225000,"chr5",229571,1,2,1,4,"chr5",1,0.0182841068917018
"7136","chr5.16785000.16790000","chr5.17190000.17195000",405000,18,6.901717e-10,16785000,17190000,16790000,17195000,"chr5",229573,2,8,2,12,"chr5",1,0.0253164556962025
"7137","chr5.31580000.31585000","chr5.31795000.31800000",215000,19,9.513721e-08,31580000,31795000,31585000,31800000,"chr5",229577,1,8,6,15,"chr5",1,0.0334036568213783
"7138","chr5.139785000.139790000","chr5.140020000.140025000",235000,15,3.336175e-05,139785000,140020000,139790000,140025000,"chr5",229692,0,3,4,7,"chr5",1,0.0123066104078762
"7139","chr5.139415000.139420000","chr5.139480000.139485000",65000,31,3.823809e-09,139415000,139480000,139420000,139485000,"chr5",229877,3,7,5,15,"chr5",1,0.0545007032348805
"7140","chr5.79395000.79400000","chr5.79560000.79565000",165000,23,1.769091e-09,79395000,79560000,79400000,79565000,"chr5",229922,2,8,0,10,"chr5",1,0.0269573370839194
"7141","chr5.138075000.138080000","chr5.138575000.138580000",500000,13,3.432456e-06,138075000,138575000,138080000,138580000,"chr5",229960,1,12,11,24,"chr5",1,0.0365682137834037
"7142","chr5.176550000.176555000","chr5.176645000.176650000",95000,17,0.002014277,176550000,176645000,176555000,176650000,"chr5",229967,0,2,1,3,"chr5",1,0.0059774964838256
"7143","chr5.59125000.59130000","chr5.59455000.59460000",330000,11,0.001416127,59125000,59455000,59130000,59460000,"chr5",230043,0,1,2,3,"chr5",1,0.00386779184247539
"7144","chr5.32505000.32510000","chr5.32610000.32615000",105000,16,0.002826812,32505000,32610000,32510000,32615000,"chr5",230054,0,6,7,13,"chr5",1,0.0243788091889358
"7145","chr5.150180000.150185000","chr5.150425000.150430000",245000,13,0.0004798947,150180000,150425000,150185000,150430000,"chr5",230065,0,2,1,3,"chr5",1,0.00457102672292546
"7146","chr5.132225000.132230000","chr5.132250000.132255000",25000,34,0.003956721,132225000,132250000,132230000,132255000,"chr5",230083,2,0,2,4,"chr5",1,0.0159399906235349
"7147","chr5.31660000.31665000","chr5.31795000.31800000",135000,15,0.001825795,31660000,31795000,31665000,31800000,"chr5",230107,1,8,6,15,"chr5",1,0.0263713080168776
"7148","chr5.14035000.14040000","chr5.14105000.14110000",70000,18,0.008249553,14035000,14105000,14040000,14110000,"chr5",230152,0,4,1,5,"chr5",1,0.0105485232067511
"7149","chr5.54755000.54760000","chr5.54895000.54900000",140000,14,0.004653114,54755000,54895000,54760000,54900000,"chr5",230158,0,2,2,4,"chr5",1,0.00656352555086732
"7150","chr5.61245000.61250000","chr5.61430000.61435000",185000,12,0.00976683,61245000,61430000,61250000,61435000,"chr5",230163,1,7,3,11,"chr5",1,0.0154711673699015
"7151","chr5.139785000.139790000","chr5.139910000.139915000",125000,16,0.0008836393,139785000,139910000,139790000,139915000,"chr5",230260,1,2,2,5,"chr5",1,0.00937646507266761
"7152","chr5.38675000.38680000","chr5.38805000.38810000",130000,15,0.002240806,38675000,38805000,38680000,38810000,"chr5",230298,0,2,1,3,"chr5",1,0.00527426160337553
"7153","chr5.111500000.111505000","chr5.111755000.111760000",255000,19,1.268646e-08,111500000,111755000,111505000,111760000,"chr5",230325,1,3,2,6,"chr5",1,0.0133614627285513
"7154","chr5.76330000.76335000","chr5.76790000.76795000",460000,9,0.005469632,76330000,76790000,76335000,76795000,"chr5",230341,1,1,1,3,"chr5",1,0.00316455696202532
"7155","chr5.141525000.141530000","chr5.142075000.142080000",550000,9,0.002321149,141525000,142075000,141530000,142080000,"chr5",230352,3,10,14,27,"chr5",1,0.0284810126582278
"7156","chr5.14705000.14710000","chr5.14780000.14785000",75000,19,0.001822093,14705000,14780000,14710000,14785000,"chr5",230393,0,2,1,3,"chr5",1,0.00668073136427567
"7157","chr5.160175000.160180000","chr5.160195000.160200000",20000,35,0.009978941,160175000,160195000,160180000,160200000,"chr5",230424,2,2,8,12,"chr5",1,0.0492264416315049
"7158","chr5.10305000.10310000","chr5.10330000.10335000",25000,33,0.007546877,10305000,10330000,10310000,10335000,"chr5",230502,1,9,13,23,"chr5",1,0.0889592123769339
"7159","chr5.176570000.176575000","chr5.176660000.176665000",90000,24,5.222529e-07,176570000,176660000,176575000,176665000,"chr5",230518,0,3,3,6,"chr5",1,0.0168776371308017
"7160","chr5.16540000.16545000","chr5.16600000.16605000",60000,21,0.002230493,16540000,16600000,16545000,16605000,"chr5",230591,2,10,11,23,"chr5",1,0.0566104078762307
"7161","chr5.14250000.14255000","chr5.14660000.14665000",410000,9,0.008799507,14250000,14660000,14255000,14665000,"chr5",230639,1,6,2,9,"chr5",1,0.00949367088607595
"7162","chr5.80255000.80260000","chr5.80485000.80490000",230000,15,3.95563e-05,80255000,80485000,80260000,80490000,"chr5",230687,2,7,3,12,"chr5",1,0.0210970464135021
"7163","chr5.122850000.122855000","chr5.122870000.122875000",20000,35,0.009978941,122850000,122870000,122855000,122875000,"chr5",230696,2,4,7,13,"chr5",1,0.053328645100797
"7164","chr5.95025000.95030000","chr5.95060000.95065000",35000,37,3.350797e-07,95025000,95060000,95030000,95065000,"chr5",230704,0,2,0,2,"chr5",1,0.00867323019221753
"7165","chr5.8840000.8845000","chr5.9055000.9060000",215000,15,7.001277e-05,8840000,9055000,8845000,9060000,"chr5",230741,0,5,4,9,"chr5",1,0.0158227848101266
"7166","chr5.16670000.16675000","chr5.17185000.17190000",515000,12,1.862059e-05,16670000,17185000,16675000,17190000,"chr5",230759,0,4,2,6,"chr5",1,0.00843881856540084
"7167","chr5.34485000.34490000","chr5.34930000.34935000",445000,13,8.310652e-06,34485000,34930000,34490000,34935000,"chr5",230760,0,2,1,3,"chr5",1,0.00457102672292546
"7168","chr5.94980000.94985000","chr5.95060000.95065000",80000,25,6.453497e-07,94980000,95060000,94985000,95065000,"chr5",230787,3,3,6,12,"chr5",1,0.0351617440225035
"7169","chr5.133485000.133490000","chr5.133950000.133955000",465000,9,0.005202139,133485000,133950000,133490000,133955000,"chr5",230837,0,2,1,3,"chr5",1,0.00316455696202532
"7170","chr5.142020000.142025000","chr5.142050000.142055000",30000,31,0.001884984,142020000,142050000,142025000,142055000,"chr5",230876,6,13,15,34,"chr5",1,0.123534927332396
"7171","chr5.137700000.137705000","chr5.137740000.137745000",40000,38,4.578868e-09,137700000,137740000,137705000,137745000,"chr5",230888,0,3,5,8,"chr5",1,0.0356305672761369
"7172","chr5.78920000.78925000","chr5.79140000.79145000",220000,12,0.003736928,78920000,79140000,78925000,79145000,"chr5",230894,2,5,4,11,"chr5",1,0.0154711673699015
"7173","chr5.31820000.31825000","chr5.31910000.31915000",90000,18,0.001051505,31820000,31910000,31825000,31915000,"chr5",230913,2,14,9,25,"chr5",1,0.0527426160337553
"7174","chr5.177495000.177500000","chr5.177600000.177605000",105000,15,0.007853845,177495000,177600000,177500000,177605000,"chr5",230944,0,2,2,4,"chr5",1,0.0070323488045007
"7175","chr5.94990000.94995000","chr5.95660000.95665000",670000,12,2.524418e-06,94990000,95660000,94995000,95665000,"chr5",230952,0,4,2,6,"chr5",1,0.00843881856540084
"7176","chr5.80235000.80240000","chr5.80585000.80590000",350000,10,0.004394792,80235000,80585000,80240000,80590000,"chr5",230987,5,20,11,36,"chr5",1,0.0421940928270042
"7177","chr5.172435000.172440000","chr5.172505000.172510000",70000,24,1.432929e-05,172435000,172505000,172440000,172510000,"chr5",231016,0,7,2,9,"chr5",1,0.0253164556962025
"7178","chr5.36075000.36080000","chr5.36305000.36310000",230000,23,1.682371e-11,36075000,36305000,36080000,36310000,"chr5",231018,2,9,0,11,"chr5",1,0.0296530707923113
"7179","chr5.10280000.10285000","chr5.10440000.10445000",160000,27,1.337134e-12,10280000,10440000,10285000,10445000,"chr5",231039,3,14,17,34,"chr5",1,0.107594936708861
"7180","chr5.64180000.64185000","chr5.64780000.64785000",600000,9,0.00150338,64180000,64780000,64185000,64785000,"chr5",231041,0,1,1,2,"chr5",1,0.00210970464135021
"7181","chr5.137920000.137925000","chr5.138605000.138610000",685000,9,0.0007453175,137920000,138605000,137925000,138610000,"chr5",231076,3,5,4,12,"chr5",1,0.0126582278481013
"7182","chr5.126865000.126870000","chr5.127490000.127495000",625000,10,0.0002094439,126865000,127490000,126870000,127495000,"chr5",231186,1,5,8,14,"chr5",1,0.0164088138771683
"7183","chr5.159455000.159460000","chr5.159770000.159775000",315000,27,1.031497e-17,159455000,159770000,159460000,159775000,"chr5",231257,0,3,1,4,"chr5",1,0.0126582278481013
"7184","chr5.138955000.138960000","chr5.138975000.138980000",20000,46,2.646006e-06,138955000,138975000,138960000,138980000,"chr5",231276,2,6,9,17,"chr5",1,0.0916549460853258
"7185","chr5.32260000.32265000","chr5.32310000.32315000",50000,22,0.005327353,32260000,32310000,32265000,32315000,"chr5",231326,1,9,11,21,"chr5",1,0.0541490857946554
"7186","chr5.43065000.43070000","chr5.43480000.43485000",415000,9,0.008398761,43065000,43480000,43070000,43485000,"chr5",231332,4,10,11,25,"chr5",1,0.0263713080168776
"7187","chr5.171385000.171390000","chr5.171415000.171420000",30000,37,1.127388e-05,171385000,171415000,171390000,171420000,"chr5",231371,3,11,7,21,"chr5",1,0.0910689170182841
"7188","chr5.137885000.137890000","chr5.138135000.138140000",250000,11,0.00615903,137885000,138135000,137890000,138140000,"chr5",231401,0,3,7,10,"chr5",1,0.012892639474918
"7189","chr5.14810000.14815000","chr5.15000000.15005000",190000,43,2.090568e-30,14810000,1.5e+07,14815000,15005000,"chr5",231420,1,4,3,8,"chr5",1,0.0403187998124707
"7190","chr5.34485000.34490000","chr5.34520000.34525000",35000,28,0.001925293,34485000,34520000,34490000,34525000,"chr5",231467,0,2,1,3,"chr5",1,0.00984528832630099
"7191","chr5.39375000.39380000","chr5.39545000.39550000",170000,22,7.374048e-09,39375000,39545000,39380000,39550000,"chr5",231488,0,2,4,6,"chr5",1,0.0154711673699015
"7192","chr5.32470000.32475000","chr5.32610000.32615000",140000,14,0.004653114,32470000,32610000,32475000,32615000,"chr5",231513,3,7,8,18,"chr5",1,0.029535864978903
"7193","chr5.172420000.172425000","chr5.172530000.172535000",110000,22,8.181314e-07,172420000,172530000,172425000,172535000,"chr5",231515,0,5,1,6,"chr5",1,0.0154711673699015
"7194","chr5.71835000.71840000","chr5.72140000.72145000",305000,12,0.0004968012,71835000,72140000,71840000,72145000,"chr5",231548,0,1,1,2,"chr5",1,0.00281293952180028
"7195","chr5.138220000.138225000","chr5.138970000.138975000",750000,8,0.002624523,138220000,138970000,138225000,138975000,"chr5",231556,4,18,11,33,"chr5",1,0.0309423347398031
"7196","chr5.90395000.90400000","chr5.90705000.90710000",310000,13,9.525402e-05,90395000,90705000,90400000,90710000,"chr5",231568,0,1,2,3,"chr5",1,0.00457102672292546
"7197","chr5.171905000.171910000","chr5.172370000.172375000",465000,12,3.852287e-05,171905000,172370000,171910000,172375000,"chr5",231594,0,1,1,2,"chr5",1,0.00281293952180028
"7198","chr5.137920000.137925000","chr5.138385000.138390000",465000,10,0.001136527,137920000,138385000,137925000,138390000,"chr5",231598,0,11,4,15,"chr5",1,0.0175808720112518
"7199","chr5.10250000.10255000","chr5.10400000.10405000",150000,13,0.009673788,10250000,10400000,10255000,10405000,"chr5",231632,0,2,0,2,"chr5",1,0.00304735114861697
"7200","chr5.132235000.132240000","chr5.132290000.132295000",55000,27,1.27215e-05,132235000,132290000,132240000,132295000,"chr5",231675,2,0,1,3,"chr5",1,0.00949367088607595
"7201","chr5.142490000.142495000","chr5.142685000.142690000",195000,12,0.007407267,142490000,142685000,142495000,142690000,"chr5",231700,0,0,3,3,"chr5",1,0.00421940928270042
"7202","chr5.137695000.137700000","chr5.137755000.137760000",60000,20,0.00547239,137695000,137755000,137700000,137760000,"chr5",231707,0,2,2,4,"chr5",1,0.00937646507266761
"7203","chr5.79395000.79400000","chr5.79460000.79465000",65000,26,3.432456e-06,79395000,79460000,79400000,79465000,"chr5",231718,3,9,6,18,"chr5",1,0.0548523206751055
"7204","chr5.13985000.13990000","chr5.14350000.14355000",365000,21,2.422909e-12,13985000,14350000,13990000,14355000,"chr5",231737,0,1,1,2,"chr5",1,0.00492264416315049
"7205","chr5.159540000.159545000","chr5.159615000.159620000",75000,29,5.336225e-09,159540000,159615000,159545000,159620000,"chr5",231750,1,2,3,6,"chr5",1,0.020393811533052
"7206","chr5.15105000.15110000","chr5.15820000.15825000",715000,9,0.0005883452,15105000,15820000,15110000,15825000,"chr5",231776,2,5,4,11,"chr5",1,0.0116033755274262
"7207","chr5.137950000.137955000","chr5.138535000.138540000",585000,14,1.10256e-07,137950000,138535000,137955000,138540000,"chr5",231779,5,16,16,37,"chr5",1,0.0607126113455227
"7208","chr5.31530000.31535000","chr5.32090000.32095000",560000,12,1.008001e-05,31530000,32090000,31535000,32095000,"chr5",231823,1,13,9,23,"chr5",1,0.0323488045007032
"7209","chr5.32255000.32260000","chr5.32275000.32280000",20000,41,0.0001697672,32255000,32275000,32260000,32280000,"chr5",231825,2,6,11,19,"chr5",1,0.0913033286451008
"7210","chr5.32485000.32490000","chr5.32585000.32590000",100000,22,2.421324e-06,32485000,32585000,32490000,32590000,"chr5",231938,2,14,16,32,"chr5",1,0.0825128926394749
"7211","chr5.31735000.31740000","chr5.31795000.31800000",60000,25,3.600385e-05,31735000,31795000,31740000,31800000,"chr5",231939,0,8,6,14,"chr5",1,0.0410220346929208
"7212","chr5.172410000.172415000","chr5.172475000.172480000",65000,20,0.002578088,172410000,172475000,172415000,172480000,"chr5",232003,0,5,1,6,"chr5",1,0.0140646976090014
"7213","chr5.146425000.146430000","chr5.146565000.146570000",140000,16,0.0004323448,146425000,146565000,146430000,146570000,"chr5",232008,1,2,1,4,"chr5",1,0.00750117205813408
"7214","chr5.151080000.151085000","chr5.151115000.151120000",35000,34,8.243646e-06,151080000,151115000,151085000,151120000,"chr5",232010,0,3,6,9,"chr5",1,0.0358649789029536
"7215","chr5.37410000.37415000","chr5.38190000.38195000",780000,22,2.198337e-18,37410000,38190000,37415000,38195000,"chr5",232034,1,2,0,3,"chr5",1,0.00773558368495077
"7216","chr5.138130000.138135000","chr5.138460000.138465000",330000,11,0.001416127,138130000,138460000,138135000,138465000,"chr5",232077,1,5,7,13,"chr5",1,0.0167604313173933
"7217","chr5.32310000.32315000","chr5.32585000.32590000",275000,13,0.0002149335,32310000,32585000,32315000,32590000,"chr5",232130,2,14,16,32,"chr5",1,0.0487576183778715
"7218","chr5.97160000.97165000","chr5.97180000.97185000",20000,37,0.002898373,97160000,97180000,97165000,97185000,"chr5",232184,0,3,1,4,"chr5",1,0.0173464603844351
"7219","chr5.137920000.137925000","chr5.138435000.138440000",515000,12,1.862059e-05,137920000,138435000,137925000,138440000,"chr5",232263,2,1,1,4,"chr5",1,0.00562587904360056
"7220","chr5.112665000.112670000","chr5.112920000.112925000",255000,11,0.005563889,112665000,112920000,112670000,112925000,"chr5",232284,3,1,2,6,"chr5",1,0.00773558368495077
"7221","chr5.151050000.151055000","chr5.151125000.151130000",75000,31,2.473461e-10,151050000,151125000,151055000,151130000,"chr5",232337,3,5,2,10,"chr5",1,0.036333802156587
"7222","chr5.112385000.112390000","chr5.112625000.112630000",240000,12,0.002189967,112385000,112625000,112390000,112630000,"chr5",232349,1,3,4,8,"chr5",1,0.0112517580872011
"7223","chr5.90295000.90300000","chr5.90705000.90710000",410000,10,0.002160047,90295000,90705000,90300000,90710000,"chr5",232384,0,2,2,4,"chr5",1,0.0046882325363338
"7224","chr5.16700000.16705000","chr5.17190000.17195000",490000,10,0.0008655904,16700000,17190000,16705000,17195000,"chr5",232408,2,7,1,10,"chr5",1,0.0117205813408345
"7225","chr5.9285000.9290000","chr5.9315000.9320000",30000,31,0.001884984,9285000,9315000,9290000,9320000,"chr5",232409,2,5,0,7,"chr5",1,0.0254336615096109
"7226","chr5.81885000.81890000","chr5.82860000.82865000",975000,7,0.003622462,81885000,82860000,81890000,82865000,"chr5",232411,0,0,5,5,"chr5",1,0.00410220346929208
"7227","chr5.7875000.7880000","chr5.8455000.8460000",580000,9,0.001798859,7875000,8455000,7880000,8460000,"chr5",232429,0,3,2,5,"chr5",1,0.00527426160337553
"7228","chr5.149340000.149345000","chr5.149380000.149385000",40000,27,0.0007453175,149340000,149380000,149345000,149385000,"chr5",232432,0,6,3,9,"chr5",1,0.0284810126582278
"7229","chr5.138985000.138990000","chr5.139140000.139145000",155000,13,0.008184516,138985000,139140000,138990000,139145000,"chr5",232479,5,12,13,30,"chr5",1,0.0457102672292546
"7230","chr5.80785000.80790000","chr5.81245000.81250000",460000,10,0.001201387,80785000,81245000,80790000,81250000,"chr5",232573,3,9,4,16,"chr5",1,0.0187529301453352
"7231","chr5.139540000.139545000","chr5.139735000.139740000",195000,15,0.0001523718,139540000,139735000,139545000,139740000,"chr5",232595,10,35,32,77,"chr5",1,0.135372714486639
"7232","chr5.146045000.146050000","chr5.146565000.146570000",520000,9,0.003066853,146045000,146565000,146050000,146570000,"chr5",232607,2,4,2,8,"chr5",1,0.00843881856540084
"7233","chr5.39080000.39085000","chr5.39190000.39195000",110000,19,5.444908e-05,39080000,39190000,39085000,39195000,"chr5",232618,0,1,2,3,"chr5",1,0.00668073136427567
"7234","chr5.11325000.11330000","chr5.11615000.11620000",290000,11,0.002807229,11325000,11615000,11330000,11620000,"chr5",232634,0,7,1,8,"chr5",1,0.0103141115799344
"7235","chr5.58200000.58205000","chr5.58295000.58300000",95000,24,2.542056e-07,58200000,58295000,58205000,58300000,"chr5",232639,1,3,7,11,"chr5",1,0.0309423347398031
"7236","chr5.32240000.32245000","chr5.32575000.32580000",335000,12,0.0002889575,32240000,32575000,32245000,32580000,"chr5",232647,3,8,7,18,"chr5",1,0.0253164556962025
"7237","chr5.79495000.79500000","chr5.79515000.79520000",20000,40,0.0003613994,79495000,79515000,79500000,79520000,"chr5",232723,1,9,7,17,"chr5",1,0.0796999531176746
"7238","chr5.34485000.34490000","chr5.34655000.34660000",170000,18,5.799638e-06,34485000,34655000,34490000,34660000,"chr5",232878,0,2,1,3,"chr5",1,0.00632911392405063
"7239","chr5.137635000.137640000","chr5.137755000.137760000",120000,20,6.271514e-06,137635000,137755000,137640000,137760000,"chr5",232885,0,2,1,3,"chr5",1,0.0070323488045007
"7240","chr5.154055000.154060000","chr5.154185000.154190000",130000,18,5.285156e-05,154055000,154185000,154060000,154190000,"chr5",232887,3,8,5,16,"chr5",1,0.0337552742616034
"7241","chr5.142020000.142025000","chr5.142065000.142070000",45000,23,0.005883287,142020000,142065000,142025000,142070000,"chr5",232951,6,13,15,34,"chr5",1,0.0916549460853258
"7242","chr5.16485000.16490000","chr5.17130000.17135000",645000,9,0.001014961,16485000,17130000,16490000,17135000,"chr5",232956,3,7,2,12,"chr5",1,0.0126582278481013
"7243","chr5.138175000.138180000","chr5.138435000.138440000",260000,13,0.0003232294,138175000,138435000,138180000,138440000,"chr5",232987,2,1,1,4,"chr5",1,0.00609470229723394
"7244","chr5.43190000.43195000","chr5.43305000.43310000",115000,15,0.004555073,43190000,43305000,43195000,43310000,"chr5",232989,2,13,6,21,"chr5",1,0.0369198312236287
"7245","chr5.31580000.31585000","chr5.31725000.31730000",145000,15,0.001192454,31580000,31725000,31585000,31730000,"chr5",233004,1,17,10,28,"chr5",1,0.0492264416315049
"7246","chr5.138210000.138215000","chr5.138530000.138535000",320000,11,0.001661806,138210000,138530000,138215000,138535000,"chr5",233026,3,13,13,29,"chr5",1,0.0373886544772621
"7247","chr5.11220000.11225000","chr5.11685000.11690000",465000,9,0.005202139,11220000,11685000,11225000,11690000,"chr5",233076,2,0,0,2,"chr5",1,0.00210970464135021
"7248","chr5.124820000.124825000","chr5.124920000.124925000",100000,26,5.568372e-09,124820000,124920000,124825000,124925000,"chr5",233086,1,3,3,7,"chr5",1,0.0213314580403188
"7249","chr5.138945000.138950000","chr5.138975000.138980000",30000,52,3.088718e-13,138945000,138975000,138950000,138980000,"chr5",233089,1,1,2,4,"chr5",1,0.0243788091889358
"7250","chr5.137920000.137925000","chr5.138130000.138135000",210000,12,0.004852777,137920000,138130000,137925000,138135000,"chr5",233091,3,11,4,18,"chr5",1,0.0253164556962025
"7251","chr5.145905000.145910000","chr5.146740000.146745000",835000,8,0.001509822,145905000,146740000,145910000,146745000,"chr5",233118,0,3,4,7,"chr5",1,0.00656352555086732
"7252","chr5.137920000.137925000","chr5.138530000.138535000",610000,8,0.006722729,137920000,138530000,137925000,138535000,"chr5",233132,3,11,4,18,"chr5",1,0.0168776371308017
"7253","chr5.16465000.16470000","chr5.16670000.16675000",205000,23,9.234937e-11,16465000,16670000,16470000,16675000,"chr5",233157,0,4,1,5,"chr5",1,0.0134786685419597
"7254","chr5.172400000.172405000","chr5.172575000.172580000",175000,17,2.029467e-05,172400000,172575000,172405000,172580000,"chr5",233308,0,4,3,7,"chr5",1,0.0139474917955931
"7255","chr5.132365000.132370000","chr5.133340000.133345000",975000,7,0.003622462,132365000,133340000,132370000,133345000,"chr5",233312,0,2,4,6,"chr5",1,0.00492264416315049
"7256","chr5.10120000.10125000","chr5.10250000.10255000",130000,15,0.002240806,10120000,10250000,10125000,10255000,"chr5",233313,0,5,2,7,"chr5",1,0.0123066104078762
"7257","chr5.37035000.37040000","chr5.37070000.37075000",35000,26,0.008554958,37035000,37070000,37040000,37075000,"chr5",233319,2,1,7,10,"chr5",1,0.0304735114861697
"7258","chr5.77275000.77280000","chr5.77560000.77565000",285000,12,0.0007528658,77275000,77560000,77280000,77565000,"chr5",233363,1,4,2,7,"chr5",1,0.00984528832630099
"7259","chr5.146095000.146100000","chr5.146235000.146240000",140000,14,0.004653114,146095000,146235000,146100000,146240000,"chr5",233373,0,2,0,2,"chr5",1,0.00328176277543366
"7260","chr5.68410000.68415000","chr5.68430000.68435000",20000,61,2.961736e-13,68410000,68430000,68415000,68435000,"chr5",233399,0,0,2,2,"chr5",1,0.0142991092358181
"7261","chr5.180240000.180245000","chr5.180290000.180295000",50000,22,0.005327353,180240000,180290000,180245000,180295000,"chr5",233449,0,6,2,8,"chr5",1,0.0206282231598687
"7262","chr5.172415000.172420000","chr5.172575000.172580000",160000,22,1.524668e-08,172415000,172575000,172420000,172580000,"chr5",233458,0,5,4,9,"chr5",1,0.0232067510548523
"7263","chr5.32310000.32315000","chr5.32420000.32425000",110000,15,0.005883287,32310000,32420000,32315000,32425000,"chr5",233495,4,11,14,29,"chr5",1,0.0509845288326301
"7264","chr5.14790000.14795000","chr5.15000000.15005000",210000,20,2.050958e-08,14790000,1.5e+07,14795000,15005000,"chr5",233537,1,4,3,8,"chr5",1,0.0187529301453352
"7265","chr5.134100000.134105000","chr5.134240000.134245000",140000,14,0.004653114,134100000,134240000,134105000,134245000,"chr5",233597,1,7,6,14,"chr5",1,0.0229723394280356
"7266","chr5.68025000.68030000","chr5.68180000.68185000",155000,15,0.0007935613,68025000,68180000,68030000,68185000,"chr5",233603,0,5,2,7,"chr5",1,0.0123066104078762
"7267","chr5.42905000.42910000","chr5.43040000.43045000",135000,23,1.829962e-08,42905000,43040000,42910000,43045000,"chr5",233612,3,4,10,17,"chr5",1,0.0458274730426629
"7268","chr5.14705000.14710000","chr5.15010000.15015000",305000,22,2.382216e-12,14705000,15010000,14710000,15015000,"chr5",233649,4,12,7,23,"chr5",1,0.0593061415846226
"7269","chr5.15515000.15520000","chr5.15795000.15800000",280000,13,0.0001890017,15515000,15795000,15520000,15800000,"chr5",233652,0,1,1,2,"chr5",1,0.00304735114861697
"7270","chr5.138150000.138155000","chr5.138630000.138635000",480000,9,0.004505825,138150000,138630000,138155000,138635000,"chr5",233695,1,14,12,27,"chr5",1,0.0284810126582278
"7271","chr5.37050000.37055000","chr5.37070000.37075000",20000,61,2.961736e-13,37050000,37070000,37055000,37075000,"chr5",233739,2,4,7,13,"chr5",1,0.0929442100328176
"7272","chr5.43040000.43045000","chr5.43065000.43070000",25000,35,0.002014277,43040000,43065000,43045000,43070000,"chr5",233753,4,6,10,20,"chr5",1,0.0820440693858415
"7273","chr5.180205000.180210000","chr5.180310000.180315000",105000,20,2.231199e-05,180205000,180310000,180210000,180315000,"chr5",233791,0,3,1,4,"chr5",1,0.00937646507266761
"7274","chr5.31640000.31645000","chr5.31805000.31810000",165000,19,1.599731e-06,31640000,31805000,31645000,31810000,"chr5",233896,0,2,1,3,"chr5",1,0.00668073136427567
"7275","chr5.79375000.79380000","chr5.79550000.79555000",175000,21,3.048979e-08,79375000,79550000,79380000,79555000,"chr5",233902,4,10,4,18,"chr5",1,0.0443037974683544
"7276","chr5.15600000.15605000","chr5.15630000.15635000",30000,33,0.0003881725,15600000,15630000,15605000,15635000,"chr5",233940,0,6,5,11,"chr5",1,0.0425457102672293
"7277","chr5.76850000.76855000","chr5.77560000.77565000",710000,13,1.712876e-07,76850000,77560000,76855000,77565000,"chr5",233954,1,4,2,7,"chr5",1,0.0106657290201594
"7278","chr5.10285000.10290000","chr5.10430000.10435000",145000,14,0.003899211,10285000,10430000,10290000,10435000,"chr5",233979,1,6,1,8,"chr5",1,0.0131270511017346
"7279","chr5.7880000.7885000","chr5.8840000.8845000",960000,7,0.003963507,7880000,8840000,7885000,8845000,"chr5",234039,2,6,5,13,"chr5",1,0.0106657290201594
"7280","chr5.39105000.39110000","chr5.39145000.39150000",40000,28,0.0003037047,39105000,39145000,39110000,39150000,"chr5",234117,2,0,3,5,"chr5",1,0.0164088138771683
"7281","chr5.148290000.148295000","chr5.148415000.148420000",125000,14,0.008184516,148290000,148415000,148295000,148420000,"chr5",234170,0,0,5,5,"chr5",1,0.00820440693858415
"7282","chr5.14645000.14650000","chr5.15010000.15015000",365000,10,0.00368931,14645000,15010000,14650000,15015000,"chr5",234240,1,10,7,18,"chr5",1,0.0210970464135021
"7283","chr5.171905000.171910000","chr5.172185000.172190000",280000,14,3.890122e-05,171905000,172185000,171910000,172190000,"chr5",234243,1,7,3,11,"chr5",1,0.0180496952648851
"7284","chr5.138985000.138990000","chr5.139130000.139135000",145000,15,0.001192454,138985000,139130000,138990000,139135000,"chr5",234259,3,7,4,14,"chr5",1,0.0246132208157525
"7285","chr5.31725000.31730000","chr5.31750000.31755000",25000,34,0.003956721,31725000,31750000,31730000,31755000,"chr5",234260,1,17,18,36,"chr5",1,0.143459915611814
"7286","chr5.41865000.41870000","chr5.41925000.41930000",60000,20,0.00547239,41865000,41925000,41870000,41930000,"chr5",234262,0,0,4,4,"chr5",1,0.00937646507266761
"7287","chr5.55535000.55540000","chr5.56125000.56130000",590000,8,0.00778408,55535000,56125000,55540000,56130000,"chr5",234284,2,3,2,7,"chr5",1,0.00656352555086732
"7288","chr5.138330000.138335000","chr5.138410000.138415000",80000,20,0.0003494013,138330000,138410000,138335000,138415000,"chr5",234326,5,24,25,54,"chr5",1,0.126582278481013
"7289","chr5.138630000.138635000","chr5.138650000.138655000",20000,66,5.39281e-16,138630000,138650000,138635000,138655000,"chr5",234343,1,14,10,25,"chr5",1,0.193389592123769
"7290","chr5.171905000.171910000","chr5.172095000.172100000",190000,12,0.008402274,171905000,172095000,171910000,172100000,"chr5",234352,0,5,3,8,"chr5",1,0.0112517580872011
"7291","chr5.15600000.15605000","chr5.15765000.15770000",165000,14,0.001839321,15600000,15765000,15605000,15770000,"chr5",234354,0,2,3,5,"chr5",1,0.00820440693858415
"7292","chr5.14810000.14815000","chr5.15010000.15015000",200000,16,2.874004e-05,14810000,15010000,14815000,15015000,"chr5",234366,5,6,4,15,"chr5",1,0.0281293952180028
"7293","chr5.137790000.137795000","chr5.137835000.137840000",45000,29,2.186062e-05,137790000,137835000,137795000,137840000,"chr5",234393,0,2,0,2,"chr5",1,0.00679793717768401
"7294","chr5.15515000.15520000","chr5.15785000.15790000",270000,13,0.0002459291,15515000,15785000,15520000,15790000,"chr5",234407,1,3,6,10,"chr5",1,0.0152367557430849
"7295","chr5.16785000.16790000","chr5.17130000.17135000",345000,14,8.243646e-06,16785000,17130000,16790000,17135000,"chr5",234445,4,10,6,20,"chr5",1,0.0328176277543366
"7296","chr5.172425000.172430000","chr5.172505000.172510000",80000,21,0.0001094911,172425000,172505000,172430000,172510000,"chr5",234454,0,2,4,6,"chr5",1,0.0147679324894515
"7297","chr5.78815000.78820000","chr5.79130000.79135000",315000,13,8.497294e-05,78815000,79130000,78820000,79135000,"chr5",234484,0,5,2,7,"chr5",1,0.0106657290201594
"7298","chr5.138535000.138540000","chr5.138650000.138655000",115000,16,0.001517047,138535000,138650000,138540000,138655000,"chr5",234509,5,16,10,31,"chr5",1,0.0581340834505391
"7299","chr5.137605000.137610000","chr5.137640000.137645000",35000,28,0.001925293,137605000,137640000,137610000,137645000,"chr5",234513,0,2,1,3,"chr5",1,0.00984528832630099
"7300","chr5.155975000.155980000","chr5.155995000.156000000",20000,70,2.687232e-18,155975000,155995000,155980000,1.56e+08,"chr5",234517,1,1,1,3,"chr5",1,0.0246132208157525
"7301","chr5.31635000.31640000","chr5.31735000.31740000",100000,19,0.0001288911,31635000,31735000,31640000,31740000,"chr5",234526,0,5,6,11,"chr5",1,0.0244960150023441
"7302","chr5.124755000.124760000","chr5.125345000.125350000",590000,8,0.00778408,124755000,125345000,124760000,125350000,"chr5",234530,0,5,4,9,"chr5",1,0.00843881856540084
"7303","chr5.42805000.42810000","chr5.42885000.42890000",80000,33,2.491155e-12,42805000,42885000,42810000,42890000,"chr5",234540,0,1,4,5,"chr5",1,0.0193389592123769
"7304","chr5.14780000.14785000","chr5.14940000.14945000",160000,13,0.006937252,14780000,14940000,14785000,14945000,"chr5",234615,0,2,1,3,"chr5",1,0.00457102672292546
"7305","chr5.72135000.72140000","chr5.72240000.72245000",105000,20,2.231199e-05,72135000,72240000,72140000,72245000,"chr5",234623,3,6,6,15,"chr5",1,0.0351617440225035
"7306","chr5.138185000.138190000","chr5.138610000.138615000",425000,9,0.007665597,138185000,138610000,138190000,138615000,"chr5",234672,1,4,5,10,"chr5",1,0.0105485232067511
"7307","chr5.134005000.134010000","chr5.134035000.134040000",30000,31,0.001884984,134005000,134035000,134010000,134040000,"chr5",234694,4,6,16,26,"chr5",1,0.0944678856071261
"7308","chr5.32095000.32100000","chr5.32170000.32175000",75000,19,0.001822093,32095000,32170000,32100000,32175000,"chr5",234719,4,11,14,29,"chr5",1,0.0645804031879981
"7309","chr5.172505000.172510000","chr5.172955000.172960000",450000,9,0.005930217,172505000,172955000,172510000,172960000,"chr5",234737,0,7,4,11,"chr5",1,0.0116033755274262
"7310","chr5.172415000.172420000","chr5.172505000.172510000",90000,22,8.249923e-06,172415000,172505000,172420000,172510000,"chr5",234756,0,5,4,9,"chr5",1,0.0232067510548523
"7311","chr5.41865000.41870000","chr5.42805000.42810000",940000,10,1.176045e-05,41865000,42805000,41870000,42810000,"chr5",234795,0,0,4,4,"chr5",1,0.0046882325363338
"7312","chr5.137835000.137840000","chr5.138535000.138540000",700000,9,0.0006604416,137835000,138535000,137840000,138540000,"chr5",234804,0,2,0,2,"chr5",1,0.00210970464135021
"7313","chr5.41900000.41905000","chr5.42870000.42875000",970000,10,8.494721e-06,41900000,42870000,41905000,42875000,"chr5",234828,0,1,2,3,"chr5",1,0.00351617440225035
"7314","chr5.16555000.16560000","chr5.16615000.16620000",60000,22,0.000864842,16555000,16615000,16560000,16620000,"chr5",234829,0,0,5,5,"chr5",1,0.012892639474918
"7315","chr5.32445000.32450000","chr5.32610000.32615000",165000,13,0.005863382,32445000,32610000,32450000,32615000,"chr5",234837,3,7,7,17,"chr5",1,0.0259024847632443
"7316","chr5.114945000.114950000","chr5.115170000.115175000",225000,18,3.361558e-07,114945000,115170000,114950000,115175000,"chr5",234845,0,3,2,5,"chr5",1,0.0105485232067511
"7317","chr5.37375000.37380000","chr5.38190000.38195000",815000,7,0.009185266,37375000,38190000,37380000,38195000,"chr5",234968,1,2,0,3,"chr5",1,0.00246132208157525
"7318","chr5.176535000.176540000","chr5.176710000.176715000",175000,16,8.710476e-05,176535000,176710000,176540000,176715000,"chr5",235003,0,1,0,1,"chr5",1,0.00187529301453352
"7319","chr5.142545000.142550000","chr5.142735000.142740000",190000,13,0.002624523,142545000,142735000,142550000,142740000,"chr5",235011,1,1,0,2,"chr5",1,0.00304735114861697
"7320","chr5.137885000.137890000","chr5.138695000.138700000",810000,7,0.00944453,137885000,138695000,137890000,138700000,"chr5",235016,3,3,7,13,"chr5",1,0.0106657290201594
"7321","chr5.172130000.172135000","chr5.172380000.172385000",250000,15,1.933811e-05,172130000,172380000,172135000,172385000,"chr5",235036,1,4,5,10,"chr5",1,0.0175808720112518
"7322","chr5.31855000.31860000","chr5.32095000.32100000",240000,11,0.00773422,31855000,32095000,31860000,32100000,"chr5",235052,3,11,5,19,"chr5",1,0.0244960150023441
"7323","chr5.133705000.133710000","chr5.134090000.134095000",385000,10,0.002887864,133705000,134090000,133710000,134095000,"chr5",235054,0,4,1,5,"chr5",1,0.00586029067041725
"7324","chr5.90410000.90415000","chr5.90705000.90710000",295000,10,0.009425316,90410000,90705000,90415000,90710000,"chr5",235107,0,2,2,4,"chr5",1,0.0046882325363338
"7325","chr5.42905000.42910000","chr5.42990000.42995000",85000,25,2.740968e-07,42905000,42990000,42910000,42995000,"chr5",235109,2,4,3,9,"chr5",1,0.0263713080168776
"7326","chr5.38145000.38150000","chr5.38190000.38195000",45000,24,0.002624523,38145000,38190000,38150000,38195000,"chr5",235129,1,2,0,3,"chr5",1,0.00843881856540084
"7327","chr5.142320000.142325000","chr5.142780000.142785000",460000,10,0.001201387,142320000,142780000,142325000,142785000,"chr5",235133,0,3,2,5,"chr5",1,0.00586029067041725
"7328","chr5.31855000.31860000","chr5.32090000.32095000",235000,13,0.0006514214,31855000,32090000,31860000,32095000,"chr5",235192,1,12,5,18,"chr5",1,0.0274261603375527
"7329","chr5.11505000.11510000","chr5.11600000.11605000",95000,23,1.080495e-06,11505000,11600000,11510000,11605000,"chr5",235214,0,3,2,5,"chr5",1,0.0134786685419597
"7330","chr5.138175000.138180000","chr5.138500000.138505000",325000,12,0.0003484694,138175000,138500000,138180000,138505000,"chr5",235329,5,13,22,40,"chr5",1,0.0562587904360056
"7331","chr5.15500000.15505000","chr5.15805000.15810000",305000,13,0.0001064071,15500000,15805000,15505000,15810000,"chr5",235331,0,1,2,3,"chr5",1,0.00457102672292546
"7332","chr5.137880000.137885000","chr5.138185000.138190000",305000,10,0.008090368,137880000,138185000,137885000,138190000,"chr5",235332,1,4,5,10,"chr5",1,0.0117205813408345
"7333","chr5.139410000.139415000","chr5.139480000.139485000",70000,23,4.713115e-05,139410000,139480000,139415000,139485000,"chr5",235347,1,8,5,14,"chr5",1,0.0377402719174871
"7334","chr5.134100000.134105000","chr5.134225000.134230000",125000,14,0.008184516,134100000,134225000,134105000,134230000,"chr5",235424,1,6,2,9,"chr5",1,0.0147679324894515
"7335","chr5.42990000.42995000","chr5.43040000.43045000",50000,26,0.000130539,42990000,43040000,42995000,43045000,"chr5",235444,2,6,3,11,"chr5",1,0.0335208626347867
"7336","chr5.141990000.141995000","chr5.142070000.142075000",80000,19,0.001014961,141990000,142070000,141995000,142075000,"chr5",235455,4,7,3,14,"chr5",1,0.0311767463666198
"7337","chr5.36725000.36730000","chr5.36870000.36875000",145000,17,9.237427e-05,36725000,36870000,36730000,36875000,"chr5",235478,0,0,2,2,"chr5",1,0.00398499765588373
"7338","chr5.127355000.127360000","chr5.127405000.127410000",50000,24,0.0009179388,127355000,127405000,127360000,127410000,"chr5",235485,2,0,2,4,"chr5",1,0.0112517580872011
"7339","chr5.11560000.11565000","chr5.11615000.11620000",55000,29,1.170921e-06,11560000,11615000,11565000,11620000,"chr5",235498,0,4,1,5,"chr5",1,0.01699484294421
"7340","chr5.137605000.137610000","chr5.137635000.137640000",30000,30,0.003924178,137605000,137635000,137610000,137640000,"chr5",235527,0,2,1,3,"chr5",1,0.0105485232067511
"7341","chr5.80485000.80490000","chr5.80585000.80590000",100000,21,9.650769e-06,80485000,80585000,80490000,80590000,"chr5",235537,2,9,7,18,"chr5",1,0.0443037974683544
"7342","chr5.16690000.16695000","chr5.16785000.16790000",95000,23,1.080495e-06,16690000,16785000,16695000,16790000,"chr5",235539,2,10,6,18,"chr5",1,0.0485232067510548
"7343","chr5.11265000.11270000","chr5.11325000.11330000",60000,20,0.00547239,11265000,11325000,11270000,11330000,"chr5",235598,0,7,2,9,"chr5",1,0.0210970464135021
"7344","chr5.16780000.16785000","chr5.17190000.17195000",410000,12,8.751074e-05,16780000,17190000,16785000,17195000,"chr5",235609,2,8,2,12,"chr5",1,0.0168776371308017
"7345","chr5.15600000.15605000","chr5.15795000.15800000",195000,17,7.598289e-06,15600000,15795000,15605000,15800000,"chr5",235619,0,1,1,2,"chr5",1,0.00398499765588373
"7346","chr5.79990000.79995000","chr5.80500000.80505000",510000,10,0.0006966913,79990000,80500000,79995000,80505000,"chr5",235642,1,1,2,4,"chr5",1,0.0046882325363338
"7347","chr5.151055000.151060000","chr5.151115000.151120000",60000,38,4.701703e-13,151055000,151115000,151060000,151120000,"chr5",235664,0,4,3,7,"chr5",1,0.0311767463666198
"7348","chr5.10350000.10355000","chr5.10430000.10435000",80000,19,0.001014961,10350000,10430000,10355000,10435000,"chr5",235723,1,5,1,7,"chr5",1,0.0155883731833099
"7349","chr5.34500000.34505000","chr5.34915000.34920000",415000,10,0.002024146,34500000,34915000,34505000,34920000,"chr5",235738,1,5,7,13,"chr5",1,0.0152367557430849
"7350","chr5.132365000.132370000","chr5.132385000.132390000",20000,55,3.197819e-10,132365000,132385000,132370000,132390000,"chr5",235743,0,3,0,3,"chr5",1,0.0193389592123769
"7351","chr5.77165000.77170000","chr5.77305000.77310000",140000,15,0.001490512,77165000,77305000,77170000,77310000,"chr5",235751,0,2,3,5,"chr5",1,0.00879043600562588
"7352","chr5.8835000.8840000","chr5.9055000.9060000",220000,16,1.22089e-05,8835000,9055000,8840000,9060000,"chr5",235757,0,2,1,3,"chr5",1,0.00562587904360056
"7353","chr5.78530000.78535000","chr5.78805000.78810000",275000,11,0.003736928,78530000,78805000,78535000,78810000,"chr5",235961,0,0,2,2,"chr5",1,0.00257852789498359
"7354","chr5.10250000.10255000","chr5.10350000.10355000",100000,23,5.686057e-07,10250000,10350000,10255000,10355000,"chr5",235978,3,5,10,18,"chr5",1,0.0485232067510548
"7355","chr5.73200000.73205000","chr5.73955000.73960000",755000,19,2.00515e-14,73200000,73955000,73205000,73960000,"chr5",235981,1,1,3,5,"chr5",1,0.0111345522737928
"7356","chr5.13985000.13990000","chr5.14660000.14665000",675000,10,0.0001296334,13985000,14660000,13990000,14665000,"chr5",235983,0,6,4,10,"chr5",1,0.0117205813408345
"7357","chr5.34515000.34520000","chr5.34835000.34840000",320000,12,0.0003715073,34515000,34835000,34520000,34840000,"chr5",236013,0,9,5,14,"chr5",1,0.019690576652602
"7358","chr5.135230000.135235000","chr5.135565000.135570000",335000,10,0.005327353,135230000,135565000,135235000,135570000,"chr5",236071,1,0,1,2,"chr5",1,0.0023441162681669
"7359","chr5.139735000.139740000","chr5.140020000.140025000",285000,11,0.003066853,139735000,140020000,139740000,140025000,"chr5",236166,0,3,4,7,"chr5",1,0.00902484763244257
"7360","chr5.138075000.138080000","chr5.138460000.138465000",385000,10,0.002887864,138075000,138460000,138080000,138465000,"chr5",236217,1,5,7,13,"chr5",1,0.0152367557430849
"7361","chr5.139630000.139635000","chr5.139730000.139735000",100000,19,0.0001288911,139630000,139730000,139635000,139735000,"chr5",236276,4,15,21,40,"chr5",1,0.0890764181903422
"7362","chr5.71600000.71605000","chr5.72140000.72145000",540000,11,8.644656e-05,71600000,72140000,71605000,72145000,"chr5",236287,8,18,26,52,"chr5",1,0.0670417252695734
"7363","chr5.167155000.167160000","chr5.167650000.167655000",495000,9,0.003924178,167155000,167650000,167160000,167655000,"chr5",236372,1,3,1,5,"chr5",1,0.00527426160337553
"7364","chr5.178200000.178205000","chr5.178230000.178235000",30000,30,0.003924178,178200000,178230000,178205000,178235000,"chr5",236413,3,8,14,25,"chr5",1,0.0879043600562588
"7365","chr5.34185000.34190000","chr5.34470000.34475000",285000,14,3.428612e-05,34185000,34470000,34190000,34475000,"chr5",236432,1,3,1,5,"chr5",1,0.00820440693858415
"7366","chr5.33440000.33445000","chr5.33970000.33975000",530000,9,0.002826812,33440000,33970000,33445000,33975000,"chr5",236452,0,0,6,6,"chr5",1,0.00632911392405063
"7367","chr5.54630000.54635000","chr5.54895000.54900000",265000,15,1.178151e-05,54630000,54895000,54635000,54900000,"chr5",236464,0,3,2,5,"chr5",1,0.00879043600562588
"7368","chr5.14350000.14355000","chr5.15010000.15015000",660000,9,0.0009051814,14350000,15010000,14355000,15015000,"chr5",236469,0,1,1,2,"chr5",1,0.00210970464135021
"7369","chr5.10450000.10455000","chr5.10625000.10630000",175000,43,2.232094e-29,10450000,10625000,10455000,10630000,"chr5",236507,3,10,9,22,"chr5",1,0.110876699484294
"7370","chr5.38990000.38995000","chr5.39105000.39110000",115000,15,0.004555073,38990000,39105000,38995000,39110000,"chr5",236513,0,0,3,3,"chr5",1,0.00527426160337553
"7371","chr5.138740000.138745000","chr5.138985000.138990000",245000,12,0.001925293,138740000,138985000,138745000,138990000,"chr5",236520,5,12,13,30,"chr5",1,0.0421940928270042
"7372","chr5.32170000.32175000","chr5.32585000.32590000",415000,11,0.0004298263,32170000,32585000,32175000,32590000,"chr5",236539,2,14,18,34,"chr5",1,0.0438349742147211
"7373","chr5.65035000.65040000","chr5.65130000.65135000",95000,17,0.002014277,65035000,65130000,65040000,65135000,"chr5",236588,3,2,4,9,"chr5",1,0.0179324894514768
"7374","chr5.94890000.94895000","chr5.94980000.94985000",90000,17,0.003066853,94890000,94980000,94895000,94985000,"chr5",236594,1,3,6,10,"chr5",1,0.0199249882794187
"7375","chr5.88760000.88765000","chr5.89400000.89405000",640000,10,0.0001805145,88760000,89400000,88765000,89405000,"chr5",236622,0,0,4,4,"chr5",1,0.0046882325363338
"7376","chr5.14395000.14400000","chr5.15010000.15015000",615000,8,0.006459534,14395000,15010000,14400000,15015000,"chr5",236677,1,1,5,7,"chr5",1,0.00656352555086732
"7377","chr5.138135000.138140000","chr5.138640000.138645000",505000,10,0.0007395159,138135000,138640000,138140000,138645000,"chr5",236717,0,6,2,8,"chr5",1,0.00937646507266761
"7378","chr5.31675000.31680000","chr5.31725000.31730000",50000,25,0.0003569199,31675000,31725000,31680000,31730000,"chr5",236814,1,6,8,15,"chr5",1,0.0439521800281294
"7379","chr5.132220000.132225000","chr5.132385000.132390000",165000,15,0.0005217579,132220000,132385000,132225000,132390000,"chr5",236877,0,2,0,2,"chr5",1,0.00351617440225035
"7380","chr5.122770000.122775000","chr5.122840000.122845000",70000,19,0.00333549,122770000,122840000,122775000,122845000,"chr5",236906,3,13,9,25,"chr5",1,0.0556727613689639
"7381","chr5.14680000.14685000","chr5.15010000.15015000",330000,19,6.651694e-10,14680000,15010000,14685000,15015000,"chr5",236969,5,12,7,24,"chr5",1,0.0534458509142053
"7382","chr5.90395000.90400000","chr5.90475000.90480000",80000,21,0.0001094911,90395000,90475000,90400000,90480000,"chr5",237014,1,1,3,5,"chr5",1,0.0123066104078762
"7383","chr5.31675000.31680000","chr5.31735000.31740000",60000,24,0.0001094911,31675000,31735000,31680000,31740000,"chr5",237035,0,6,8,14,"chr5",1,0.0393811533052039
"7384","chr5.138135000.138140000","chr5.138970000.138975000",835000,7,0.008233541,138135000,138970000,138140000,138975000,"chr5",237073,0,13,11,24,"chr5",1,0.019690576652602
"7385","chr5.138640000.138645000","chr5.138945000.138950000",305000,11,0.002132895,138640000,138945000,138645000,138950000,"chr5",237089,1,1,2,4,"chr5",1,0.00515705578996718
"7386","chr5.137865000.137870000","chr5.138610000.138615000",745000,9,0.0004606412,137865000,138610000,137870000,138615000,"chr5",237121,1,1,2,4,"chr5",1,0.00421940928270042
"7387","chr5.108125000.108130000","chr5.108220000.108225000",95000,16,0.005568258,108125000,108220000,108130000,108225000,"chr5",237165,0,2,0,2,"chr5",1,0.00375058602906704
"7388","chr5.168365000.168370000","chr5.168930000.168935000",565000,8,0.009382133,168365000,168930000,168370000,168935000,"chr5",237185,0,2,0,2,"chr5",1,0.00187529301453352
"7389","chr5.139085000.139090000","chr5.139125000.139130000",40000,42,2.192928e-11,139085000,139125000,139090000,139130000,"chr5",237198,4,5,7,16,"chr5",1,0.0787623066104079
"7390","chr5.31595000.31600000","chr5.31805000.31810000",210000,12,0.004852777,31595000,31805000,31600000,31810000,"chr5",237269,0,5,1,6,"chr5",1,0.00843881856540084
"7391","chr5.124625000.124630000","chr5.124755000.124760000",130000,16,0.0006966913,124625000,124755000,124630000,124760000,"chr5",237288,1,1,1,3,"chr5",1,0.00562587904360056
"7392","chr5.138990000.138995000","chr5.139410000.139415000",420000,10,0.001920287,138990000,139410000,138995000,139415000,"chr5",237368,1,3,3,7,"chr5",1,0.00820440693858415
"7393","chr5.173055000.173060000","chr5.173290000.173295000",235000,20,5.076264e-09,173055000,173290000,173060000,173295000,"chr5",237407,3,11,5,19,"chr5",1,0.0445382090951711
"7394","chr5.31885000.31890000","chr5.32030000.32035000",145000,15,0.001192454,31885000,32030000,31890000,32035000,"chr5",237429,0,5,1,6,"chr5",1,0.0105485232067511
"7395","chr5.139480000.139485000","chr5.139775000.139780000",295000,10,0.009425316,139480000,139775000,139485000,139780000,"chr5",237450,3,5,7,15,"chr5",1,0.0175808720112518
"7396","chr5.80710000.80715000","chr5.81550000.81555000",840000,7,0.008068309,80710000,81550000,80715000,81555000,"chr5",237453,0,3,2,5,"chr5",1,0.00410220346929208
"7397","chr5.32610000.32615000","chr5.33435000.33440000",825000,9,0.0002548727,32610000,33435000,32615000,33440000,"chr5",237468,3,7,8,18,"chr5",1,0.0189873417721519
"7398","chr5.10450000.10455000","chr5.10600000.10605000",150000,20,8.42303e-07,10450000,10600000,10455000,10605000,"chr5",237550,3,11,6,20,"chr5",1,0.046882325363338
"7399","chr5.126865000.126870000","chr5.127515000.127520000",650000,9,0.000977843,126865000,127515000,126870000,127520000,"chr5",237587,0,3,3,6,"chr5",1,0.00632911392405063
"7400","chr5.14725000.14730000","chr5.15010000.15015000",285000,30,3.408665e-20,14725000,15010000,14730000,15015000,"chr5",237614,2,12,5,19,"chr5",1,0.0668073136427567
"7401","chr5.138460000.138465000","chr5.138535000.138540000",75000,20,0.0006514032,138460000,138535000,138465000,138540000,"chr5",237634,1,5,7,13,"chr5",1,0.0304735114861697
"7402","chr5.172170000.172175000","chr5.172290000.172295000",120000,17,0.0003496829,172170000,172290000,172175000,172295000,"chr5",237661,3,18,8,29,"chr5",1,0.0577824660103141
"7403","chr5.15525000.15530000","chr5.15795000.15800000",270000,12,0.001045873,15525000,15795000,15530000,15800000,"chr5",237676,0,1,1,2,"chr5",1,0.00281293952180028
"7404","chr5.15105000.15110000","chr5.15805000.15810000",700000,12,1.768327e-06,15105000,15805000,15110000,15810000,"chr5",237694,0,1,3,4,"chr5",1,0.00562587904360056
"7405","chr5.168580000.168585000","chr5.168995000.169000000",415000,9,0.008398761,168580000,168995000,168585000,1.69e+08,"chr5",237739,2,3,2,7,"chr5",1,0.00738396624472574
"7406","chr5.34485000.34490000","chr5.34955000.34960000",470000,9,0.004944774,34485000,34955000,34490000,34960000,"chr5",237774,0,0,1,1,"chr5",1,0.00105485232067511
"7407","chr5.171905000.171910000","chr5.172575000.172580000",670000,8,0.004437524,171905000,172575000,171910000,172580000,"chr5",237785,0,8,8,16,"chr5",1,0.0150023441162682
"7408","chr5.31660000.31665000","chr5.31725000.31730000",65000,19,0.006346632,31660000,31725000,31665000,31730000,"chr5",237798,1,14,9,24,"chr5",1,0.0534458509142053
"7409","chr5.37410000.37415000","chr5.37815000.37820000",405000,10,0.002264742,37410000,37815000,37415000,37820000,"chr5",237854,1,1,2,4,"chr5",1,0.0046882325363338
"7410","chr5.172185000.172190000","chr5.172345000.172350000",160000,13,0.006937252,172185000,172345000,172190000,172350000,"chr5",237928,1,4,1,6,"chr5",1,0.00914205344585091
"7411","chr5.39945000.39950000","chr5.40870000.40875000",925000,7,0.004979926,39945000,40870000,39950000,40875000,"chr5",237942,0,5,3,8,"chr5",1,0.00656352555086732
"7412","chr5.172420000.172425000","chr5.172505000.172510000",85000,27,1.414816e-08,172420000,172505000,172425000,172510000,"chr5",237954,0,6,2,8,"chr5",1,0.0253164556962025
"7413","chr5.127090000.127095000","chr5.127515000.127520000",425000,13,1.172009e-05,127090000,127515000,127095000,127520000,"chr5",237996,0,2,0,2,"chr5",1,0.00304735114861697
"7414","chr5.35650000.35655000","chr5.35760000.35765000",110000,15,0.005883287,35650000,35760000,35655000,35765000,"chr5",238018,0,0,3,3,"chr5",1,0.00527426160337553
"7415","chr5.132065000.132070000","chr5.132250000.132255000",185000,12,0.00976683,132065000,132250000,132070000,132255000,"chr5",238093,0,0,1,1,"chr5",1,0.00140646976090014
"7416","chr5.172420000.172425000","chr5.172575000.172580000",155000,16,0.0002166689,172420000,172575000,172425000,172580000,"chr5",238114,0,6,2,8,"chr5",1,0.0150023441162682
"7417","chr5.138955000.138960000","chr5.138980000.138985000",25000,47,5.877826e-08,138955000,138980000,138960000,138985000,"chr5",238131,1,5,8,14,"chr5",1,0.077121425222691
"7418","chr5.31820000.31825000","chr5.32030000.32035000",210000,16,1.838168e-05,31820000,32030000,31825000,32035000,"chr5",238149,0,5,1,6,"chr5",1,0.0112517580872011
"7419","chr5.16465000.16470000","chr5.16565000.16570000",100000,16,0.00394017,16465000,16565000,16470000,16570000,"chr5",238183,0,4,1,5,"chr5",1,0.00937646507266761
"7420","chr5.43040000.43045000","chr5.43310000.43315000",270000,15,9.987615e-06,43040000,43310000,43045000,43315000,"chr5",238187,0,2,1,3,"chr5",1,0.00527426160337553
"7421","chr5.31925000.31930000","chr5.32015000.32020000",90000,23,2.146078e-06,31925000,32015000,31930000,32020000,"chr5",238211,2,6,9,17,"chr5",1,0.0458274730426629
"7422","chr5.8455000.8460000","chr5.8835000.8840000",380000,10,0.003066853,8455000,8835000,8460000,8840000,"chr5",238249,0,2,1,3,"chr5",1,0.00351617440225035
"7423","chr5.171905000.171910000","chr5.172130000.172135000",225000,36,1.652565e-24,171905000,172130000,171910000,172135000,"chr5",238267,1,4,5,10,"chr5",1,0.0421940928270042
"7424","chr5.171905000.171910000","chr5.172040000.172045000",135000,18,3.95563e-05,171905000,172040000,171910000,172045000,"chr5",238275,1,10,13,24,"chr5",1,0.0506329113924051
"7425","chr5.39145000.39150000","chr5.39545000.39550000",400000,14,2.839201e-06,39145000,39545000,39150000,39550000,"chr5",238313,0,2,5,7,"chr5",1,0.0114861697140178
"7426","chr5.137580000.137585000","chr5.137635000.137640000",55000,24,0.0003232294,137580000,137635000,137585000,137640000,"chr5",238328,0,2,1,3,"chr5",1,0.00843881856540084
"7427","chr5.9895000.9900000","chr5.10145000.10150000",250000,12,0.001715355,9895000,10145000,9900000,10150000,"chr5",238337,1,1,3,5,"chr5",1,0.0070323488045007
"7428","chr5.72155000.72160000","chr5.72175000.72180000",20000,37,0.002898373,72155000,72175000,72160000,72180000,"chr5",238362,2,8,10,20,"chr5",1,0.0867323019221753
"7429","chr5.43120000.43125000","chr5.43385000.43390000",265000,11,0.004551179,43120000,43385000,43125000,43390000,"chr5",238381,2,3,9,14,"chr5",1,0.0180496952648851
"7430","chr5.31845000.31850000","chr5.32095000.32100000",250000,12,0.001715355,31845000,32095000,31850000,32100000,"chr5",238397,1,8,9,18,"chr5",1,0.0253164556962025
"7431","chr5.150435000.150440000","chr5.151055000.151060000",620000,8,0.006231724,150435000,151055000,150440000,151060000,"chr5",238405,0,4,3,7,"chr5",1,0.00656352555086732
"7432","chr5.87065000.87070000","chr5.87950000.87955000",885000,9,0.0001578056,87065000,87950000,87070000,87955000,"chr5",238409,0,4,5,9,"chr5",1,0.00949367088607595
"7433","chr5.31650000.31655000","chr5.32090000.32095000",440000,10,0.001517047,31650000,32090000,31655000,32095000,"chr5",238441,1,13,9,23,"chr5",1,0.0269573370839194
"7434","chr5.173045000.173050000","chr5.173330000.173335000",285000,27,5.758033e-17,173045000,173330000,173050000,173335000,"chr5",238443,1,0,0,1,"chr5",1,0.00316455696202532
"7435","chr5.138210000.138215000","chr5.138410000.138415000",200000,16,2.874004e-05,138210000,138410000,138215000,138415000,"chr5",238453,3,13,13,29,"chr5",1,0.0543834974214721
"7436","chr5.31650000.31655000","chr5.31795000.31800000",145000,16,0.0003494013,31650000,31795000,31655000,31800000,"chr5",238471,1,8,6,15,"chr5",1,0.0281293952180028
"7437","chr5.137880000.137885000","chr5.138595000.138600000",715000,8,0.003281739,137880000,138595000,137885000,138600000,"chr5",238482,3,8,5,16,"chr5",1,0.0150023441162682
"7438","chr5.76370000.76375000","chr5.76715000.76720000",345000,10,0.004687522,76370000,76715000,76375000,76720000,"chr5",238483,3,3,3,9,"chr5",1,0.0105485232067511
"7439","chr5.57135000.57140000","chr5.57720000.57725000",585000,10,0.0003175315,57135000,57720000,57140000,57725000,"chr5",238487,1,0,6,7,"chr5",1,0.00820440693858415
"7440","chr5.17130000.17135000","chr5.17185000.17190000",55000,22,0.002170212,17130000,17185000,17135000,17190000,"chr5",238501,2,4,3,9,"chr5",1,0.0232067510548523
"7441","chr5.139630000.139635000","chr5.139735000.139740000",105000,15,0.007853845,139630000,139735000,139635000,139740000,"chr5",238533,4,15,21,40,"chr5",1,0.070323488045007
"7442","chr5.74685000.74690000","chr5.74980000.74985000",295000,10,0.009425316,74685000,74980000,74690000,74985000,"chr5",238543,0,3,4,7,"chr5",1,0.00820440693858415
"7443","chr5.79435000.79440000","chr5.79485000.79490000",50000,24,0.0009179388,79435000,79485000,79440000,79490000,"chr5",238588,1,1,6,8,"chr5",1,0.0225035161744023
"7444","chr5.35775000.35780000","chr5.35925000.35930000",150000,31,1.093659e-15,35775000,35925000,35780000,35930000,"chr5",238602,0,3,2,5,"chr5",1,0.0181669010782935
"7445","chr5.78645000.78650000","chr5.78735000.78740000",90000,20,0.0001064071,78645000,78735000,78650000,78740000,"chr5",238651,0,4,5,9,"chr5",1,0.0210970464135021
"7446","chr5.138695000.138700000","chr5.138720000.138725000",25000,34,0.003956721,138695000,138720000,138700000,138725000,"chr5",238684,1,12,13,26,"chr5",1,0.103609939052977
"7447","chr5.176605000.176610000","chr5.176700000.176705000",95000,19,0.0002085006,176605000,176700000,176610000,176705000,"chr5",238685,0,2,1,3,"chr5",1,0.00668073136427567
"7448","chr5.14725000.14730000","chr5.14790000.14795000",65000,20,0.002578088,14725000,14790000,14730000,14795000,"chr5",238741,2,17,5,24,"chr5",1,0.0562587904360056
"7449","chr5.81165000.81170000","chr5.81245000.81250000",80000,17,0.007473604,81165000,81245000,81170000,81250000,"chr5",238793,1,3,2,6,"chr5",1,0.0119549929676512
"7450","chr5.146895000.146900000","chr5.146940000.146945000",45000,24,0.002624523,146895000,146940000,146900000,146945000,"chr5",238841,0,1,2,3,"chr5",1,0.00843881856540084
"7451","chr5.139085000.139090000","chr5.139110000.139115000",25000,44,1.146363e-06,139085000,139110000,139090000,139115000,"chr5",238849,6,13,10,29,"chr5",1,0.149554617909048
"7452","chr5.14865000.14870000","chr5.15000000.15005000",135000,25,5.853235e-10,14865000,1.5e+07,14870000,15005000,"chr5",238865,1,4,3,8,"chr5",1,0.023441162681669
"7453","chr5.124750000.124755000","chr5.124820000.124825000",70000,45,2.115688e-20,124750000,124820000,124755000,124825000,"chr5",238877,1,3,9,13,"chr5",1,0.0685654008438819
"7454","chr5.153465000.153470000","chr5.153555000.153560000",90000,18,0.001051505,153465000,153555000,153470000,153560000,"chr5",238921,0,6,3,9,"chr5",1,0.0189873417721519
"7455","chr5.34520000.34525000","chr5.34915000.34920000",395000,12,0.0001098725,34520000,34915000,34525000,34920000,"chr5",238932,3,3,6,12,"chr5",1,0.0168776371308017
"7456","chr5.172775000.172780000","chr5.173015000.173020000",240000,11,0.00773422,172775000,173015000,172780000,173020000,"chr5",238949,1,6,5,12,"chr5",1,0.0154711673699015
"7457","chr5.42950000.42955000","chr5.42990000.42995000",40000,38,4.578868e-09,42950000,42990000,42955000,42995000,"chr5",238957,2,8,3,13,"chr5",1,0.0578996718237225
"7458","chr5.31825000.31830000","chr5.32075000.32080000",250000,22,3.95793e-11,31825000,32075000,31830000,32080000,"chr5",238965,4,7,9,20,"chr5",1,0.0515705578996718
"7459","chr5.8365000.8370000","chr5.8455000.8460000",90000,20,0.0001064071,8365000,8455000,8370000,8460000,"chr5",238982,0,2,2,4,"chr5",1,0.00937646507266761
"7460","chr5.13985000.13990000","chr5.14105000.14110000",120000,29,1.842013e-12,13985000,14105000,13990000,14110000,"chr5",239003,0,4,2,6,"chr5",1,0.020393811533052
"7461","chr5.127230000.127235000","chr5.127350000.127355000",120000,15,0.003574578,127230000,127350000,127235000,127355000,"chr5",239006,0,2,0,2,"chr5",1,0.00351617440225035
"7462","chr5.173470000.173475000","chr5.173745000.173750000",275000,22,1.009889e-11,173470000,173745000,173475000,173750000,"chr5",239013,2,2,6,10,"chr5",1,0.0257852789498359
"7463","chr5.31820000.31825000","chr5.32080000.32085000",260000,13,0.0003232294,31820000,32080000,31825000,32085000,"chr5",239020,1,7,9,17,"chr5",1,0.0259024847632443
"7464","chr5.176605000.176610000","chr5.176630000.176635000",25000,38,0.0002166689,176605000,176630000,176610000,176635000,"chr5",239031,4,13,3,20,"chr5",1,0.0890764181903422
"7465","chr5.112635000.112640000","chr5.112665000.112670000",30000,39,1.568348e-06,112635000,112665000,112640000,112670000,"chr5",239074,5,8,11,24,"chr5",1,0.109704641350211
"7466","chr5.32490000.32495000","chr5.32575000.32580000",85000,19,0.0005917436,32490000,32575000,32495000,32580000,"chr5",239107,3,8,7,18,"chr5",1,0.040084388185654
"7467","chr5.135230000.135235000","chr5.135550000.135555000",320000,16,3.794585e-07,135230000,135550000,135235000,135555000,"chr5",239124,1,1,2,4,"chr5",1,0.00750117205813408
"7468","chr5.55575000.55580000","chr5.56160000.56165000",585000,16,1.154927e-09,55575000,56160000,55580000,56165000,"chr5",239142,3,2,12,17,"chr5",1,0.0318799812470699
"7469","chr5.138075000.138080000","chr5.138645000.138650000",570000,8,0.00896904,138075000,138645000,138080000,138650000,"chr5",239221,1,1,0,2,"chr5",1,0.00187529301453352
"7470","chr5.14445000.14450000","chr5.15000000.15005000",555000,12,1.085975e-05,14445000,1.5e+07,14450000,15005000,"chr5",239255,0,3,2,5,"chr5",1,0.0070323488045007
"7471","chr5.139410000.139415000","chr5.139540000.139545000",130000,15,0.002240806,139410000,139540000,139415000,139545000,"chr5",239258,1,8,5,14,"chr5",1,0.0246132208157525
"7472","chr5.16690000.16695000","chr5.16775000.16780000",85000,17,0.004736201,16690000,16775000,16695000,16780000,"chr5",239274,2,13,10,25,"chr5",1,0.0498124706985466
"7473","chr5.38440000.38445000","chr5.38805000.38810000",365000,21,2.422909e-12,38440000,38805000,38445000,38810000,"chr5",239363,0,2,1,3,"chr5",1,0.00738396624472574
"7474","chr5.176540000.176545000","chr5.176660000.176665000",120000,23,6.594718e-08,176540000,176660000,176545000,176665000,"chr5",239483,0,1,1,2,"chr5",1,0.00539146741678387
"7475","chr5.173045000.173050000","chr5.173730000.173735000",685000,9,0.0007453175,173045000,173730000,173050000,173735000,"chr5",239579,3,3,3,9,"chr5",1,0.00949367088607595
"7476","chr5.16690000.16695000","chr5.17130000.17135000",440000,12,5.584874e-05,16690000,17130000,16695000,17135000,"chr5",239613,2,13,10,25,"chr5",1,0.0351617440225035
"7477","chr5.72300000.72305000","chr5.72330000.72335000",30000,38,4.280784e-06,72300000,72330000,72305000,72335000,"chr5",239618,2,2,7,11,"chr5",1,0.0489920300046882
"7478","chr5.133705000.133710000","chr5.133745000.133750000",40000,35,1.831364e-07,133705000,133745000,133710000,133750000,"chr5",239647,0,4,1,5,"chr5",1,0.0205110173464604
"7479","chr5.31845000.31850000","chr5.32075000.32080000",230000,12,0.002842625,31845000,32075000,31850000,32080000,"chr5",239697,1,8,9,18,"chr5",1,0.0253164556962025
"7480","chr5.32275000.32280000","chr5.32610000.32615000",335000,10,0.005327353,32275000,32610000,32280000,32615000,"chr5",239718,2,6,8,16,"chr5",1,0.0187529301453352
"7481","chr5.138955000.138960000","chr5.139400000.139405000",445000,11,0.0002909332,138955000,139400000,138960000,139405000,"chr5",239750,2,6,5,13,"chr5",1,0.0167604313173933
"7482","chr5.78805000.78810000","chr5.79375000.79380000",570000,9,0.001948204,78805000,79375000,78810000,79380000,"chr5",239797,0,0,2,2,"chr5",1,0.00210970464135021
"7483","chr5.42885000.42890000","chr5.42905000.42910000",20000,42,7.832946e-05,42885000,42905000,42890000,42910000,"chr5",239802,3,4,11,18,"chr5",1,0.0886075949367089
"7484","chr5.11265000.11270000","chr5.11505000.11510000",240000,17,9.908917e-07,11265000,11505000,11270000,11510000,"chr5",239886,0,4,4,8,"chr5",1,0.0159399906235349
"7485","chr5.95120000.95125000","chr5.95660000.95665000",540000,9,0.002573396,95120000,95660000,95125000,95665000,"chr5",239905,0,0,8,8,"chr5",1,0.00843881856540084
"7486","chr5.41925000.41930000","chr5.42870000.42875000",945000,8,0.0007036742,41925000,42870000,41930000,42875000,"chr5",239917,0,0,2,2,"chr5",1,0.00187529301453352
"7487","chr5.16700000.16705000","chr5.17200000.17205000",500000,9,0.003736928,16700000,17200000,16705000,17205000,"chr5",239921,0,7,1,8,"chr5",1,0.00843881856540084
"7488","chr5.39375000.39380000","chr5.39560000.39565000",185000,13,0.003066853,39375000,39560000,39380000,39565000,"chr5",239927,0,1,2,3,"chr5",1,0.00457102672292546
"7489","chr5.95025000.95030000","chr5.95065000.95070000",40000,31,1.573413e-05,95025000,95065000,95030000,95070000,"chr5",239929,0,1,0,1,"chr5",1,0.0036333802156587
"7490","chr5.43105000.43110000","chr5.43310000.43315000",205000,15,0.0001038464,43105000,43310000,43110000,43315000,"chr5",240025,0,2,1,3,"chr5",1,0.00527426160337553
"7491","chr5.31935000.31940000","chr5.32015000.32020000",80000,18,0.00285359,31935000,32015000,31940000,32020000,"chr5",240052,2,1,0,3,"chr5",1,0.00632911392405063
"7492","chr5.139110000.139115000","chr5.139130000.139135000",20000,39,0.0007493829,139110000,139130000,139115000,139135000,"chr5",240064,3,7,4,14,"chr5",1,0.0639943741209564
"7493","chr5.31795000.31800000","chr5.32090000.32095000",295000,12,0.0006148647,31795000,32090000,31800000,32095000,"chr5",240073,1,8,6,15,"chr5",1,0.0210970464135021
"7494","chr5.31725000.31730000","chr5.32090000.32095000",365000,10,0.00368931,31725000,32090000,31730000,32095000,"chr5",240151,1,13,9,23,"chr5",1,0.0269573370839194
"7495","chr5.138610000.138615000","chr5.138640000.138645000",30000,31,0.001884984,138610000,138640000,138615000,138645000,"chr5",240225,2,6,2,10,"chr5",1,0.036333802156587
"7496","chr5.137755000.137760000","chr5.138645000.138650000",890000,7,0.006046949,137755000,138645000,137760000,138650000,"chr5",240368,1,1,0,2,"chr5",1,0.00164088138771683
"7497","chr5.40755000.40760000","chr5.40830000.40835000",75000,25,1.568348e-06,40755000,40830000,40760000,40835000,"chr5",240403,1,6,5,12,"chr5",1,0.0351617440225035
"7498","chr6.56770000.56775000","chr6.56890000.56895000",120000,15,0.004837722,56770000,56890000,56775000,56895000,"chr6",240426,0,4,0,4,"chr6",1,0.0070323488045007
"7499","chr6.37965000.37970000","chr6.38290000.38295000",325000,11,0.001903583,37965000,38290000,37970000,38295000,"chr6",240449,0,2,0,2,"chr6",1,0.00257852789498359
"7500","chr6.3740000.3745000","chr6.3940000.3945000",200000,17,8.604292e-06,3740000,3940000,3745000,3945000,"chr6",240460,0,3,1,4,"chr6",1,0.00796999531176746
"7501","chr6.17705000.17710000","chr6.18150000.18155000",445000,11,0.0003519427,17705000,18150000,17710000,18155000,"chr6",240471,0,5,8,13,"chr6",1,0.0167604313173933
"7502","chr6.26380000.26385000","chr6.26470000.26475000",90000,33,4.834821e-13,26380000,26470000,26385000,26475000,"chr6",240492,1,6,5,12,"chr6",1,0.0464135021097046
"7503","chr6.42875000.42880000","chr6.43515000.43520000",640000,8,0.005980343,42875000,43515000,42880000,43520000,"chr6",240493,1,2,3,6,"chr6",1,0.00562587904360056
"7504","chr6.32130000.32135000","chr6.32840000.32845000",710000,8,0.003605059,32130000,32840000,32135000,32845000,"chr6",240498,3,6,2,11,"chr6",1,0.0103141115799344
"7505","chr6.31680000.31685000","chr6.31830000.31835000",150000,17,0.0001020577,31680000,31830000,31685000,31835000,"chr6",240577,1,8,6,15,"chr6",1,0.029887482419128
"7506","chr6.28920000.28925000","chr6.28950000.28955000",30000,39,2.940968e-06,28920000,28950000,28925000,28955000,"chr6",240585,0,4,2,6,"chr6",1,0.0274261603375527
"7507","chr6.26320000.26325000","chr6.26530000.26535000",210000,14,0.0004857598,26320000,26530000,26325000,26535000,"chr6",240688,6,5,8,19,"chr6",1,0.0311767463666198
"7508","chr6.157105000.157110000","chr6.157165000.157170000",60000,23,0.0004898132,157105000,157165000,157110000,157170000,"chr6",240701,0,2,1,3,"chr6",1,0.00808720112517581
"7509","chr6.157895000.157900000","chr6.158000000.158005000",105000,18,0.0004195353,157895000,1.58e+08,157900000,158005000,"chr6",240714,0,1,2,3,"chr6",1,0.00632911392405063
"7510","chr6.134480000.134485000","chr6.134910000.134915000",430000,14,2.077534e-06,134480000,134910000,134485000,134915000,"chr6",240721,1,9,5,15,"chr6",1,0.0246132208157525
"7511","chr6.38275000.38280000","chr6.38355000.38360000",80000,18,0.004053176,38275000,38355000,38280000,38360000,"chr6",240722,0,1,6,7,"chr6",1,0.0147679324894515
"7512","chr6.112035000.112040000","chr6.112295000.112300000",260000,16,3.511384e-06,112035000,112295000,112040000,112300000,"chr6",240779,1,1,2,4,"chr6",1,0.00750117205813408
"7513","chr6.38275000.38280000","chr6.38320000.38325000",45000,23,0.008672865,38275000,38320000,38280000,38325000,"chr6",240838,0,4,1,5,"chr6",1,0.0134786685419597
"7514","chr6.111725000.111730000","chr6.111795000.111800000",70000,21,0.0006733273,111725000,111795000,111730000,111800000,"chr6",240859,0,2,1,3,"chr6",1,0.00738396624472574
"7515","chr6.157105000.157110000","chr6.157485000.157490000",380000,10,0.003746171,157105000,157485000,157110000,157490000,"chr6",240865,0,2,1,3,"chr6",1,0.00351617440225035
"7516","chr6.26420000.26425000","chr6.26470000.26475000",50000,30,2.785437e-06,26420000,26470000,26425000,26475000,"chr6",240878,0,1,2,3,"chr6",1,0.0105485232067511
"7517","chr6.7260000.7265000","chr6.7390000.7395000",130000,18,7.754492e-05,7260000,7390000,7265000,7395000,"chr6",240906,2,8,3,13,"chr6",1,0.0274261603375527
"7518","chr6.6760000.6765000","chr6.7240000.7245000",480000,12,3.766511e-05,6760000,7240000,6765000,7245000,"chr6",240922,1,3,5,9,"chr6",1,0.0126582278481013
"7519","chr6.149410000.149415000","chr6.149545000.149550000",135000,17,0.0002187489,149410000,149545000,149415000,149550000,"chr6",240931,4,11,14,29,"chr6",1,0.0577824660103141
"7520","chr6.16510000.16515000","chr6.17085000.17090000",575000,11,6.537819e-05,16510000,17085000,16515000,17090000,"chr6",240956,1,5,3,9,"chr6",1,0.0116033755274262
"7521","chr6.26340000.26345000","chr6.26400000.26405000",60000,21,0.003287302,26340000,26400000,26345000,26405000,"chr6",240997,3,10,6,19,"chr6",1,0.0467651195499297
"7522","chr6.158645000.158650000","chr6.158920000.158925000",275000,14,5.999569e-05,158645000,158920000,158650000,158925000,"chr6",241009,1,3,5,9,"chr6",1,0.0147679324894515
"7523","chr6.26155000.26160000","chr6.26205000.26210000",50000,38,8.119791e-11,26155000,26205000,26160000,26210000,"chr6",241031,0,4,5,9,"chr6",1,0.040084388185654
"7524","chr6.13905000.13910000","chr6.14065000.14070000",160000,41,8.767034e-26,13905000,14065000,13910000,14070000,"chr6",241065,0,4,2,6,"chr6",1,0.0288326300984529
"7525","chr6.138490000.138495000","chr6.138600000.138605000",110000,15,0.008000267,138490000,138600000,138495000,138605000,"chr6",241093,0,3,2,5,"chr6",1,0.00879043600562588
"7526","chr6.37670000.37675000","chr6.37785000.37790000",115000,28,4.300074e-11,37670000,37785000,37675000,37790000,"chr6",241100,2,2,2,6,"chr6",1,0.019690576652602
"7527","chr6.26320000.26325000","chr6.26565000.26570000",245000,19,3.101156e-08,26320000,26565000,26325000,26570000,"chr6",241138,2,7,13,22,"chr6",1,0.0489920300046882
"7528","chr6.149410000.149415000","chr6.149715000.149720000",305000,12,0.0006365693,149410000,149715000,149415000,149720000,"chr6",241153,3,14,14,31,"chr6",1,0.0436005625879044
"7529","chr6.56590000.56595000","chr6.56710000.56715000",120000,16,0.001601229,56590000,56710000,56595000,56715000,"chr6",241178,0,0,1,1,"chr6",1,0.00187529301453352
"7530","chr6.26055000.26060000","chr6.26100000.26105000",45000,52,3.052977e-19,26055000,26100000,26060000,26105000,"chr6",241206,0,7,9,16,"chr6",1,0.0975152367557431
"7531","chr6.26030000.26035000","chr6.26125000.26130000",95000,19,0.0003106794,26030000,26125000,26035000,26130000,"chr6",241208,3,5,3,11,"chr6",1,0.0244960150023441
"7532","chr6.3125000.3130000","chr6.3190000.3195000",65000,19,0.009047489,3125000,3190000,3130000,3195000,"chr6",241215,0,8,11,19,"chr6",1,0.0423112986404126
"7533","chr6.6720000.6725000","chr6.7260000.7265000",540000,12,1.556915e-05,6720000,7260000,6725000,7265000,"chr6",241225,2,0,0,2,"chr6",1,0.00281293952180028
"7534","chr6.148610000.148615000","chr6.148700000.148705000",90000,21,4.777466e-05,148610000,148700000,148615000,148705000,"chr6",241239,1,3,0,4,"chr6",1,0.00984528832630099
"7535","chr6.11170000.11175000","chr6.11495000.11500000",325000,34,9.001821e-26,11170000,11495000,11175000,11500000,"chr6",241268,0,0,4,4,"chr6",1,0.0159399906235349
"7536","chr6.151335000.151340000","chr6.151690000.151695000",355000,12,0.0002608528,151335000,151690000,151340000,151695000,"chr6",241286,0,6,4,10,"chr6",1,0.0140646976090014
"7537","chr6.43510000.43515000","chr6.44170000.44175000",660000,8,0.005181923,43510000,44170000,43515000,44175000,"chr6",241292,0,3,4,7,"chr6",1,0.00656352555086732
"7538","chr6.25310000.25315000","chr6.25365000.25370000",55000,22,0.003206695,25310000,25365000,25315000,25370000,"chr6",241294,0,3,7,10,"chr6",1,0.0257852789498359
"7539","chr6.26205000.26210000","chr6.26305000.26310000",100000,17,0.001910446,26205000,26305000,26210000,26310000,"chr6",241300,0,4,5,9,"chr6",1,0.0179324894514768
"7540","chr6.11160000.11165000","chr6.11250000.11255000",90000,26,4.795948e-08,11160000,11250000,11165000,11255000,"chr6",241328,0,2,1,3,"chr6",1,0.00914205344585091
"7541","chr6.87855000.87860000","chr6.88105000.88110000",250000,11,0.007749285,87855000,88105000,87860000,88110000,"chr6",241360,0,6,5,11,"chr6",1,0.0141819034224098
"7542","chr6.53030000.53035000","chr6.53355000.53360000",325000,25,1.4489e-15,53030000,53355000,53035000,53360000,"chr6",241383,1,5,4,10,"chr6",1,0.0293014533520863
"7543","chr6.35270000.35275000","chr6.35410000.35415000",140000,22,1.079291e-07,35270000,35410000,35275000,35415000,"chr6",241417,0,5,6,11,"chr6",1,0.0283638068448195
"7544","chr6.26530000.26535000","chr6.26570000.26575000",40000,51,8.460385e-17,26530000,26570000,26535000,26575000,"chr6",241425,4,5,8,17,"chr6",1,0.101617440225035
"7545","chr6.34150000.34155000","chr6.34345000.34350000",195000,25,6.27338e-12,34150000,34345000,34155000,34350000,"chr6",241432,2,5,7,14,"chr6",1,0.0410220346929208
"7546","chr6.56785000.56790000","chr6.57170000.57175000",385000,13,2.957729e-05,56785000,57170000,56790000,57175000,"chr6",241435,2,10,10,22,"chr6",1,0.0335208626347867
"7547","chr6.56910000.56915000","chr6.57085000.57090000",175000,17,2.917956e-05,56910000,57085000,56915000,57090000,"chr6",241447,2,3,4,9,"chr6",1,0.0179324894514768
"7548","chr6.111085000.111090000","chr6.111110000.111115000",25000,36,0.00167179,111085000,111110000,111090000,111115000,"chr6",241478,3,9,4,16,"chr6",1,0.0675105485232067
"7549","chr6.37670000.37675000","chr6.38555000.38560000",885000,9,0.0001606117,37670000,38555000,37675000,38560000,"chr6",241498,1,2,1,4,"chr6",1,0.00421940928270042
"7550","chr6.134245000.134250000","chr6.134445000.134450000",200000,20,5.707802e-08,134245000,134445000,134250000,134450000,"chr6",241506,5,11,8,24,"chr6",1,0.0562587904360056
"7551","chr6.44235000.44240000","chr6.44305000.44310000",70000,26,1.934617e-06,44235000,44305000,44240000,44310000,"chr6",241511,0,4,1,5,"chr6",1,0.0152367557430849
"7552","chr6.37015000.37020000","chr6.37165000.37170000",150000,21,2.648301e-07,37015000,37165000,37020000,37170000,"chr6",241524,1,6,3,10,"chr6",1,0.0246132208157525
"7553","chr6.15255000.15260000","chr6.15390000.15395000",135000,25,1.020897e-09,15255000,15390000,15260000,15395000,"chr6",241537,0,5,2,7,"chr6",1,0.0205110173464604
"7554","chr6.108925000.108930000","chr6.109095000.109100000",170000,18,8.51929e-06,108925000,109095000,108930000,109100000,"chr6",241548,3,3,3,9,"chr6",1,0.0189873417721519
"7555","chr6.2995000.3000000","chr6.3050000.3055000",55000,41,8.884609e-14,2995000,3050000,3e+06,3055000,"chr6",241576,2,9,11,22,"chr6",1,0.105719643694327
"7556","chr6.28950000.28955000","chr6.28975000.28980000",25000,39,0.0001789227,28950000,28975000,28955000,28980000,"chr6",241579,3,8,7,18,"chr6",1,0.0822784810126582
"7557","chr6.26570000.26575000","chr6.27145000.27150000",575000,13,1.27014e-06,26570000,27145000,26575000,27150000,"chr6",241599,0,7,3,10,"chr6",1,0.0152367557430849
"7558","chr6.134300000.134305000","chr6.134415000.134420000",115000,16,0.002119166,134300000,134415000,134305000,134420000,"chr6",241612,5,10,13,28,"chr6",1,0.0525082044069386
"7559","chr6.2790000.2795000","chr6.2920000.2925000",130000,14,0.008995566,2790000,2920000,2795000,2925000,"chr6",241745,0,2,1,3,"chr6",1,0.00492264416315049
"7560","chr6.34235000.34240000","chr6.34280000.34285000",45000,23,0.008672865,34235000,34280000,34240000,34285000,"chr6",241766,0,1,1,2,"chr6",1,0.00539146741678387
"7561","chr6.13335000.13340000","chr6.13570000.13575000",235000,18,3.061033e-07,13335000,13570000,13340000,13575000,"chr6",241777,1,5,4,10,"chr6",1,0.0210970464135021
"7562","chr6.150740000.150745000","chr6.151060000.151065000",320000,12,0.0004857598,150740000,151060000,150745000,151065000,"chr6",241782,0,6,4,10,"chr6",1,0.0140646976090014
"7563","chr6.3205000.3210000","chr6.4015000.4020000",810000,7,0.00973435,3205000,4015000,3210000,4020000,"chr6",241807,3,7,6,16,"chr6",1,0.0131270511017346
"7564","chr6.31650000.31655000","chr6.31815000.31820000",165000,13,0.007734444,31650000,31815000,31655000,31820000,"chr6",241816,2,10,13,25,"chr6",1,0.0380918893577121
"7565","chr6.38320000.38325000","chr6.38410000.38415000",90000,22,1.343839e-05,38320000,38410000,38325000,38415000,"chr6",241860,1,4,1,6,"chr6",1,0.0154711673699015
"7566","chr6.139135000.139140000","chr6.139580000.139585000",445000,11,0.0003519427,139135000,139580000,139140000,139585000,"chr6",241864,0,2,0,2,"chr6",1,0.00257852789498359
"7567","chr6.28125000.28130000","chr6.28215000.28220000",90000,19,0.000515061,28125000,28215000,28130000,28220000,"chr6",241888,1,1,3,5,"chr6",1,0.0111345522737928
"7568","chr6.26570000.26575000","chr6.27475000.27480000",905000,7,0.005770094,26570000,27475000,26575000,27480000,"chr6",241897,4,7,12,23,"chr6",1,0.0188701359587436
"7569","chr6.26195000.26200000","chr6.26270000.26275000",75000,18,0.006748519,26195000,26270000,26200000,26275000,"chr6",241909,0,2,0,2,"chr6",1,0.00421940928270042
"7570","chr6.16530000.16535000","chr6.16720000.16725000",190000,14,0.000974011,16530000,16720000,16535000,16725000,"chr6",241924,0,1,0,1,"chr6",1,0.00164088138771683
"7571","chr6.111030000.111035000","chr6.111055000.111060000",25000,42,1.469486e-05,111030000,111055000,111035000,111060000,"chr6",241946,3,9,8,20,"chr6",1,0.0984528832630098
"7572","chr6.111680000.111685000","chr6.111850000.111855000",170000,16,0.0001547714,111680000,111850000,111685000,111855000,"chr6",241948,3,10,15,28,"chr6",1,0.0525082044069386
"7573","chr6.24580000.24585000","chr6.24775000.24780000",195000,19,4.293056e-07,24580000,24775000,24585000,24780000,"chr6",242000,0,2,0,2,"chr6",1,0.00445382090951711
"7574","chr6.134500000.134505000","chr6.135200000.135205000",700000,13,2.076973e-07,134500000,135200000,134505000,135205000,"chr6",242030,2,4,6,12,"chr6",1,0.0182841068917018
"7575","chr6.56680000.56685000","chr6.56700000.56705000",20000,72,8.008684e-19,56680000,56700000,56685000,56705000,"chr6",242109,2,4,3,9,"chr6",1,0.0759493670886076
"7576","chr6.110875000.110880000","chr6.110995000.111000000",120000,18,0.0001432066,110875000,110995000,110880000,1.11e+08,"chr6",242159,4,21,20,45,"chr6",1,0.0949367088607595
"7577","chr6.37725000.37730000","chr6.38480000.38485000",755000,9,0.0004512193,37725000,38480000,37730000,38485000,"chr6",242169,1,1,2,4,"chr6",1,0.00421940928270042
"7578","chr6.17165000.17170000","chr6.17580000.17585000",415000,16,5.24899e-08,17165000,17580000,17170000,17585000,"chr6",242173,0,0,3,3,"chr6",1,0.00562587904360056
"7579","chr6.158655000.158660000","chr6.158970000.158975000",315000,10,0.008579001,158655000,158970000,158660000,158975000,"chr6",242203,0,6,7,13,"chr6",1,0.0152367557430849
"7580","chr6.136945000.136950000","chr6.136985000.136990000",40000,32,9.79823e-06,136945000,136985000,136950000,136990000,"chr6",242345,1,3,3,7,"chr6",1,0.0262541022034693
"7581","chr6.17705000.17710000","chr6.17985000.17990000",280000,19,6.319485e-09,17705000,17985000,17710000,17990000,"chr6",242362,0,4,2,6,"chr6",1,0.0133614627285513
"7582","chr6.26020000.26025000","chr6.26205000.26210000",185000,14,0.001182822,26020000,26205000,26025000,26210000,"chr6",242411,0,4,5,9,"chr6",1,0.0147679324894515
"7583","chr6.31700000.31705000","chr6.31830000.31835000",130000,22,2.270638e-07,31700000,31830000,31705000,31835000,"chr6",242413,7,17,15,39,"chr6",1,0.10056258790436
"7584","chr6.150730000.150735000","chr6.151010000.151015000",280000,12,0.00107979,150730000,151010000,150735000,151015000,"chr6",242432,1,8,12,21,"chr6",1,0.029535864978903
"7585","chr6.3275000.3280000","chr6.3740000.3745000",465000,13,7.452347e-06,3275000,3740000,3280000,3745000,"chr6",242440,0,3,1,4,"chr6",1,0.00609470229723394
"7586","chr6.16510000.16515000","chr6.16725000.16730000",215000,21,3.733329e-09,16510000,16725000,16515000,16730000,"chr6",242449,0,5,0,5,"chr6",1,0.0123066104078762
"7587","chr6.26055000.26060000","chr6.26085000.26090000",30000,38,7.841178e-06,26055000,26085000,26060000,26090000,"chr6",242495,0,7,9,16,"chr6",1,0.0712611345522738
"7588","chr6.37025000.37030000","chr6.37050000.37055000",25000,42,1.469486e-05,37025000,37050000,37030000,37055000,"chr6",242505,4,4,2,10,"chr6",1,0.0492264416315049
"7589","chr6.108580000.108585000","chr6.108610000.108615000",30000,37,2.013492e-05,108580000,108610000,108585000,108615000,"chr6",242510,0,1,0,1,"chr6",1,0.00433661509610877
"7590","chr6.11095000.11100000","chr6.11200000.11205000",105000,21,8.960961e-06,11095000,11200000,11100000,11205000,"chr6",242537,0,3,2,5,"chr6",1,0.0123066104078762
"7591","chr6.13410000.13415000","chr6.13445000.13450000",35000,38,2.136305e-07,13410000,13445000,13415000,13450000,"chr6",242555,0,1,2,3,"chr6",1,0.0133614627285513
"7592","chr6.30890000.30895000","chr6.31035000.31040000",145000,16,0.0004894394,30890000,31035000,30895000,31040000,"chr6",242570,0,1,1,2,"chr6",1,0.00375058602906704
"7593","chr6.27145000.27150000","chr6.27790000.27795000",645000,8,0.005772119,27145000,27790000,27150000,27795000,"chr6",242573,0,4,3,7,"chr6",1,0.00656352555086732
"7594","chr6.111705000.111710000","chr6.111725000.111730000",20000,37,0.005260689,111705000,111725000,111710000,111730000,"chr6",242596,0,2,1,3,"chr6",1,0.0130098452883263
"7595","chr6.134590000.134595000","chr6.135200000.135205000",610000,9,0.001523264,134590000,135200000,134595000,135205000,"chr6",242602,0,2,1,3,"chr6",1,0.00316455696202532
"7596","chr6.19010000.19015000","chr6.19800000.19805000",790000,8,0.002085711,19010000,19800000,19015000,19805000,"chr6",242605,0,3,4,7,"chr6",1,0.00656352555086732
"7597","chr6.27820000.27825000","chr6.27865000.27870000",45000,30,1.311401e-05,27820000,27865000,27825000,27870000,"chr6",242607,3,1,5,9,"chr6",1,0.0316455696202532
"7598","chr6.34220000.34225000","chr6.34245000.34250000",25000,34,0.006369861,34220000,34245000,34225000,34250000,"chr6",242635,0,2,1,3,"chr6",1,0.0119549929676512
"7599","chr6.134520000.134525000","chr6.135055000.135060000",535000,9,0.00308896,134520000,135055000,134525000,135060000,"chr6",242703,3,12,7,22,"chr6",1,0.0232067510548523
"7600","chr6.34920000.34925000","chr6.35010000.35015000",90000,20,0.0001628069,34920000,35010000,34925000,35015000,"chr6",242794,4,2,5,11,"chr6",1,0.0257852789498359
"7601","chr6.52375000.52380000","chr6.52420000.52425000",45000,23,0.008672865,52375000,52420000,52380000,52425000,"chr6",242795,2,0,1,3,"chr6",1,0.00808720112517581
"7602","chr6.134500000.134505000","chr6.135140000.135145000",640000,33,1.650522e-31,134500000,135140000,134505000,135145000,"chr6",242798,3,5,5,13,"chr6",1,0.05028129395218
"7603","chr6.24665000.24670000","chr6.24695000.24700000",30000,38,7.841178e-06,24665000,24695000,24670000,24700000,"chr6",242827,0,6,2,8,"chr6",1,0.0356305672761369
"7604","chr6.17165000.17170000","chr6.17705000.17710000",540000,14,2.782546e-07,17165000,17705000,17170000,17710000,"chr6",242836,0,4,7,11,"chr6",1,0.0180496952648851
"7605","chr6.158405000.158410000","chr6.158495000.158500000",90000,24,8.828706e-07,158405000,158495000,158410000,158500000,"chr6",242905,0,0,4,4,"chr6",1,0.0112517580872011
"7606","chr6.154475000.154480000","chr6.154670000.154675000",195000,25,6.27338e-12,154475000,154670000,154480000,154675000,"chr6",242910,0,4,5,9,"chr6",1,0.0263713080168776
"7607","chr6.13370000.13375000","chr6.13420000.13425000",50000,24,0.00140844,13370000,13420000,13375000,13425000,"chr6",242921,0,5,3,8,"chr6",1,0.0225035161744023
"7608","chr6.47010000.47015000","chr6.47275000.47280000",265000,14,7.939078e-05,47010000,47275000,47015000,47280000,"chr6",242949,0,2,0,2,"chr6",1,0.00328176277543366
"7609","chr6.158640000.158645000","chr6.159000000.159005000",360000,10,0.004767617,158640000,1.59e+08,158645000,159005000,"chr6",242955,0,4,1,5,"chr6",1,0.00586029067041725
"7610","chr6.158165000.158170000","chr6.158230000.158235000",65000,20,0.003746171,158165000,158230000,158170000,158235000,"chr6",242993,1,13,14,28,"chr6",1,0.0656352555086732
"7611","chr6.134530000.134535000","chr6.134550000.134555000",20000,38,0.002817976,134530000,134550000,134535000,134555000,"chr6",243007,0,0,4,4,"chr6",1,0.0178152836380684
"7612","chr6.11095000.11100000","chr6.11160000.11165000",65000,21,0.001439076,11095000,11160000,11100000,11165000,"chr6",243108,2,17,18,37,"chr6",1,0.0910689170182841
"7613","chr6.10950000.10955000","chr6.11090000.11095000",140000,15,0.002020592,10950000,11090000,10955000,11095000,"chr6",243112,3,1,7,11,"chr6",1,0.0193389592123769
"7614","chr6.131160000.131165000","chr6.131440000.131445000",280000,11,0.004199105,131160000,131440000,131165000,131445000,"chr6",243135,2,2,5,9,"chr6",1,0.0116033755274262
"7615","chr6.36855000.36860000","chr6.36875000.36880000",20000,41,0.0003488147,36855000,36875000,36860000,36880000,"chr6",243209,0,6,4,10,"chr6",1,0.0480543834974215
"7616","chr6.10695000.10700000","chr6.10720000.10725000",25000,45,9.308319e-07,10695000,10720000,10700000,10725000,"chr6",243246,0,4,7,11,"chr6",1,0.0580168776371308
"7617","chr6.3235000.3240000","chr6.3940000.3945000",705000,8,0.003746171,3235000,3940000,3240000,3945000,"chr6",243304,0,5,1,6,"chr6",1,0.00562587904360056
"7618","chr6.26310000.26315000","chr6.26565000.26570000",255000,20,2.767192e-09,26310000,26565000,26315000,26570000,"chr6",243317,2,7,7,16,"chr6",1,0.0375058602906704
"7619","chr6.37670000.37675000","chr6.38645000.38650000",975000,7,0.003746171,37670000,38645000,37675000,38650000,"chr6",243342,2,2,2,6,"chr6",1,0.00492264416315049
"7620","chr6.110390000.110395000","chr6.110415000.110420000",25000,36,0.00167179,110390000,110415000,110395000,110420000,"chr6",243381,0,0,2,2,"chr6",1,0.00843881856540084
"7621","chr6.150730000.150735000","chr6.150890000.150895000",160000,15,0.0008765327,150730000,150890000,150735000,150895000,"chr6",243382,1,7,2,10,"chr6",1,0.0175808720112518
"7622","chr6.26320000.26325000","chr6.26535000.26540000",215000,15,9.524909e-05,26320000,26535000,26325000,26540000,"chr6",243419,0,5,10,15,"chr6",1,0.0263713080168776
"7623","chr6.15255000.15260000","chr6.15620000.15625000",365000,12,0.0002203551,15255000,15620000,15260000,15625000,"chr6",243432,0,7,2,9,"chr6",1,0.0126582278481013
"7624","chr6.11120000.11125000","chr6.11495000.11500000",375000,16,1.313315e-07,11120000,11495000,11125000,11500000,"chr6",243476,0,0,4,4,"chr6",1,0.00750117205813408
"7625","chr6.134500000.134505000","chr6.134885000.134890000",385000,12,0.000163514,134500000,134885000,134505000,134890000,"chr6",243535,4,5,6,15,"chr6",1,0.0210970464135021
"7626","chr6.109925000.109930000","chr6.110535000.110540000",610000,8,0.007483355,109925000,110535000,109930000,110540000,"chr6",243550,0,4,2,6,"chr6",1,0.00562587904360056
"7627","chr6.24855000.24860000","chr6.24910000.24915000",55000,23,0.001313581,24855000,24910000,24860000,24915000,"chr6",243571,1,5,3,9,"chr6",1,0.0242616033755274
"7628","chr6.156875000.156880000","chr6.157105000.157110000",230000,13,0.0009742253,156875000,157105000,156880000,157110000,"chr6",243594,0,2,1,3,"chr6",1,0.00457102672292546
"7629","chr6.157100000.157105000","chr6.157165000.157170000",65000,25,1.92953e-05,157100000,157165000,157105000,157170000,"chr6",243683,0,2,1,3,"chr6",1,0.00879043600562588
"7630","chr6.26380000.26385000","chr6.26400000.26405000",20000,61,1.139207e-12,26380000,26400000,26385000,26405000,"chr6",243688,1,6,5,12,"chr6",1,0.0857946554149086
"7631","chr6.31125000.31130000","chr6.31165000.31170000",40000,31,2.750654e-05,31125000,31165000,31130000,31170000,"chr6",243694,0,9,7,16,"chr6",1,0.0581340834505391
"7632","chr6.34245000.34250000","chr6.34380000.34385000",135000,17,0.0002187489,34245000,34380000,34250000,34385000,"chr6",243699,0,2,1,3,"chr6",1,0.0059774964838256
"7633","chr6.157940000.157945000","chr6.158025000.158030000",85000,19,0.0008640958,157940000,158025000,157945000,158030000,"chr6",243702,0,3,1,4,"chr6",1,0.00890764181903422
"7634","chr6.134250000.134255000","chr6.134390000.134395000",140000,18,4.442838e-05,134250000,134390000,134255000,134395000,"chr6",243737,5,9,8,22,"chr6",1,0.0464135021097046
"7635","chr6.32110000.32115000","chr6.32145000.32150000",35000,31,0.0002492805,32110000,32145000,32115000,32150000,"chr6",243746,4,6,5,15,"chr6",1,0.0545007032348805
"7636","chr6.27125000.27130000","chr6.27820000.27825000",695000,9,0.0007231554,27125000,27820000,27130000,27825000,"chr6",243764,2,5,7,14,"chr6",1,0.0147679324894515
"7637","chr6.17815000.17820000","chr6.17945000.17950000",130000,17,0.0002859613,17815000,17945000,17820000,17950000,"chr6",243778,1,15,5,21,"chr6",1,0.0418424753867792
"7638","chr6.136720000.136725000","chr6.136790000.136795000",70000,21,0.0006733273,136720000,136790000,136725000,136795000,"chr6",243788,2,11,8,21,"chr6",1,0.0516877637130802
"7639","chr6.161580000.161585000","chr6.161615000.161620000",35000,28,0.002985581,161580000,161615000,161585000,161620000,"chr6",243794,0,2,0,2,"chr6",1,0.00656352555086732
"7640","chr6.147825000.147830000","chr6.148700000.148705000",875000,10,2.181917e-05,147825000,148700000,147830000,148705000,"chr6",243809,0,2,6,8,"chr6",1,0.00937646507266761
"7641","chr6.17885000.17890000","chr6.17985000.17990000",100000,34,8.478589e-15,17885000,17985000,17890000,17990000,"chr6",243812,2,4,2,8,"chr6",1,0.0318799812470699
"7642","chr6.31680000.31685000","chr6.31750000.31755000",70000,24,2.340075e-05,31680000,31750000,31685000,31755000,"chr6",243852,1,8,6,15,"chr6",1,0.0421940928270042
"7643","chr6.108860000.108865000","chr6.109315000.109320000",455000,15,1.729961e-07,108860000,109315000,108865000,109320000,"chr6",243856,2,3,2,7,"chr6",1,0.0123066104078762
"7644","chr6.26055000.26060000","chr6.26120000.26125000",65000,21,0.001439076,26055000,26120000,26060000,26125000,"chr6",243958,0,3,4,7,"chr6",1,0.0172292545710267
"7645","chr6.26285000.26290000","chr6.26320000.26325000",35000,27,0.006289337,26285000,26320000,26290000,26325000,"chr6",243961,5,4,5,14,"chr6",1,0.0443037974683544
"7646","chr6.38180000.38185000","chr6.38275000.38280000",95000,17,0.002870974,38180000,38275000,38185000,38280000,"chr6",244002,0,4,3,7,"chr6",1,0.0139474917955931
"7647","chr6.22780000.22785000","chr6.23025000.23030000",245000,11,0.008670633,22780000,23025000,22785000,23030000,"chr6",244050,0,1,2,3,"chr6",1,0.00386779184247539
"7648","chr6.111065000.111070000","chr6.111210000.111215000",145000,14,0.005181923,111065000,111210000,111070000,111215000,"chr6",244091,2,2,4,8,"chr6",1,0.0131270511017346
"7649","chr6.37820000.37825000","chr6.38495000.38500000",675000,8,0.004652964,37820000,38495000,37825000,38500000,"chr6",244148,0,0,2,2,"chr6",1,0.00187529301453352
"7650","chr6.157780000.157785000","chr6.157985000.157990000",205000,20,4.26317e-08,157780000,157985000,157785000,157990000,"chr6",244172,0,9,0,9,"chr6",1,0.0210970464135021
"7651","chr6.150735000.150740000","chr6.151060000.151065000",325000,10,0.007483355,150735000,151060000,150740000,151065000,"chr6",244202,0,6,4,10,"chr6",1,0.0117205813408345
"7652","chr6.17705000.17710000","chr6.18120000.18125000",415000,11,0.0005294253,17705000,18120000,17710000,18125000,"chr6",244208,0,3,8,11,"chr6",1,0.0141819034224098
"7653","chr6.13795000.13800000","chr6.14065000.14070000",270000,11,0.005168928,13795000,14065000,13800000,14070000,"chr6",244213,1,6,3,10,"chr6",1,0.012892639474918
"7654","chr6.154475000.154480000","chr6.154730000.154735000",255000,63,1.601449e-60,154475000,154730000,154480000,154735000,"chr6",244217,0,4,5,9,"chr6",1,0.0664556962025316
"7655","chr6.18150000.18155000","chr6.18265000.18270000",115000,22,8.114039e-07,18150000,18265000,18155000,18270000,"chr6",244249,4,3,1,8,"chr6",1,0.0206282231598687
"7656","chr6.136715000.136720000","chr6.136835000.136840000",120000,27,1.359644e-10,136715000,136835000,136720000,136840000,"chr6",244280,4,8,17,29,"chr6",1,0.0917721518987342
"7657","chr6.134445000.134450000","chr6.135200000.135205000",755000,24,8.415436e-21,134445000,135200000,134450000,135205000,"chr6",244325,2,4,6,12,"chr6",1,0.0337552742616034
"7658","chr6.13015000.13020000","chr6.13325000.13330000",310000,11,0.002488349,13015000,13325000,13020000,13330000,"chr6",244326,0,4,2,6,"chr6",1,0.00773558368495077
"7659","chr6.53035000.53040000","chr6.53355000.53360000",320000,21,1.88305e-11,53035000,53355000,53040000,53360000,"chr6",244329,0,2,1,3,"chr6",1,0.00738396624472574
"7660","chr6.111170000.111175000","chr6.111265000.111270000",95000,16,0.007739499,111170000,111265000,111175000,111270000,"chr6",244346,0,4,4,8,"chr6",1,0.0150023441162682
"7661","chr6.134285000.134290000","chr6.134415000.134420000",130000,25,1.625912e-09,134285000,134415000,134290000,134420000,"chr6",244362,5,4,13,22,"chr6",1,0.0644631973745898
"7662","chr6.35870000.35875000","chr6.36660000.36665000",790000,11,5.896098e-06,35870000,36660000,35875000,36665000,"chr6",244368,0,7,3,10,"chr6",1,0.012892639474918
"7663","chr6.27160000.27165000","chr6.27820000.27825000",660000,8,0.005181923,27160000,27820000,27165000,27825000,"chr6",244408,0,11,7,18,"chr6",1,0.0168776371308017
"7664","chr6.148610000.148615000","chr6.148745000.148750000",135000,16,0.0007626282,148610000,148745000,148615000,148750000,"chr6",244450,1,3,0,4,"chr6",1,0.00750117205813408
"7665","chr6.149960000.149965000","chr6.150075000.150080000",115000,18,0.0001982416,149960000,150075000,149965000,150080000,"chr6",244451,0,2,8,10,"chr6",1,0.0210970464135021
"7666","chr6.27125000.27130000","chr6.27795000.27800000",670000,10,0.0001487934,27125000,27795000,27130000,27800000,"chr6",244452,2,5,7,14,"chr6",1,0.0164088138771683
"7667","chr6.157875000.157880000","chr6.158000000.158005000",125000,16,0.001254039,157875000,1.58e+08,157880000,158005000,"chr6",244457,0,1,2,3,"chr6",1,0.00562587904360056
"7668","chr6.26155000.26160000","chr6.26215000.26220000",60000,28,1.735974e-06,26155000,26215000,26160000,26220000,"chr6",244459,2,5,7,14,"chr6",1,0.0459446788560713
"7669","chr6.13355000.13360000","chr6.13485000.13490000",130000,15,0.00308896,13355000,13485000,13360000,13490000,"chr6",244464,0,1,0,1,"chr6",1,0.00175808720112518
"7670","chr6.37690000.37695000","chr6.38190000.38195000",500000,9,0.004299098,37690000,38190000,37695000,38195000,"chr6",244540,0,1,1,2,"chr6",1,0.00210970464135021
"7671","chr6.24885000.24890000","chr6.25015000.25020000",130000,17,0.0002859613,24885000,25015000,24890000,25020000,"chr6",244557,2,3,4,9,"chr6",1,0.0179324894514768
"7672","chr6.26305000.26310000","chr6.27145000.27150000",840000,10,3.018214e-05,26305000,27145000,26310000,27150000,"chr6",244571,0,7,3,10,"chr6",1,0.0117205813408345
"7673","chr6.37670000.37675000","chr6.38145000.38150000",475000,13,6.328427e-06,37670000,38145000,37675000,38150000,"chr6",244600,2,2,2,6,"chr6",1,0.00914205344585091
"7674","chr6.31460000.31465000","chr6.31860000.31865000",400000,10,0.002960758,31460000,31860000,31465000,31865000,"chr6",244626,0,2,3,5,"chr6",1,0.00586029067041725
"7675","chr6.149405000.149410000","chr6.149645000.149650000",240000,11,0.009613542,149405000,149645000,149410000,149650000,"chr6",244639,0,3,2,5,"chr6",1,0.00644631973745898
"7676","chr6.3150000.3155000","chr6.3235000.3240000",85000,17,0.006589942,3150000,3235000,3155000,3240000,"chr6",244643,2,1,1,4,"chr6",1,0.00796999531176746
"7677","chr6.17885000.17890000","chr6.17945000.17950000",60000,44,4.572338e-17,17885000,17945000,17890000,17950000,"chr6",244648,1,15,5,21,"chr6",1,0.108298171589311
"7678","chr6.156875000.156880000","chr6.157090000.157095000",215000,12,0.005449888,156875000,157090000,156880000,157095000,"chr6",244686,0,2,0,2,"chr6",1,0.00281293952180028
"7679","chr6.16510000.16515000","chr6.16625000.16630000",115000,16,0.002119166,16510000,16625000,16515000,16630000,"chr6",244693,1,5,4,10,"chr6",1,0.0187529301453352
"7680","chr6.26660000.26665000","chr6.27125000.27130000",465000,17,1.957388e-09,26660000,27125000,26665000,27130000,"chr6",244716,2,5,7,14,"chr6",1,0.0278949835911861
"7681","chr6.134620000.134625000","chr6.134910000.134915000",290000,14,3.938591e-05,134620000,134910000,134625000,134915000,"chr6",244767,1,4,4,9,"chr6",1,0.0147679324894515
"7682","chr6.26065000.26070000","chr6.26185000.26190000",120000,15,0.004837722,26065000,26185000,26070000,26190000,"chr6",244770,2,4,6,12,"chr6",1,0.0210970464135021
"7683","chr6.134480000.134485000","chr6.135200000.135205000",720000,26,4.833665e-23,134480000,135200000,134485000,135205000,"chr6",244780,1,4,5,10,"chr6",1,0.0304735114861697
"7684","chr6.30720000.30725000","chr6.30740000.30745000",20000,42,0.0001659547,30720000,30740000,30725000,30745000,"chr6",244891,3,7,2,12,"chr6",1,0.0590717299578059
"7685","chr6.26100000.26105000","chr6.26155000.26160000",55000,24,0.0004989935,26100000,26155000,26105000,26160000,"chr6",244903,2,5,7,14,"chr6",1,0.0393811533052039
"7686","chr6.38355000.38360000","chr6.38390000.38395000",35000,28,0.002985581,38355000,38390000,38360000,38395000,"chr6",244975,0,1,3,4,"chr6",1,0.0131270511017346
"7687","chr6.136745000.136750000","chr6.136840000.136845000",95000,37,8.190688e-17,136745000,136840000,136750000,136845000,"chr6",245071,1,5,4,10,"chr6",1,0.0433661509610877
"7688","chr6.15320000.15325000","chr6.15440000.15445000",120000,17,0.0004985722,15320000,15440000,15325000,15445000,"chr6",245096,0,5,4,9,"chr6",1,0.0179324894514768
"7689","chr6.26030000.26035000","chr6.26200000.26205000",170000,13,0.006513716,26030000,26200000,26035000,26205000,"chr6",245102,1,5,2,8,"chr6",1,0.0121894045944679
"7690","chr6.53665000.53670000","chr6.53725000.53730000",60000,29,4.891734e-07,53665000,53725000,53670000,53730000,"chr6",245113,0,6,3,9,"chr6",1,0.0305907172995781
"7691","chr6.134445000.134450000","chr6.135140000.135145000",695000,15,2.117532e-09,134445000,135140000,134450000,135145000,"chr6",245121,3,11,5,19,"chr6",1,0.0334036568213783
"7692","chr6.26360000.26365000","chr6.26470000.26475000",110000,25,1.316435e-08,26360000,26470000,26365000,26475000,"chr6",245174,3,3,5,11,"chr6",1,0.0322315986872949
"7693","chr6.35325000.35330000","chr6.35375000.35380000",50000,45,1.76534e-15,35325000,35375000,35330000,35380000,"chr6",245205,3,12,10,25,"chr6",1,0.131856540084388
"7694","chr6.15265000.15270000","chr6.15360000.15365000",95000,19,0.0003106794,15265000,15360000,15270000,15365000,"chr6",245223,2,3,1,6,"chr6",1,0.0133614627285513
"7695","chr6.33160000.33165000","chr6.33210000.33215000",50000,26,0.0002097868,33160000,33210000,33165000,33215000,"chr6",245261,1,1,2,4,"chr6",1,0.0121894045944679
"7696","chr6.134640000.134645000","chr6.135140000.135145000",500000,11,0.0001705187,134640000,135140000,134645000,135145000,"chr6",245306,0,2,1,3,"chr6",1,0.00386779184247539
"7697","chr6.17830000.17835000","chr6.18000000.18005000",170000,14,0.002038406,17830000,1.8e+07,17835000,18005000,"chr6",245332,2,8,4,14,"chr6",1,0.0229723394280356
"7698","chr6.16335000.16340000","chr6.16725000.16730000",390000,11,0.0007380716,16335000,16725000,16340000,16730000,"chr6",245342,0,5,0,5,"chr6",1,0.00644631973745898
"7699","chr6.138765000.138770000","chr6.138830000.138835000",65000,22,0.0005333286,138765000,138830000,138770000,138835000,"chr6",245369,0,6,3,9,"chr6",1,0.0232067510548523
"7700","chr6.17815000.17820000","chr6.18150000.18155000",335000,10,0.006489871,17815000,18150000,17820000,18155000,"chr6",245373,3,22,16,41,"chr6",1,0.0480543834974215
"7701","chr6.27160000.27165000","chr6.27750000.27755000",590000,12,7.784612e-06,27160000,27750000,27165000,27755000,"chr6",245390,0,11,7,18,"chr6",1,0.0253164556962025
"7702","chr6.39345000.39350000","chr6.39890000.39895000",545000,10,0.0005511993,39345000,39890000,39350000,39895000,"chr6",245401,0,2,3,5,"chr6",1,0.00586029067041725
"7703","chr6.158260000.158265000","chr6.158280000.158285000",20000,39,0.001426362,158260000,158280000,158265000,158285000,"chr6",245444,0,4,7,11,"chr6",1,0.05028129395218
"7704","chr6.136580000.136585000","chr6.136600000.136605000",20000,41,0.0003488147,136580000,136600000,136585000,136605000,"chr6",245457,4,7,15,26,"chr6",1,0.124941397093296
"7705","chr6.15255000.15260000","chr6.15440000.15445000",185000,27,2.490965e-13,15255000,15440000,15260000,15445000,"chr6",245462,0,5,2,7,"chr6",1,0.0221518987341772
"7706","chr6.134520000.134525000","chr6.134620000.134625000",100000,19,0.0001929429,134520000,134620000,134525000,134625000,"chr6",245515,1,4,4,9,"chr6",1,0.020042194092827
"7707","chr6.157865000.157870000","chr6.158040000.158045000",175000,13,0.005577214,157865000,158040000,157870000,158045000,"chr6",245540,2,2,1,5,"chr6",1,0.00761837787154243
"7708","chr6.149410000.149415000","chr6.149615000.149620000",205000,13,0.002119166,149410000,149615000,149415000,149620000,"chr6",245566,5,17,20,42,"chr6",1,0.0639943741209564
"7709","chr6.30885000.30890000","chr6.31055000.31060000",170000,16,0.0001547714,30885000,31055000,30890000,31060000,"chr6",245570,0,7,6,13,"chr6",1,0.0243788091889358
"7710","chr6.3740000.3745000","chr6.3990000.3995000",250000,17,9.238731e-07,3740000,3990000,3745000,3995000,"chr6",245649,1,3,1,5,"chr6",1,0.00996249413970933
"7711","chr6.158655000.158660000","chr6.158920000.158925000",265000,11,0.005701523,158655000,158920000,158660000,158925000,"chr6",245715,1,9,6,16,"chr6",1,0.0206282231598687
"7712","chr6.31620000.31625000","chr6.31860000.31865000",240000,14,0.0001731928,31620000,31860000,31625000,31865000,"chr6",245730,0,4,3,7,"chr6",1,0.0114861697140178
"7713","chr6.134500000.134505000","chr6.134880000.134885000",380000,20,2.282632e-11,134500000,134880000,134505000,134885000,"chr6",245741,1,5,5,11,"chr6",1,0.0257852789498359
"7714","chr6.134500000.134505000","chr6.134530000.134535000",30000,50,1.100002e-11,134500000,134530000,134505000,134535000,"chr6",245775,0,0,4,4,"chr6",1,0.023441162681669
"7715","chr6.13335000.13340000","chr6.13370000.13375000",35000,29,0.001361644,13335000,13370000,13340000,13375000,"chr6",245787,0,6,3,9,"chr6",1,0.0305907172995781
"7716","chr6.3120000.3125000","chr6.3195000.3200000",75000,24,9.624623e-06,3120000,3195000,3125000,3200000,"chr6",245798,0,3,1,4,"chr6",1,0.0112517580872011
"7717","chr6.157775000.157780000","chr6.158110000.158115000",335000,11,0.001622331,157775000,158110000,157780000,158115000,"chr6",245882,0,0,4,4,"chr6",1,0.00515705578996718
"7718","chr6.35565000.35570000","chr6.35690000.35695000",125000,15,0.003840393,35565000,35690000,35570000,35695000,"chr6",245883,1,9,26,36,"chr6",1,0.0632911392405063
"7719","chr6.125845000.125850000","chr6.125865000.125870000",20000,40,0.0007119341,125845000,125865000,125850000,125870000,"chr6",245891,0,1,1,2,"chr6",1,0.00937646507266761
"7720","chr6.147825000.147830000","chr6.148165000.148170000",340000,11,0.001503541,147825000,148165000,147830000,148170000,"chr6",245920,0,2,2,4,"chr6",1,0.00515705578996718
"7721","chr6.38275000.38280000","chr6.38435000.38440000",160000,13,0.009047489,38275000,38435000,38280000,38440000,"chr6",245949,0,4,6,10,"chr6",1,0.0152367557430849
"7722","chr6.157105000.157110000","chr6.157215000.157220000",110000,19,8.052119e-05,157105000,157215000,157110000,157220000,"chr6",245973,0,2,1,3,"chr6",1,0.00668073136427567
"7723","chr6.138185000.138190000","chr6.138265000.138270000",80000,19,0.001487732,138185000,138265000,138190000,138270000,"chr6",245984,1,1,0,2,"chr6",1,0.00445382090951711
"7724","chr6.16295000.16300000","chr6.17095000.17100000",800000,8,0.001938553,16295000,17095000,16300000,17100000,"chr6",246064,1,1,2,4,"chr6",1,0.00375058602906704
"7725","chr6.18155000.18160000","chr6.18265000.18270000",110000,18,0.0002859613,18155000,18265000,18160000,18270000,"chr6",246077,4,3,1,8,"chr6",1,0.0168776371308017
"7726","chr6.26230000.26235000","chr6.26280000.26285000",50000,24,0.00140844,26230000,26280000,26235000,26285000,"chr6",246103,1,1,1,3,"chr6",1,0.00843881856540084
"7727","chr6.3845000.3850000","chr6.3990000.3995000",145000,18,3.376723e-05,3845000,3990000,3850000,3995000,"chr6",246114,0,1,0,1,"chr6",1,0.00210970464135021
"7728","chr6.13370000.13375000","chr6.13410000.13415000",40000,32,9.79823e-06,13370000,13410000,13375000,13415000,"chr6",246138,0,5,2,7,"chr6",1,0.0262541022034693
"7729","chr6.158705000.158710000","chr6.158835000.158840000",130000,15,0.00308896,158705000,158835000,158710000,158840000,"chr6",246141,0,7,4,11,"chr6",1,0.0193389592123769
"7730","chr6.17865000.17870000","chr6.18120000.18125000",255000,21,3.740474e-10,17865000,18120000,17870000,18125000,"chr6",246156,1,1,1,3,"chr6",1,0.00738396624472574
"7731","chr6.23025000.23030000","chr6.23215000.23220000",190000,17,1.405663e-05,23025000,23215000,23030000,23220000,"chr6",246160,0,3,1,4,"chr6",1,0.00796999531176746
"7732","chr6.134480000.134485000","chr6.135025000.135030000",545000,10,0.0005511993,134480000,135025000,134485000,135030000,"chr6",246165,1,3,1,5,"chr6",1,0.00586029067041725
"7733","chr6.20640000.20645000","chr6.21590000.21595000",950000,8,0.0006858512,20640000,21590000,20645000,21595000,"chr6",246193,0,3,1,4,"chr6",1,0.00375058602906704
"7734","chr6.26340000.26345000","chr6.26570000.26575000",230000,20,1.013899e-08,26340000,26570000,26345000,26575000,"chr6",246202,3,10,6,19,"chr6",1,0.0445382090951711
"7735","chr6.53355000.53360000","chr6.53505000.53510000",150000,20,1.289905e-06,53355000,53505000,53360000,53510000,"chr6",246236,0,0,3,3,"chr6",1,0.0070323488045007
"7736","chr6.1550000.1555000","chr6.2350000.2355000",800000,8,0.001938553,1550000,2350000,1555000,2355000,"chr6",246239,0,1,5,6,"chr6",1,0.00562587904360056
"7737","chr6.99390000.99395000","chr6.99565000.99570000",175000,13,0.005577214,99390000,99565000,99395000,99570000,"chr6",246318,3,20,17,40,"chr6",1,0.0609470229723394
"7738","chr6.134235000.134240000","chr6.134415000.134420000",180000,25,2.116736e-11,134235000,134415000,134240000,134420000,"chr6",246339,3,6,9,18,"chr6",1,0.0527426160337553
"7739","chr6.112035000.112040000","chr6.112160000.112165000",125000,18,0.0001035882,112035000,112160000,112040000,112165000,"chr6",246425,1,1,2,4,"chr6",1,0.00843881856540084
"7740","chr6.3345000.3350000","chr6.3995000.4000000",650000,8,0.005568493,3345000,3995000,3350000,4e+06,"chr6",246428,0,6,3,9,"chr6",1,0.00843881856540084
"7741","chr6.25255000.25260000","chr6.25490000.25495000",235000,13,0.0008436764,25255000,25490000,25260000,25495000,"chr6",246452,2,0,0,2,"chr6",1,0.00304735114861697
"7742","chr6.30715000.30720000","chr6.31055000.31060000",340000,15,1.997198e-06,30715000,31055000,30720000,31060000,"chr6",246462,0,7,6,13,"chr6",1,0.0228551336146273
"7743","chr6.53030000.53035000","chr6.53345000.53350000",315000,36,6.678199e-28,53030000,53345000,53035000,53350000,"chr6",246493,1,2,1,4,"chr6",1,0.0168776371308017
"7744","chr6.53410000.53415000","chr6.53500000.53505000",90000,38,4.290708e-17,53410000,53500000,53415000,53505000,"chr6",246505,0,4,4,8,"chr6",1,0.0356305672761369
"7745","chr6.37685000.37690000","chr6.38640000.38645000",955000,9,8.739704e-05,37685000,38640000,37690000,38645000,"chr6",246532,6,9,7,22,"chr6",1,0.0232067510548523
"7746","chr6.13370000.13375000","chr6.13445000.13450000",75000,24,9.624623e-06,13370000,13445000,13375000,13450000,"chr6",246558,0,1,2,3,"chr6",1,0.00843881856540084
"7747","chr6.41755000.41760000","chr6.41890000.41895000",135000,15,0.002508496,41755000,41890000,41760000,41895000,"chr6",246600,2,6,2,10,"chr6",1,0.0175808720112518
"7748","chr6.24580000.24585000","chr6.24665000.24670000",85000,29,1.195463e-09,24580000,24665000,24585000,24670000,"chr6",246614,0,2,0,2,"chr6",1,0.00679793717768401
"7749","chr6.3115000.3120000","chr6.3250000.3255000",135000,18,5.87959e-05,3115000,3250000,3120000,3255000,"chr6",246627,1,0,0,1,"chr6",1,0.00210970464135021
"7750","chr6.10690000.10695000","chr6.10745000.10750000",55000,27,2.113861e-05,10690000,10745000,10695000,10750000,"chr6",246629,1,2,2,5,"chr6",1,0.0158227848101266
"7751","chr6.111030000.111035000","chr6.111170000.111175000",140000,21,5.24625e-07,111030000,111170000,111035000,111175000,"chr6",246657,10,9,8,27,"chr6",1,0.0664556962025316
"7752","chr6.15265000.15270000","chr6.15440000.15445000",175000,23,1.39832e-09,15265000,15440000,15270000,15445000,"chr6",246668,0,3,1,4,"chr6",1,0.0107829348335677
"7753","chr6.26055000.26060000","chr6.26125000.26130000",70000,20,0.001836515,26055000,26125000,26060000,26130000,"chr6",246673,0,7,8,15,"chr6",1,0.0351617440225035
"7754","chr6.17030000.17035000","chr6.17095000.17100000",65000,20,0.003746171,17030000,17095000,17035000,17100000,"chr6",246740,1,1,3,5,"chr6",1,0.0117205813408345
"7755","chr6.12895000.12900000","chr6.13330000.13335000",435000,12,7.566497e-05,12895000,13330000,12900000,13335000,"chr6",246753,0,2,1,3,"chr6",1,0.00421940928270042
"7756","chr6.13350000.13355000","chr6.13410000.13415000",60000,26,1.893153e-05,13350000,13410000,13355000,13415000,"chr6",246757,0,5,2,7,"chr6",1,0.0213314580403188
"7757","chr6.113875000.113880000","chr6.114165000.114170000",290000,12,0.0008640958,113875000,114165000,113880000,114170000,"chr6",246761,1,6,4,11,"chr6",1,0.0154711673699015
"7758","chr6.157925000.157930000","chr6.158000000.158005000",75000,19,0.002672369,157925000,1.58e+08,157930000,158005000,"chr6",246774,0,0,2,2,"chr6",1,0.00445382090951711
"7759","chr6.13405000.13410000","chr6.13455000.13460000",50000,28,2.651746e-05,13405000,13455000,13410000,13460000,"chr6",246801,0,2,6,8,"chr6",1,0.0262541022034693
"7760","chr6.110810000.110815000","chr6.111255000.111260000",445000,10,0.001706765,110810000,111255000,110815000,111260000,"chr6",246813,2,6,17,25,"chr6",1,0.0293014533520863
"7761","chr6.26340000.26345000","chr6.26535000.26540000",195000,17,1.095407e-05,26340000,26535000,26345000,26540000,"chr6",246846,0,5,6,11,"chr6",1,0.0219174871073605
"7762","chr6.34280000.34285000","chr6.34315000.34320000",35000,27,0.006289337,34280000,34315000,34285000,34320000,"chr6",246858,0,0,1,1,"chr6",1,0.00316455696202532
"7763","chr6.31680000.31685000","chr6.31725000.31730000",45000,26,0.0006964557,31680000,31725000,31685000,31730000,"chr6",246869,0,0,2,2,"chr6",1,0.00609470229723394
"7764","chr6.105915000.105920000","chr6.106625000.106630000",710000,9,0.0006427944,105915000,106625000,105920000,106630000,"chr6",246878,1,16,13,30,"chr6",1,0.0316455696202532
"7765","chr6.26435000.26440000","chr6.26535000.26540000",100000,19,0.0001929429,26435000,26535000,26440000,26540000,"chr6",246884,0,5,10,15,"chr6",1,0.0334036568213783
"7766","chr6.134445000.134450000","chr6.135055000.135060000",610000,12,5.976364e-06,134445000,135055000,134450000,135060000,"chr6",246889,4,11,8,23,"chr6",1,0.0323488045007032
"7767","chr6.158645000.158650000","chr6.159090000.159095000",445000,12,6.40787e-05,158645000,159090000,158650000,159095000,"chr6",246895,1,3,0,4,"chr6",1,0.00562587904360056
"7768","chr6.110995000.111000000","chr6.111260000.111265000",265000,25,3.970491e-14,110995000,111260000,1.11e+08,111265000,"chr6",246910,4,8,11,23,"chr6",1,0.0673933427097984
"7769","chr6.37670000.37675000","chr6.38275000.38280000",605000,12,6.35758e-06,37670000,38275000,37675000,38280000,"chr6",246920,0,2,2,4,"chr6",1,0.00562587904360056
"7770","chr6.15660000.15665000","chr6.16235000.16240000",575000,11,6.537819e-05,15660000,16235000,15665000,16240000,"chr6",246943,4,7,5,16,"chr6",1,0.0206282231598687
"7771","chr6.110040000.110045000","chr6.110725000.110730000",685000,8,0.004284741,110040000,110725000,110045000,110730000,"chr6",246965,0,8,3,11,"chr6",1,0.0103141115799344
"7772","chr6.27470000.27475000","chr6.27865000.27870000",395000,10,0.003129371,27470000,27865000,27475000,27870000,"chr6",247026,1,1,2,4,"chr6",1,0.0046882325363338
"7773","chr6.134510000.134515000","chr6.135200000.135205000",690000,8,0.004138798,134510000,135200000,134515000,135205000,"chr6",247030,2,4,6,12,"chr6",1,0.0112517580872011
"7774","chr6.134245000.134250000","chr6.134415000.134420000",170000,80,4.97348e-75,134245000,134415000,134250000,134420000,"chr6",247038,5,10,13,28,"chr6",1,0.262541022034693
"7775","chr6.44235000.44240000","chr6.44300000.44305000",65000,35,1.83298e-11,44235000,44300000,44240000,44305000,"chr6",247095,0,4,6,10,"chr6",1,0.0410220346929208
"7776","chr6.34155000.34160000","chr6.34370000.34375000",215000,27,1.808043e-14,34155000,34370000,34160000,34375000,"chr6",247108,2,9,14,25,"chr6",1,0.0791139240506329
"7777","chr6.110015000.110020000","chr6.110415000.110420000",400000,12,0.000127731,110015000,110415000,110020000,110420000,"chr6",247121,0,0,2,2,"chr6",1,0.00281293952180028
"7778","chr6.2790000.2795000","chr6.2990000.2995000",200000,13,0.00250774,2790000,2990000,2795000,2995000,"chr6",247126,0,2,2,4,"chr6",1,0.00609470229723394
"7779","chr6.26240000.26245000","chr6.26605000.26610000",365000,10,0.004466007,26240000,26605000,26245000,26610000,"chr6",247159,0,7,5,12,"chr6",1,0.0140646976090014
"7780","chr6.26380000.26385000","chr6.26420000.26425000",40000,25,0.005943794,26380000,26420000,26385000,26425000,"chr6",247168,0,1,2,3,"chr6",1,0.00879043600562588
"7781","chr6.20290000.20295000","chr6.20475000.20480000",185000,13,0.004005289,20290000,20475000,20295000,20480000,"chr6",247179,2,5,1,8,"chr6",1,0.0121894045944679
"7782","chr6.134250000.134255000","chr6.134400000.134405000",150000,14,0.004271906,134250000,134400000,134255000,134405000,"chr6",247180,5,18,11,34,"chr6",1,0.0557899671823722
"7783","chr6.110995000.111000000","chr6.111265000.111270000",270000,16,2.47264e-06,110995000,111265000,1.11e+08,111270000,"chr6",247183,0,4,4,8,"chr6",1,0.0150023441162682
"7784","chr6.150730000.150735000","chr6.151135000.151140000",405000,26,3.66191e-18,150730000,151135000,150735000,151140000,"chr6",247184,1,8,13,22,"chr6",1,0.0670417252695734
"7785","chr6.154475000.154480000","chr6.154805000.154810000",330000,11,0.001747481,154475000,154805000,154480000,154810000,"chr6",247194,0,4,4,8,"chr6",1,0.0103141115799344
"7786","chr6.30715000.30720000","chr6.30740000.30745000",25000,48,4.719444e-08,30715000,30740000,30720000,30745000,"chr6",247197,0,8,6,14,"chr6",1,0.0787623066104079
"7787","chr6.26155000.26160000","chr6.26195000.26200000",40000,70,1.968648e-31,26155000,26195000,26160000,26200000,"chr6",247223,2,5,7,14,"chr6",1,0.114861697140178
"7788","chr6.52285000.52290000","chr6.52375000.52380000",90000,21,4.777466e-05,52285000,52375000,52290000,52380000,"chr6",247232,4,11,5,20,"chr6",1,0.0492264416315049
"7789","chr6.78865000.78870000","chr6.78910000.78915000",45000,27,0.0002769738,78865000,78910000,78870000,78915000,"chr6",247235,0,5,5,10,"chr6",1,0.0316455696202532
"7790","chr6.134605000.134610000","chr6.135200000.135205000",595000,9,0.001742766,134605000,135200000,134610000,135205000,"chr6",247253,0,3,3,6,"chr6",1,0.00632911392405063
"7791","chr6.111010000.111015000","chr6.111205000.111210000",195000,12,0.009418563,111010000,111205000,111015000,111210000,"chr6",247265,4,12,8,24,"chr6",1,0.0337552742616034
"7792","chr6.15265000.15270000","chr6.15320000.15325000",55000,22,0.003206695,15265000,15320000,15270000,15325000,"chr6",247368,3,3,1,7,"chr6",1,0.0180496952648851
"7793","chr6.24855000.24860000","chr6.25005000.25010000",150000,16,0.0003861622,24855000,25005000,24860000,25010000,"chr6",247384,1,5,1,7,"chr6",1,0.0131270511017346
"7794","chr6.53005000.53010000","chr6.53435000.53440000",430000,9,0.008670633,53005000,53435000,53010000,53440000,"chr6",247427,0,2,2,4,"chr6",1,0.00421940928270042
"7795","chr6.28950000.28955000","chr6.28980000.28985000",30000,30,0.005980343,28950000,28980000,28955000,28985000,"chr6",247467,0,5,7,12,"chr6",1,0.0421940928270042
"7796","chr6.26360000.26365000","chr6.26380000.26385000",20000,37,0.005260689,26360000,26380000,26365000,26385000,"chr6",247488,1,3,5,9,"chr6",1,0.0390295358649789
"7797","chr6.56915000.56920000","chr6.57085000.57090000",170000,17,3.740874e-05,56915000,57085000,56920000,57090000,"chr6",247513,1,6,7,14,"chr6",1,0.0278949835911861
"7798","chr6.8130000.8135000","chr6.8215000.8220000",85000,21,8.788792e-05,8130000,8215000,8135000,8220000,"chr6",247531,1,9,5,15,"chr6",1,0.0369198312236287
"7799","chr6.17885000.17890000","chr6.18100000.18105000",215000,16,2.091485e-05,17885000,18100000,17890000,18105000,"chr6",247532,1,13,7,21,"chr6",1,0.0393811533052039
"7800","chr6.31700000.31705000","chr6.31860000.31865000",160000,15,0.0008765327,31700000,31860000,31705000,31865000,"chr6",247534,0,4,3,7,"chr6",1,0.0123066104078762
"7801","chr6.111085000.111090000","chr6.111260000.111265000",175000,16,0.0001220207,111085000,111260000,111090000,111265000,"chr6",247567,3,8,8,19,"chr6",1,0.0356305672761369
"7802","chr6.13335000.13340000","chr6.13525000.13530000",190000,17,1.405663e-05,13335000,13525000,13340000,13530000,"chr6",247581,1,11,19,31,"chr6",1,0.0617674636661978
"7803","chr6.157440000.157445000","chr6.157460000.157465000",20000,45,1.479594e-05,157440000,157460000,157445000,157465000,"chr6",247643,2,6,4,12,"chr6",1,0.0632911392405063
"7804","chr6.39330000.39335000","chr6.39830000.39835000",500000,9,0.004299098,39330000,39830000,39335000,39835000,"chr6",247673,0,3,0,3,"chr6",1,0.00316455696202532
"7805","chr6.111010000.111015000","chr6.111030000.111035000",20000,38,0.002817976,111010000,111030000,111015000,111035000,"chr6",247715,8,9,8,25,"chr6",1,0.111345522737928
"7806","chr6.150075000.150080000","chr6.150130000.150135000",55000,22,0.003206695,150075000,150130000,150080000,150135000,"chr6",247741,3,2,11,16,"chr6",1,0.0412564463197375
"7807","chr6.26195000.26200000","chr6.26285000.26290000",90000,22,1.343839e-05,26195000,26285000,26200000,26290000,"chr6",247747,5,4,5,14,"chr6",1,0.0360993905297703
"7808","chr6.56745000.56750000","chr6.56785000.56790000",40000,30,7.566497e-05,56745000,56785000,56750000,56790000,"chr6",247750,1,4,0,5,"chr6",1,0.0175808720112518
"7809","chr6.26215000.26220000","chr6.26535000.26540000",320000,11,0.002064233,26215000,26535000,26220000,26540000,"chr6",247770,0,5,10,15,"chr6",1,0.0193389592123769
"7810","chr6.53100000.53105000","chr6.53345000.53350000",245000,12,0.002504867,53100000,53345000,53105000,53350000,"chr6",247823,1,2,1,4,"chr6",1,0.00562587904360056
"7811","chr6.26170000.26175000","chr6.26200000.26205000",30000,41,3.886085e-07,26170000,26200000,26175000,26205000,"chr6",247836,1,5,2,8,"chr6",1,0.0384435067979372
"7812","chr6.117555000.117560000","chr6.117605000.117610000",50000,22,0.007734444,117555000,117605000,117560000,117610000,"chr6",247837,2,3,0,5,"chr6",1,0.012892639474918
"7813","chr6.11315000.11320000","chr6.11495000.11500000",180000,14,0.00140844,11315000,11495000,11320000,11500000,"chr6",247851,0,0,1,1,"chr6",1,0.00164088138771683
"7814","chr6.134250000.134255000","chr6.134445000.134450000",195000,13,0.002934017,134250000,134445000,134255000,134450000,"chr6",247868,5,11,8,24,"chr6",1,0.0365682137834037
"7815","chr6.3160000.3165000","chr6.3250000.3255000",90000,18,0.001524141,3160000,3250000,3165000,3255000,"chr6",247875,1,0,0,1,"chr6",1,0.00210970464135021
"7816","chr6.134245000.134250000","chr6.134285000.134290000",40000,34,1.106133e-06,134245000,134285000,134250000,134290000,"chr6",247877,6,4,18,28,"chr6",1,0.111579934364744
"7817","chr6.158110000.158115000","chr6.158375000.158380000",265000,11,0.005701523,158110000,158375000,158115000,158380000,"chr6",247909,0,0,1,1,"chr6",1,0.0012892639474918
"7818","chr6.16510000.16515000","chr6.16640000.16645000",130000,26,2.800343e-10,16510000,16640000,16515000,16645000,"chr6",247911,3,5,4,12,"chr6",1,0.0365682137834037
"7819","chr6.41370000.41375000","chr6.41630000.41635000",260000,11,0.006289337,41370000,41630000,41375000,41635000,"chr6",247939,2,3,8,13,"chr6",1,0.0167604313173933
"7820","chr6.26155000.26160000","chr6.26605000.26610000",450000,9,0.007080125,26155000,26605000,26160000,26610000,"chr6",247954,1,5,5,11,"chr6",1,0.0116033755274262
"7821","chr6.26305000.26310000","chr6.27125000.27130000",820000,7,0.009242015,26305000,27125000,26310000,27130000,"chr6",248018,2,5,7,14,"chr6",1,0.0114861697140178
"7822","chr6.136745000.136750000","chr6.136835000.136840000",90000,22,1.343839e-05,136745000,136835000,136750000,136840000,"chr6",248076,1,5,4,10,"chr6",1,0.0257852789498359
"7823","chr6.138490000.138495000","chr6.138515000.138520000",25000,34,0.006369861,138490000,138515000,138495000,138520000,"chr6",248098,0,3,2,5,"chr6",1,0.0199249882794187
"7824","chr6.30585000.30590000","chr6.30645000.30650000",60000,20,0.007808024,30585000,30645000,30590000,30650000,"chr6",248112,0,6,3,9,"chr6",1,0.0210970464135021
"7825","chr6.132275000.132280000","chr6.132530000.132535000",255000,16,4.264276e-06,132275000,132530000,132280000,132535000,"chr6",248174,0,3,4,7,"chr6",1,0.0131270511017346
"7826","chr6.110995000.111000000","chr6.111110000.111115000",115000,15,0.006219749,110995000,111110000,1.11e+08,111115000,"chr6",248209,4,15,4,23,"chr6",1,0.040436005625879
"7827","chr6.110040000.110045000","chr6.110355000.110360000",315000,11,0.002256852,110040000,110355000,110045000,110360000,"chr6",248239,0,3,1,4,"chr6",1,0.00515705578996718
"7828","chr6.25265000.25270000","chr6.25555000.25560000",290000,11,0.003483448,25265000,25555000,25270000,25560000,"chr6",248247,0,2,0,2,"chr6",1,0.00257852789498359
"7829","chr6.27790000.27795000","chr6.27830000.27835000",40000,28,0.0004907997,27790000,27830000,27795000,27835000,"chr6",248304,0,4,4,8,"chr6",1,0.0262541022034693
"7830","chr6.136200000.136205000","chr6.136525000.136530000",325000,11,0.001903583,136200000,136525000,136205000,136530000,"chr6",248333,0,4,1,5,"chr6",1,0.00644631973745898
"7831","chr6.151060000.151065000","chr6.151135000.151140000",75000,22,0.000106262,151060000,151135000,151065000,151140000,"chr6",248346,0,6,4,10,"chr6",1,0.0257852789498359
"7832","chr6.11140000.11145000","chr6.11495000.11500000",355000,107,9.374726e-139,11140000,11495000,11145000,11500000,"chr6",248366,0,0,4,4,"chr6",1,0.0501640881387717
"7833","chr6.150730000.150735000","chr6.151060000.151065000",330000,15,2.536046e-06,150730000,151060000,150735000,151065000,"chr6",248373,0,6,4,10,"chr6",1,0.0175808720112518
"7834","chr6.42710000.42715000","chr6.42745000.42750000",35000,54,1.148336e-16,42710000,42745000,42715000,42750000,"chr6",248420,0,4,5,9,"chr6",1,0.0569620253164557
"7835","chr6.53665000.53670000","chr6.53700000.53705000",35000,40,2.168707e-08,53665000,53700000,53670000,53705000,"chr6",248459,4,8,3,15,"chr6",1,0.070323488045007
"7836","chr6.111675000.111680000","chr6.111970000.111975000",295000,11,0.003195669,111675000,111970000,111680000,111975000,"chr6",248476,0,2,2,4,"chr6",1,0.00515705578996718
"7837","chr6.30875000.30880000","chr6.31080000.31085000",205000,12,0.007127411,30875000,31080000,30880000,31085000,"chr6",248482,6,16,19,41,"chr6",1,0.0576652601969058
"7838","chr6.3280000.3285000","chr6.3740000.3745000",460000,13,8.13e-06,3280000,3740000,3285000,3745000,"chr6",248504,0,1,1,2,"chr6",1,0.00304735114861697
"7839","chr6.134605000.134610000","chr6.134910000.134915000",305000,12,0.0006365693,134605000,134910000,134610000,134915000,"chr6",248518,0,3,3,6,"chr6",1,0.00843881856540084
"7840","chr6.2850000.2855000","chr6.2930000.2935000",80000,38,8.086127e-16,2850000,2930000,2855000,2935000,"chr6",248575,4,19,18,41,"chr6",1,0.182606657290202
"7841","chr6.108925000.108930000","chr6.109090000.109095000",165000,14,0.002498518,108925000,109090000,108930000,109095000,"chr6",248603,2,1,3,6,"chr6",1,0.00984528832630099
"7842","chr6.152465000.152470000","chr6.152485000.152490000",20000,36,0.009530062,152465000,152485000,152470000,152490000,"chr6",248611,0,1,2,3,"chr6",1,0.0126582278481013
"7843","chr6.28105000.28110000","chr6.28350000.28355000",245000,12,0.002504867,28105000,28350000,28110000,28355000,"chr6",248633,0,4,1,5,"chr6",1,0.0070323488045007
"7844","chr6.37790000.37795000","chr6.37965000.37970000",175000,16,0.0001220207,37790000,37965000,37795000,37970000,"chr6",248652,2,2,6,10,"chr6",1,0.0187529301453352
"7845","chr6.31680000.31685000","chr6.31860000.31865000",180000,13,0.004759726,31680000,31860000,31685000,31865000,"chr6",248678,0,4,3,7,"chr6",1,0.0106657290201594
"7846","chr6.17600000.17605000","chr6.18120000.18125000",520000,10,0.0007190849,17600000,18120000,17605000,18125000,"chr6",248696,3,3,5,11,"chr6",1,0.012892639474918
"7847","chr6.13355000.13360000","chr6.13470000.13475000",115000,15,0.006219749,13355000,13470000,13360000,13475000,"chr6",248769,1,2,0,3,"chr6",1,0.00527426160337553
"7848","chr6.89690000.89695000","chr6.90095000.90100000",405000,10,0.002817341,89690000,90095000,89695000,90100000,"chr6",248789,3,4,4,11,"chr6",1,0.012892639474918
"7849","chr6.13410000.13415000","chr6.13485000.13490000",75000,22,0.000106262,13410000,13485000,13415000,13490000,"chr6",248797,0,1,0,1,"chr6",1,0.00257852789498359
"7850","chr6.17865000.17870000","chr6.18100000.18105000",235000,25,2.951991e-13,17865000,18100000,17870000,18105000,"chr6",248804,1,1,1,3,"chr6",1,0.00879043600562588
"7851","chr6.99090000.99095000","chr6.99120000.99125000",30000,37,2.013492e-05,99090000,99120000,99095000,99125000,"chr6",248807,0,2,2,4,"chr6",1,0.0173464603844351
"7852","chr6.27130000.27135000","chr6.27500000.27505000",370000,10,0.004195168,27130000,27500000,27135000,27505000,"chr6",248810,1,6,5,12,"chr6",1,0.0140646976090014
"7853","chr6.89690000.89695000","chr6.89815000.89820000",125000,20,6.707045e-06,89690000,89815000,89695000,89820000,"chr6",248824,4,4,4,12,"chr6",1,0.0281293952180028
"7854","chr6.134530000.134535000","chr6.134900000.134905000",370000,11,0.0009742253,134530000,134900000,134535000,134905000,"chr6",248840,0,0,4,4,"chr6",1,0.00515705578996718
"7855","chr6.136605000.136610000","chr6.136625000.136630000",20000,36,0.009530062,136605000,136625000,136610000,136630000,"chr6",248873,4,12,14,30,"chr6",1,0.126582278481013
"7856","chr6.3120000.3125000","chr6.3930000.3935000",810000,7,0.00973435,3120000,3930000,3125000,3935000,"chr6",248881,1,12,11,24,"chr6",1,0.019690576652602
"7857","chr6.2850000.2855000","chr6.2960000.2965000",110000,17,0.0009326017,2850000,2960000,2855000,2965000,"chr6",248882,4,4,7,15,"chr6",1,0.029887482419128
"7858","chr6.26170000.26175000","chr6.26215000.26220000",45000,27,0.0002769738,26170000,26215000,26175000,26220000,"chr6",248893,2,5,11,18,"chr6",1,0.0569620253164557
"7859","chr6.158645000.158650000","chr6.158835000.158840000",190000,17,1.405663e-05,158645000,158835000,158650000,158840000,"chr6",248897,1,3,5,9,"chr6",1,0.0179324894514768
"7860","chr6.125695000.125700000","chr6.125995000.126000000",300000,12,0.0007007347,125695000,125995000,125700000,1.26e+08,"chr6",248902,1,0,1,2,"chr6",1,0.00281293952180028
"7861","chr6.32145000.32150000","chr6.32160000.32165000",15000,43,7.615044e-05,32145000,32160000,32150000,32165000,"chr6",248904,4,11,6,21,"chr6",1,0.105836849507736
"7862","chr6.3125000.3130000","chr6.3205000.3210000",80000,23,1.497665e-05,3125000,3205000,3130000,3210000,"chr6",248914,4,7,6,17,"chr6",1,0.0458274730426629
"7863","chr6.134515000.134520000","chr6.135025000.135030000",510000,13,3.522106e-06,134515000,135025000,134520000,135030000,"chr6",248931,0,2,1,3,"chr6",1,0.00457102672292546
"7864","chr6.39330000.39335000","chr6.39770000.39775000",440000,17,3.554693e-09,39330000,39770000,39335000,39775000,"chr6",248944,0,4,2,6,"chr6",1,0.0119549929676512
"7865","chr6.163315000.163320000","chr6.163345000.163350000",30000,37,2.013492e-05,163315000,163345000,163320000,163350000,"chr6",248975,0,3,1,4,"chr6",1,0.0173464603844351
"7866","chr6.113730000.113735000","chr6.114165000.114170000",435000,12,7.566497e-05,113730000,114165000,113735000,114170000,"chr6",248989,3,12,14,29,"chr6",1,0.0407876230661041
"7867","chr6.157020000.157025000","chr6.157090000.157095000",70000,21,0.0006733273,157020000,157090000,157025000,157095000,"chr6",249000,0,2,0,2,"chr6",1,0.00492264416315049
"7868","chr6.158245000.158250000","chr6.158310000.158315000",65000,24,6.165327e-05,158245000,158310000,158250000,158315000,"chr6",249022,1,3,1,5,"chr6",1,0.0140646976090014
"7869","chr6.26400000.26405000","chr6.26570000.26575000",170000,18,8.51929e-06,26400000,26570000,26405000,26575000,"chr6",249024,4,14,10,28,"chr6",1,0.0590717299578059
"7870","chr6.37705000.37710000","chr6.38555000.38560000",850000,7,0.007808024,37705000,38555000,37710000,38560000,"chr6",249035,1,5,1,7,"chr6",1,0.00574308485700891
"7871","chr6.136600000.136605000","chr6.136855000.136860000",255000,14,0.0001071815,136600000,136855000,136605000,136860000,"chr6",249044,4,5,2,11,"chr6",1,0.0180496952648851
"7872","chr6.5230000.5235000","chr6.5385000.5390000",155000,15,0.001086923,5230000,5385000,5235000,5390000,"chr6",249050,0,6,2,8,"chr6",1,0.0140646976090014
"7873","chr6.25250000.25255000","chr6.25490000.25495000",240000,13,0.0007231554,25250000,25490000,25255000,25495000,"chr6",249089,2,0,0,2,"chr6",1,0.00304735114861697
"7874","chr6.10510000.10515000","chr6.10585000.10590000",75000,18,0.006748519,10510000,10585000,10515000,10590000,"chr6",249092,2,7,6,15,"chr6",1,0.0316455696202532
"7875","chr6.53050000.53055000","chr6.53545000.53550000",495000,10,0.0009644138,53050000,53545000,53055000,53550000,"chr6",249143,0,2,4,6,"chr6",1,0.0070323488045007
"7876","chr6.133180000.133185000","chr6.133835000.133840000",655000,14,4.193862e-08,133180000,133835000,133185000,133840000,"chr6",249183,2,3,4,9,"chr6",1,0.0147679324894515
"7877","chr6.18025000.18030000","chr6.18095000.18100000",70000,26,1.934617e-06,18025000,18095000,18030000,18100000,"chr6",249207,4,7,9,20,"chr6",1,0.0609470229723394
"7878","chr6.112050000.112055000","chr6.112335000.112340000",285000,11,0.003840393,112050000,112335000,112055000,112340000,"chr6",249214,1,6,3,10,"chr6",1,0.012892639474918
"7879","chr6.11170000.11175000","chr6.11200000.11205000",30000,35,0.0001217853,11170000,11200000,11175000,11205000,"chr6",249233,0,3,2,5,"chr6",1,0.0205110173464604
"7880","chr6.157870000.157875000","chr6.157940000.157945000",70000,19,0.004790033,157870000,157940000,157875000,157945000,"chr6",249246,0,3,1,4,"chr6",1,0.00890764181903422
"7881","chr6.39345000.39350000","chr6.39790000.39795000",445000,13,1.050126e-05,39345000,39790000,39350000,39795000,"chr6",249280,0,1,3,4,"chr6",1,0.00609470229723394
"7882","chr6.53035000.53040000","chr6.53260000.53265000",225000,13,0.001148837,53035000,53260000,53040000,53265000,"chr6",249286,0,2,1,3,"chr6",1,0.00457102672292546
"7883","chr6.138515000.138520000","chr6.138585000.138590000",70000,21,0.0006733273,138515000,138585000,138520000,138590000,"chr6",249304,2,3,3,8,"chr6",1,0.019690576652602
"7884","chr6.111030000.111035000","chr6.111110000.111115000",80000,24,4.199469e-06,111030000,111110000,111035000,111115000,"chr6",249322,5,9,4,18,"chr6",1,0.0506329113924051
"7885","chr6.10510000.10515000","chr6.10555000.10560000",45000,31,4.326025e-06,10510000,10555000,10515000,10560000,"chr6",249388,1,1,3,5,"chr6",1,0.0181669010782935
"7886","chr6.16555000.16560000","chr6.16695000.16700000",140000,14,0.006219749,16555000,16695000,16560000,16700000,"chr6",249401,2,4,9,15,"chr6",1,0.0246132208157525
"7887","chr6.111030000.111035000","chr6.111260000.111265000",230000,25,4.214434e-13,111030000,111260000,111035000,111265000,"chr6",249418,4,8,8,20,"chr6",1,0.0586029067041725
"7888","chr6.16510000.16515000","chr6.16540000.16545000",30000,31,0.002960758,16510000,16540000,16515000,16545000,"chr6",249443,1,2,2,5,"chr6",1,0.0181669010782935
"7889","chr6.10950000.10955000","chr6.11065000.11070000",115000,64,3.486718e-47,10950000,11065000,10955000,11070000,"chr6",249504,0,0,5,5,"chr6",1,0.0375058602906704
"7890","chr6.34220000.34225000","chr6.34380000.34385000",160000,44,5.227768e-29,34220000,34380000,34225000,34385000,"chr6",249511,10,14,23,47,"chr6",1,0.242381622128458
"7891","chr6.2845000.2850000","chr6.2920000.2925000",75000,24,9.624623e-06,2845000,2920000,2850000,2925000,"chr6",249513,0,3,1,4,"chr6",1,0.0112517580872011
"7892","chr6.3120000.3125000","chr6.4005000.4010000",885000,7,0.006415741,3120000,4005000,3125000,4010000,"chr6",249519,1,12,8,21,"chr6",1,0.0172292545710267
"7893","chr6.109325000.109330000","chr6.109380000.109385000",55000,22,0.003206695,109325000,109380000,109330000,109385000,"chr6",249524,0,5,0,5,"chr6",1,0.012892639474918
"7894","chr6.149615000.149620000","chr6.149755000.149760000",140000,19,1.077722e-05,149615000,149755000,149620000,149760000,"chr6",249526,2,19,12,33,"chr6",1,0.0734880450070323
"7895","chr6.167895000.167900000","chr6.168305000.168310000",410000,16,5.904898e-08,167895000,168305000,167900000,168310000,"chr6",249538,0,1,0,1,"chr6",1,0.00187529301453352
"7896","chr6.13425000.13430000","chr6.13445000.13450000",20000,54,2.893562e-09,13425000,13445000,13430000,13450000,"chr6",249556,2,1,2,5,"chr6",1,0.0316455696202532
"7897","chr6.36840000.36845000","chr6.36955000.36960000",115000,25,7.398664e-09,36840000,36955000,36845000,36960000,"chr6",249561,0,1,1,2,"chr6",1,0.00586029067041725
"7898","chr6.13395000.13400000","chr6.13445000.13450000",50000,32,2.539278e-07,13395000,13445000,13400000,13450000,"chr6",249592,2,1,2,5,"chr6",1,0.0187529301453352
"7899","chr6.30615000.30620000","chr6.30690000.30695000",75000,30,2.289753e-09,30615000,30690000,30620000,30695000,"chr6",249623,0,2,2,4,"chr6",1,0.0140646976090014
"7900","chr6.110825000.110830000","chr6.111260000.111265000",435000,9,0.00818327,110825000,111260000,110830000,111265000,"chr6",249639,4,8,11,23,"chr6",1,0.0242616033755274
"7901","chr6.3995000.4000000","chr6.4015000.4020000",20000,38,0.002817976,3995000,4015000,4e+06,4020000,"chr6",249695,1,10,5,16,"chr6",1,0.0712611345522738
"7902","chr6.2990000.2995000","chr6.3050000.3055000",60000,54,3.057619e-25,2990000,3050000,2995000,3055000,"chr6",249706,2,7,6,15,"chr6",1,0.0949367088607595
"7903","chr6.155095000.155100000","chr6.155120000.155125000",25000,36,0.00167179,155095000,155120000,155100000,155125000,"chr6",249743,1,4,1,6,"chr6",1,0.0253164556962025
"7904","chr6.34235000.34240000","chr6.34365000.34370000",130000,17,0.0002859613,34235000,34365000,34240000,34370000,"chr6",249756,4,1,2,7,"chr6",1,0.0139474917955931
"7905","chr6.5215000.5220000","chr6.5470000.5475000",255000,13,0.0004857598,5215000,5470000,5220000,5475000,"chr6",249774,1,3,3,7,"chr6",1,0.0106657290201594
"7906","chr6.4315000.4320000","chr6.4935000.4940000",620000,8,0.006921365,4315000,4935000,4320000,4940000,"chr6",249823,0,5,1,6,"chr6",1,0.00562587904360056
"7907","chr6.16620000.16625000","chr6.16640000.16645000",20000,42,0.0001659547,16620000,16640000,16625000,16645000,"chr6",249885,0,6,4,10,"chr6",1,0.0492264416315049
"7908","chr6.12635000.12640000","chr6.12895000.12900000",260000,20,2.162494e-09,12635000,12895000,12640000,12900000,"chr6",249886,0,2,1,3,"chr6",1,0.0070323488045007
"7909","chr6.17095000.17100000","chr6.17580000.17585000",485000,9,0.005037543,17095000,17580000,17100000,17585000,"chr6",249936,0,0,3,3,"chr6",1,0.00316455696202532
"7910","chr6.26125000.26130000","chr6.26200000.26205000",75000,28,4.392156e-08,26125000,26200000,26130000,26205000,"chr6",249964,1,6,2,9,"chr6",1,0.029535864978903
"7911","chr6.43225000.43230000","chr6.43485000.43490000",260000,13,0.0004195353,43225000,43485000,43230000,43490000,"chr6",249966,1,12,6,19,"chr6",1,0.0289498359118612
"7912","chr6.110870000.110875000","chr6.111065000.111070000",195000,14,0.0008147436,110870000,111065000,110875000,111070000,"chr6",249967,2,7,4,13,"chr6",1,0.0213314580403188
"7913","chr6.161415000.161420000","chr6.161435000.161440000",20000,36,0.009530062,161415000,161435000,161420000,161440000,"chr6",249969,0,3,1,4,"chr6",1,0.0168776371308017
"7914","chr6.110990000.110995000","chr6.111210000.111215000",220000,13,0.001338848,110990000,111210000,110995000,111215000,"chr6",250020,2,2,4,8,"chr6",1,0.0121894045944679
"7915","chr6.25275000.25280000","chr6.25555000.25560000",280000,14,5.209382e-05,25275000,25555000,25280000,25560000,"chr6",250024,0,2,0,2,"chr6",1,0.00328176277543366
"7916","chr6.26125000.26130000","chr6.26140000.26145000",15000,55,1.001438e-09,26125000,26140000,26130000,26145000,"chr6",250030,3,13,8,24,"chr6",1,0.154711673699015
"7917","chr6.131205000.131210000","chr6.131365000.131370000",160000,13,0.009047489,131205000,131365000,131210000,131370000,"chr6",250068,2,1,5,8,"chr6",1,0.0121894045944679
"7918","chr6.24695000.24700000","chr6.24770000.24775000",75000,20,0.0009604426,24695000,24770000,24700000,24775000,"chr6",250070,7,18,12,37,"chr6",1,0.0867323019221753
"7919","chr6.5205000.5210000","chr6.5385000.5390000",180000,15,0.0003873044,5205000,5385000,5210000,5390000,"chr6",250080,0,2,2,4,"chr6",1,0.0070323488045007
"7920","chr6.157355000.157360000","chr6.157460000.157465000",105000,20,3.43331e-05,157355000,157460000,157360000,157465000,"chr6",250102,2,13,4,19,"chr6",1,0.0445382090951711
"7921","chr6.158580000.158585000","chr6.159070000.159075000",490000,10,0.001019896,158580000,159070000,158585000,159075000,"chr6",250119,2,7,10,19,"chr6",1,0.0222691045475856
"7922","chr6.16335000.16340000","chr6.16965000.16970000",630000,10,0.0002203551,16335000,16965000,16340000,16970000,"chr6",250134,0,4,2,6,"chr6",1,0.0070323488045007
"7923","chr6.31660000.31665000","chr6.31790000.31795000",130000,16,0.0009696025,31660000,31790000,31665000,31795000,"chr6",250135,4,15,13,32,"chr6",1,0.0600093764650727
"7924","chr6.20290000.20295000","chr6.20400000.20405000",110000,24,6.386319e-08,20290000,20400000,20295000,20405000,"chr6",250166,0,3,1,4,"chr6",1,0.0112517580872011
"7925","chr6.134250000.134255000","chr6.134415000.134420000",165000,25,7.485866e-11,134250000,134415000,134255000,134420000,"chr6",250182,5,10,13,28,"chr6",1,0.0820440693858415
"7926","chr6.26065000.26070000","chr6.26085000.26090000",20000,88,3.823381e-29,26065000,26085000,26070000,26090000,"chr6",250240,2,4,6,12,"chr6",1,0.123769338959212
"7927","chr6.111680000.111685000","chr6.111795000.111800000",115000,27,2.487725e-10,111680000,111795000,111685000,111800000,"chr6",250277,0,3,2,5,"chr6",1,0.0158227848101266
"7928","chr6.14140000.14145000","chr6.15070000.15075000",930000,9,0.000108605,14140000,15070000,14145000,15075000,"chr6",250283,2,0,4,6,"chr6",1,0.00632911392405063
"7929","chr6.26125000.26130000","chr6.26215000.26220000",90000,21,4.777466e-05,26125000,26215000,26130000,26220000,"chr6",250301,4,14,8,26,"chr6",1,0.0639943741209564
"7930","chr6.15310000.15315000","chr6.15390000.15395000",80000,19,0.001487732,15310000,15390000,15315000,15395000,"chr6",250302,0,5,2,7,"chr6",1,0.0155883731833099
"7931","chr6.5215000.5220000","chr6.5260000.5265000",45000,27,0.0002769738,5215000,5260000,5220000,5265000,"chr6",250306,5,11,22,38,"chr6",1,0.120253164556962
"7932","chr6.125865000.125870000","chr6.125985000.125990000",120000,15,0.004837722,125865000,125985000,125870000,125990000,"chr6",250342,3,9,2,14,"chr6",1,0.0246132208157525
"7933","chr6.142885000.142890000","chr6.143740000.143745000",855000,8,0.001357449,142885000,143740000,142890000,143745000,"chr6",250370,3,7,6,16,"chr6",1,0.0150023441162682
"7934","chr6.47030000.47035000","chr6.47275000.47280000",245000,14,0.0001487934,47030000,47275000,47035000,47280000,"chr6",250432,0,2,3,5,"chr6",1,0.00820440693858415
"7935","chr6.24775000.24780000","chr6.25015000.25020000",240000,13,0.0007231554,24775000,25015000,24780000,25020000,"chr6",250479,2,8,7,17,"chr6",1,0.0259024847632443
"7936","chr6.26170000.26175000","chr6.26565000.26570000",395000,12,0.0001389651,26170000,26565000,26175000,26570000,"chr6",250498,2,5,11,18,"chr6",1,0.0253164556962025
"7937","chr6.26305000.26310000","chr6.26570000.26575000",265000,11,0.005701523,26305000,26570000,26310000,26575000,"chr6",250532,4,12,11,27,"chr6",1,0.0348101265822785
"7938","chr6.134500000.134505000","chr6.135025000.135030000",525000,11,0.0001221151,134500000,135025000,134505000,135030000,"chr6",250544,2,3,1,6,"chr6",1,0.00773558368495077
"7939","chr6.43625000.43630000","chr6.44045000.44050000",420000,12,9.363282e-05,43625000,44045000,43630000,44050000,"chr6",250551,0,2,1,3,"chr6",1,0.00421940928270042
"7940","chr6.16510000.16515000","chr6.16555000.16560000",45000,34,1.293185e-07,16510000,16555000,16515000,16560000,"chr6",250601,3,5,4,12,"chr6",1,0.0478199718706048
"7941","chr6.3275000.3280000","chr6.4005000.4010000",730000,12,1.303007e-06,3275000,4005000,3280000,4010000,"chr6",250634,0,3,4,7,"chr6",1,0.00984528832630099
"7942","chr6.28135000.28140000","chr6.28160000.28165000",25000,36,0.00167179,28135000,28160000,28140000,28165000,"chr6",250672,1,1,0,2,"chr6",1,0.00843881856540084
"7943","chr6.136945000.136950000","chr6.137075000.137080000",130000,17,0.0002859613,136945000,137075000,136950000,137080000,"chr6",250697,2,3,3,8,"chr6",1,0.0159399906235349
"7944","chr6.56635000.56640000","chr6.56680000.56685000",45000,26,0.0006964557,56635000,56680000,56640000,56685000,"chr6",250717,0,3,2,5,"chr6",1,0.0152367557430849
"7945","chr6.35325000.35330000","chr6.35415000.35420000",90000,35,1.282725e-14,35325000,35415000,35330000,35420000,"chr6",250721,4,4,5,13,"chr6",1,0.053328645100797
"7946","chr6.134560000.134565000","chr6.135035000.135040000",475000,9,0.005555649,134560000,135035000,134565000,135040000,"chr6",250730,0,1,1,2,"chr6",1,0.00210970464135021
"7947","chr6.37815000.37820000","chr6.37965000.37970000",150000,15,0.001345451,37815000,37965000,37820000,37970000,"chr6",250734,0,2,1,3,"chr6",1,0.00527426160337553
"7948","chr6.156600000.156605000","chr6.157235000.157240000",635000,8,0.006219749,156600000,157235000,156605000,157240000,"chr6",250754,1,2,0,3,"chr6",1,0.00281293952180028
"7949","chr6.6725000.6730000","chr6.7240000.7245000",515000,19,5.288439e-12,6725000,7240000,6730000,7245000,"chr6",250827,1,3,6,10,"chr6",1,0.0222691045475856
"7950","chr6.26360000.26365000","chr6.26550000.26555000",190000,23,4.512672e-10,26360000,26550000,26365000,26555000,"chr6",250839,0,1,9,10,"chr6",1,0.0269573370839194
"7951","chr6.136790000.136795000","chr6.136835000.136840000",45000,38,7.472214e-10,136790000,136835000,136795000,136840000,"chr6",250844,2,8,8,18,"chr6",1,0.080168776371308
"7952","chr6.30765000.30770000","chr6.31055000.31060000",290000,14,3.938591e-05,30765000,31055000,30770000,31060000,"chr6",250853,0,3,6,9,"chr6",1,0.0147679324894515
"7953","chr6.26155000.26160000","chr6.26285000.26290000",130000,16,0.0009696025,26155000,26285000,26160000,26290000,"chr6",250866,2,4,5,11,"chr6",1,0.0206282231598687
"7954","chr6.16315000.16320000","chr6.16510000.16515000",195000,14,0.0008147436,16315000,16510000,16320000,16515000,"chr6",250894,3,5,4,12,"chr6",1,0.019690576652602
"7955","chr6.16510000.16515000","chr6.16635000.16640000",125000,16,0.001254039,16510000,16635000,16515000,16640000,"chr6",250934,1,2,4,7,"chr6",1,0.0131270511017346
"7956","chr6.97370000.97375000","chr6.97390000.97395000",20000,42,0.0001659547,97370000,97390000,97375000,97395000,"chr6",250962,0,1,2,3,"chr6",1,0.0147679324894515
"7957","chr6.134480000.134485000","chr6.134880000.134885000",400000,11,0.0006472299,134480000,134880000,134485000,134885000,"chr6",250975,1,5,5,11,"chr6",1,0.0141819034224098
"7958","chr6.15515000.15520000","chr6.15620000.15625000",105000,18,0.0004195353,15515000,15620000,15520000,15625000,"chr6",251004,4,5,7,16,"chr6",1,0.0337552742616034
"7959","chr6.26065000.26070000","chr6.26195000.26200000",130000,14,0.008995566,26065000,26195000,26070000,26200000,"chr6",251021,2,4,6,12,"chr6",1,0.019690576652602
"7960","chr6.6710000.6715000","chr6.7240000.7245000",530000,12,1.809464e-05,6710000,7240000,6715000,7245000,"chr6",251040,1,0,2,3,"chr6",1,0.00421940928270042
"7961","chr6.36660000.36665000","chr6.37165000.37170000",505000,10,0.0008590983,36660000,37165000,36665000,37170000,"chr6",251080,0,7,3,10,"chr6",1,0.0117205813408345
"7962","chr6.134590000.134595000","chr6.135055000.135060000",465000,9,0.006135482,134590000,135055000,134595000,135060000,"chr6",251095,0,2,1,3,"chr6",1,0.00316455696202532
"7963","chr6.17945000.17950000","chr6.18100000.18105000",155000,19,4.384746e-06,17945000,18100000,17950000,18105000,"chr6",251097,1,13,5,19,"chr6",1,0.0423112986404126
"7964","chr6.26305000.26310000","chr6.26550000.26555000",245000,19,3.101156e-08,26305000,26550000,26310000,26555000,"chr6",251099,0,1,9,10,"chr6",1,0.0222691045475856
"7965","chr6.149645000.149650000","chr6.149715000.149720000",70000,27,5.187769e-07,149645000,149715000,149650000,149720000,"chr6",251126,3,3,3,9,"chr6",1,0.0284810126582278
"7966","chr6.26215000.26220000","chr6.26305000.26310000",90000,19,0.000515061,26215000,26305000,26220000,26310000,"chr6",251128,10,12,11,33,"chr6",1,0.0734880450070323
"7967","chr6.13795000.13800000","chr6.14140000.14145000",345000,10,0.005746584,13795000,14140000,13800000,14145000,"chr6",251138,1,0,4,5,"chr6",1,0.00586029067041725
"7968","chr6.11230000.11235000","chr6.11250000.11255000",20000,42,0.0001659547,11230000,11250000,11235000,11255000,"chr6",251160,0,2,1,3,"chr6",1,0.0147679324894515
"7969","chr6.10745000.10750000","chr6.10800000.10805000",55000,24,0.0004989935,10745000,10800000,10750000,10805000,"chr6",251175,1,2,2,5,"chr6",1,0.0140646976090014
"7970","chr6.26550000.26555000","chr6.26570000.26575000",20000,71,3.184826e-18,26550000,26570000,26555000,26575000,"chr6",251179,0,1,9,10,"chr6",1,0.083216127519925
"7971","chr6.30885000.30890000","chr6.31035000.31040000",150000,24,1.667798e-09,30885000,31035000,30890000,31040000,"chr6",251181,0,7,2,9,"chr6",1,0.0253164556962025
"7972","chr6.17040000.17045000","chr6.17580000.17585000",540000,10,0.000580956,17040000,17580000,17045000,17585000,"chr6",251205,0,0,3,3,"chr6",1,0.00351617440225035
"7973","chr6.16555000.16560000","chr6.16620000.16625000",65000,24,6.165327e-05,16555000,16620000,16560000,16625000,"chr6",251239,0,6,4,10,"chr6",1,0.0281293952180028
"7974","chr6.24855000.24860000","chr6.25070000.25075000",215000,29,2.094061e-16,24855000,25070000,24860000,25075000,"chr6",251241,1,5,3,9,"chr6",1,0.0305907172995781
"7975","chr6.134500000.134505000","chr6.134635000.134640000",135000,14,0.007483355,134500000,134635000,134505000,134640000,"chr6",251258,3,4,5,12,"chr6",1,0.019690576652602
"7976","chr6.12890000.12895000","chr6.13325000.13330000",435000,9,0.00818327,12890000,13325000,12895000,13330000,"chr6",251266,0,1,0,1,"chr6",1,0.00105485232067511
"7977","chr6.37705000.37710000","chr6.38645000.38650000",940000,7,0.004682318,37705000,38645000,37710000,38650000,"chr6",251304,3,6,2,11,"chr6",1,0.00902484763244257
"7978","chr6.89755000.89760000","chr6.90045000.90050000",290000,11,0.003483448,89755000,90045000,89760000,90050000,"chr6",251322,2,8,11,21,"chr6",1,0.0270745428973277
"7979","chr6.37725000.37730000","chr6.38630000.38635000",905000,10,1.64028e-05,37725000,38630000,37730000,38635000,"chr6",251371,2,4,0,6,"chr6",1,0.0070323488045007
"7980","chr6.10555000.10560000","chr6.10745000.10750000",190000,18,2.897449e-06,10555000,10745000,10560000,10750000,"chr6",251377,1,1,2,4,"chr6",1,0.00843881856540084
"7981","chr6.112035000.112040000","chr6.112180000.112185000",145000,18,3.376723e-05,112035000,112180000,112040000,112185000,"chr6",251393,0,1,0,1,"chr6",1,0.00210970464135021
"7982","chr6.3295000.3300000","chr6.3375000.3380000",80000,21,0.0001695711,3295000,3375000,3300000,3380000,"chr6",251435,0,1,0,1,"chr6",1,0.00246132208157525
"7983","chr6.3160000.3165000","chr6.3245000.3250000",85000,20,0.0002859613,3160000,3245000,3165000,3250000,"chr6",251460,3,9,10,22,"chr6",1,0.0515705578996718
"7984","chr6.31830000.31835000","chr6.31860000.31865000",30000,33,0.0006400976,31830000,31860000,31835000,31865000,"chr6",251502,0,4,3,7,"chr6",1,0.0270745428973277
"7985","chr6.150080000.150085000","chr6.150125000.150130000",45000,24,0.003929417,150080000,150125000,150085000,150130000,"chr6",251516,0,5,2,7,"chr6",1,0.019690576652602
"7986","chr6.42615000.42620000","chr6.42700000.42705000",85000,21,8.788792e-05,42615000,42700000,42620000,42705000,"chr6",251526,7,21,20,48,"chr6",1,0.118143459915612
"7987","chr6.26280000.26285000","chr6.26535000.26540000",255000,13,0.0004857598,26280000,26535000,26285000,26540000,"chr6",251544,0,5,5,10,"chr6",1,0.0152367557430849
"7988","chr6.12955000.12960000","chr6.13330000.13335000",375000,12,0.000189072,12955000,13330000,12960000,13335000,"chr6",251581,0,3,1,4,"chr6",1,0.00562587904360056
"7989","chr6.161580000.161585000","chr6.161675000.161680000",95000,23,1.781351e-06,161580000,161675000,161585000,161680000,"chr6",251654,0,3,3,6,"chr6",1,0.0161744022503516
"7990","chr6.16550000.16555000","chr6.16725000.16730000",175000,13,0.005577214,16550000,16725000,16555000,16730000,"chr6",251673,0,5,0,5,"chr6",1,0.00761837787154243
"7991","chr6.30645000.30650000","chr6.30690000.30695000",45000,116,3.71769e-80,30645000,30690000,30650000,30695000,"chr6",251712,0,6,3,9,"chr6",1,0.122362869198312
"7992","chr6.149575000.149580000","chr6.149750000.149755000",175000,20,2.637781e-07,149575000,149750000,149580000,149755000,"chr6",251730,2,7,2,11,"chr6",1,0.0257852789498359
"7993","chr6.16285000.16290000","chr6.16330000.16335000",45000,24,0.003929417,16285000,16330000,16290000,16335000,"chr6",251795,3,4,2,9,"chr6",1,0.0253164556962025
"7994","chr6.134245000.134250000","chr6.134370000.134375000",125000,29,2.039124e-12,134245000,134370000,134250000,134375000,"chr6",251824,6,12,11,29,"chr6",1,0.0985700890764182
"7995","chr6.13355000.13360000","chr6.13405000.13410000",50000,30,2.785437e-06,13355000,13405000,13360000,13410000,"chr6",251831,0,2,0,2,"chr6",1,0.0070323488045007
"7996","chr6.31680000.31685000","chr6.31810000.31815000",130000,21,1.061453e-06,31680000,31810000,31685000,31815000,"chr6",251871,1,8,6,15,"chr6",1,0.0369198312236287
"7997","chr6.99390000.99395000","chr6.99425000.99430000",35000,28,0.002985581,99390000,99425000,99395000,99430000,"chr6",251885,1,12,13,26,"chr6",1,0.0853258321612752
"7998","chr6.46385000.46390000","chr6.46605000.46610000",220000,15,7.877136e-05,46385000,46605000,46390000,46610000,"chr6",251913,0,2,1,3,"chr6",1,0.00527426160337553
"7999","chr6.98495000.98500000","chr6.99090000.99095000",595000,11,5.128094e-05,98495000,99090000,98500000,99095000,"chr6",251918,0,2,2,4,"chr6",1,0.00515705578996718
"8000","chr6.3740000.3745000","chr6.3930000.3935000",190000,13,0.003407933,3740000,3930000,3745000,3935000,"chr6",251929,1,3,1,5,"chr6",1,0.00761837787154243
"8001","chr6.157895000.157900000","chr6.157985000.157990000",90000,19,0.000515061,157895000,157985000,157900000,157990000,"chr6",251943,0,2,4,6,"chr6",1,0.0133614627285513
"8002","chr6.110015000.110020000","chr6.110355000.110360000",340000,13,6.674425e-05,110015000,110355000,110020000,110360000,"chr6",251966,0,3,1,4,"chr6",1,0.00609470229723394
"8003","chr6.150075000.150080000","chr6.150140000.150145000",65000,23,0.0001854044,150075000,150140000,150080000,150145000,"chr6",251993,0,1,1,2,"chr6",1,0.00539146741678387
"8004","chr6.30610000.30615000","chr6.30690000.30695000",80000,20,0.0005181948,30610000,30690000,30615000,30695000,"chr6",252022,2,4,2,8,"chr6",1,0.0187529301453352
"8005","chr6.15660000.15665000","chr6.16625000.16630000",965000,7,0.003966483,15660000,16625000,15665000,16630000,"chr6",252039,1,8,6,15,"chr6",1,0.0123066104078762
"8006","chr6.2850000.2855000","chr6.2950000.2955000",100000,22,3.876225e-06,2850000,2950000,2855000,2955000,"chr6",252083,7,17,8,32,"chr6",1,0.0825128926394749
"8007","chr6.34150000.34155000","chr6.34390000.34395000",240000,21,8.490306e-10,34150000,34390000,34155000,34395000,"chr6",252097,2,5,4,11,"chr6",1,0.0270745428973277
"8008","chr6.36875000.36880000","chr6.36965000.36970000",90000,18,0.001524141,36875000,36965000,36880000,36970000,"chr6",252125,0,5,4,9,"chr6",1,0.0189873417721519
"8009","chr6.15250000.15255000","chr6.15395000.15400000",145000,37,9.385404e-21,15250000,15395000,15255000,15400000,"chr6",252129,2,14,6,22,"chr6",1,0.0954055321143929
"8010","chr6.30645000.30650000","chr6.31065000.31070000",420000,9,0.009530062,30645000,31065000,30650000,31070000,"chr6",252227,0,6,3,9,"chr6",1,0.00949367088607595
"8011","chr6.15265000.15270000","chr6.15385000.15390000",120000,27,1.359644e-10,15265000,15385000,15270000,15390000,"chr6",252234,3,3,1,7,"chr6",1,0.0221518987341772
"8012","chr6.157820000.157825000","chr6.157870000.157875000",50000,26,0.0002097868,157820000,157870000,157825000,157875000,"chr6",252260,4,9,6,19,"chr6",1,0.0578996718237225
"8013","chr6.150730000.150735000","chr6.150875000.150880000",145000,14,0.005181923,150730000,150875000,150735000,150880000,"chr6",252286,1,8,9,18,"chr6",1,0.029535864978903
"8014","chr6.111010000.111015000","chr6.111220000.111225000",210000,14,0.0004857598,111010000,111220000,111015000,111225000,"chr6",252287,4,7,8,19,"chr6",1,0.0311767463666198
"8015","chr6.16335000.16340000","chr6.16405000.16410000",70000,30,7.908552e-09,16335000,16405000,16340000,16410000,"chr6",252375,0,5,9,14,"chr6",1,0.0492264416315049
"8016","chr6.30655000.30660000","chr6.30675000.30680000",20000,56,3.398093e-10,30655000,30675000,30660000,30680000,"chr6",252386,2,14,12,28,"chr6",1,0.183778715424285
"8017","chr6.111210000.111215000","chr6.111260000.111265000",50000,36,1.376834e-09,111210000,111260000,111215000,111265000,"chr6",252419,2,2,4,8,"chr6",1,0.0337552742616034
"8018","chr6.89690000.89695000","chr6.90040000.90045000",350000,11,0.001317138,89690000,90040000,89695000,90045000,"chr6",252455,1,1,1,3,"chr6",1,0.00386779184247539
"8019","chr6.26065000.26070000","chr6.26100000.26105000",35000,69,1.587919e-27,26065000,26100000,26070000,26105000,"chr6",252468,2,4,6,12,"chr6",1,0.0970464135021097
"8020","chr6.15250000.15255000","chr6.15455000.15460000",205000,18,1.334031e-06,15250000,15455000,15255000,15460000,"chr6",252508,2,5,2,9,"chr6",1,0.0189873417721519
"8021","chr6.13355000.13360000","chr6.13445000.13450000",90000,27,1.047025e-08,13355000,13445000,13360000,13450000,"chr6",252517,1,1,0,2,"chr6",1,0.00632911392405063
"8022","chr6.129580000.129585000","chr6.129605000.129610000",25000,39,0.0001789227,129580000,129605000,129585000,129610000,"chr6",252538,0,1,0,1,"chr6",1,0.00457102672292546
"8023","chr6.125975000.125980000","chr6.125995000.126000000",20000,47,2.600241e-06,125975000,125995000,125980000,1.26e+08,"chr6",252546,1,0,1,2,"chr6",1,0.0110173464603844
"8024","chr6.15260000.15265000","chr6.15390000.15395000",130000,14,0.008995566,15260000,15390000,15265000,15395000,"chr6",252553,4,5,2,11,"chr6",1,0.0180496952648851
"8025","chr6.16330000.16335000","chr6.17030000.17035000",700000,13,2.076973e-07,16330000,17030000,16335000,17035000,"chr6",252556,2,1,3,6,"chr6",1,0.00914205344585091
"8026","chr6.27125000.27130000","chr6.27750000.27755000",625000,14,6.650381e-08,27125000,27750000,27130000,27755000,"chr6",252586,2,5,7,14,"chr6",1,0.0229723394280356
"8027","chr6.53015000.53020000","chr6.53355000.53360000",340000,13,6.674425e-05,53015000,53355000,53020000,53360000,"chr6",252590,1,0,3,4,"chr6",1,0.00609470229723394
"8028","chr6.13615000.13620000","chr6.13710000.13715000",95000,21,2.651746e-05,13615000,13710000,13620000,13715000,"chr6",252607,0,3,2,5,"chr6",1,0.0123066104078762
"8029","chr6.13455000.13460000","chr6.13570000.13575000",115000,19,5.551494e-05,13455000,13570000,13460000,13575000,"chr6",252614,1,5,4,10,"chr6",1,0.0222691045475856
"8030","chr6.136705000.136710000","chr6.136840000.136845000",135000,29,6.607593e-13,136705000,136840000,136710000,136845000,"chr6",252621,3,5,6,14,"chr6",1,0.0475855602437881
"8031","chr6.34195000.34200000","chr6.34370000.34375000",175000,22,8.425481e-09,34195000,34370000,34200000,34375000,"chr6",252703,0,5,12,17,"chr6",1,0.0438349742147211
"8032","chr6.53005000.53010000","chr6.53890000.53895000",885000,7,0.006415741,53005000,53890000,53010000,53895000,"chr6",252723,0,3,2,5,"chr6",1,0.00410220346929208
"8033","chr6.134445000.134450000","chr6.135025000.135030000",580000,10,0.0003761279,134445000,135025000,134450000,135030000,"chr6",252802,2,3,1,6,"chr6",1,0.0070323488045007
"8034","chr6.87885000.87890000","chr6.87930000.87935000",45000,23,0.008672865,87885000,87930000,87890000,87935000,"chr6",252866,1,2,1,4,"chr6",1,0.0107829348335677
"8035","chr6.110870000.110875000","chr6.111205000.111210000",335000,11,0.001622331,110870000,111205000,110875000,111210000,"chr6",252867,3,8,4,15,"chr6",1,0.0193389592123769
"8036","chr6.13615000.13620000","chr6.13705000.13710000",90000,27,1.047025e-08,13615000,13705000,13620000,13710000,"chr6",252875,4,9,12,25,"chr6",1,0.0791139240506329
"8037","chr6.3765000.3770000","chr6.3845000.3850000",80000,18,0.004053176,3765000,3845000,3770000,3850000,"chr6",252977,0,1,0,1,"chr6",1,0.00210970464135021
"8038","chr6.17030000.17035000","chr6.17085000.17090000",55000,21,0.007492585,17030000,17085000,17035000,17090000,"chr6",252993,1,1,3,5,"chr6",1,0.0123066104078762
"8039","chr6.13350000.13355000","chr6.13570000.13575000",220000,15,7.877136e-05,13350000,13570000,13355000,13575000,"chr6",253006,1,5,4,10,"chr6",1,0.0175808720112518
"8040","chr6.56635000.56640000","chr6.56710000.56715000",75000,24,9.624623e-06,56635000,56710000,56640000,56715000,"chr6",253009,0,0,2,2,"chr6",1,0.00562587904360056
"8041","chr6.157875000.157880000","chr6.158030000.158035000",155000,23,6.465914e-09,157875000,158030000,157880000,158035000,"chr6",253055,0,1,2,3,"chr6",1,0.00808720112517581
"8042","chr6.53410000.53415000","chr6.53495000.53500000",85000,52,3.897419e-29,53410000,53495000,53415000,53500000,"chr6",253062,0,3,3,6,"chr6",1,0.0365682137834037
"8043","chr6.30890000.30895000","chr6.31055000.31060000",165000,13,0.007734444,30890000,31055000,30895000,31060000,"chr6",253074,0,1,1,2,"chr6",1,0.00304735114861697
"8044","chr6.11140000.11145000","chr6.11250000.11255000",110000,15,0.008000267,11140000,11250000,11145000,11255000,"chr6",253075,0,2,1,3,"chr6",1,0.00527426160337553
"8045","chr6.15690000.15695000","chr6.16180000.16185000",490000,42,6.563327e-41,15690000,16180000,15695000,16185000,"chr6",253076,0,2,2,4,"chr6",1,0.019690576652602
"8046","chr6.149750000.149755000","chr6.149830000.149835000",80000,22,5.206096e-05,149750000,149830000,149755000,149835000,"chr6",253081,2,11,14,27,"chr6",1,0.069620253164557
"8047","chr6.3190000.3195000","chr6.3210000.3215000",20000,36,0.009530062,3190000,3210000,3195000,3215000,"chr6",253104,0,8,9,17,"chr6",1,0.0717299578059072
"8048","chr6.5470000.5475000","chr6.5660000.5665000",190000,15,0.0002576869,5470000,5660000,5475000,5665000,"chr6",253116,1,2,2,5,"chr6",1,0.00879043600562588
"8049","chr6.36385000.36390000","chr6.36675000.36680000",290000,11,0.003483448,36385000,36675000,36390000,36680000,"chr6",253140,3,4,4,11,"chr6",1,0.0141819034224098
"8050","chr6.17860000.17865000","chr6.18120000.18125000",260000,25,5.414891e-14,17860000,18120000,17865000,18125000,"chr6",253161,7,3,9,19,"chr6",1,0.0556727613689639
"8051","chr6.108525000.108530000","chr6.108555000.108560000",30000,36,5.066556e-05,108525000,108555000,108530000,108560000,"chr6",253165,2,1,1,4,"chr6",1,0.0168776371308017
"8052","chr6.5140000.5145000","chr6.5205000.5210000",65000,26,5.865938e-06,5140000,5205000,5145000,5210000,"chr6",253177,0,0,1,1,"chr6",1,0.00304735114861697
"8053","chr6.26215000.26220000","chr6.26240000.26245000",25000,40,7.939078e-05,26215000,26240000,26220000,26245000,"chr6",253191,0,8,5,13,"chr6",1,0.0609470229723394
"8054","chr6.26120000.26125000","chr6.26155000.26160000",35000,81,2.569121e-37,26120000,26155000,26125000,26160000,"chr6",253208,0,3,4,7,"chr6",1,0.0664556962025316
"8055","chr6.149450000.149455000","chr6.149720000.149725000",270000,15,1.374525e-05,149450000,149720000,149455000,149725000,"chr6",253268,4,4,9,17,"chr6",1,0.029887482419128
"8056","chr6.150005000.150010000","chr6.150025000.150030000",20000,40,0.0007119341,150005000,150025000,150010000,150030000,"chr6",253304,1,1,1,3,"chr6",1,0.0140646976090014
"8057","chr6.53665000.53670000","chr6.53795000.53800000",130000,18,7.754492e-05,53665000,53795000,53670000,53800000,"chr6",253315,1,0,3,4,"chr6",1,0.00843881856540084
"8058","chr6.16330000.16335000","chr6.16370000.16375000",40000,29,0.0001935403,16330000,16370000,16335000,16375000,"chr6",253389,2,3,0,5,"chr6",1,0.01699484294421
"8059","chr6.31700000.31705000","chr6.31810000.31815000",110000,23,2.989375e-07,31700000,31810000,31705000,31815000,"chr6",253391,9,17,15,41,"chr6",1,0.110525082044069
"8060","chr6.108890000.108895000","chr6.108925000.108930000",35000,51,1.006605e-14,108890000,108925000,108895000,108930000,"chr6",253405,2,3,3,8,"chr6",1,0.0478199718706048
"8061","chr6.26040000.26045000","chr6.26125000.26130000",85000,17,0.006589942,26040000,26125000,26045000,26130000,"chr6",253446,2,14,8,24,"chr6",1,0.0478199718706048
"8062","chr6.137705000.137710000","chr6.137725000.137730000",20000,41,0.0003488147,137705000,137725000,137710000,137730000,"chr6",253583,0,0,1,1,"chr6",1,0.00480543834974215
"8063","chr6.53030000.53035000","chr6.53495000.53500000",465000,12,4.759576e-05,53030000,53495000,53035000,53500000,"chr6",253590,1,3,3,7,"chr6",1,0.00984528832630099
"8064","chr6.108860000.108865000","chr6.109395000.109400000",535000,31,8.93469e-27,108860000,109395000,108865000,109400000,"chr6",253619,4,18,16,38,"chr6",1,0.13806844819503
"8065","chr6.42745000.42750000","chr6.42840000.42845000",95000,30,3.157085e-11,42745000,42840000,42750000,42845000,"chr6",253623,0,4,5,9,"chr6",1,0.0316455696202532
"8066","chr6.34285000.34290000","chr6.34315000.34320000",30000,41,3.886085e-07,34285000,34315000,34290000,34320000,"chr6",253663,3,0,1,4,"chr6",1,0.0192217533989686
"8067","chr6.73305000.73310000","chr6.73325000.73330000",20000,38,0.002817976,73305000,73325000,73310000,73330000,"chr6",253730,5,33,27,65,"chr6",1,0.289498359118612
"8068","chr6.3285000.3290000","chr6.3330000.3335000",45000,23,0.008672865,3285000,3330000,3290000,3335000,"chr6",253744,0,3,0,3,"chr6",1,0.00808720112517581
"8069","chr6.26125000.26130000","chr6.26170000.26175000",45000,62,4.236827e-27,26125000,26170000,26130000,26175000,"chr6",253754,2,5,8,15,"chr6",1,0.109001406469761
"8070","chr6.128350000.128355000","chr6.128740000.128745000",390000,11,0.0007380716,128350000,128740000,128355000,128745000,"chr6",253801,0,0,4,4,"chr6",1,0.00515705578996718
"8071","chr6.34220000.34225000","chr6.34345000.34350000",125000,27,7.823684e-11,34220000,34345000,34225000,34350000,"chr6",253820,9,24,22,55,"chr6",1,0.174050632911392
"8072","chr6.35520000.35525000","chr6.35730000.35735000",210000,15,0.0001158305,35520000,35730000,35525000,35735000,"chr6",253821,5,10,9,24,"chr6",1,0.0421940928270042
"8073","chr6.3275000.3280000","chr6.3690000.3695000",415000,10,0.002498841,3275000,3690000,3280000,3695000,"chr6",253841,0,3,4,7,"chr6",1,0.00820440693858415
"8074","chr6.134300000.134305000","chr6.134370000.134375000",70000,33,8.28162e-11,134300000,134370000,134305000,134375000,"chr6",253858,6,12,11,29,"chr6",1,0.112165963431786
"8075","chr6.136760000.136765000","chr6.136840000.136845000",80000,24,4.199469e-06,136760000,136840000,136765000,136845000,"chr6",253911,3,5,3,11,"chr6",1,0.0309423347398031
"8076","chr6.56660000.56665000","chr6.56680000.56685000",20000,39,0.001426362,56660000,56680000,56665000,56685000,"chr6",253918,0,4,2,6,"chr6",1,0.0274261603375527
"8077","chr6.149430000.149435000","chr6.149755000.149760000",325000,21,1.554894e-11,149430000,149755000,149435000,149760000,"chr6",253922,2,13,5,20,"chr6",1,0.0492264416315049
"8078","chr6.13610000.13615000","chr6.13705000.13710000",95000,20,9.297491e-05,13610000,13705000,13615000,13710000,"chr6",253991,4,4,1,9,"chr6",1,0.0210970464135021
"8079","chr6.26040000.26045000","chr6.26100000.26105000",60000,23,0.0004898132,26040000,26100000,26045000,26105000,"chr6",254108,2,20,13,35,"chr6",1,0.0943506797937178
"8080","chr6.37690000.37695000","chr6.38555000.38560000",865000,8,0.001274837,37690000,38555000,37695000,38560000,"chr6",254160,0,1,1,2,"chr6",1,0.00187529301453352
"8081","chr6.34155000.34160000","chr6.34220000.34225000",65000,22,0.0005333286,34155000,34220000,34160000,34225000,"chr6",254177,10,28,24,62,"chr6",1,0.159868729488983
"8082","chr6.106895000.106900000","chr6.107025000.107030000",130000,16,0.0009696025,106895000,107025000,106900000,107030000,"chr6",254205,1,7,6,14,"chr6",1,0.0262541022034693
"8083","chr6.98495000.98500000","chr6.99390000.99395000",895000,10,1.810326e-05,98495000,99390000,98500000,99395000,"chr6",254308,0,4,2,6,"chr6",1,0.0070323488045007
"8084","chr6.2950000.2955000","chr6.3050000.3055000",100000,18,0.0006301579,2950000,3050000,2955000,3055000,"chr6",254310,2,9,8,19,"chr6",1,0.040084388185654
"8085","chr6.26185000.26190000","chr6.27130000.27135000",945000,7,0.00452827,26185000,27130000,26190000,27135000,"chr6",254311,1,6,5,12,"chr6",1,0.00984528832630099
"8086","chr6.28655000.28660000","chr6.28985000.28990000",330000,25,1.155161e-15,28655000,28985000,28660000,28990000,"chr6",254315,0,6,6,12,"chr6",1,0.0351617440225035
"8087","chr6.34285000.34290000","chr6.34345000.34350000",60000,29,4.891734e-07,34285000,34345000,34290000,34350000,"chr6",254349,4,6,1,11,"chr6",1,0.0373886544772621
"8088","chr6.158650000.158655000","chr6.159070000.159075000",420000,10,0.002341791,158650000,159070000,158655000,159075000,"chr6",254358,1,7,10,18,"chr6",1,0.0210970464135021
"8089","chr6.157030000.157035000","chr6.157460000.157465000",430000,10,0.002057231,157030000,157460000,157035000,157465000,"chr6",254371,0,3,1,4,"chr6",1,0.0046882325363338
"8090","chr6.37725000.37730000","chr6.38645000.38650000",920000,8,0.0008565646,37725000,38645000,37730000,38650000,"chr6",254374,3,4,2,9,"chr6",1,0.00843881856540084
"8091","chr6.37705000.37710000","chr6.37965000.37970000",260000,11,0.006289337,37705000,37965000,37710000,37970000,"chr6",254379,4,2,6,12,"chr6",1,0.0154711673699015
"8092","chr6.17155000.17160000","chr6.17580000.17585000",425000,44,8.151585e-42,17155000,17580000,17160000,17585000,"chr6",254518,0,0,3,3,"chr6",1,0.0154711673699015
"8093","chr6.2900000.2905000","chr6.3060000.3065000",160000,15,0.0008765327,2900000,3060000,2905000,3065000,"chr6",254533,0,1,2,3,"chr6",1,0.00527426160337553
"8094","chr6.134620000.134625000","chr6.135050000.135055000",430000,14,2.077534e-06,134620000,135050000,134625000,135055000,"chr6",254537,1,3,1,5,"chr6",1,0.00820440693858415
"8095","chr6.42545000.42550000","chr6.42815000.42820000",270000,13,0.0003197647,42545000,42815000,42550000,42820000,"chr6",254564,4,9,9,22,"chr6",1,0.0335208626347867
"8096","chr6.2790000.2795000","chr6.2930000.2935000",140000,15,0.002020592,2790000,2930000,2795000,2935000,"chr6",254567,0,2,2,4,"chr6",1,0.0070323488045007
"8097","chr6.16335000.16340000","chr6.16620000.16625000",285000,12,0.0009644138,16335000,16620000,16340000,16625000,"chr6",254581,0,5,4,9,"chr6",1,0.0126582278481013
"8098","chr6.11125000.11130000","chr6.11495000.11500000",370000,19,2.846577e-10,11125000,11495000,11130000,11500000,"chr6",254608,0,0,4,4,"chr6",1,0.00890764181903422
"8099","chr6.30875000.30880000","chr6.31035000.31040000",160000,16,0.0002430781,30875000,31035000,30880000,31040000,"chr6",254660,0,7,2,9,"chr6",1,0.0168776371308017
"8100","chr6.34220000.34225000","chr6.34370000.34375000",150000,48,1.245493e-32,34220000,34370000,34225000,34375000,"chr6",254681,2,9,14,25,"chr6",1,0.140646976090014
"8101","chr6.108890000.108895000","chr6.109000000.109005000",110000,19,8.052119e-05,108890000,1.09e+08,108895000,109005000,"chr6",254707,0,3,3,6,"chr6",1,0.0133614627285513
"8102","chr6.13005000.13010000","chr6.13055000.13060000",50000,31,8.594862e-07,13005000,13055000,13010000,13060000,"chr6",254743,1,0,0,1,"chr6",1,0.0036333802156587
"8103","chr6.15395000.15400000","chr6.15440000.15445000",45000,39,1.876773e-10,15395000,15440000,15400000,15445000,"chr6",254776,0,5,7,12,"chr6",1,0.0548523206751055
"8104","chr6.131205000.131210000","chr6.131460000.131465000",255000,22,4.73377e-11,131205000,131460000,131210000,131465000,"chr6",254777,0,1,3,4,"chr6",1,0.0103141115799344
"8105","chr6.13350000.13355000","chr6.13455000.13460000",105000,21,8.960961e-06,13350000,13455000,13355000,13460000,"chr6",254785,2,5,7,14,"chr6",1,0.0344585091420534
"8106","chr6.128530000.128535000","chr6.128550000.128555000",20000,55,1.001438e-09,128530000,128550000,128535000,128555000,"chr6",254836,0,4,4,8,"chr6",1,0.0515705578996718
"8107","chr6.16620000.16625000","chr6.16720000.16725000",100000,16,0.005454981,16620000,16720000,16625000,16725000,"chr6",254863,0,1,1,2,"chr6",1,0.00375058602906704
"8108","chr6.8060000.8065000","chr6.8105000.8110000",45000,23,0.008672865,8060000,8105000,8065000,8110000,"chr6",254866,0,3,0,3,"chr6",1,0.00808720112517581
"8109","chr6.2990000.2995000","chr6.3120000.3125000",130000,14,0.008995566,2990000,3120000,2995000,3125000,"chr6",254887,1,7,6,14,"chr6",1,0.0229723394280356
"8110","chr6.26535000.26540000","chr6.26570000.26575000",35000,47,2.865419e-12,26535000,26570000,26540000,26575000,"chr6",254917,0,5,10,15,"chr6",1,0.0826300984528833
"8111","chr6.10745000.10750000","chr6.11095000.11100000",350000,13,5.551494e-05,10745000,11095000,10750000,11100000,"chr6",254948,1,2,2,5,"chr6",1,0.00761837787154243
"8112","chr6.26340000.26345000","chr6.26550000.26555000",210000,12,0.006222837,26340000,26550000,26345000,26555000,"chr6",254966,0,1,6,7,"chr6",1,0.00984528832630099
"8113","chr6.34220000.34225000","chr6.34365000.34370000",145000,14,0.005181923,34220000,34365000,34225000,34370000,"chr6",254974,10,24,26,60,"chr6",1,0.0984528832630098
"8114","chr6.15595000.15600000","chr6.16180000.16185000",585000,8,0.009047489,15595000,16180000,15600000,16185000,"chr6",254987,0,2,0,2,"chr6",1,0.00187529301453352
"8115","chr6.15690000.15695000","chr6.16250000.16255000",560000,9,0.002477219,15690000,16250000,15695000,16255000,"chr6",255002,0,6,8,14,"chr6",1,0.0147679324894515
"8116","chr6.26435000.26440000","chr6.26470000.26475000",35000,32,0.0001004907,26435000,26470000,26440000,26475000,"chr6",255008,2,8,5,15,"chr6",1,0.0562587904360056
"8117","chr6.5155000.5160000","chr6.5205000.5210000",50000,31,8.594862e-07,5155000,5205000,5160000,5210000,"chr6",255016,0,2,1,3,"chr6",1,0.0109001406469761
"8118","chr6.16330000.16335000","chr6.16725000.16730000",395000,11,0.0006945079,16330000,16725000,16335000,16730000,"chr6",255026,0,5,0,5,"chr6",1,0.00644631973745898
"8119","chr6.149405000.149410000","chr6.149830000.149835000",425000,11,0.000468814,149405000,149830000,149410000,149835000,"chr6",255040,0,3,2,5,"chr6",1,0.00644631973745898
"8120","chr6.37685000.37690000","chr6.38435000.38440000",750000,10,6.901475e-05,37685000,38435000,37690000,38440000,"chr6",255045,4,9,7,20,"chr6",1,0.023441162681669
"8121","chr6.32865000.32870000","chr6.32965000.32970000",100000,20,5.591745e-05,32865000,32965000,32870000,32970000,"chr6",255100,0,2,0,2,"chr6",1,0.0046882325363338
"8122","chr6.16555000.16560000","chr6.16720000.16725000",165000,14,0.002498518,16555000,16720000,16560000,16725000,"chr6",255109,1,1,1,3,"chr6",1,0.00492264416315049
"8123","chr6.2990000.2995000","chr6.3245000.3250000",255000,12,0.00191407,2990000,3245000,2995000,3250000,"chr6",255132,3,7,6,16,"chr6",1,0.0225035161744023
"8124","chr6.2995000.3000000","chr6.3060000.3065000",65000,27,1.677032e-06,2995000,3060000,3e+06,3065000,"chr6",255137,0,4,8,12,"chr6",1,0.0379746835443038
"8125","chr6.46075000.46080000","chr6.46650000.46655000",575000,8,0.009721644,46075000,46650000,46080000,46655000,"chr6",255154,2,0,0,2,"chr6",1,0.00187529301453352
"8126","chr6.17815000.17820000","chr6.18095000.18100000",280000,12,0.00107979,17815000,18095000,17820000,18100000,"chr6",255169,3,8,9,20,"chr6",1,0.0281293952180028
"8127","chr6.53355000.53360000","chr6.53585000.53590000",230000,14,0.000241863,53355000,53585000,53360000,53590000,"chr6",255193,5,10,10,25,"chr6",1,0.0410220346929208
"8128","chr6.17880000.17885000","chr6.17945000.17950000",65000,22,0.0005333286,17880000,17945000,17885000,17950000,"chr6",255197,1,15,5,21,"chr6",1,0.0541490857946554
"8129","chr6.136750000.136755000","chr6.136840000.136845000",90000,17,0.004284741,136750000,136840000,136755000,136845000,"chr6",255224,3,5,4,12,"chr6",1,0.0239099859353024
"8130","chr6.110980000.110985000","chr6.111030000.111035000",50000,22,0.007734444,110980000,111030000,110985000,111035000,"chr6",255255,6,9,8,23,"chr6",1,0.0593061415846226
"8131","chr6.111210000.111215000","chr6.111255000.111260000",45000,31,4.326025e-06,111210000,111255000,111215000,111260000,"chr6",255302,2,2,4,8,"chr6",1,0.0290670417252696
"8132","chr6.20290000.20295000","chr6.20530000.20535000",240000,43,3.774847e-33,20290000,20530000,20295000,20535000,"chr6",255305,2,5,1,8,"chr6",1,0.0403187998124707
"8133","chr6.16595000.16600000","chr6.16620000.16625000",25000,38,0.000389857,16595000,16620000,16600000,16625000,"chr6",255314,0,6,4,10,"chr6",1,0.0445382090951711
"8134","chr6.134515000.134520000","chr6.135035000.135040000",520000,9,0.003554338,134515000,135035000,134520000,135040000,"chr6",255334,0,2,2,4,"chr6",1,0.00421940928270042
"8135","chr6.151025000.151030000","chr6.151100000.151105000",75000,19,0.002672369,151025000,151100000,151030000,151105000,"chr6",255368,3,9,14,26,"chr6",1,0.0578996718237225
"8136","chr6.26310000.26315000","chr6.26530000.26535000",220000,23,5.353704e-11,26310000,26530000,26315000,26535000,"chr6",255380,3,5,7,15,"chr6",1,0.040436005625879
"8137","chr6.118260000.118265000","chr6.118550000.118555000",290000,12,0.0008640958,118260000,118550000,118265000,118555000,"chr6",255383,3,9,2,14,"chr6",1,0.019690576652602
"8138","chr6.16510000.16515000","chr6.17080000.17085000",570000,16,1.904925e-09,16510000,17080000,16515000,17085000,"chr6",255395,3,5,4,12,"chr6",1,0.0225035161744023
"8139","chr6.13395000.13400000","chr6.13550000.13555000",155000,22,3.585763e-08,13395000,13550000,13400000,13555000,"chr6",255425,1,6,6,13,"chr6",1,0.0335208626347867
"8140","chr6.36385000.36390000","chr6.36840000.36845000",455000,17,2.481089e-09,36385000,36840000,36390000,36845000,"chr6",255448,0,5,1,6,"chr6",1,0.0119549929676512
"8141","chr6.17580000.17585000","chr6.17705000.17710000",125000,19,2.725089e-05,17580000,17705000,17585000,17710000,"chr6",255513,0,0,3,3,"chr6",1,0.00668073136427567
"8142","chr6.4055000.4060000","chr6.4155000.4160000",100000,18,0.0006301579,4055000,4155000,4060000,4160000,"chr6",255546,0,0,3,3,"chr6",1,0.00632911392405063
"8143","chr6.30880000.30885000","chr6.31035000.31040000",155000,39,2.249417e-23,30880000,31035000,30885000,31040000,"chr6",255571,0,0,1,1,"chr6",1,0.00457102672292546
"8144","chr6.38030000.38035000","chr6.38225000.38230000",195000,12,0.009418563,38030000,38225000,38035000,38230000,"chr6",255592,2,7,5,14,"chr6",1,0.019690576652602
"8145","chr6.17865000.17870000","chr6.17885000.17890000",20000,62,3.459867e-13,17865000,17885000,17870000,17890000,"chr6",255597,1,1,1,3,"chr6",1,0.0218002812939522
"8146","chr6.158245000.158250000","chr6.158320000.158325000",75000,26,7.07871e-07,158245000,158320000,158250000,158325000,"chr6",255650,0,3,0,3,"chr6",1,0.00914205344585091
"8147","chr6.27125000.27130000","chr6.27830000.27835000",705000,12,1.766147e-06,27125000,27830000,27130000,27835000,"chr6",255670,2,5,7,14,"chr6",1,0.019690576652602
"8148","chr6.53030000.53035000","chr6.53585000.53590000",555000,10,0.000494912,53030000,53585000,53035000,53590000,"chr6",255709,1,5,4,10,"chr6",1,0.0117205813408345
"8149","chr6.146215000.146220000","chr6.147110000.147115000",895000,7,0.006128106,146215000,147110000,146220000,147115000,"chr6",255781,0,2,4,6,"chr6",1,0.00492264416315049
"8150","chr6.26320000.26325000","chr6.26570000.26575000",250000,30,8.737287e-19,26320000,26570000,26325000,26575000,"chr6",255801,4,12,12,28,"chr6",1,0.0984528832630098
"8151","chr6.12955000.12960000","chr6.13325000.13330000",370000,14,6.559432e-06,12955000,13325000,12960000,13330000,"chr6",255803,0,3,2,5,"chr6",1,0.00820440693858415
"8152","chr6.118965000.118970000","chr6.119095000.119100000",130000,21,1.061453e-06,118965000,119095000,118970000,119100000,"chr6",255812,2,3,3,8,"chr6",1,0.019690576652602
"8153","chr6.39650000.39655000","chr6.39685000.39690000",35000,39,6.843329e-08,39650000,39685000,39655000,39690000,"chr6",255875,0,4,2,6,"chr6",1,0.0274261603375527
"8154","chr6.157940000.157945000","chr6.158000000.158005000",60000,27,5.880073e-06,157940000,1.58e+08,157945000,158005000,"chr6",255919,0,1,1,2,"chr6",1,0.00632911392405063
"8155","chr6.38030000.38035000","chr6.38555000.38560000",525000,9,0.003382287,38030000,38555000,38035000,38560000,"chr6",256010,1,5,1,7,"chr6",1,0.00738396624472574
"8156","chr6.24875000.24880000","chr6.24905000.24910000",30000,31,0.002960758,24875000,24905000,24880000,24910000,"chr6",256021,2,4,1,7,"chr6",1,0.0254336615096109
"8157","chr6.37965000.37970000","chr6.38345000.38350000",380000,10,0.003746171,37965000,38345000,37970000,38350000,"chr6",256050,2,2,4,8,"chr6",1,0.00937646507266761
"8158","chr6.34155000.34160000","chr6.34380000.34385000",225000,36,3.377679e-24,34155000,34380000,34160000,34385000,"chr6",256075,10,14,23,47,"chr6",1,0.19831223628692
"8159","chr6.150815000.150820000","chr6.151025000.151030000",210000,14,0.0004857598,150815000,151025000,150820000,151030000,"chr6",256091,2,9,1,12,"chr6",1,0.019690576652602
"8160","chr6.151010000.151015000","chr6.151135000.151140000",125000,17,0.0003746708,151010000,151135000,151015000,151140000,"chr6",256126,2,11,12,25,"chr6",1,0.0498124706985466
"8161","chr6.14800000.14805000","chr6.15490000.15495000",690000,8,0.004138798,14800000,15490000,14805000,15495000,"chr6",256173,0,0,3,3,"chr6",1,0.00281293952180028
"8162","chr6.16330000.16335000","chr6.16550000.16555000",220000,19,1.096389e-07,16330000,16550000,16335000,16555000,"chr6",256190,1,9,12,22,"chr6",1,0.0489920300046882
"8163","chr6.144610000.144615000","chr6.144630000.144635000",20000,55,1.001438e-09,144610000,144630000,144615000,144635000,"chr6",256226,0,3,3,6,"chr6",1,0.0386779184247539
"8164","chr6.134235000.134240000","chr6.135200000.135205000",965000,8,0.0006126246,134235000,135200000,134240000,135205000,"chr6",256228,2,4,6,12,"chr6",1,0.0112517580872011
"8165","chr6.26155000.26160000","chr6.26200000.26205000",45000,39,1.876773e-10,26155000,26200000,26160000,26205000,"chr6",256255,1,5,2,8,"chr6",1,0.0365682137834037
"8166","chr6.31065000.31070000","chr6.31155000.31160000",90000,17,0.004284741,31065000,31155000,31070000,31160000,"chr6",256264,2,3,12,17,"chr6",1,0.0338724800750117
"8167","chr6.17985000.17990000","chr6.18150000.18155000",165000,29,2.848233e-14,17985000,18150000,17990000,18155000,"chr6",256290,3,4,2,9,"chr6",1,0.0305907172995781
"8168","chr6.26360000.26365000","chr6.26400000.26405000",40000,39,2.758383e-09,26360000,26400000,26365000,26405000,"chr6",256306,4,3,10,17,"chr6",1,0.0777074542897328
"8169","chr6.157895000.157900000","chr6.158005000.158010000",110000,21,5.563589e-06,157895000,158005000,157900000,158010000,"chr6",256329,0,2,10,12,"chr6",1,0.029535864978903
"8170","chr6.7725000.7730000","chr6.7990000.7995000",265000,11,0.005701523,7725000,7990000,7730000,7995000,"chr6",256345,1,5,3,9,"chr6",1,0.0116033755274262
"8171","chr6.35600000.35605000","chr6.35690000.35695000",90000,19,0.000515061,35600000,35690000,35605000,35695000,"chr6",256379,6,6,11,23,"chr6",1,0.0512189404594468
"8172","chr6.111205000.111210000","chr6.111260000.111265000",55000,30,6.111367e-07,111205000,111260000,111210000,111265000,"chr6",256414,4,8,8,20,"chr6",1,0.070323488045007
"8173","chr6.157830000.157835000","chr6.158000000.158005000",170000,15,0.0005825807,157830000,1.58e+08,157835000,158005000,"chr6",256441,0,1,2,3,"chr6",1,0.00527426160337553
"8174","chr6.111680000.111685000","chr6.111800000.111805000",120000,16,0.001601229,111680000,111800000,111685000,111805000,"chr6",256471,2,2,1,5,"chr6",1,0.00937646507266761
"8175","chr6.15265000.15270000","chr6.15310000.15315000",45000,24,0.003929417,15265000,15310000,15270000,15315000,"chr6",256563,0,3,1,4,"chr6",1,0.0112517580872011
"8176","chr6.31700000.31705000","chr6.31790000.31795000",90000,18,0.001524141,31700000,31790000,31705000,31795000,"chr6",256582,4,17,15,36,"chr6",1,0.0759493670886076
"8177","chr6.46200000.46205000","chr6.46375000.46380000",175000,22,8.425481e-09,46200000,46375000,46205000,46380000,"chr6",256593,2,2,5,9,"chr6",1,0.0232067510548523
"8178","chr6.53015000.53020000","chr6.53345000.53350000",330000,14,1.488791e-05,53015000,53345000,53020000,53350000,"chr6",256607,1,0,1,2,"chr6",1,0.00328176277543366
"8179","chr6.90035000.90040000","chr6.90360000.90365000",325000,11,0.001903583,90035000,90360000,90040000,90365000,"chr6",256609,0,2,2,4,"chr6",1,0.00515705578996718
"8180","chr6.27125000.27130000","chr6.27770000.27775000",645000,17,3.740908e-11,27125000,27770000,27130000,27775000,"chr6",256646,2,5,7,14,"chr6",1,0.0278949835911861
"8181","chr6.16370000.16375000","chr6.16965000.16970000",595000,8,0.008345777,16370000,16965000,16375000,16970000,"chr6",256659,2,3,0,5,"chr6",1,0.0046882325363338
"8182","chr6.136760000.136765000","chr6.136835000.136840000",75000,24,9.624623e-06,136760000,136835000,136765000,136840000,"chr6",256679,3,6,3,12,"chr6",1,0.0337552742616034
"8183","chr6.136945000.136950000","chr6.137120000.137125000",175000,16,0.0001220207,136945000,137120000,136950000,137125000,"chr6",256702,3,3,3,9,"chr6",1,0.0168776371308017
"8184","chr6.151335000.151340000","chr6.151760000.151765000",425000,9,0.009059499,151335000,151760000,151340000,151765000,"chr6",256727,0,3,2,5,"chr6",1,0.00527426160337553
"8185","chr6.31650000.31655000","chr6.31810000.31815000",160000,17,6.204979e-05,31650000,31810000,31655000,31815000,"chr6",256747,8,18,25,51,"chr6",1,0.101617440225035
"8186","chr6.43625000.43630000","chr6.44055000.44060000",430000,9,0.008670633,43625000,44055000,43630000,44060000,"chr6",256776,0,3,1,4,"chr6",1,0.00421940928270042
"8187","chr6.27145000.27150000","chr6.27440000.27445000",295000,18,2.508282e-08,27145000,27440000,27150000,27445000,"chr6",256780,0,7,3,10,"chr6",1,0.0210970464135021
"8188","chr6.149010000.149015000","chr6.149755000.149760000",745000,8,0.00286202,149010000,149755000,149015000,149760000,"chr6",256791,2,8,5,15,"chr6",1,0.0140646976090014
"8189","chr6.111730000.111735000","chr6.111795000.111800000",65000,28,4.582543e-07,111730000,111795000,111735000,111800000,"chr6",256840,0,2,2,4,"chr6",1,0.0131270511017346
"8190","chr6.41600000.41605000","chr6.41630000.41635000",30000,34,0.0002859613,41600000,41630000,41605000,41635000,"chr6",256843,0,2,3,5,"chr6",1,0.0199249882794187
"8191","chr6.13905000.13910000","chr6.14125000.14130000",220000,17,3.371631e-06,13905000,14125000,13910000,14130000,"chr6",256847,0,2,0,2,"chr6",1,0.00398499765588373
"8192","chr6.13355000.13360000","chr6.13535000.13540000",180000,16,9.715038e-05,13355000,13535000,13360000,13540000,"chr6",256890,1,2,0,3,"chr6",1,0.00562587904360056
"8193","chr6.157105000.157110000","chr6.157210000.157215000",105000,16,0.003896423,157105000,157210000,157110000,157215000,"chr6",256950,0,1,1,2,"chr6",1,0.00375058602906704
"8194","chr6.35520000.35525000","chr6.35720000.35725000",200000,15,0.0001728745,35520000,35720000,35525000,35725000,"chr6",256955,2,7,8,17,"chr6",1,0.029887482419128
"8195","chr6.3740000.3745000","chr6.3995000.4000000",255000,17,7.51314e-07,3740000,3995000,3745000,4e+06,"chr6",257003,1,3,1,5,"chr6",1,0.00996249413970933
"8196","chr6.109995000.110000000","chr6.110320000.110325000",325000,10,0.007483355,109995000,110320000,1.1e+08,110325000,"chr6",257030,0,2,0,2,"chr6",1,0.0023441162681669
"8197","chr6.36855000.36860000","chr6.36955000.36960000",100000,37,2.399429e-17,36855000,36955000,36860000,36960000,"chr6",257054,2,1,2,5,"chr6",1,0.0216830754805438
"8198","chr6.157435000.157440000","chr6.157455000.157460000",20000,40,0.0007119341,157435000,157455000,157440000,157460000,"chr6",257094,2,2,4,8,"chr6",1,0.0375058602906704
"8199","chr6.26170000.26175000","chr6.26270000.26275000",100000,17,0.001910446,26170000,26270000,26175000,26275000,"chr6",257145,0,2,0,2,"chr6",1,0.00398499765588373
"8200","chr6.131195000.131200000","chr6.131440000.131445000",245000,21,6.448333e-10,131195000,131440000,131200000,131445000,"chr6",257188,1,2,0,3,"chr6",1,0.00738396624472574
"8201","chr6.26065000.26070000","chr6.26155000.26160000",90000,22,1.343839e-05,26065000,26155000,26070000,26160000,"chr6",257195,2,4,6,12,"chr6",1,0.0309423347398031
"8202","chr6.134500000.134505000","chr6.134820000.134825000",320000,13,9.933344e-05,134500000,134820000,134505000,134825000,"chr6",257241,0,2,0,2,"chr6",1,0.00304735114861697
"8203","chr6.52360000.52365000","chr6.52420000.52425000",60000,20,0.007808024,52360000,52420000,52365000,52425000,"chr6",257255,2,0,1,3,"chr6",1,0.0070323488045007
"8204","chr6.11140000.11145000","chr6.11160000.11165000",20000,51,6.10445e-08,11140000,11160000,11145000,11165000,"chr6",257299,0,8,5,13,"chr6",1,0.0777074542897328
"8205","chr6.23025000.23030000","chr6.23655000.23660000",630000,9,0.001300213,23025000,23655000,23030000,23660000,"chr6",257319,1,7,10,18,"chr6",1,0.0189873417721519
"8206","chr6.26305000.26310000","chr6.26530000.26535000",225000,14,0.0002859613,26305000,26530000,26310000,26535000,"chr6",257325,6,5,8,19,"chr6",1,0.0311767463666198
"8207","chr6.11090000.11095000","chr6.11495000.11500000",405000,17,8.268055e-09,11090000,11495000,11095000,11500000,"chr6",257334,0,0,4,4,"chr6",1,0.00796999531176746
"8208","chr6.12955000.12960000","chr6.13005000.13010000",50000,40,4.395622e-12,12955000,13005000,12960000,13010000,"chr6",257351,3,0,0,3,"chr6",1,0.0140646976090014
"8209","chr6.134620000.134625000","chr6.135140000.135145000",520000,12,2.091485e-05,134620000,135140000,134625000,135145000,"chr6",257384,1,4,4,9,"chr6",1,0.0126582278481013
"8210","chr6.37690000.37695000","chr6.38120000.38125000",430000,12,7.981093e-05,37690000,38120000,37695000,38125000,"chr6",257389,0,1,1,2,"chr6",1,0.00281293952180028
"8211","chr6.3120000.3125000","chr6.3230000.3235000",110000,21,5.563589e-06,3120000,3230000,3125000,3235000,"chr6",257420,0,2,0,2,"chr6",1,0.00492264416315049
"8212","chr6.37685000.37690000","chr6.38555000.38560000",870000,9,0.0001790819,37685000,38555000,37690000,38560000,"chr6",257429,1,5,1,7,"chr6",1,0.00738396624472574
"8213","chr6.38145000.38150000","chr6.38220000.38225000",75000,19,0.002672369,38145000,38220000,38150000,38225000,"chr6",257449,4,6,3,13,"chr6",1,0.0289498359118612
"8214","chr6.26420000.26425000","chr6.26550000.26555000",130000,17,0.0002859613,26420000,26550000,26425000,26555000,"chr6",257456,0,1,2,3,"chr6",1,0.0059774964838256
"8215","chr6.13380000.13385000","chr6.13445000.13450000",65000,19,0.009047489,13380000,13445000,13385000,13450000,"chr6",257471,0,1,2,3,"chr6",1,0.00668073136427567
"8216","chr6.3115000.3120000","chr6.3235000.3240000",120000,17,0.0004985722,3115000,3235000,3120000,3240000,"chr6",257515,2,7,6,15,"chr6",1,0.029887482419128
"8217","chr6.3120000.3125000","chr6.3235000.3240000",115000,15,0.006219749,3120000,3235000,3125000,3240000,"chr6",257551,1,12,12,25,"chr6",1,0.0439521800281294
"8218","chr6.31825000.31830000","chr6.32145000.32150000",320000,10,0.007951428,31825000,32145000,31830000,32150000,"chr6",257564,3,11,6,20,"chr6",1,0.023441162681669
"8219","chr6.124975000.124980000","chr6.125020000.125025000",45000,23,0.008672865,124975000,125020000,124980000,125025000,"chr6",257571,5,11,10,26,"chr6",1,0.0700890764181903
"8220","chr6.26535000.26540000","chr6.26550000.26555000",15000,71,3.184826e-18,26535000,26550000,26540000,26555000,"chr6",257579,0,1,9,10,"chr6",1,0.083216127519925
"8221","chr6.3155000.3160000","chr6.3175000.3180000",20000,62,3.459867e-13,3155000,3175000,3160000,3180000,"chr6",257622,0,0,2,2,"chr6",1,0.0145335208626348
"8222","chr6.149410000.149415000","chr6.149755000.149760000",345000,16,2.694211e-07,149410000,149755000,149415000,149760000,"chr6",257644,2,17,12,31,"chr6",1,0.0581340834505391
"8223","chr6.158700000.158705000","chr6.158835000.158840000",135000,16,0.0007626282,158700000,158835000,158705000,158840000,"chr6",257647,2,15,14,31,"chr6",1,0.0581340834505391
"8224","chr6.110040000.110045000","chr6.110295000.110300000",255000,15,2.231505e-05,110040000,110295000,110045000,110300000,"chr6",257654,0,8,3,11,"chr6",1,0.0193389592123769
"8225","chr6.26020000.26025000","chr6.26155000.26160000",135000,16,0.0007626282,26020000,26155000,26025000,26160000,"chr6",257731,2,5,7,14,"chr6",1,0.0262541022034693
"8226","chr6.23025000.23030000","chr6.23275000.23280000",250000,13,0.0005511993,23025000,23275000,23030000,23280000,"chr6",257745,0,3,1,4,"chr6",1,0.00609470229723394
"8227","chr6.18120000.18125000","chr6.18265000.18270000",145000,15,0.001633642,18120000,18265000,18125000,18270000,"chr6",257755,4,3,1,8,"chr6",1,0.0140646976090014
"8228","chr6.26310000.26315000","chr6.26535000.26540000",225000,23,3.867266e-11,26310000,26535000,26315000,26540000,"chr6",257781,0,5,7,12,"chr6",1,0.0323488045007032
"8229","chr6.26180000.26185000","chr6.26200000.26205000",20000,42,0.0001659547,26180000,26200000,26185000,26205000,"chr6",257839,1,6,2,9,"chr6",1,0.0443037974683544
"8230","chr6.26285000.26290000","chr6.26535000.26540000",250000,12,0.002184215,26285000,26535000,26290000,26540000,"chr6",257861,0,4,5,9,"chr6",1,0.0126582278481013
"8231","chr6.29720000.29725000","chr6.29940000.29945000",220000,15,7.877136e-05,29720000,29940000,29725000,29945000,"chr6",257945,0,0,4,4,"chr6",1,0.0070323488045007
"8232","chr6.136580000.136585000","chr6.136840000.136845000",260000,13,0.0004195353,136580000,136840000,136585000,136845000,"chr6",257973,3,5,6,14,"chr6",1,0.0213314580403188
"8233","chr6.26065000.26070000","chr6.26170000.26175000",105000,16,0.003896423,26065000,26170000,26070000,26175000,"chr6",257979,2,4,6,12,"chr6",1,0.0225035161744023
"8234","chr6.15260000.15265000","chr6.15395000.15400000",135000,17,0.0002187489,15260000,15395000,15265000,15400000,"chr6",258013,3,12,12,27,"chr6",1,0.0537974683544304
"8235","chr6.30595000.30600000","chr6.30690000.30695000",95000,17,0.002870974,30595000,30690000,30600000,30695000,"chr6",258089,6,24,23,53,"chr6",1,0.105602437880919
"8236","chr6.157875000.157880000","chr6.158005000.158010000",130000,14,0.008995566,157875000,158005000,157880000,158010000,"chr6",258102,3,11,4,18,"chr6",1,0.029535864978903
"8237","chr6.26570000.26575000","chr6.27125000.27130000",555000,18,2.22821e-11,26570000,27125000,26575000,27130000,"chr6",258122,2,5,7,14,"chr6",1,0.029535864978903
"8238","chr6.11095000.11100000","chr6.11120000.11125000",25000,38,0.000389857,11095000,11120000,11100000,11125000,"chr6",258173,1,3,6,10,"chr6",1,0.0445382090951711
"8239","chr6.26030000.26035000","chr6.26195000.26200000",165000,14,0.002498518,26030000,26195000,26035000,26200000,"chr6",258181,3,5,3,11,"chr6",1,0.0180496952648851
"8240","chr6.16335000.16340000","chr6.16510000.16515000",175000,18,6.491672e-06,16335000,16510000,16340000,16515000,"chr6",258191,0,5,4,9,"chr6",1,0.0189873417721519
"8241","chr6.6700000.6705000","chr6.7240000.7245000",540000,9,0.002960758,6700000,7240000,6705000,7245000,"chr6",258193,4,2,6,12,"chr6",1,0.0126582278481013
"8242","chr6.46490000.46495000","chr6.46510000.46515000",20000,37,0.005260689,46490000,46510000,46495000,46515000,"chr6",258206,1,3,2,6,"chr6",1,0.0260196905766526
"8243","chr6.37725000.37730000","chr6.38435000.38440000",710000,10,0.0001000098,37725000,38435000,37730000,38440000,"chr6",258245,4,4,9,17,"chr6",1,0.0199249882794187
"8244","chr6.17830000.17835000","chr6.17985000.17990000",155000,30,1.032006e-14,17830000,17985000,17835000,17990000,"chr6",258286,2,4,2,8,"chr6",1,0.0281293952180028
"8245","chr6.158655000.158660000","chr6.158835000.158840000",180000,16,9.715038e-05,158655000,158835000,158660000,158840000,"chr6",258317,1,9,12,22,"chr6",1,0.0412564463197375
"8246","chr6.15690000.15695000","chr6.16155000.16160000",465000,18,2.003707e-10,15690000,16155000,15695000,16160000,"chr6",258319,0,6,6,12,"chr6",1,0.0253164556962025
"8247","chr6.26170000.26175000","chr6.26195000.26200000",25000,43,6.006953e-06,26170000,26195000,26175000,26200000,"chr6",258321,2,5,11,18,"chr6",1,0.0907172995780591
"8248","chr6.43630000.43635000","chr6.44055000.44060000",425000,13,1.479594e-05,43630000,44055000,43635000,44060000,"chr6",258336,0,3,1,4,"chr6",1,0.00609470229723394
"8249","chr6.26065000.26070000","chr6.26125000.26130000",60000,21,0.003287302,26065000,26125000,26070000,26130000,"chr6",258389,2,4,6,12,"chr6",1,0.029535864978903
"8250","chr6.3845000.3850000","chr6.3975000.3980000",130000,17,0.0002859613,3845000,3975000,3850000,3980000,"chr6",258394,0,1,0,1,"chr6",1,0.00199249882794187
"8251","chr6.134515000.134520000","chr6.135140000.135145000",625000,13,5.991228e-07,134515000,135140000,134520000,135145000,"chr6",258396,0,2,2,4,"chr6",1,0.00609470229723394
"8252","chr6.142495000.142500000","chr6.142675000.142680000",180000,13,0.004759726,142495000,142675000,142500000,142680000,"chr6",258407,2,6,7,15,"chr6",1,0.0228551336146273
"8253","chr6.166705000.166710000","chr6.166795000.166800000",90000,17,0.004284741,166705000,166795000,166710000,166800000,"chr6",258425,0,4,1,5,"chr6",1,0.00996249413970933
"8254","chr6.134265000.134270000","chr6.134415000.134420000",150000,20,1.289905e-06,134265000,134415000,134270000,134420000,"chr6",258451,5,10,13,28,"chr6",1,0.0656352555086732
"8255","chr6.26320000.26325000","chr6.26550000.26555000",230000,27,5.226946e-15,26320000,26550000,26325000,26555000,"chr6",258453,0,1,9,10,"chr6",1,0.0316455696202532
"8256","chr6.26380000.26385000","chr6.26530000.26535000",150000,28,9.649425e-13,26380000,26530000,26385000,26535000,"chr6",258478,1,5,5,11,"chr6",1,0.0360993905297703
"8257","chr6.154730000.154735000","chr6.154805000.154810000",75000,33,2.023245e-11,154730000,154805000,154735000,154810000,"chr6",258492,0,6,4,10,"chr6",1,0.0386779184247539
"8258","chr6.112050000.112055000","chr6.112295000.112300000",245000,13,0.0006330558,112050000,112295000,112055000,112300000,"chr6",258495,2,11,8,21,"chr6",1,0.0319971870604782
"8259","chr6.108860000.108865000","chr6.109400000.109405000",540000,18,3.168918e-11,108860000,109400000,108865000,109405000,"chr6",258521,4,18,16,38,"chr6",1,0.080168776371308
"8260","chr6.37820000.37825000","chr6.38490000.38495000",670000,9,0.0009022344,37820000,38490000,37825000,38495000,"chr6",258524,0,2,0,2,"chr6",1,0.00210970464135021
"8261","chr6.17880000.17885000","chr6.17905000.17910000",25000,43,6.006953e-06,17880000,17905000,17885000,17910000,"chr6",258530,5,12,8,25,"chr6",1,0.125996249413971
"8262","chr6.3155000.3160000","chr6.3245000.3250000",90000,21,4.777466e-05,3155000,3245000,3160000,3250000,"chr6",258549,0,0,2,2,"chr6",1,0.00492264416315049
"8263","chr6.108860000.108865000","chr6.108925000.108930000",65000,19,0.009047489,108860000,108925000,108865000,108930000,"chr6",258554,3,3,3,9,"chr6",1,0.020042194092827
"8264","chr6.26125000.26130000","chr6.26570000.26575000",445000,14,1.569216e-06,26125000,26570000,26130000,26575000,"chr6",258575,4,14,8,26,"chr6",1,0.0426629160806376
"8265","chr6.27130000.27135000","chr6.27830000.27835000",700000,8,0.003871089,27130000,27830000,27135000,27835000,"chr6",258607,1,6,5,12,"chr6",1,0.0112517580872011
"8266","chr6.16330000.16335000","chr6.16485000.16490000",155000,14,0.003554338,16330000,16485000,16335000,16490000,"chr6",258644,5,9,14,28,"chr6",1,0.0459446788560713
"8267","chr6.53050000.53055000","chr6.53280000.53285000",230000,16,1.125926e-05,53050000,53280000,53055000,53285000,"chr6",258648,3,4,3,10,"chr6",1,0.0187529301453352
"8268","chr6.108860000.108865000","chr6.109185000.109190000",325000,19,1.153267e-09,108860000,109185000,108865000,109190000,"chr6",258661,3,8,4,15,"chr6",1,0.0334036568213783
"8269","chr6.37820000.37825000","chr6.38480000.38485000",660000,8,0.005181923,37820000,38480000,37825000,38485000,"chr6",258701,0,1,2,3,"chr6",1,0.00281293952180028
"8270","chr6.26240000.26245000","chr6.26280000.26285000",40000,27,0.001181139,26240000,26280000,26245000,26285000,"chr6",258703,0,7,5,12,"chr6",1,0.0379746835443038
"8271","chr6.26310000.26315000","chr6.26570000.26575000",260000,18,1.000319e-07,26310000,26570000,26315000,26575000,"chr6",258713,3,11,7,21,"chr6",1,0.0443037974683544
"8272","chr6.26055000.26060000","chr6.26155000.26160000",100000,18,0.0006301579,26055000,26155000,26060000,26160000,"chr6",258718,0,5,7,12,"chr6",1,0.0253164556962025
"8273","chr6.154475000.154480000","chr6.154865000.154870000",390000,11,0.0007380716,154475000,154865000,154480000,154870000,"chr6",258729,0,4,5,9,"chr6",1,0.0116033755274262
"8274","chr6.53035000.53040000","chr6.53345000.53350000",310000,49,1.488332e-44,53035000,53345000,53040000,53350000,"chr6",258738,0,2,1,3,"chr6",1,0.0172292545710267
"8275","chr6.13410000.13415000","chr6.13615000.13620000",205000,14,0.0005716608,13410000,13615000,13415000,13620000,"chr6",258755,0,5,2,7,"chr6",1,0.0114861697140178
"8276","chr6.53355000.53360000","chr6.53495000.53500000",140000,22,1.079291e-07,53355000,53495000,53360000,53500000,"chr6",258766,2,3,3,8,"chr6",1,0.0206282231598687
"8277","chr6.8100000.8105000","chr6.8435000.8440000",335000,10,0.006489871,8100000,8435000,8105000,8440000,"chr6",258767,0,1,2,3,"chr6",1,0.00351617440225035
"8278","chr6.35415000.35420000","chr6.35710000.35715000",295000,11,0.003195669,35415000,35710000,35420000,35715000,"chr6",258858,4,4,5,13,"chr6",1,0.0167604313173933
"8279","chr6.108890000.108895000","chr6.109095000.109100000",205000,19,2.451413e-07,108890000,109095000,108895000,109100000,"chr6",258860,2,6,6,14,"chr6",1,0.0311767463666198
"8280","chr6.4350000.4355000","chr6.4645000.4650000",295000,14,3.451758e-05,4350000,4645000,4355000,4650000,"chr6",258893,0,2,0,2,"chr6",1,0.00328176277543366
"8281","chr6.26380000.26385000","chr6.26565000.26570000",185000,19,7.552214e-07,26380000,26565000,26385000,26570000,"chr6",258901,1,6,5,12,"chr6",1,0.0267229254571027
"8282","chr6.17985000.17990000","chr6.18095000.18100000",110000,19,8.052119e-05,17985000,18095000,17990000,18100000,"chr6",258920,3,4,2,9,"chr6",1,0.020042194092827
"8283","chr6.30880000.30885000","chr6.31055000.31060000",175000,32,1.496964e-17,30880000,31055000,30885000,31060000,"chr6",258949,0,0,1,1,"chr6",1,0.00375058602906704
"8284","chr6.10555000.10560000","chr6.10695000.10700000",140000,16,0.0006090269,10555000,10695000,10560000,10700000,"chr6",259003,0,1,3,4,"chr6",1,0.00750117205813408
"8285","chr6.39330000.39335000","chr6.39650000.39655000",320000,12,0.0004857598,39330000,39650000,39335000,39655000,"chr6",259060,0,4,2,6,"chr6",1,0.00843881856540084
"8286","chr6.70545000.70550000","chr6.70565000.70570000",20000,36,0.009530062,70545000,70565000,70550000,70570000,"chr6",259063,0,4,0,4,"chr6",1,0.0168776371308017
"8287","chr6.149455000.149460000","chr6.149720000.149725000",265000,11,0.005701523,149455000,149720000,149460000,149725000,"chr6",259100,4,6,9,19,"chr6",1,0.0244960150023441
"8288","chr6.3740000.3745000","chr6.4015000.4020000",275000,16,2.078412e-06,3740000,4015000,3745000,4020000,"chr6",259132,1,3,1,5,"chr6",1,0.00937646507266761
"8289","chr6.37055000.37060000","chr6.37075000.37080000",20000,45,1.479594e-05,37055000,37075000,37060000,37080000,"chr6",259139,0,4,2,6,"chr6",1,0.0316455696202532
"8290","chr6.134465000.134470000","chr6.135035000.135040000",570000,9,0.002221238,134465000,135035000,134470000,135040000,"chr6",259144,0,3,2,5,"chr6",1,0.00527426160337553
"8291","chr6.167840000.167845000","chr6.168280000.168285000",440000,9,0.007800642,167840000,168280000,167845000,168285000,"chr6",259147,0,5,3,8,"chr6",1,0.00843881856540084
"8292","chr6.158645000.158650000","chr6.159075000.159080000",430000,10,0.002057231,158645000,159075000,158650000,159080000,"chr6",259150,1,3,5,9,"chr6",1,0.0105485232067511
"8293","chr6.5470000.5475000","chr6.5760000.5765000",290000,11,0.003483448,5470000,5760000,5475000,5765000,"chr6",259238,1,3,3,7,"chr6",1,0.00902484763244257
"8294","chr6.24720000.24725000","chr6.24770000.24775000",50000,27,7.635209e-05,24720000,24770000,24725000,24775000,"chr6",259240,2,15,7,24,"chr6",1,0.0759493670886076
"8295","chr6.135905000.135910000","chr6.136510000.136515000",605000,9,0.001597269,135905000,136510000,135910000,136515000,"chr6",259244,1,4,1,6,"chr6",1,0.00632911392405063
"8296","chr6.11200000.11205000","chr6.11495000.11500000",295000,15,6.38924e-06,11200000,11495000,11205000,11500000,"chr6",259280,0,0,2,2,"chr6",1,0.00351617440225035
"8297","chr6.134880000.134885000","chr6.134900000.134905000",20000,38,0.002817976,134880000,134900000,134885000,134905000,"chr6",259288,1,5,5,11,"chr6",1,0.0489920300046882
"8298","chr6.26285000.26290000","chr6.27145000.27150000",860000,7,0.007475354,26285000,27145000,26290000,27150000,"chr6",259307,0,4,3,7,"chr6",1,0.00574308485700891
"8299","chr6.16335000.16340000","chr6.16720000.16725000",385000,10,0.003506077,16335000,16720000,16340000,16725000,"chr6",259322,0,1,1,2,"chr6",1,0.0023441162681669
"8300","chr6.16555000.16560000","chr6.16700000.16705000",145000,20,1.781351e-06,16555000,16700000,16560000,16705000,"chr6",259326,0,3,4,7,"chr6",1,0.0164088138771683
"8301","chr6.53725000.53730000","chr6.53790000.53795000",65000,20,0.003746171,53725000,53790000,53730000,53795000,"chr6",259328,0,2,1,3,"chr6",1,0.0070323488045007
"8302","chr6.3330000.3335000","chr6.3385000.3390000",55000,25,0.0001818139,3330000,3385000,3335000,3390000,"chr6",259381,0,3,0,3,"chr6",1,0.00879043600562588
"8303","chr6.25255000.25260000","chr6.25555000.25560000",300000,12,0.0007007347,25255000,25555000,25260000,25560000,"chr6",259396,0,2,0,2,"chr6",1,0.00281293952180028
"8304","chr6.108860000.108865000","chr6.109180000.109185000",320000,10,0.007951428,108860000,109180000,108865000,109185000,"chr6",259397,0,5,2,7,"chr6",1,0.00820440693858415
"8305","chr6.3125000.3130000","chr6.3235000.3240000",110000,16,0.002870974,3125000,3235000,3130000,3240000,"chr6",259450,3,17,12,32,"chr6",1,0.0600093764650727
"8306","chr6.89690000.89695000","chr6.89820000.89825000",130000,22,2.270638e-07,89690000,89820000,89695000,89825000,"chr6",259461,4,4,4,12,"chr6",1,0.0309423347398031
"8307","chr6.7895000.7900000","chr6.7990000.7995000",95000,17,0.002870974,7895000,7990000,7900000,7995000,"chr6",259462,1,5,6,12,"chr6",1,0.0239099859353024
"8308","chr6.128415000.128420000","chr6.128730000.128735000",315000,12,0.0005251001,128415000,128730000,128420000,128735000,"chr6",259468,0,0,2,2,"chr6",1,0.00281293952180028
"8309","chr6.43425000.43430000","chr6.43450000.43455000",25000,37,0.0008178929,43425000,43450000,43430000,43455000,"chr6",259469,3,11,5,19,"chr6",1,0.0823956868260666
"8310","chr6.17310000.17315000","chr6.17350000.17355000",40000,26,0.002722566,17310000,17350000,17315000,17355000,"chr6",259472,2,19,15,36,"chr6",1,0.109704641350211
"8311","chr6.17155000.17160000","chr6.17815000.17820000",660000,11,2.380553e-05,17155000,17815000,17160000,17820000,"chr6",259473,1,6,8,15,"chr6",1,0.0193389592123769
"8312","chr6.27145000.27150000","chr6.27750000.27755000",605000,13,8.069131e-07,27145000,27750000,27150000,27755000,"chr6",259527,0,7,3,10,"chr6",1,0.0152367557430849
"8313","chr6.39650000.39655000","chr6.39725000.39730000",75000,18,0.006748519,39650000,39725000,39655000,39730000,"chr6",259545,0,1,2,3,"chr6",1,0.00632911392405063
"8314","chr6.10275000.10280000","chr6.10315000.10320000",40000,28,0.0004907997,10275000,10315000,10280000,10320000,"chr6",259554,0,4,3,7,"chr6",1,0.0229723394280356
"8315","chr6.150735000.150740000","chr6.151100000.151105000",365000,11,0.001054337,150735000,151100000,150740000,151105000,"chr6",259623,2,9,13,24,"chr6",1,0.0309423347398031
"8316","chr6.82990000.82995000","chr6.83825000.83830000",835000,8,0.00152873,82990000,83825000,82995000,83830000,"chr6",259646,0,4,2,6,"chr6",1,0.00562587904360056
"8317","chr6.53355000.53360000","chr6.53600000.53605000",245000,12,0.002504867,53355000,53600000,53360000,53605000,"chr6",259698,3,9,6,18,"chr6",1,0.0253164556962025
"8318","chr6.11140000.11145000","chr6.11430000.11435000",290000,11,0.003483448,11140000,11430000,11145000,11435000,"chr6",259699,0,4,2,6,"chr6",1,0.00773558368495077
"8319","chr6.136720000.136725000","chr6.136840000.136845000",120000,29,3.756448e-12,136720000,136840000,136725000,136845000,"chr6",259724,3,5,6,14,"chr6",1,0.0475855602437881
"8320","chr6.11160000.11165000","chr6.11200000.11205000",40000,25,0.005943794,11160000,11200000,11165000,11205000,"chr6",259737,0,3,2,5,"chr6",1,0.0146507266760431
"8321","chr6.43425000.43430000","chr6.43445000.43450000",20000,39,0.001426362,43425000,43445000,43430000,43450000,"chr6",259748,0,2,2,4,"chr6",1,0.0182841068917018
"8322","chr6.13355000.13360000","chr6.13425000.13430000",70000,22,0.0002318073,13355000,13425000,13360000,13430000,"chr6",259753,1,4,0,5,"chr6",1,0.012892639474918
"8323","chr6.129580000.129585000","chr6.129680000.129685000",100000,16,0.005454981,129580000,129680000,129585000,129685000,"chr6",259785,1,2,0,3,"chr6",1,0.00562587904360056
"8324","chr6.26400000.26405000","chr6.26550000.26555000",150000,22,5.118718e-08,26400000,26550000,26405000,26555000,"chr6",259838,0,1,9,10,"chr6",1,0.0257852789498359
"8325","chr6.16555000.16560000","chr6.16640000.16645000",85000,17,0.006589942,16555000,16640000,16560000,16645000,"chr6",259843,4,7,9,20,"chr6",1,0.0398499765588373
"8326","chr6.35520000.35525000","chr6.35715000.35720000",195000,20,7.660639e-08,35520000,35715000,35525000,35720000,"chr6",259846,3,8,7,18,"chr6",1,0.0421940928270042
"8327","chr6.16550000.16555000","chr6.16640000.16645000",90000,18,0.001524141,16550000,16640000,16555000,16645000,"chr6",259880,1,7,12,20,"chr6",1,0.0421940928270042
"8328","chr6.34245000.34250000","chr6.34345000.34350000",100000,19,0.0001929429,34245000,34345000,34250000,34350000,"chr6",259886,0,2,1,3,"chr6",1,0.00668073136427567
"8329","chr6.14210000.14215000","chr6.14800000.14805000",590000,8,0.008672865,14210000,14800000,14215000,14805000,"chr6",259933,1,2,2,5,"chr6",1,0.0046882325363338
"8330","chr6.149455000.149460000","chr6.149750000.149755000",295000,11,0.003195669,149455000,149750000,149460000,149755000,"chr6",259937,2,6,9,17,"chr6",1,0.0219174871073605
"8331","chr6.134620000.134625000","chr6.134900000.134905000",280000,16,1.765246e-06,134620000,134900000,134625000,134905000,"chr6",259961,1,4,4,9,"chr6",1,0.0168776371308017
"8332","chr6.150375000.150380000","chr6.150730000.150735000",355000,15,1.419133e-06,150375000,150730000,150380000,150735000,"chr6",259997,1,8,4,13,"chr6",1,0.0228551336146273
"8333","chr6.108890000.108895000","chr6.109395000.109400000",505000,9,0.004109948,108890000,109395000,108895000,109400000,"chr6",260013,2,6,6,14,"chr6",1,0.0147679324894515
"8334","chr6.149960000.149965000","chr6.150025000.150030000",65000,21,0.001439076,149960000,150025000,149965000,150030000,"chr6",260030,0,1,1,2,"chr6",1,0.00492264416315049
"8335","chr6.110550000.110555000","chr6.110680000.110685000",130000,14,0.008995566,110550000,110680000,110555000,110685000,"chr6",260035,0,9,5,14,"chr6",1,0.0229723394280356
"8336","chr6.36865000.36870000","chr6.37165000.37170000",300000,11,0.002934017,36865000,37165000,36870000,37170000,"chr6",260137,2,3,2,7,"chr6",1,0.00902484763244257
"8337","chr6.148505000.148510000","chr6.148575000.148580000",70000,28,1.330966e-07,148505000,148575000,148510000,148580000,"chr6",260139,2,4,2,8,"chr6",1,0.0262541022034693
"8338","chr6.34985000.34990000","chr6.35020000.35025000",35000,32,0.0001004907,34985000,35020000,34990000,35025000,"chr6",260145,0,2,2,4,"chr6",1,0.0150023441162682
"8339","chr6.15325000.15330000","chr6.15395000.15400000",70000,19,0.004790033,15325000,15395000,15330000,15400000,"chr6",260192,3,5,6,14,"chr6",1,0.0311767463666198
"8340","chr6.3120000.3125000","chr6.3205000.3210000",85000,18,0.00250774,3120000,3205000,3125000,3210000,"chr6",260273,1,7,6,14,"chr6",1,0.029535864978903
"8341","chr6.16510000.16515000","chr6.17030000.17035000",520000,9,0.003554338,16510000,17030000,16515000,17035000,"chr6",260307,2,1,3,6,"chr6",1,0.00632911392405063
"8342","chr6.110875000.110880000","chr6.111260000.111265000",385000,12,0.000163514,110875000,111260000,110880000,111265000,"chr6",260326,4,8,11,23,"chr6",1,0.0323488045007032
"8343","chr6.10510000.10515000","chr6.10755000.10760000",245000,18,1.917297e-07,10510000,10755000,10515000,10760000,"chr6",260336,2,7,6,15,"chr6",1,0.0316455696202532
"8344","chr6.15250000.15255000","chr6.15490000.15495000",240000,18,2.421428e-07,15250000,15490000,15255000,15495000,"chr6",260388,0,0,4,4,"chr6",1,0.00843881856540084
"8345","chr6.150735000.150740000","chr6.151135000.151140000",400000,35,5.478327e-29,150735000,151135000,150740000,151140000,"chr6",260390,2,9,13,24,"chr6",1,0.0984528832630098
"8346","chr6.3295000.3300000","chr6.3740000.3745000",445000,9,0.007483355,3295000,3740000,3300000,3745000,"chr6",260417,1,1,1,3,"chr6",1,0.00316455696202532
"8347","chr6.26030000.26035000","chr6.26215000.26220000",185000,13,0.004005289,26030000,26215000,26035000,26220000,"chr6",260439,3,5,3,11,"chr6",1,0.0167604313173933
"8348","chr6.134910000.134915000","chr6.135025000.135030000",115000,19,5.551494e-05,134910000,135025000,134915000,135030000,"chr6",260497,2,3,1,6,"chr6",1,0.0133614627285513
"8349","chr6.26215000.26220000","chr6.26310000.26315000",95000,20,9.297491e-05,26215000,26310000,26220000,26315000,"chr6",260522,3,11,7,21,"chr6",1,0.0492264416315049
"8350","chr6.134480000.134485000","chr6.134620000.134625000",140000,16,0.0006090269,134480000,134620000,134485000,134625000,"chr6",260584,1,4,4,9,"chr6",1,0.0168776371308017
"8351","chr6.26125000.26130000","chr6.26195000.26200000",70000,44,3.751405e-19,26125000,26195000,26130000,26200000,"chr6",260596,4,13,8,25,"chr6",1,0.12892639474918
"8352","chr6.108585000.108590000","chr6.108620000.108625000",35000,29,0.001361644,108585000,108620000,108590000,108625000,"chr6",260606,5,1,1,7,"chr6",1,0.023792780121894
"8353","chr6.108860000.108865000","chr6.109090000.109095000",230000,15,5.469659e-05,108860000,109090000,108865000,109095000,"chr6",260678,2,1,3,6,"chr6",1,0.0105485232067511
"8354","chr6.17830000.17835000","chr6.17860000.17865000",30000,43,4.517327e-08,17830000,17860000,17835000,17865000,"chr6",260730,2,8,4,14,"chr6",1,0.0705578996718237
"8355","chr6.2845000.2850000","chr6.2950000.2955000",105000,26,4.987327e-09,2845000,2950000,2850000,2955000,"chr6",260765,1,16,8,25,"chr6",1,0.0761837787154243
"8356","chr6.53700000.53705000","chr6.53725000.53730000",25000,44,2.393591e-06,53700000,53725000,53705000,53730000,"chr6",260803,0,6,4,10,"chr6",1,0.0515705578996718
"8357","chr6.53035000.53040000","chr6.53285000.53290000",250000,15,2.651746e-05,53035000,53285000,53040000,53290000,"chr6",260811,0,2,1,3,"chr6",1,0.00527426160337553
"8358","chr6.3115000.3120000","chr6.3255000.3260000",140000,14,0.006219749,3115000,3255000,3120000,3260000,"chr6",260823,2,3,3,8,"chr6",1,0.0131270511017346
"8359","chr6.3120000.3125000","chr6.3255000.3260000",135000,24,5.784593e-09,3120000,3255000,3125000,3260000,"chr6",260851,1,3,3,7,"chr6",1,0.019690576652602
"8360","chr6.34980000.34985000","chr6.35015000.35020000",35000,39,6.843329e-08,34980000,35015000,34985000,35020000,"chr6",260869,0,2,2,4,"chr6",1,0.0182841068917018
"8361","chr6.31460000.31465000","chr6.31495000.31500000",35000,27,0.006289337,31460000,31495000,31465000,31500000,"chr6",260891,2,2,6,10,"chr6",1,0.0316455696202532
"8362","chr6.157875000.157880000","chr6.157985000.157990000",110000,17,0.0009326017,157875000,157985000,157880000,157990000,"chr6",260923,1,9,4,14,"chr6",1,0.0278949835911861
"8363","chr6.34980000.34985000","chr6.35010000.35015000",30000,75,3.523368e-28,34980000,35010000,34985000,35015000,"chr6",260997,0,2,3,5,"chr6",1,0.0439521800281294
"8364","chr6.14800000.14805000","chr6.15395000.15400000",595000,8,0.008345777,14800000,15395000,14805000,15400000,"chr6",261023,1,7,3,11,"chr6",1,0.0103141115799344
"8365","chr6.31835000.31840000","chr6.31860000.31865000",25000,39,0.0001789227,31835000,31860000,31840000,31865000,"chr6",261032,0,4,3,7,"chr6",1,0.0319971870604782
"8366","chr6.24665000.24670000","chr6.24775000.24780000",110000,22,1.31708e-06,24665000,24775000,24670000,24780000,"chr6",261050,0,6,2,8,"chr6",1,0.0206282231598687
"8367","chr6.3115000.3120000","chr6.3245000.3250000",130000,20,4.757806e-06,3115000,3245000,3120000,3250000,"chr6",261058,2,7,6,15,"chr6",1,0.0351617440225035
"8368","chr6.32795000.32800000","chr6.32840000.32845000",45000,24,0.003929417,32795000,32840000,32800000,32845000,"chr6",261064,3,6,2,11,"chr6",1,0.0309423347398031
"8369","chr6.12975000.12980000","chr6.13355000.13360000",380000,11,0.0008532671,12975000,13355000,12980000,13360000,"chr6",261069,1,4,0,5,"chr6",1,0.00644631973745898
"8370","chr6.157430000.157435000","chr6.157455000.157460000",25000,36,0.00167179,157430000,157455000,157435000,157460000,"chr6",261092,2,4,5,11,"chr6",1,0.0464135021097046
"8371","chr6.3120000.3125000","chr6.3975000.3980000",855000,7,0.007658088,3120000,3975000,3125000,3980000,"chr6",261124,1,12,15,28,"chr6",1,0.0229723394280356
"8372","chr6.99095000.99100000","chr6.99120000.99125000",25000,52,6.43389e-10,99095000,99120000,99100000,99125000,"chr6",261150,0,0,2,2,"chr6",1,0.0121894045944679
"8373","chr6.27130000.27135000","chr6.27865000.27870000",735000,20,1.920976e-15,27130000,27865000,27135000,27870000,"chr6",261159,1,1,5,7,"chr6",1,0.0164088138771683
"8374","chr6.3190000.3195000","chr6.3235000.3240000",45000,23,0.008672865,3190000,3235000,3195000,3240000,"chr6",261165,0,8,11,19,"chr6",1,0.0512189404594468
"8375","chr6.16510000.16515000","chr6.16710000.16715000",200000,13,0.00250774,16510000,16710000,16515000,16715000,"chr6",261173,3,5,4,12,"chr6",1,0.0182841068917018
"8376","chr6.6755000.6760000","chr6.7240000.7245000",485000,11,0.0002051372,6755000,7240000,6760000,7245000,"chr6",261209,3,3,5,11,"chr6",1,0.0141819034224098
"8377","chr6.26285000.26290000","chr6.26565000.26570000",280000,12,0.00107979,26285000,26565000,26290000,26570000,"chr6",261222,2,4,5,11,"chr6",1,0.0154711673699015
"8378","chr6.30740000.30745000","chr6.30765000.30770000",25000,38,0.000389857,30740000,30765000,30745000,30770000,"chr6",261260,3,3,6,12,"chr6",1,0.0534458509142053
"8379","chr6.158405000.158410000","chr6.158475000.158480000",70000,24,2.340075e-05,158405000,158475000,158410000,158480000,"chr6",261290,0,0,7,7,"chr6",1,0.019690576652602
"8380","chr6.13455000.13460000","chr6.13535000.13540000",80000,32,2.871131e-11,13455000,13535000,13460000,13540000,"chr6",261308,1,2,5,8,"chr6",1,0.0300046882325363
"8381","chr6.111010000.111015000","chr6.111260000.111265000",250000,11,0.007749285,111010000,111260000,111015000,111265000,"chr6",261311,4,8,11,23,"chr6",1,0.0296530707923113
"8382","chr6.148505000.148510000","chr6.148610000.148615000",105000,16,0.003896423,148505000,148610000,148510000,148615000,"chr6",261312,1,3,0,4,"chr6",1,0.00750117205813408
"8383","chr6.166295000.166300000","chr6.166515000.166520000",220000,27,1.185236e-14,166295000,166515000,166300000,166520000,"chr6",261327,0,5,2,7,"chr6",1,0.0221518987341772
"8384","chr6.24885000.24890000","chr6.24905000.24910000",20000,38,0.002817976,24885000,24905000,24890000,24910000,"chr6",261337,2,3,1,6,"chr6",1,0.0267229254571027
"8385","chr6.148575000.148580000","chr6.148745000.148750000",170000,16,0.0001547714,148575000,148745000,148580000,148750000,"chr6",261350,2,4,2,8,"chr6",1,0.0150023441162682
"8386","chr6.13370000.13375000","chr6.13610000.13615000",240000,13,0.0007231554,13370000,13610000,13375000,13615000,"chr6",261351,0,4,1,5,"chr6",1,0.00761837787154243
"8387","chr6.34155000.34160000","chr6.34285000.34290000",130000,17,0.0002859613,34155000,34285000,34160000,34290000,"chr6",261365,4,6,1,11,"chr6",1,0.0219174871073605
"8388","chr6.149010000.149015000","chr6.149830000.149835000",820000,7,0.009242015,149010000,149830000,149015000,149835000,"chr6",261386,2,8,5,15,"chr6",1,0.0123066104078762
"8389","chr6.27130000.27135000","chr6.27475000.27480000",345000,15,1.781351e-06,27130000,27475000,27135000,27480000,"chr6",261388,1,6,5,12,"chr6",1,0.0210970464135021
"8390","chr6.26125000.26130000","chr6.26280000.26285000",155000,16,0.0003060486,26125000,26280000,26130000,26285000,"chr6",261399,1,7,5,13,"chr6",1,0.0243788091889358
"8391","chr6.3120000.3125000","chr6.3210000.3215000",90000,17,0.004284741,3120000,3210000,3125000,3215000,"chr6",261418,1,12,9,22,"chr6",1,0.0438349742147211
"8392","chr6.35580000.35585000","chr6.35690000.35695000",110000,24,6.386319e-08,35580000,35690000,35585000,35695000,"chr6",261486,3,8,4,15,"chr6",1,0.0421940928270042
"8393","chr6.6675000.6680000","chr6.7240000.7245000",565000,26,7.537741e-21,6675000,7240000,6680000,7245000,"chr6",261512,2,3,6,11,"chr6",1,0.0335208626347867
"8394","chr6.24575000.24580000","chr6.24770000.24775000",195000,20,7.660639e-08,24575000,24770000,24580000,24775000,"chr6",261551,1,1,1,3,"chr6",1,0.0070323488045007
"8395","chr6.28860000.28865000","chr6.28920000.28925000",60000,24,0.0001730704,28860000,28920000,28865000,28925000,"chr6",261570,0,4,1,5,"chr6",1,0.0140646976090014
"8396","chr6.105590000.105595000","chr6.105610000.105615000",20000,48,1.054553e-06,105590000,105610000,105595000,105615000,"chr6",261575,1,2,1,4,"chr6",1,0.0225035161744023
"8397","chr6.3740000.3745000","chr6.3845000.3850000",105000,24,1.15788e-07,3740000,3845000,3745000,3850000,"chr6",261596,0,1,0,1,"chr6",1,0.00281293952180028
"8398","chr6.150720000.150725000","chr6.151135000.151140000",415000,12,0.000101101,150720000,151135000,150725000,151140000,"chr6",261612,0,4,3,7,"chr6",1,0.00984528832630099
"8399","chr6.136720000.136725000","chr6.136835000.136840000",115000,21,3.493892e-06,136720000,136835000,136725000,136840000,"chr6",261621,4,8,9,21,"chr6",1,0.0516877637130802
"8400","chr6.25255000.25260000","chr6.25940000.25945000",685000,10,0.0001270986,25255000,25940000,25260000,25945000,"chr6",261678,2,12,12,26,"chr6",1,0.0304735114861697
"8401","chr6.3115000.3120000","chr6.4015000.4020000",900000,10,1.72241e-05,3115000,4015000,3120000,4020000,"chr6",261734,2,7,6,15,"chr6",1,0.0175808720112518
"8402","chr6.31680000.31685000","chr6.31825000.31830000",145000,15,0.001633642,31680000,31825000,31685000,31830000,"chr6",261742,1,8,6,15,"chr6",1,0.0263713080168776
"8403","chr6.157760000.157765000","chr6.158000000.158005000",240000,14,0.0001731928,157760000,1.58e+08,157765000,158005000,"chr6",261751,0,1,2,3,"chr6",1,0.00492264416315049
"8404","chr6.35465000.35470000","chr6.35710000.35715000",245000,13,0.0006330558,35465000,35710000,35470000,35715000,"chr6",261805,2,12,18,32,"chr6",1,0.0487576183778715
"8405","chr6.34280000.34285000","chr6.34345000.34350000",65000,35,1.83298e-11,34280000,34345000,34285000,34350000,"chr6",261847,0,2,1,3,"chr6",1,0.0123066104078762
"8406","chr6.106890000.106895000","chr6.107025000.107030000",135000,15,0.002508496,106890000,107025000,106895000,107030000,"chr6",261848,1,12,13,26,"chr6",1,0.0457102672292546
"8407","chr6.37050000.37055000","chr6.37075000.37080000",25000,36,0.00167179,37050000,37075000,37055000,37080000,"chr6",261911,4,4,12,20,"chr6",1,0.0843881856540084
"8408","chr6.16335000.16340000","chr6.16370000.16375000",35000,29,0.001361644,16335000,16370000,16340000,16375000,"chr6",261917,0,3,0,3,"chr6",1,0.010196905766526
"8409","chr6.46075000.46080000","chr6.46315000.46320000",240000,11,0.009613542,46075000,46315000,46080000,46320000,"chr6",261945,0,1,2,3,"chr6",1,0.00386779184247539
"8410","chr6.149545000.149550000","chr6.149645000.149650000",100000,17,0.001910446,149545000,149645000,149550000,149650000,"chr6",261956,3,3,3,9,"chr6",1,0.0179324894514768
"8411","chr6.15660000.15665000","chr6.16205000.16210000",545000,11,9.455566e-05,15660000,16205000,15665000,16210000,"chr6",261999,4,14,6,24,"chr6",1,0.0309423347398031
"8412","chr6.13795000.13800000","chr6.13905000.13910000",110000,18,0.0002859613,13795000,13905000,13800000,13910000,"chr6",262009,0,4,2,6,"chr6",1,0.0126582278481013
"8413","chr6.26180000.26185000","chr6.26320000.26325000",140000,15,0.002020592,26180000,26320000,26185000,26325000,"chr6",262018,2,12,10,24,"chr6",1,0.0421940928270042
"8414","chr6.134480000.134485000","chr6.135050000.135055000",570000,9,0.002221238,134480000,135050000,134485000,135055000,"chr6",262035,1,3,1,5,"chr6",1,0.00527426160337553
"8415","chr6.36855000.36860000","chr6.36980000.36985000",125000,20,6.707045e-06,36855000,36980000,36860000,36985000,"chr6",262103,0,2,2,4,"chr6",1,0.00937646507266761
"8416","chr6.3295000.3300000","chr6.3330000.3335000",35000,45,4.153206e-11,3295000,3330000,3300000,3335000,"chr6",262136,0,1,0,1,"chr6",1,0.00527426160337553
"8417","chr6.44235000.44240000","chr6.44265000.44270000",30000,33,0.0006400976,44235000,44265000,44240000,44270000,"chr6",262177,1,4,3,8,"chr6",1,0.0309423347398031
"8418","chr6.112035000.112040000","chr6.112360000.112365000",325000,15,2.861605e-06,112035000,112360000,112040000,112365000,"chr6",262190,1,1,1,3,"chr6",1,0.00527426160337553
"8419","chr6.26180000.26185000","chr6.26605000.26610000",425000,12,8.656383e-05,26180000,26605000,26185000,26610000,"chr6",262225,1,7,5,13,"chr6",1,0.0182841068917018
"8420","chr6.34370000.34375000","chr6.34390000.34395000",20000,45,1.479594e-05,34370000,34390000,34375000,34395000,"chr6",262241,2,9,4,15,"chr6",1,0.0791139240506329
"8421","chr6.110990000.110995000","chr6.111265000.111270000",275000,14,5.999569e-05,110990000,111265000,110995000,111270000,"chr6",262253,0,4,4,8,"chr6",1,0.0131270511017346
"8422","chr6.12955000.12960000","chr6.13010000.13015000",55000,23,0.001313581,12955000,13010000,12960000,13015000,"chr6",262270,1,3,3,7,"chr6",1,0.0188701359587436
"8423","chr6.157875000.157880000","chr6.158015000.158020000",140000,16,0.0006090269,157875000,158015000,157880000,158020000,"chr6",262271,0,6,2,8,"chr6",1,0.0150023441162682
"8424","chr6.31620000.31625000","chr6.31830000.31835000",210000,15,0.0001158305,31620000,31830000,31625000,31835000,"chr6",262291,0,6,6,12,"chr6",1,0.0210970464135021
"8425","chr6.159070000.159075000","chr6.159105000.159110000",35000,30,0.0005922996,159070000,159105000,159075000,159110000,"chr6",262308,2,1,1,4,"chr6",1,0.0140646976090014
"8426","chr6.43635000.43640000","chr6.44045000.44050000",410000,16,5.904898e-08,43635000,44045000,43640000,44050000,"chr6",262312,0,2,1,3,"chr6",1,0.00562587904360056
"8427","chr6.158645000.158650000","chr6.158970000.158975000",325000,14,1.67077e-05,158645000,158970000,158650000,158975000,"chr6",262315,0,3,5,8,"chr6",1,0.0131270511017346
"8428","chr6.110940000.110945000","chr6.110995000.111000000",55000,23,0.001313581,110940000,110995000,110945000,1.11e+08,"chr6",262427,4,38,31,73,"chr6",1,0.196788560712611
"8429","chr6.32110000.32115000","chr6.32865000.32870000",755000,8,0.002683372,32110000,32865000,32115000,32870000,"chr6",262439,2,6,5,13,"chr6",1,0.0121894045944679
"8430","chr6.154475000.154480000","chr6.154675000.154680000",200000,13,0.00250774,154475000,154675000,154480000,154680000,"chr6",262440,0,4,5,9,"chr6",1,0.0137130801687764
"8431","chr6.150730000.150735000","chr6.151100000.151105000",370000,18,2.476087e-09,150730000,151100000,150735000,151105000,"chr6",262449,1,8,14,23,"chr6",1,0.0485232067510548
"8432","chr6.26170000.26175000","chr6.26310000.26315000",140000,14,0.006219749,26170000,26310000,26175000,26315000,"chr6",262459,2,5,7,14,"chr6",1,0.0229723394280356
"8433","chr6.32195000.32200000","chr6.32795000.32800000",600000,8,0.008004726,32195000,32795000,32200000,32800000,"chr6",262493,3,8,16,27,"chr6",1,0.0253164556962025
"8434","chr6.26285000.26290000","chr6.26550000.26555000",265000,17,5.054734e-07,26285000,26550000,26290000,26555000,"chr6",262515,0,1,5,6,"chr6",1,0.0119549929676512
"8435","chr6.26065000.26070000","chr6.26095000.26100000",30000,69,8.715878e-24,26065000,26095000,26070000,26100000,"chr6",262534,2,4,6,12,"chr6",1,0.0970464135021097
"8436","chr6.16335000.16340000","chr6.16700000.16705000",365000,11,0.001054337,16335000,16700000,16340000,16705000,"chr6",262587,0,3,4,7,"chr6",1,0.00902484763244257
"8437","chr6.13920000.13925000","chr6.14140000.14145000",220000,14,0.0003387122,13920000,14140000,13925000,14145000,"chr6",262589,0,0,4,4,"chr6",1,0.00656352555086732
"8438","chr6.26400000.26405000","chr6.26535000.26540000",135000,23,3.101156e-08,26400000,26535000,26405000,26540000,"chr6",262590,0,5,10,15,"chr6",1,0.040436005625879
"8439","chr6.13890000.13895000","chr6.14140000.14145000",250000,11,0.007749285,13890000,14140000,13895000,14145000,"chr6",262597,1,0,4,5,"chr6",1,0.00644631973745898
"8440","chr6.27155000.27160000","chr6.27750000.27755000",595000,12,7.232843e-06,27155000,27750000,27160000,27755000,"chr6",262614,5,12,12,29,"chr6",1,0.0407876230661041
"8441","chr6.20095000.20100000","chr6.20290000.20295000",195000,15,0.0002093035,20095000,20290000,20100000,20295000,"chr6",262648,0,4,1,5,"chr6",1,0.00879043600562588
"8442","chr6.3275000.3280000","chr6.3975000.3980000",700000,10,0.0001094413,3275000,3975000,3280000,3980000,"chr6",262652,0,3,4,7,"chr6",1,0.00820440693858415
"8443","chr6.37660000.37665000","chr6.38645000.38650000",985000,9,6.667698e-05,37660000,38645000,37665000,38650000,"chr6",262711,3,2,2,7,"chr6",1,0.00738396624472574
"8444","chr6.138485000.138490000","chr6.138600000.138605000",115000,16,0.002119166,138485000,138600000,138490000,138605000,"chr6",262725,2,3,4,9,"chr6",1,0.0168776371308017
"8445","chr6.35445000.35450000","chr6.35710000.35715000",265000,12,0.001504806,35445000,35710000,35450000,35715000,"chr6",262731,6,16,22,44,"chr6",1,0.0618846694796062
"8446","chr6.26360000.26365000","chr6.26530000.26535000",170000,24,3.248204e-10,26360000,26530000,26365000,26535000,"chr6",262807,6,3,8,17,"chr6",1,0.0478199718706048
"8447","chr6.34150000.34155000","chr6.34410000.34415000",260000,11,0.006289337,34150000,34410000,34155000,34415000,"chr6",262825,2,5,7,14,"chr6",1,0.0180496952648851
"8448","chr6.18015000.18020000","chr6.18100000.18105000",85000,18,0.00250774,18015000,18100000,18020000,18105000,"chr6",262830,1,13,7,21,"chr6",1,0.0443037974683544
"8449","chr6.34245000.34250000","chr6.34370000.34375000",125000,22,3.41802e-07,34245000,34370000,34250000,34375000,"chr6",262831,0,2,1,3,"chr6",1,0.00773558368495077
"8450","chr6.27145000.27150000","chr6.27830000.27835000",685000,14,2.639576e-08,27145000,27830000,27150000,27835000,"chr6",262842,0,7,3,10,"chr6",1,0.0164088138771683
"8451","chr6.24665000.24670000","chr6.24720000.24725000",55000,24,0.0004989935,24665000,24720000,24670000,24725000,"chr6",262847,0,6,2,8,"chr6",1,0.0225035161744023
"8452","chr6.150740000.150745000","chr6.151065000.151070000",325000,12,0.0004383063,150740000,151065000,150745000,151070000,"chr6",262851,0,7,6,13,"chr6",1,0.0182841068917018
"8453","chr6.39345000.39350000","chr6.39770000.39775000",425000,10,0.002188461,39345000,39770000,39350000,39775000,"chr6",262858,0,2,2,4,"chr6",1,0.0046882325363338
"8454","chr6.53665000.53670000","chr6.53715000.53720000",50000,29,8.775471e-06,53665000,53715000,53670000,53720000,"chr6",262859,0,2,2,4,"chr6",1,0.013595874355368
"8455","chr6.29720000.29725000","chr6.30060000.30065000",340000,10,0.006135482,29720000,30060000,29725000,30065000,"chr6",262902,2,0,3,5,"chr6",1,0.00586029067041725
"8456","chr6.134520000.134525000","chr6.134560000.134565000",40000,31,2.750654e-05,134520000,134560000,134525000,134565000,"chr6",262923,0,1,1,2,"chr6",1,0.00726676043131739
"8457","chr6.30740000.30745000","chr6.31055000.31060000",315000,11,0.002256852,30740000,31055000,30745000,31060000,"chr6",262959,0,7,6,13,"chr6",1,0.0167604313173933
"8458","chr6.7915000.7920000","chr6.7975000.7980000",60000,20,0.007808024,7915000,7975000,7920000,7980000,"chr6",262966,1,4,0,5,"chr6",1,0.0117205813408345
"8459","chr6.150730000.150735000","chr6.151020000.151025000",290000,15,7.341422e-06,150730000,151020000,150735000,151025000,"chr6",262987,1,8,12,21,"chr6",1,0.0369198312236287
"8460","chr6.15255000.15260000","chr6.15420000.15425000",165000,13,0.007734444,15255000,15420000,15260000,15425000,"chr6",263012,0,7,2,9,"chr6",1,0.0137130801687764
"8461","chr6.13370000.13375000","chr6.13395000.13400000",25000,45,9.308319e-07,13370000,13395000,13375000,13400000,"chr6",263019,0,6,3,9,"chr6",1,0.0474683544303797
"8462","chr6.27440000.27445000","chr6.27830000.27835000",390000,10,0.00331223,27440000,27830000,27445000,27835000,"chr6",263023,5,13,18,36,"chr6",1,0.0421940928270042
"8463","chr6.16235000.16240000","chr6.16330000.16335000",95000,16,0.007739499,16235000,16330000,16240000,16335000,"chr6",263030,4,7,5,16,"chr6",1,0.0300046882325363
"8464","chr6.37815000.37820000","chr6.38630000.38635000",815000,7,0.009530062,37815000,38630000,37820000,38635000,"chr6",263039,0,2,0,2,"chr6",1,0.00164088138771683
"8465","chr6.3825000.3830000","chr6.3845000.3850000",20000,38,0.002817976,3825000,3845000,3830000,3850000,"chr6",263073,0,1,0,1,"chr6",1,0.00445382090951711
"8466","chr6.17155000.17160000","chr6.17985000.17990000",830000,8,0.001588727,17155000,17985000,17160000,17990000,"chr6",263137,1,4,2,7,"chr6",1,0.00656352555086732
"8467","chr6.11200000.11205000","chr6.11230000.11235000",30000,44,1.481112e-08,11200000,11230000,11205000,11235000,"chr6",263171,0,2,1,3,"chr6",1,0.0154711673699015
"8468","chr6.16330000.16335000","chr6.16640000.16645000",310000,11,0.002488349,16330000,16640000,16335000,16645000,"chr6",263181,4,7,14,25,"chr6",1,0.0322315986872949
"8469","chr6.43055000.43060000","chr6.43075000.43080000",20000,39,0.001426362,43055000,43075000,43060000,43080000,"chr6",263200,5,12,24,41,"chr6",1,0.187412095639944
"8470","chr6.151335000.151340000","chr6.151625000.151630000",290000,11,0.003483448,151335000,151625000,151340000,151630000,"chr6",263237,0,1,2,3,"chr6",1,0.00386779184247539
"8471","chr6.36735000.36740000","chr6.36965000.36970000",230000,13,0.0009742253,36735000,36965000,36740000,36970000,"chr6",263241,0,3,0,3,"chr6",1,0.00457102672292546
"8472","chr6.34235000.34240000","chr6.34370000.34375000",135000,24,5.784593e-09,34235000,34370000,34240000,34375000,"chr6",263269,2,1,2,5,"chr6",1,0.0140646976090014
"8473","chr6.27145000.27150000","chr6.27865000.27870000",720000,19,4.326549e-14,27145000,27865000,27150000,27870000,"chr6",263274,0,1,3,4,"chr6",1,0.00890764181903422
"8474","chr6.5155000.5160000","chr6.5385000.5390000",230000,12,0.00363063,5155000,5385000,5160000,5390000,"chr6",263310,0,2,1,3,"chr6",1,0.00421940928270042
"8475","chr6.144610000.144615000","chr6.144770000.144775000",160000,13,0.009047489,144610000,144770000,144615000,144775000,"chr6",263318,0,5,3,8,"chr6",1,0.0121894045944679
"8476","chr6.167845000.167850000","chr6.168305000.168310000",460000,9,0.006388194,167845000,168305000,167850000,168310000,"chr6",263328,0,1,1,2,"chr6",1,0.00210970464135021
"8477","chr6.157985000.157990000","chr6.158005000.158010000",20000,41,0.0003488147,157985000,158005000,157990000,158010000,"chr6",263357,1,9,4,14,"chr6",1,0.0672761368963901
"8478","chr6.26195000.26200000","chr6.26310000.26315000",115000,19,5.551494e-05,26195000,26310000,26200000,26315000,"chr6",263442,3,11,7,21,"chr6",1,0.0467651195499297
"8479","chr6.3125000.3130000","chr6.3255000.3260000",130000,21,1.061453e-06,3125000,3255000,3130000,3260000,"chr6",263464,2,3,3,8,"chr6",1,0.019690576652602
"8480","chr6.26420000.26425000","chr6.26530000.26535000",110000,19,8.052119e-05,26420000,26530000,26425000,26535000,"chr6",263519,0,1,2,3,"chr6",1,0.00668073136427567
"8481","chr6.12975000.12980000","chr6.13350000.13355000",375000,10,0.00394479,12975000,13350000,12980000,13355000,"chr6",263561,2,4,6,12,"chr6",1,0.0140646976090014
"8482","chr6.13350000.13355000","chr6.13370000.13375000",20000,39,0.001426362,13350000,13370000,13355000,13375000,"chr6",263578,0,6,3,9,"chr6",1,0.0411392405063291
"8483","chr6.13335000.13340000","chr6.13615000.13620000",280000,12,0.00107979,13335000,13615000,13340000,13620000,"chr6",263594,4,9,12,25,"chr6",1,0.0351617440225035
"8484","chr6.34235000.34240000","chr6.34345000.34350000",110000,25,1.316435e-08,34235000,34345000,34240000,34350000,"chr6",263596,4,1,2,7,"chr6",1,0.0205110173464604
"8485","chr6.34245000.34250000","chr6.34610000.34615000",365000,10,0.004466007,34245000,34610000,34250000,34615000,"chr6",263601,0,2,1,3,"chr6",1,0.00351617440225035
"8486","chr6.87855000.87860000","chr6.87945000.87950000",90000,24,8.828706e-07,87855000,87945000,87860000,87950000,"chr6",263701,0,0,3,3,"chr6",1,0.00843881856540084
"8487","chr6.30585000.30590000","chr6.30690000.30695000",105000,21,8.960961e-06,30585000,30690000,30590000,30695000,"chr6",263744,1,24,23,48,"chr6",1,0.118143459915612
"8488","chr6.27145000.27150000","chr6.27770000.27775000",625000,17,5.546763e-11,27145000,27770000,27150000,27775000,"chr6",263775,0,7,3,10,"chr6",1,0.0199249882794187
"8489","chr6.36025000.36030000","chr6.36050000.36055000",25000,34,0.006369861,36025000,36050000,36030000,36055000,"chr6",263810,0,4,3,7,"chr6",1,0.0278949835911861
"8490","chr6.47035000.47040000","chr6.47275000.47280000",240000,17,1.397687e-06,47035000,47275000,47040000,47280000,"chr6",263842,0,2,3,5,"chr6",1,0.00996249413970933
"8491","chr6.13445000.13450000","chr6.13535000.13540000",90000,23,3.493892e-06,13445000,13535000,13450000,13540000,"chr6",263850,1,1,2,4,"chr6",1,0.0107829348335677
"8492","chr6.11230000.11235000","chr6.11495000.11500000",265000,20,1.695072e-09,11230000,11495000,11235000,11500000,"chr6",263866,0,0,1,1,"chr6",1,0.0023441162681669
"8493","chr6.161350000.161355000","chr6.161770000.161775000",420000,13,1.597715e-05,161350000,161770000,161355000,161775000,"chr6",263905,0,2,2,4,"chr6",1,0.00609470229723394
"8494","chr6.24720000.24725000","chr6.24775000.24780000",55000,26,6.372368e-05,24720000,24775000,24725000,24780000,"chr6",263926,2,8,7,17,"chr6",1,0.0518049695264885
"8495","chr6.42725000.42730000","chr6.42745000.42750000",20000,69,4.776559e-17,42725000,42745000,42730000,42750000,"chr6",263981,0,4,5,9,"chr6",1,0.0727848101265823
"8496","chr6.47045000.47050000","chr6.47275000.47280000",230000,24,3.535703e-12,47045000,47275000,47050000,47280000,"chr6",263993,0,2,3,5,"chr6",1,0.0140646976090014
"8497","chr6.15250000.15255000","chr6.15440000.15445000",190000,34,2.613703e-20,15250000,15440000,15255000,15445000,"chr6",264037,0,5,6,11,"chr6",1,0.0438349742147211
"8498","chr6.26120000.26125000","chr6.26170000.26175000",50000,24,0.00140844,26120000,26170000,26125000,26175000,"chr6",264049,0,3,4,7,"chr6",1,0.019690576652602
"8499","chr6.15260000.15265000","chr6.15385000.15390000",125000,31,4.470344e-14,15260000,15385000,15265000,15390000,"chr6",264083,5,12,14,31,"chr6",1,0.11263478668542
"8500","chr6.158650000.158655000","chr6.158970000.158975000",320000,11,0.002064233,158650000,158970000,158655000,158975000,"chr6",264092,0,6,7,13,"chr6",1,0.0167604313173933
"8501","chr6.26100000.26105000","chr6.26120000.26125000",20000,38,0.002817976,26100000,26120000,26105000,26125000,"chr6",264131,0,3,4,7,"chr6",1,0.0311767463666198
"8502","chr6.6675000.6680000","chr6.7260000.7265000",585000,13,1.077625e-06,6675000,7260000,6680000,7265000,"chr6",264135,2,10,3,15,"chr6",1,0.0228551336146273
"8503","chr6.7730000.7735000","chr6.7990000.7995000",260000,14,9.248264e-05,7730000,7990000,7735000,7995000,"chr6",264138,1,5,3,9,"chr6",1,0.0147679324894515
"8504","chr6.53020000.53025000","chr6.53530000.53535000",510000,9,0.003919333,53020000,53530000,53025000,53535000,"chr6",264159,0,3,1,4,"chr6",1,0.00421940928270042
"8505","chr6.2845000.2850000","chr6.2930000.2935000",85000,34,2.742098e-13,2845000,2930000,2850000,2935000,"chr6",264190,1,16,13,30,"chr6",1,0.119549929676512
"8506","chr6.129075000.129080000","chr6.129580000.129585000",505000,11,0.0001604957,129075000,129580000,129080000,129585000,"chr6",264210,2,2,0,4,"chr6",1,0.00515705578996718
"8507","chr6.158780000.158785000","chr6.158835000.158840000",55000,23,0.001313581,158780000,158835000,158785000,158840000,"chr6",264251,1,1,3,5,"chr6",1,0.0134786685419597
"8508","chr6.20290000.20295000","chr6.20480000.20485000",190000,14,0.000974011,20290000,20480000,20295000,20485000,"chr6",264267,2,5,1,8,"chr6",1,0.0131270511017346
"8509","chr6.17880000.17885000","chr6.18150000.18155000",270000,11,0.005168928,17880000,18150000,17885000,18155000,"chr6",264277,8,24,27,59,"chr6",1,0.0760665729020159
"8510","chr6.15320000.15325000","chr6.15385000.15390000",65000,19,0.009047489,15320000,15385000,15325000,15390000,"chr6",264278,5,10,4,19,"chr6",1,0.0423112986404126
"8511","chr6.108860000.108865000","chr6.109095000.109100000",235000,19,4.995874e-08,108860000,109095000,108865000,109100000,"chr6",264291,3,12,6,21,"chr6",1,0.0467651195499297
"8512","chr6.13350000.13355000","chr6.13535000.13540000",185000,17,1.776426e-05,13350000,13535000,13355000,13540000,"chr6",264301,1,2,5,8,"chr6",1,0.0159399906235349
"8513","chr6.132810000.132815000","chr6.132830000.132835000",20000,64,3.016503e-14,132810000,132830000,132815000,132835000,"chr6",264304,1,0,0,1,"chr6",1,0.00750117205813408
"8514","chr6.167895000.167900000","chr6.168300000.168305000",405000,21,1.038682e-12,167895000,168300000,167900000,168305000,"chr6",264307,0,2,0,2,"chr6",1,0.00492264416315049
"8515","chr6.3750000.3755000","chr6.3845000.3850000",95000,20,9.297491e-05,3750000,3845000,3755000,3850000,"chr6",264311,0,1,0,1,"chr6",1,0.0023441162681669
"8516","chr6.26170000.26175000","chr6.26205000.26210000",35000,30,0.0005922996,26170000,26205000,26175000,26210000,"chr6",264314,0,4,5,9,"chr6",1,0.0316455696202532
"8517","chr6.15265000.15270000","chr6.15395000.15400000",130000,32,3.199234e-15,15265000,15395000,15270000,15400000,"chr6",264340,3,3,1,7,"chr6",1,0.0262541022034693
"8518","chr6.24575000.24580000","chr6.24645000.24650000",70000,22,0.0002318073,24575000,24645000,24580000,24650000,"chr6",264349,1,1,1,3,"chr6",1,0.00773558368495077
"8519","chr6.17830000.17835000","chr6.18020000.18025000",190000,17,1.405663e-05,17830000,18020000,17835000,18025000,"chr6",264363,2,8,2,12,"chr6",1,0.0239099859353024
"8520","chr6.26470000.26475000","chr6.26530000.26535000",60000,33,2.162494e-09,26470000,26530000,26475000,26535000,"chr6",264414,3,5,5,13,"chr6",1,0.05028129395218
"8521","chr6.26605000.26610000","chr6.27125000.27130000",520000,25,6.463319e-19,26605000,27125000,26610000,27130000,"chr6",264424,1,5,5,11,"chr6",1,0.0322315986872949
"8522","chr6.3155000.3160000","chr6.3190000.3195000",35000,30,0.0005922996,3155000,3190000,3160000,3195000,"chr6",264433,0,0,2,2,"chr6",1,0.0070323488045007
"8523","chr6.17985000.17990000","chr6.18120000.18125000",135000,39,4.535434e-22,17985000,18120000,17990000,18125000,"chr6",264446,3,3,2,8,"chr6",1,0.0365682137834037
"8524","chr6.26310000.26315000","chr6.26605000.26610000",295000,11,0.003195669,26310000,26605000,26315000,26610000,"chr6",264470,1,7,5,13,"chr6",1,0.0167604313173933
"8525","chr6.15310000.15315000","chr6.15395000.15400000",85000,18,0.00250774,15310000,15395000,15315000,15400000,"chr6",264484,0,6,7,13,"chr6",1,0.0274261603375527
"8526","chr6.26305000.26310000","chr6.27130000.27135000",825000,7,0.009030593,26305000,27130000,26310000,27135000,"chr6",264485,1,6,5,12,"chr6",1,0.00984528832630099
"8527","chr6.34235000.34240000","chr6.34380000.34385000",145000,15,0.001633642,34235000,34380000,34240000,34385000,"chr6",264486,4,1,2,7,"chr6",1,0.0123066104078762
"8528","chr6.136640000.136645000","chr6.136840000.136845000",200000,19,3.254325e-07,136640000,136840000,136645000,136845000,"chr6",264683,1,5,2,8,"chr6",1,0.0178152836380684
"8529","chr6.56635000.56640000","chr6.56700000.56705000",65000,30,3.101156e-08,56635000,56700000,56640000,56705000,"chr6",264736,0,3,2,5,"chr6",1,0.0175808720112518
"8530","chr6.56635000.56640000","chr6.56660000.56665000",25000,42,1.469486e-05,56635000,56660000,56640000,56665000,"chr6",264753,0,3,2,5,"chr6",1,0.0246132208157525
"8531","chr6.15395000.15400000","chr6.15620000.15625000",225000,16,1.39202e-05,15395000,15620000,15400000,15625000,"chr6",264755,3,8,12,23,"chr6",1,0.043131739334271
"8532","chr6.53410000.53415000","chr6.53585000.53590000",175000,17,2.917956e-05,53410000,53585000,53415000,53590000,"chr6",264772,0,4,4,8,"chr6",1,0.0159399906235349
"8533","chr6.17155000.17160000","chr6.17705000.17710000",550000,9,0.00270808,17155000,17705000,17160000,17710000,"chr6",264773,0,5,8,13,"chr6",1,0.0137130801687764
"8534","chr6.26320000.26325000","chr6.27125000.27130000",805000,8,0.001881143,26320000,27125000,26325000,27130000,"chr6",264783,2,5,7,14,"chr6",1,0.0131270511017346
"8535","chr6.136715000.136720000","chr6.136855000.136860000",140000,14,0.006219749,136715000,136855000,136720000,136860000,"chr6",264788,4,5,2,11,"chr6",1,0.0180496952648851
"8536","chr6.111205000.111210000","chr6.111265000.111270000",60000,26,1.893153e-05,111205000,111265000,111210000,111270000,"chr6",264802,0,4,4,8,"chr6",1,0.0243788091889358
"8537","chr6.134500000.134505000","chr6.135035000.135040000",535000,12,1.677979e-05,134500000,135035000,134505000,135040000,"chr6",264812,2,5,5,12,"chr6",1,0.0168776371308017
"8538","chr6.75285000.75290000","chr6.75890000.75895000",605000,10,0.0002859613,75285000,75890000,75290000,75895000,"chr6",264847,0,3,6,9,"chr6",1,0.0105485232067511
"8539","chr6.26470000.26475000","chr6.26565000.26570000",95000,18,0.0009696025,26470000,26565000,26475000,26570000,"chr6",264850,2,7,5,14,"chr6",1,0.029535864978903
"8540","chr6.113730000.113735000","chr6.114230000.114235000",500000,10,0.0009105737,113730000,114230000,113735000,114235000,"chr6",264851,4,5,6,15,"chr6",1,0.0175808720112518
"8541","chr6.26400000.26405000","chr6.26420000.26425000",20000,58,3.661973e-11,26400000,26420000,26405000,26425000,"chr6",264868,0,1,2,3,"chr6",1,0.020393811533052
"8542","chr6.43575000.43580000","chr6.44045000.44050000",470000,25,4.080621e-18,43575000,44045000,43580000,44050000,"chr6",264888,0,2,1,3,"chr6",1,0.00879043600562588
"8543","chr6.30740000.30745000","chr6.31065000.31070000",325000,11,0.001903583,30740000,31065000,30745000,31070000,"chr6",264929,3,8,6,17,"chr6",1,0.0219174871073605
"8544","chr6.39345000.39350000","chr6.39830000.39835000",485000,9,0.005037543,39345000,39830000,39350000,39835000,"chr6",264954,0,2,0,2,"chr6",1,0.00210970464135021
"8545","chr6.27770000.27775000","chr6.27830000.27835000",60000,21,0.003287302,27770000,27830000,27775000,27835000,"chr6",264996,3,9,16,28,"chr6",1,0.0689170182841069
"8546","chr6.28105000.28110000","chr6.28225000.28230000",120000,20,9.658193e-06,28105000,28225000,28110000,28230000,"chr6",265030,2,9,8,19,"chr6",1,0.0445382090951711
"8547","chr6.13335000.13340000","chr6.13455000.13460000",120000,16,0.001601229,13335000,13455000,13340000,13460000,"chr6",265050,2,5,7,14,"chr6",1,0.0262541022034693
"8548","chr6.11170000.11175000","chr6.11430000.11435000",260000,15,1.893153e-05,11170000,11430000,11175000,11435000,"chr6",265055,1,4,2,7,"chr6",1,0.0123066104078762
"8549","chr6.158320000.158325000","chr6.158350000.158355000",30000,36,5.066556e-05,158320000,158350000,158325000,158355000,"chr6",265063,0,3,0,3,"chr6",1,0.0126582278481013
"8550","chr6.158245000.158250000","chr6.158265000.158270000",20000,37,0.005260689,158245000,158265000,158250000,158270000,"chr6",265090,2,8,9,19,"chr6",1,0.0823956868260666
"8551","chr6.38180000.38185000","chr6.38225000.38230000",45000,25,0.001683742,38180000,38225000,38185000,38230000,"chr6",265134,1,5,3,9,"chr6",1,0.0263713080168776
"8552","chr6.39330000.39335000","chr6.39610000.39615000",280000,14,5.209382e-05,39330000,39610000,39335000,39615000,"chr6",265138,0,2,0,2,"chr6",1,0.00328176277543366
"8553","chr6.16330000.16335000","chr6.16540000.16545000",210000,16,2.603616e-05,16330000,16540000,16335000,16545000,"chr6",265143,1,2,2,5,"chr6",1,0.00937646507266761
"8554","chr6.111065000.111070000","chr6.111085000.111090000",20000,43,7.615044e-05,111065000,111085000,111070000,111090000,"chr6",265205,2,7,4,13,"chr6",1,0.0655180496952649
"8555","chr6.31665000.31670000","chr6.31805000.31810000",140000,16,0.0006090269,31665000,31805000,31670000,31810000,"chr6",265206,0,3,2,5,"chr6",1,0.00937646507266761
"8556","chr6.26285000.26290000","chr6.26570000.26575000",285000,23,1.10528e-12,26285000,26570000,26290000,26575000,"chr6",265234,4,4,5,13,"chr6",1,0.0350445382090952
"8557","chr6.26605000.26610000","chr6.26660000.26665000",55000,22,0.003206695,26605000,26660000,26610000,26665000,"chr6",265240,1,7,5,13,"chr6",1,0.0335208626347867
"8558","chr6.157355000.157360000","chr6.157500000.157505000",145000,17,0.0001319731,157355000,157500000,157360000,157505000,"chr6",265267,2,16,10,28,"chr6",1,0.0557899671823722
"8559","chr6.109325000.109330000","chr6.109395000.109400000",70000,22,0.0002318073,109325000,109395000,109330000,109400000,"chr6",265307,3,9,8,20,"chr6",1,0.0515705578996718
"8560","chr6.129130000.129135000","chr6.129580000.129585000",450000,11,0.0003303043,129130000,129580000,129135000,129585000,"chr6",265319,0,1,0,1,"chr6",1,0.0012892639474918
"8561","chr6.16595000.16600000","chr6.16725000.16730000",130000,18,7.754492e-05,16595000,16725000,16600000,16730000,"chr6",265366,0,5,0,5,"chr6",1,0.0105485232067511
"8562","chr6.28105000.28110000","chr6.28860000.28865000",755000,10,6.551175e-05,28105000,28860000,28110000,28865000,"chr6",265372,1,7,1,9,"chr6",1,0.0105485232067511
"8563","chr6.13410000.13415000","chr6.13550000.13555000",140000,19,1.077722e-05,13410000,13550000,13415000,13555000,"chr6",265392,0,5,2,7,"chr6",1,0.0155883731833099
"8564","chr6.26170000.26175000","chr6.27125000.27130000",955000,7,0.00423306,26170000,27125000,26175000,27130000,"chr6",265406,2,5,7,14,"chr6",1,0.0114861697140178
"8565","chr6.158165000.158170000","chr6.158350000.158355000",185000,14,0.001182822,158165000,158350000,158170000,158355000,"chr6",265419,1,13,14,28,"chr6",1,0.0459446788560713
"8566","chr6.27770000.27775000","chr6.27865000.27870000",95000,20,9.297491e-05,27770000,27865000,27775000,27870000,"chr6",265466,3,1,5,9,"chr6",1,0.0210970464135021
"8567","chr6.38185000.38190000","chr6.38225000.38230000",40000,27,0.001181139,38185000,38225000,38190000,38230000,"chr6",265488,2,8,6,16,"chr6",1,0.0506329113924051
"8568","chr6.17830000.17835000","chr6.17945000.17950000",115000,19,5.551494e-05,17830000,17945000,17835000,17950000,"chr6",265494,1,8,4,13,"chr6",1,0.0289498359118612
"8569","chr6.144885000.144890000","chr6.145255000.145260000",370000,11,0.0009742253,144885000,145255000,144890000,145260000,"chr6",265513,0,5,3,8,"chr6",1,0.0103141115799344
"8570","chr6.110995000.111000000","chr6.111210000.111215000",215000,19,1.4109e-07,110995000,111210000,1.11e+08,111215000,"chr6",265536,2,2,4,8,"chr6",1,0.0178152836380684
"8571","chr6.13355000.13360000","chr6.13395000.13400000",40000,45,7.640693e-13,13355000,13395000,13360000,13400000,"chr6",265539,1,5,0,6,"chr6",1,0.0316455696202532
"8572","chr6.27145000.27150000","chr6.27835000.27840000",690000,8,0.004138798,27145000,27835000,27150000,27840000,"chr6",265562,0,7,3,10,"chr6",1,0.00937646507266761
"8573","chr6.26180000.26185000","chr6.26215000.26220000",35000,34,1.479594e-05,26180000,26215000,26185000,26220000,"chr6",265582,2,12,10,24,"chr6",1,0.0956399437412096
"8574","chr6.20640000.20645000","chr6.20840000.20845000",200000,18,1.735974e-06,20640000,20840000,20645000,20845000,"chr6",265605,4,8,12,24,"chr6",1,0.0506329113924051
"8575","chr6.6725000.6730000","chr6.7260000.7265000",535000,10,0.0006132981,6725000,7260000,6730000,7265000,"chr6",265606,1,6,3,10,"chr6",1,0.0117205813408345
"8576","chr6.136605000.136610000","chr6.136840000.136845000",235000,19,4.995874e-08,136605000,136840000,136610000,136845000,"chr6",265612,3,5,6,14,"chr6",1,0.0311767463666198
"8577","chr6.157100000.157105000","chr6.157355000.157360000",255000,17,7.51314e-07,157100000,157355000,157105000,157360000,"chr6",265624,0,5,1,6,"chr6",1,0.0119549929676512
"8578","chr6.6710000.6715000","chr6.7260000.7265000",550000,9,0.00270808,6710000,7260000,6715000,7265000,"chr6",265644,1,0,2,3,"chr6",1,0.00316455696202532
"8579","chr6.4315000.4320000","chr6.4350000.4355000",35000,29,0.001361644,4315000,4350000,4320000,4355000,"chr6",265657,0,2,0,2,"chr6",1,0.00679793717768401
"8580","chr6.134500000.134505000","chr6.134620000.134625000",120000,28,2.303467e-11,134500000,134620000,134505000,134625000,"chr6",265659,1,4,4,9,"chr6",1,0.029535864978903
"8581","chr6.108950000.108955000","chr6.109095000.109100000",145000,14,0.005181923,108950000,109095000,108955000,109100000,"chr6",265670,0,4,6,10,"chr6",1,0.0164088138771683
"8582","chr6.26310000.26315000","chr6.27145000.27150000",835000,10,3.173832e-05,26310000,27145000,26315000,27150000,"chr6",265697,0,7,3,10,"chr6",1,0.0117205813408345
"8583","chr6.157895000.157900000","chr6.158220000.158225000",325000,10,0.007483355,157895000,158220000,157900000,158225000,"chr6",265710,0,2,10,12,"chr6",1,0.0140646976090014
"8584","chr6.4350000.4355000","chr6.4730000.4735000",380000,11,0.0008532671,4350000,4730000,4355000,4735000,"chr6",265733,0,2,0,2,"chr6",1,0.00257852789498359
"8585","chr6.108580000.108585000","chr6.109395000.109400000",815000,7,0.009530062,108580000,109395000,108585000,109400000,"chr6",265736,0,3,2,5,"chr6",1,0.00410220346929208
"8586","chr6.1600000.1605000","chr6.2350000.2355000",750000,21,7.778795e-17,1600000,2350000,1605000,2355000,"chr6",265737,0,0,1,1,"chr6",1,0.00246132208157525
"8587","chr6.15255000.15260000","chr6.15320000.15325000",65000,26,5.865938e-06,15255000,15320000,15260000,15325000,"chr6",265792,0,7,2,9,"chr6",1,0.0274261603375527
"8588","chr6.138600000.138605000","chr6.138620000.138625000",20000,44,3.396597e-05,138600000,138620000,138605000,138625000,"chr6",265819,0,5,7,12,"chr6",1,0.0618846694796062
"8589","chr6.27160000.27165000","chr6.27685000.27690000",525000,9,0.003382287,27160000,27685000,27165000,27690000,"chr6",265824,0,7,7,14,"chr6",1,0.0147679324894515
"8590","chr6.37820000.37825000","chr6.38225000.38230000",405000,10,0.002817341,37820000,38225000,37825000,38230000,"chr6",265838,0,9,2,11,"chr6",1,0.012892639474918
"8591","chr6.125820000.125825000","chr6.125995000.126000000",175000,13,0.005577214,125820000,125995000,125825000,1.26e+08,"chr6",265841,0,0,1,1,"chr6",1,0.00152367557430849
"8592","chr6.36865000.36870000","chr6.36965000.36970000",100000,17,0.001910446,36865000,36965000,36870000,36970000,"chr6",265879,2,3,2,7,"chr6",1,0.0139474917955931
"8593","chr6.36875000.36880000","chr6.36980000.36985000",105000,27,9.578352e-10,36875000,36980000,36880000,36985000,"chr6",265892,0,2,2,4,"chr6",1,0.0126582278481013
"8594","chr6.26240000.26245000","chr6.26270000.26275000",30000,40,1.076804e-06,26240000,26270000,26245000,26275000,"chr6",265988,0,2,0,2,"chr6",1,0.00937646507266761
"8595","chr6.150890000.150895000","chr6.151025000.151030000",135000,14,0.007483355,150890000,151025000,150895000,151030000,"chr6",266021,3,7,2,12,"chr6",1,0.019690576652602
"8596","chr6.108860000.108865000","chr6.109380000.109385000",520000,23,1.596422e-16,108860000,109380000,108865000,109385000,"chr6",266047,0,5,0,5,"chr6",1,0.0134786685419597
"8597","chr6.134245000.134250000","chr6.134300000.134305000",55000,30,6.111367e-07,134245000,134300000,134250000,134305000,"chr6",266064,9,27,18,54,"chr6",1,0.189873417721519
"8598","chr6.98495000.98500000","chr6.99095000.99100000",600000,13,8.671205e-07,98495000,99095000,98500000,99100000,"chr6",266093,0,0,2,2,"chr6",1,0.00304735114861697
"8599","chr6.8130000.8135000","chr6.8220000.8225000",90000,25,2.106159e-07,8130000,8220000,8135000,8225000,"chr6",266221,1,4,5,10,"chr6",1,0.0293014533520863
"8600","chr6.3160000.3165000","chr6.3230000.3235000",70000,20,0.001836515,3160000,3230000,3165000,3235000,"chr6",266243,0,2,0,2,"chr6",1,0.0046882325363338
"8601","chr6.3150000.3155000","chr6.3205000.3210000",55000,21,0.007492585,3150000,3205000,3155000,3210000,"chr6",266267,2,1,1,4,"chr6",1,0.00984528832630099
"8602","chr6.138100000.138105000","chr6.138265000.138270000",165000,13,0.007734444,138100000,138265000,138105000,138270000,"chr6",266278,0,9,13,22,"chr6",1,0.0335208626347867
"8603","chr6.16510000.16515000","chr6.16620000.16625000",110000,21,5.563589e-06,16510000,16620000,16515000,16625000,"chr6",266287,0,5,4,9,"chr6",1,0.0221518987341772
"8604","chr6.5205000.5210000","chr6.5260000.5265000",55000,24,0.0004989935,5205000,5260000,5210000,5265000,"chr6",266295,0,2,4,6,"chr6",1,0.0168776371308017
"8605","chr6.134500000.134505000","chr6.134605000.134610000",105000,20,3.43331e-05,134500000,134605000,134505000,134610000,"chr6",266342,0,3,3,6,"chr6",1,0.0140646976090014
"8606","chr6.5170000.5175000","chr6.5205000.5210000",35000,28,0.002985581,5170000,5205000,5175000,5210000,"chr6",266384,0,2,4,6,"chr6",1,0.019690576652602
"8607","chr6.17165000.17170000","chr6.17800000.17805000",635000,9,0.00123636,17165000,17800000,17170000,17805000,"chr6",266419,2,4,7,13,"chr6",1,0.0137130801687764
"8608","chr6.108580000.108585000","chr6.108860000.108865000",280000,17,2.890328e-07,108580000,108860000,108585000,108865000,"chr6",266423,0,3,2,5,"chr6",1,0.00996249413970933
"8609","chr6.17860000.17865000","chr6.17945000.17950000",85000,21,8.788792e-05,17860000,17945000,17865000,17950000,"chr6",266460,1,15,5,21,"chr6",1,0.0516877637130802
"8610","chr6.64045000.64050000","chr6.64415000.64420000",370000,14,6.559432e-06,64045000,64415000,64050000,64420000,"chr6",266468,0,1,1,2,"chr6",1,0.00328176277543366
"8611","chr6.26205000.26210000","chr6.26270000.26275000",65000,25,1.92953e-05,26205000,26270000,26210000,26275000,"chr6",266471,0,2,0,2,"chr6",1,0.00586029067041725
"8612","chr6.37685000.37690000","chr6.38010000.38015000",325000,12,0.0004383063,37685000,38010000,37690000,38015000,"chr6",266476,6,9,7,22,"chr6",1,0.0309423347398031
"8613","chr6.52400000.52405000","chr6.52420000.52425000",20000,41,0.0003488147,52400000,52420000,52405000,52425000,"chr6",266484,1,0,1,2,"chr6",1,0.00961087669948429
"8614","chr6.11170000.11175000","chr6.11230000.11235000",60000,27,5.880073e-06,11170000,11230000,11175000,11235000,"chr6",266509,0,2,1,3,"chr6",1,0.00949367088607595
"8615","chr6.35315000.35320000","chr6.35415000.35420000",100000,25,4.77303e-08,35315000,35415000,35320000,35420000,"chr6",266530,4,4,5,13,"chr6",1,0.0380918893577121
"8616","chr6.111565000.111570000","chr6.112335000.112340000",770000,13,8.234684e-08,111565000,112335000,111570000,112340000,"chr6",266549,0,6,2,8,"chr6",1,0.0121894045944679
"8617","chr6.52285000.52290000","chr6.52420000.52425000",135000,14,0.007483355,52285000,52420000,52290000,52425000,"chr6",266551,2,0,1,3,"chr6",1,0.00492264416315049
"8618","chr6.13335000.13340000","chr6.13485000.13490000",150000,14,0.004271906,13335000,13485000,13340000,13490000,"chr6",266569,0,1,0,1,"chr6",1,0.00164088138771683
"8619","chr6.72340000.72345000","chr6.72870000.72875000",530000,9,0.003237994,72340000,72870000,72345000,72875000,"chr6",266570,1,1,0,2,"chr6",1,0.00210970464135021
"8620","chr6.150740000.150745000","chr6.151135000.151140000",395000,50,2.338862e-49,150740000,151135000,150745000,151140000,"chr6",266581,0,7,6,13,"chr6",1,0.0761837787154243
"8621","chr6.24665000.24670000","chr6.24770000.24775000",105000,17,0.001335707,24665000,24770000,24670000,24775000,"chr6",266589,0,6,2,8,"chr6",1,0.0159399906235349
"8622","chr6.10510000.10515000","chr6.10745000.10750000",235000,21,1.130774e-09,10510000,10745000,10515000,10750000,"chr6",266611,1,2,2,5,"chr6",1,0.0123066104078762
"8623","chr6.5205000.5210000","chr6.5230000.5235000",25000,47,1.309885e-07,5205000,5230000,5210000,5235000,"chr6",266624,0,2,4,6,"chr6",1,0.0330520393811533
"8624","chr6.37680000.37685000","chr6.38630000.38635000",950000,7,0.004365074,37680000,38630000,37685000,38635000,"chr6",266650,0,2,0,2,"chr6",1,0.00164088138771683
"8625","chr6.3740000.3745000","chr6.3975000.3980000",235000,21,1.130774e-09,3740000,3975000,3745000,3980000,"chr6",266668,1,3,1,5,"chr6",1,0.0123066104078762
"8626","chr6.111155000.111160000","chr6.111210000.111215000",55000,21,0.007492585,111155000,111210000,111160000,111215000,"chr6",266706,2,2,4,8,"chr6",1,0.019690576652602
"8627","chr6.34985000.34990000","chr6.35010000.35015000",25000,44,2.393591e-06,34985000,35010000,34990000,35015000,"chr6",266733,0,2,4,6,"chr6",1,0.0309423347398031
"8628","chr6.25365000.25370000","chr6.25490000.25495000",125000,20,6.707045e-06,25365000,25490000,25370000,25495000,"chr6",266737,2,0,0,2,"chr6",1,0.0046882325363338
"8629","chr6.15250000.15255000","chr6.15385000.15390000",135000,26,1.721244e-10,15250000,15385000,15255000,15390000,"chr6",266745,2,14,6,22,"chr6",1,0.0670417252695734
"8630","chr6.26340000.26345000","chr6.26565000.26570000",225000,14,0.0002859613,26340000,26565000,26345000,26570000,"chr6",266780,2,7,6,15,"chr6",1,0.0246132208157525
"8631","chr6.109315000.109320000","chr6.109380000.109385000",65000,40,4.757123e-15,109315000,109380000,109320000,109385000,"chr6",266782,0,3,0,3,"chr6",1,0.0140646976090014
"8632","chr6.134435000.134440000","chr6.135140000.135145000",705000,14,1.964485e-08,134435000,135140000,134440000,135145000,"chr6",266799,1,8,1,10,"chr6",1,0.0164088138771683
"8633","chr6.13335000.13340000","chr6.13395000.13400000",60000,22,0.001313581,13335000,13395000,13340000,13400000,"chr6",266800,4,6,6,16,"chr6",1,0.0412564463197375
"8634","chr6.26180000.26185000","chr6.26310000.26315000",130000,19,1.972107e-05,26180000,26310000,26185000,26315000,"chr6",266824,2,11,7,20,"chr6",1,0.0445382090951711
"8635","chr6.15440000.15445000","chr6.15620000.15625000",180000,13,0.004759726,15440000,15620000,15445000,15625000,"chr6",266827,0,5,7,12,"chr6",1,0.0182841068917018
"8636","chr6.27145000.27150000","chr6.27805000.27810000",660000,8,0.005181923,27145000,27805000,27150000,27810000,"chr6",266847,0,3,3,6,"chr6",1,0.00562587904360056
"8637","chr6.110995000.111000000","chr6.111205000.111210000",210000,13,0.001800439,110995000,111205000,1.11e+08,111210000,"chr6",266874,4,12,8,24,"chr6",1,0.0365682137834037
"8638","chr6.26125000.26130000","chr6.26285000.26290000",160000,16,0.0002430781,26125000,26285000,26130000,26290000,"chr6",266884,4,4,5,13,"chr6",1,0.0243788091889358
"8639","chr6.36760000.36765000","chr6.36780000.36785000",20000,51,6.10445e-08,36760000,36780000,36765000,36785000,"chr6",266890,2,3,1,6,"chr6",1,0.0358649789029536
"8640","chr6.135835000.135840000","chr6.136525000.136530000",690000,10,0.0001217627,135835000,136525000,135840000,136530000,"chr6",266933,0,0,1,1,"chr6",1,0.00117205813408345
"8641","chr6.11140000.11145000","chr6.11200000.11205000",60000,31,3.511392e-08,11140000,11200000,11145000,11205000,"chr6",266943,0,3,2,5,"chr6",1,0.0181669010782935
"8642","chr6.17945000.17950000","chr6.17985000.17990000",40000,33,3.366466e-06,17945000,17985000,17950000,17990000,"chr6",266951,1,4,2,7,"chr6",1,0.0270745428973277
"8643","chr6.111030000.111035000","chr6.111210000.111215000",180000,28,5.051509e-14,111030000,111210000,111035000,111215000,"chr6",266952,2,2,4,8,"chr6",1,0.0262541022034693
"8644","chr6.34160000.34165000","chr6.34390000.34395000",230000,19,6.461736e-08,34160000,34390000,34165000,34395000,"chr6",266956,6,14,4,24,"chr6",1,0.0534458509142053
"8645","chr6.150735000.150740000","chr6.151025000.151030000",290000,11,0.003483448,150735000,151025000,150740000,151030000,"chr6",266958,2,9,13,24,"chr6",1,0.0309423347398031
"8646","chr6.37685000.37690000","chr6.38495000.38500000",810000,7,0.00973435,37685000,38495000,37690000,38500000,"chr6",266964,3,0,2,5,"chr6",1,0.00410220346929208
"8647","chr6.15250000.15255000","chr6.15390000.15395000",140000,23,2.090197e-08,15250000,15390000,15255000,15395000,"chr6",267025,2,5,2,9,"chr6",1,0.0242616033755274
"8648","chr6.149865000.149870000","chr6.150070000.150075000",205000,16,3.238894e-05,149865000,150070000,149870000,150075000,"chr6",267057,0,2,0,2,"chr6",1,0.00375058602906704
"8649","chr6.26400000.26405000","chr6.26440000.26445000",40000,32,9.79823e-06,26400000,26440000,26405000,26445000,"chr6",267058,2,8,10,20,"chr6",1,0.0750117205813408
"8650","chr6.26470000.26475000","chr6.26535000.26540000",65000,38,1.431277e-13,26470000,26535000,26475000,26540000,"chr6",267090,0,5,5,10,"chr6",1,0.0445382090951711
"8651","chr6.13355000.13360000","chr6.13455000.13460000",100000,23,9.37537e-07,13355000,13455000,13360000,13460000,"chr6",267101,1,5,0,6,"chr6",1,0.0161744022503516
"8652","chr6.17830000.17835000","chr6.18095000.18100000",265000,20,1.695072e-09,17830000,18095000,17835000,18100000,"chr6",267130,2,8,4,14,"chr6",1,0.0328176277543366
"8653","chr6.134465000.134470000","chr6.135050000.135055000",585000,9,0.00191407,134465000,135050000,134470000,135055000,"chr6",267133,0,3,1,4,"chr6",1,0.00421940928270042
"8654","chr6.111030000.111035000","chr6.111065000.111070000",35000,27,0.006289337,111030000,111065000,111035000,111070000,"chr6",267179,2,7,4,13,"chr6",1,0.0411392405063291
"8655","chr6.136820000.136825000","chr6.136840000.136845000",20000,55,1.001438e-09,136820000,136840000,136825000,136845000,"chr6",267187,3,5,6,14,"chr6",1,0.0902484763244257
"8656","chr6.136625000.136630000","chr6.136840000.136845000",215000,21,3.733329e-09,136625000,136840000,136630000,136845000,"chr6",267189,3,5,6,14,"chr6",1,0.0344585091420534
"8657","chr6.111030000.111035000","chr6.111205000.111210000",175000,18,6.491672e-06,111030000,111205000,111035000,111210000,"chr6",267254,4,9,8,21,"chr6",1,0.0443037974683544
"8658","chr6.13905000.13910000","chr6.14115000.14120000",210000,22,7.599215e-10,13905000,14115000,13910000,14120000,"chr6",267264,0,4,2,6,"chr6",1,0.0154711673699015
"8659","chr6.108460000.108465000","chr6.108580000.108585000",120000,15,0.004837722,108460000,108580000,108465000,108585000,"chr6",267311,0,3,2,5,"chr6",1,0.00879043600562588
"8660","chr6.31365000.31370000","chr6.31400000.31405000",35000,41,6.540575e-09,31365000,31400000,31370000,31405000,"chr6",267326,1,2,2,5,"chr6",1,0.0240271917487107
"8661","chr6.3750000.3755000","chr6.4005000.4010000",255000,14,0.0001071815,3750000,4005000,3755000,4010000,"chr6",267342,0,2,1,3,"chr6",1,0.00492264416315049
"8662","chr6.34195000.34200000","chr6.34380000.34385000",185000,17,1.776426e-05,34195000,34380000,34200000,34385000,"chr6",267358,0,5,12,17,"chr6",1,0.0338724800750117
"8663","chr6.34980000.34985000","chr6.35005000.35010000",25000,49,1.67916e-08,34980000,35005000,34985000,35010000,"chr6",267367,0,2,3,5,"chr6",1,0.0287154242850445
"8664","chr6.108860000.108865000","chr6.109480000.109485000",620000,8,0.006921365,108860000,109480000,108865000,109485000,"chr6",267369,1,4,5,10,"chr6",1,0.00937646507266761
"8665","chr6.31125000.31130000","chr6.31365000.31370000",240000,14,0.0001731928,31125000,31365000,31130000,31370000,"chr6",267384,0,4,3,7,"chr6",1,0.0114861697140178
"8666","chr6.38010000.38015000","chr6.38030000.38035000",20000,37,0.005260689,38010000,38030000,38015000,38035000,"chr6",267390,5,7,5,17,"chr6",1,0.073722456633849
"8667","chr6.109340000.109345000","chr6.109360000.109365000",20000,36,0.009530062,109340000,109360000,109345000,109365000,"chr6",267406,1,3,1,5,"chr6",1,0.0210970464135021
"8668","chr6.17985000.17990000","chr6.18155000.18160000",170000,16,0.0001547714,17985000,18155000,17990000,18160000,"chr6",267461,3,4,2,9,"chr6",1,0.0168776371308017
"8669","chr6.135835000.135840000","chr6.136545000.136550000",710000,10,0.0001000098,135835000,136545000,135840000,136550000,"chr6",267468,0,0,4,4,"chr6",1,0.0046882325363338
"8670","chr6.15255000.15260000","chr6.15385000.15390000",130000,23,4.596696e-08,15255000,15385000,15260000,15390000,"chr6",267487,0,7,2,9,"chr6",1,0.0242616033755274
"8671","chr6.36855000.36860000","chr6.36965000.36970000",110000,20,2.181917e-05,36855000,36965000,36860000,36970000,"chr6",267509,3,5,8,16,"chr6",1,0.0375058602906704
"8672","chr6.147825000.147830000","chr6.148460000.148465000",635000,11,3.194014e-05,147825000,148460000,147830000,148465000,"chr6",267514,0,2,1,3,"chr6",1,0.00386779184247539
"8673","chr6.150740000.150745000","chr6.150895000.150900000",155000,18,1.92953e-05,150740000,150895000,150745000,150900000,"chr6",267529,0,7,6,13,"chr6",1,0.0274261603375527
"8674","chr6.128350000.128355000","chr6.128415000.128420000",65000,20,0.003746171,128350000,128415000,128355000,128420000,"chr6",267531,0,0,4,4,"chr6",1,0.00937646507266761
"8675","chr6.56785000.56790000","chr6.56805000.56810000",20000,51,6.10445e-08,56785000,56805000,56790000,56810000,"chr6",267559,2,0,0,2,"chr6",1,0.0119549929676512
"8676","chr6.147825000.147830000","chr6.148465000.148470000",640000,10,0.0001983977,147825000,148465000,147830000,148470000,"chr6",267637,0,2,6,8,"chr6",1,0.00937646507266761
"8677","chr6.35580000.35585000","chr6.35710000.35715000",130000,16,0.0009696025,35580000,35710000,35585000,35715000,"chr6",267733,3,8,4,15,"chr6",1,0.0281293952180028
"8678","chr6.30655000.30660000","chr6.30875000.30880000",220000,12,0.004767617,30655000,30875000,30660000,30880000,"chr6",267741,2,14,12,28,"chr6",1,0.0393811533052039
"8679","chr6.31700000.31705000","chr6.31805000.31810000",105000,19,0.0001231311,31700000,31805000,31705000,31810000,"chr6",267789,9,17,15,41,"chr6",1,0.0913033286451008
"8680","chr6.31125000.31130000","chr6.31155000.31160000",30000,47,4.443039e-10,31125000,31155000,31130000,31160000,"chr6",267857,0,3,12,15,"chr6",1,0.0826300984528833
"8681","chr6.111675000.111680000","chr6.111815000.111820000",140000,15,0.002020592,111675000,111815000,111680000,111820000,"chr6",267858,1,1,1,3,"chr6",1,0.00527426160337553
"8682","chr6.134480000.134485000","chr6.134900000.134905000",420000,16,4.704772e-08,134480000,134900000,134485000,134905000,"chr6",267881,1,8,5,14,"chr6",1,0.0262541022034693
"8683","chr6.150720000.150725000","chr6.151100000.151105000",380000,12,0.0001746887,150720000,151100000,150725000,151105000,"chr6",267921,0,4,3,7,"chr6",1,0.00984528832630099
"8684","chr6.24775000.24780000","chr6.25005000.25010000",230000,12,0.00363063,24775000,25005000,24780000,25010000,"chr6",267948,1,5,1,7,"chr6",1,0.00984528832630099
"8685","chr6.26155000.26160000","chr6.26180000.26185000",25000,55,2.01713e-11,26155000,26180000,26160000,26185000,"chr6",267956,2,5,7,14,"chr6",1,0.0902484763244257
"8686","chr6.2835000.2840000","chr6.2990000.2995000",155000,16,0.0003060486,2835000,2990000,2840000,2995000,"chr6",267967,3,7,6,16,"chr6",1,0.0300046882325363
"8687","chr6.13395000.13400000","chr6.13420000.13425000",25000,39,0.0001789227,13395000,13420000,13400000,13425000,"chr6",267982,5,5,5,15,"chr6",1,0.0685654008438819
"8688","chr6.56660000.56665000","chr6.56700000.56705000",40000,27,0.001181139,56660000,56700000,56665000,56705000,"chr6",267983,0,5,2,7,"chr6",1,0.0221518987341772
"8689","chr6.157875000.157880000","chr6.158350000.158355000",475000,9,0.005555649,157875000,158350000,157880000,158355000,"chr6",267995,3,11,4,18,"chr6",1,0.0189873417721519
"8690","chr6.110015000.110020000","chr6.110365000.110370000",350000,11,0.001317138,110015000,110365000,110020000,110370000,"chr6",268058,0,3,3,6,"chr6",1,0.00773558368495077
"8691","chr6.161350000.161355000","chr6.161825000.161830000",475000,9,0.005555649,161350000,161825000,161355000,161830000,"chr6",268059,0,5,2,7,"chr6",1,0.00738396624472574
"8692","chr6.138490000.138495000","chr6.138830000.138835000",340000,10,0.006135482,138490000,138830000,138495000,138835000,"chr6",268061,0,3,2,5,"chr6",1,0.00586029067041725
"8693","chr6.16510000.16515000","chr6.16550000.16555000",40000,30,7.566497e-05,16510000,16550000,16515000,16555000,"chr6",268100,1,5,4,10,"chr6",1,0.0351617440225035
"8694","chr6.24855000.24860000","chr6.25015000.25020000",160000,37,1.126094e-21,24855000,25015000,24860000,25020000,"chr6",268132,1,5,3,9,"chr6",1,0.0390295358649789
"8695","chr6.16330000.16335000","chr6.17095000.17100000",765000,13,8.794996e-08,16330000,17095000,16335000,17100000,"chr6",268153,1,5,6,12,"chr6",1,0.0182841068917018
"8696","chr6.34315000.34320000","chr6.34345000.34350000",30000,37,2.013492e-05,34315000,34345000,34320000,34350000,"chr6",268193,3,0,7,10,"chr6",1,0.0433661509610877
"8697","chr6.12975000.12980000","chr6.13005000.13010000",30000,44,1.481112e-08,12975000,13005000,12980000,13010000,"chr6",268231,2,0,0,2,"chr6",1,0.0103141115799344
"8698","chr6.26180000.26185000","chr6.26550000.26555000",370000,11,0.0009742253,26180000,26550000,26185000,26555000,"chr6",268243,0,1,9,10,"chr6",1,0.012892639474918
"8699","chr6.53665000.53670000","chr6.53790000.53795000",125000,19,2.725089e-05,53665000,53790000,53670000,53795000,"chr6",268252,2,2,1,5,"chr6",1,0.0111345522737928
"8700","chr6.16330000.16335000","chr6.16510000.16515000",180000,37,7.469266e-23,16330000,16510000,16335000,16515000,"chr6",268284,3,5,4,12,"chr6",1,0.0520393811533052
"8701","chr6.3125000.3130000","chr6.3210000.3215000",85000,17,0.006589942,3125000,3210000,3130000,3215000,"chr6",268287,3,20,9,32,"chr6",1,0.0637599624941397
"8702","chr6.30875000.30880000","chr6.31055000.31060000",180000,18,4.9834e-06,30875000,31055000,30880000,31060000,"chr6",268293,0,7,6,13,"chr6",1,0.0274261603375527
"8703","chr6.136625000.136630000","chr6.136855000.136860000",230000,18,3.889022e-07,136625000,136855000,136630000,136860000,"chr6",268304,4,5,2,11,"chr6",1,0.0232067510548523
"8704","chr6.89690000.89695000","chr6.90035000.90040000",345000,23,7.430917e-14,89690000,90035000,89695000,90040000,"chr6",268305,0,4,4,8,"chr6",1,0.0215658696671355
"8705","chr6.116275000.116280000","chr6.116370000.116375000",95000,16,0.007739499,116275000,116370000,116280000,116375000,"chr6",268318,0,4,2,6,"chr6",1,0.0112517580872011
"8706","chr6.134465000.134470000","chr6.135140000.135145000",675000,11,2.004181e-05,134465000,135140000,134470000,135145000,"chr6",268331,0,3,2,5,"chr6",1,0.00644631973745898
"8707","chr6.26120000.26125000","chr6.26205000.26210000",85000,21,8.788792e-05,26120000,26205000,26125000,26210000,"chr6",268342,0,3,4,7,"chr6",1,0.0172292545710267
"8708","chr6.13420000.13425000","chr6.13550000.13555000",130000,16,0.0009696025,13420000,13550000,13425000,13555000,"chr6",268377,1,5,5,11,"chr6",1,0.0206282231598687
"8709","chr6.136580000.136585000","chr6.136605000.136610000",25000,38,0.000389857,136580000,136605000,136585000,136610000,"chr6",268388,4,10,14,28,"chr6",1,0.124706985466479
"8710","chr6.28860000.28865000","chr6.28985000.28990000",125000,16,0.001254039,28860000,28985000,28865000,28990000,"chr6",268406,1,7,1,9,"chr6",1,0.0168776371308017
"8711","chr6.106890000.106895000","chr6.107315000.107320000",425000,10,0.002188461,106890000,107315000,106895000,107320000,"chr6",268426,0,5,1,6,"chr6",1,0.0070323488045007
"8712","chr6.96855000.96860000","chr6.96900000.96905000",45000,28,0.0001029385,96855000,96900000,96860000,96905000,"chr6",268435,0,2,0,2,"chr6",1,0.00656352555086732
"8713","chr6.25260000.25265000","chr6.25555000.25560000",295000,11,0.003195669,25260000,25555000,25265000,25560000,"chr6",268498,0,2,0,2,"chr6",1,0.00257852789498359
"8714","chr6.87895000.87900000","chr6.87945000.87950000",50000,23,0.003375895,87895000,87945000,87900000,87950000,"chr6",268548,0,0,3,3,"chr6",1,0.00808720112517581
"8715","chr6.42710000.42715000","chr6.42815000.42820000",105000,20,3.43331e-05,42710000,42815000,42715000,42820000,"chr6",268553,8,19,23,50,"chr6",1,0.117205813408345
"8716","chr6.37670000.37675000","chr6.38630000.38635000",960000,10,9.596701e-06,37670000,38630000,37675000,38635000,"chr6",268587,2,2,0,4,"chr6",1,0.0046882325363338
"8717","chr6.26360000.26365000","chr6.26565000.26570000",205000,25,2.814084e-12,26360000,26565000,26365000,26570000,"chr6",268593,2,3,12,17,"chr6",1,0.0498124706985466
"8718","chr6.15490000.15495000","chr6.15620000.15625000",130000,23,4.596696e-08,15490000,15620000,15495000,15625000,"chr6",268624,0,0,4,4,"chr6",1,0.0107829348335677
"8719","chr6.135835000.135840000","chr6.136625000.136630000",790000,8,0.002085711,135835000,136625000,135840000,136630000,"chr6",268657,0,0,6,6,"chr6",1,0.00562587904360056
"8720","chr6.87895000.87900000","chr6.87940000.87945000",45000,23,0.008672865,87895000,87940000,87900000,87945000,"chr6",268677,3,10,13,26,"chr6",1,0.0700890764181903
"8721","chr6.17600000.17605000","chr6.17705000.17710000",105000,38,9.774487e-19,17600000,17705000,17605000,17710000,"chr6",268684,0,5,5,10,"chr6",1,0.0445382090951711
"8722","chr6.149430000.149435000","chr6.149720000.149725000",290000,12,0.0008640958,149430000,149720000,149435000,149725000,"chr6",268704,3,13,5,21,"chr6",1,0.029535864978903
"8723","chr6.24610000.24615000","chr6.24630000.24635000",20000,41,0.0003488147,24610000,24630000,24615000,24635000,"chr6",268714,1,2,3,6,"chr6",1,0.0288326300984529
"8724","chr6.3125000.3130000","chr6.3245000.3250000",120000,38,4.935682e-20,3125000,3245000,3130000,3250000,"chr6",268719,5,9,12,26,"chr6",1,0.115799343647445
"8725","chr6.13410000.13415000","chr6.13535000.13540000",125000,19,2.725089e-05,13410000,13535000,13415000,13540000,"chr6",268726,0,2,2,4,"chr6",1,0.00890764181903422
"8726","chr6.37670000.37675000","chr6.38175000.38180000",505000,14,5.175069e-07,37670000,38175000,37675000,38180000,"chr6",268735,0,1,2,3,"chr6",1,0.00492264416315049
"8727","chr6.133920000.133925000","chr6.134245000.134250000",325000,11,0.001903583,133920000,134245000,133925000,134250000,"chr6",268752,1,9,0,10,"chr6",1,0.012892639474918
"8728","chr6.134435000.134440000","chr6.135200000.135205000",765000,14,8.1715e-09,134435000,135200000,134440000,135205000,"chr6",268757,1,4,1,6,"chr6",1,0.00984528832630099
"8729","chr6.35580000.35585000","chr6.35685000.35690000",105000,23,5.181966e-07,35580000,35685000,35585000,35690000,"chr6",268782,0,6,2,8,"chr6",1,0.0215658696671355
"8730","chr6.17600000.17605000","chr6.17800000.17805000",200000,15,0.0001728745,17600000,17800000,17605000,17805000,"chr6",268784,3,16,5,24,"chr6",1,0.0421940928270042
"8731","chr6.17985000.17990000","chr6.18100000.18105000",115000,36,8.348935e-18,17985000,18100000,17990000,18105000,"chr6",268804,1,4,2,7,"chr6",1,0.029535864978903
"8732","chr6.17040000.17045000","chr6.17080000.17085000",40000,32,9.79823e-06,17040000,17080000,17045000,17085000,"chr6",268812,0,6,4,10,"chr6",1,0.0375058602906704
"8733","chr6.134465000.134470000","chr6.135200000.135205000",735000,12,1.225568e-06,134465000,135200000,134470000,135205000,"chr6",268853,0,3,2,5,"chr6",1,0.0070323488045007
"8734","chr6.131205000.131210000","chr6.131415000.131420000",210000,18,1.033846e-06,131205000,131415000,131210000,131420000,"chr6",268859,1,1,5,7,"chr6",1,0.0147679324894515
"8735","chr6.15385000.15390000","chr6.15440000.15445000",55000,24,0.0004989935,15385000,15440000,15390000,15445000,"chr6",268875,0,5,7,12,"chr6",1,0.0337552742616034
"8736","chr6.2850000.2855000","chr6.2890000.2895000",40000,26,0.002722566,2850000,2890000,2855000,2895000,"chr6",268894,1,3,1,5,"chr6",1,0.0152367557430849
"8737","chr6.30515000.30520000","chr6.30690000.30695000",175000,13,0.005577214,30515000,30690000,30520000,30695000,"chr6",268897,6,24,23,53,"chr6",1,0.0807548054383497
"8738","chr6.23025000.23030000","chr6.23640000.23645000",615000,11,3.993522e-05,23025000,23640000,23030000,23645000,"chr6",268925,1,2,1,4,"chr6",1,0.00515705578996718
"8739","chr6.17040000.17045000","chr6.17085000.17090000",45000,41,1.141762e-11,17040000,17085000,17045000,17090000,"chr6",268935,0,6,3,9,"chr6",1,0.0432489451476793
"8740","chr6.56660000.56665000","chr6.56710000.56715000",50000,24,0.00140844,56660000,56710000,56665000,56715000,"chr6",268944,0,0,2,2,"chr6",1,0.00562587904360056
"8741","chr6.37025000.37030000","chr6.37055000.37060000",30000,43,4.517327e-08,37025000,37055000,37030000,37060000,"chr6",268971,0,4,2,6,"chr6",1,0.030239099859353
"8742","chr6.17905000.17910000","chr6.17945000.17950000",40000,41,1.96797e-10,17905000,17945000,17910000,17950000,"chr6",269003,1,12,5,18,"chr6",1,0.0864978902953586
"8743","chr6.16555000.16560000","chr6.16575000.16580000",20000,42,0.0001659547,16555000,16575000,16560000,16580000,"chr6",269013,0,2,0,2,"chr6",1,0.00984528832630099
"8744","chr6.118965000.118970000","chr6.119110000.119115000",145000,23,1.399547e-08,118965000,119110000,118970000,119115000,"chr6",269018,2,3,3,8,"chr6",1,0.0215658696671355
"8745","chr6.149405000.149410000","chr6.149745000.149750000",340000,26,6.060439e-17,149405000,149745000,149410000,149750000,"chr6",269098,0,3,2,5,"chr6",1,0.0152367557430849
"8746","chr6.47075000.47080000","chr6.47275000.47280000",200000,17,8.604292e-06,47075000,47275000,47080000,47280000,"chr6",269116,0,2,1,3,"chr6",1,0.0059774964838256
"8747","chr6.35315000.35320000","chr6.35410000.35415000",95000,26,2.168707e-08,35315000,35410000,35320000,35415000,"chr6",269153,0,5,6,11,"chr6",1,0.0335208626347867
"8748","chr6.129055000.129060000","chr6.129630000.129635000",575000,8,0.009721644,129055000,129630000,129060000,129635000,"chr6",269162,0,2,0,2,"chr6",1,0.00187529301453352
"8749","chr6.3125000.3130000","chr6.3740000.3745000",615000,9,0.001453335,3125000,3740000,3130000,3745000,"chr6",269182,1,3,1,5,"chr6",1,0.00527426160337553
"8750","chr6.17815000.17820000","chr6.18025000.18030000",210000,12,0.006222837,17815000,18025000,17820000,18030000,"chr6",269214,3,7,11,21,"chr6",1,0.029535864978903
"8751","chr6.26215000.26220000","chr6.26270000.26275000",55000,25,0.0001818139,26215000,26270000,26220000,26275000,"chr6",269229,0,2,0,2,"chr6",1,0.00586029067041725
"8752","chr6.37685000.37690000","chr6.38355000.38360000",670000,10,0.0001487934,37685000,38355000,37690000,38360000,"chr6",269231,0,1,7,8,"chr6",1,0.00937646507266761
"8753","chr6.110725000.110730000","chr6.111420000.111425000",695000,8,0.004000535,110725000,111420000,110730000,111425000,"chr6",269234,0,1,11,12,"chr6",1,0.0112517580872011
"8754","chr6.16330000.16335000","chr6.16805000.16810000",475000,12,4.051735e-05,16330000,16805000,16335000,16810000,"chr6",269261,0,1,3,4,"chr6",1,0.00562587904360056
"8755","chr6.42700000.42705000","chr6.42745000.42750000",45000,24,0.003929417,42700000,42745000,42705000,42750000,"chr6",269267,0,4,5,9,"chr6",1,0.0253164556962025
"8756","chr6.108925000.108930000","chr6.109080000.109085000",155000,15,0.001086923,108925000,109080000,108930000,109085000,"chr6",269296,1,3,2,6,"chr6",1,0.0105485232067511
"8757","chr6.134480000.134485000","chr6.135055000.135060000",575000,10,0.0003966667,134480000,135055000,134485000,135060000,"chr6",269316,1,13,5,19,"chr6",1,0.0222691045475856
"8758","chr6.30880000.30885000","chr6.31080000.31085000",200000,20,5.707802e-08,30880000,31080000,30885000,31085000,"chr6",269339,2,0,1,3,"chr6",1,0.0070323488045007
"8759","chr6.13350000.13355000","chr6.13445000.13450000",95000,22,7.021292e-06,13350000,13445000,13355000,13450000,"chr6",269360,2,1,2,5,"chr6",1,0.012892639474918
"8760","chr6.16540000.16545000","chr6.16640000.16645000",100000,17,0.001910446,16540000,16640000,16545000,16645000,"chr6",269362,1,2,2,5,"chr6",1,0.00996249413970933
"8761","chr6.15660000.15665000","chr6.16180000.16185000",520000,15,4.746111e-08,15660000,16180000,15665000,16185000,"chr6",269394,0,2,2,4,"chr6",1,0.0070323488045007
"8762","chr6.34590000.34595000","chr6.34610000.34615000",20000,37,0.005260689,34590000,34610000,34595000,34615000,"chr6",269417,6,10,10,26,"chr6",1,0.112751992498828
"8763","chr6.149550000.149555000","chr6.149715000.149720000",165000,15,0.0007119341,149550000,149715000,149555000,149720000,"chr6",269469,3,14,14,31,"chr6",1,0.0545007032348805
"8764","chr6.26565000.26570000","chr6.27145000.27150000",580000,9,0.002018034,26565000,27145000,26570000,27150000,"chr6",269481,0,7,3,10,"chr6",1,0.0105485232067511
"8765","chr6.147825000.147830000","chr6.148505000.148510000",680000,12,2.399537e-06,147825000,148505000,147830000,148510000,"chr6",269500,0,2,6,8,"chr6",1,0.0112517580872011
"8766","chr6.17885000.17890000","chr6.17905000.17910000",20000,87,1.814795e-28,17885000,17905000,17890000,17910000,"chr6",269516,2,12,8,22,"chr6",1,0.224331926863572
"8767","chr6.16360000.16365000","chr6.16380000.16385000",20000,37,0.005260689,16360000,16380000,16365000,16385000,"chr6",269566,0,0,5,5,"chr6",1,0.0216830754805438
"8768","chr6.15325000.15330000","chr6.15490000.15495000",165000,13,0.007734444,15325000,15490000,15330000,15495000,"chr6",269582,0,0,4,4,"chr6",1,0.00609470229723394
"8769","chr6.26550000.26555000","chr6.27125000.27130000",575000,8,0.009721644,26550000,27125000,26555000,27130000,"chr6",269583,0,1,7,8,"chr6",1,0.00750117205813408
"8770","chr6.34220000.34225000","chr6.34390000.34395000",170000,31,2.406789e-16,34220000,34390000,34225000,34395000,"chr6",269614,6,14,4,24,"chr6",1,0.0872011251758087
"8771","chr6.32965000.32970000","chr6.33195000.33200000",230000,12,0.00363063,32965000,33195000,32970000,33200000,"chr6",269634,0,2,0,2,"chr6",1,0.00281293952180028
"8772","chr6.8060000.8065000","chr6.8100000.8105000",40000,33,3.366466e-06,8060000,8100000,8065000,8105000,"chr6",269743,0,1,0,1,"chr6",1,0.00386779184247539
"8773","chr6.53030000.53035000","chr6.53505000.53510000",475000,9,0.005555649,53030000,53505000,53035000,53510000,"chr6",269755,0,0,3,3,"chr6",1,0.00316455696202532
"8774","chr6.158000000.158005000","chr6.158475000.158480000",475000,9,0.005555649,1.58e+08,158475000,158005000,158480000,"chr6",269805,0,1,2,3,"chr6",1,0.00316455696202532
"8775","chr6.26530000.26535000","chr6.26565000.26570000",35000,31,0.0002492805,26530000,26565000,26535000,26570000,"chr6",269832,2,5,8,15,"chr6",1,0.0545007032348805
"8776","chr6.31690000.31695000","chr6.31735000.31740000",45000,26,0.0006964557,31690000,31735000,31695000,31740000,"chr6",269862,0,0,1,1,"chr6",1,0.00304735114861697
"8777","chr6.149860000.149865000","chr6.149960000.149965000",100000,17,0.001910446,149860000,149960000,149865000,149965000,"chr6",269876,0,4,4,8,"chr6",1,0.0159399906235349
"8778","chr6.13405000.13410000","chr6.13445000.13450000",40000,44,3.205729e-12,13405000,13445000,13410000,13450000,"chr6",269900,0,1,2,3,"chr6",1,0.0154711673699015
"8779","chr6.36735000.36740000","chr6.36840000.36845000",105000,16,0.003896423,36735000,36840000,36740000,36845000,"chr6",269901,0,3,0,3,"chr6",1,0.00562587904360056
"8780","chr6.15265000.15270000","chr6.15490000.15495000",225000,15,6.546842e-05,15265000,15490000,15270000,15495000,"chr6",269914,0,0,1,1,"chr6",1,0.00175808720112518
"8781","chr6.89690000.89695000","chr6.90045000.90050000",355000,13,5.066556e-05,89690000,90045000,89695000,90050000,"chr6",269941,2,4,4,10,"chr6",1,0.0152367557430849
"8782","chr6.25250000.25255000","chr6.25910000.25915000",660000,8,0.005181923,25250000,25910000,25255000,25915000,"chr6",270001,1,1,3,5,"chr6",1,0.0046882325363338
"8783","chr6.16180000.16185000","chr6.16200000.16205000",20000,42,0.0001659547,16180000,16200000,16185000,16205000,"chr6",270047,0,2,2,4,"chr6",1,0.019690576652602
"8784","chr6.108860000.108865000","chr6.109325000.109330000",465000,9,0.006135482,108860000,109325000,108865000,109330000,"chr6",270091,3,9,8,20,"chr6",1,0.0210970464135021
"8785","chr6.16725000.16730000","chr6.17085000.17090000",360000,11,0.001138265,16725000,17085000,16730000,17090000,"chr6",270104,0,5,0,5,"chr6",1,0.00644631973745898
"8786","chr6.15660000.15665000","chr6.16200000.16205000",540000,11,0.0001006445,15660000,16200000,15665000,16205000,"chr6",270111,3,8,6,17,"chr6",1,0.0219174871073605
"8787","chr6.13420000.13425000","chr6.13445000.13450000",25000,39,0.0001789227,13420000,13445000,13425000,13450000,"chr6",270183,2,1,2,5,"chr6",1,0.0228551336146273
"8788","chr6.42980000.42985000","chr6.43140000.43145000",160000,17,6.204979e-05,42980000,43140000,42985000,43145000,"chr6",270200,5,7,5,17,"chr6",1,0.0338724800750117
"8789","chr6.18100000.18105000","chr6.18120000.18125000",20000,45,1.479594e-05,18100000,18120000,18105000,18125000,"chr6",270236,1,3,7,11,"chr6",1,0.0580168776371308
"8790","chr6.53040000.53045000","chr6.53345000.53350000",305000,21,3.447864e-11,53040000,53345000,53045000,53350000,"chr6",270249,0,2,1,3,"chr6",1,0.00738396624472574
"8791","chr6.35890000.35895000","chr6.36050000.36055000",160000,14,0.002960758,35890000,36050000,35895000,36055000,"chr6",270313,0,5,3,8,"chr6",1,0.0131270511017346
"8792","chr6.15585000.15590000","chr6.16200000.16205000",615000,9,0.001453335,15585000,16200000,15590000,16205000,"chr6",270373,0,5,1,6,"chr6",1,0.00632911392405063
"8793","chr6.128530000.128535000","chr6.128730000.128735000",200000,13,0.00250774,128530000,128730000,128535000,128735000,"chr6",270381,0,4,2,6,"chr6",1,0.00914205344585091
"8794","chr6.11160000.11165000","chr6.11495000.11500000",335000,24,1.021111e-14,11160000,11495000,11165000,11500000,"chr6",270411,0,0,4,4,"chr6",1,0.0112517580872011
"8795","chr6.2815000.2820000","chr6.2950000.2955000",135000,18,5.87959e-05,2815000,2950000,2820000,2955000,"chr6",270413,3,3,6,12,"chr6",1,0.0253164556962025
"8796","chr6.18320000.18325000","chr6.18500000.18505000",180000,27,3.92383e-13,18320000,18500000,18325000,18505000,"chr6",270442,0,2,2,4,"chr6",1,0.0126582278481013
"8797","chr6.150730000.150735000","chr6.151065000.151070000",335000,11,0.001622331,150730000,151065000,150735000,151070000,"chr6",270534,1,8,8,17,"chr6",1,0.0219174871073605
"8798","chr6.26055000.26060000","chr6.26215000.26220000",160000,20,6.801276e-07,26055000,26215000,26060000,26220000,"chr6",270581,0,7,9,16,"chr6",1,0.0375058602906704
"8799","chr6.11140000.11145000","chr6.11170000.11175000",30000,43,4.517327e-08,11140000,11170000,11145000,11175000,"chr6",270588,0,6,5,11,"chr6",1,0.0554383497421472
"8800","chr6.15265000.15270000","chr6.15390000.15395000",125000,21,1.556348e-06,15265000,15390000,15270000,15395000,"chr6",270626,3,3,1,7,"chr6",1,0.0172292545710267
"8801","chr6.37680000.37685000","chr6.38030000.38035000",350000,11,0.001317138,37680000,38030000,37685000,38035000,"chr6",270641,0,2,1,3,"chr6",1,0.00386779184247539
"8802","chr6.108685000.108690000","chr6.108780000.108785000",95000,16,0.007739499,108685000,108780000,108690000,108785000,"chr6",270654,0,2,2,4,"chr6",1,0.00750117205813408
"8803","chr6.52990000.52995000","chr6.53440000.53445000",450000,9,0.007080125,52990000,53440000,52995000,53445000,"chr6",270661,0,2,0,2,"chr6",1,0.00210970464135021
"8804","chr6.13330000.13335000","chr6.13445000.13450000",115000,16,0.002119166,13330000,13445000,13335000,13450000,"chr6",270674,0,1,1,2,"chr6",1,0.00375058602906704
"8805","chr6.53440000.53445000","chr6.53495000.53500000",55000,22,0.003206695,53440000,53495000,53445000,53500000,"chr6",270678,0,2,0,2,"chr6",1,0.00515705578996718
"8806","chr6.38145000.38150000","chr6.38190000.38195000",45000,26,0.0006964557,38145000,38190000,38150000,38195000,"chr6",270743,3,3,3,9,"chr6",1,0.0274261603375527
"8807","chr6.35260000.35265000","chr6.35415000.35420000",155000,15,0.001086923,35260000,35415000,35265000,35420000,"chr6",270758,1,3,3,7,"chr6",1,0.0123066104078762
"8808","chr6.24580000.24585000","chr6.24695000.24700000",115000,62,7.304557e-45,24580000,24695000,24585000,24700000,"chr6",270761,0,2,0,2,"chr6",1,0.0145335208626348
"8809","chr6.37785000.37790000","chr6.37820000.37825000",35000,27,0.006289337,37785000,37820000,37790000,37825000,"chr6",270775,0,9,2,11,"chr6",1,0.0348101265822785
"8810","chr6.17705000.17710000","chr6.18100000.18105000",395000,11,0.0006945079,17705000,18100000,17710000,18105000,"chr6",270782,0,5,7,12,"chr6",1,0.0154711673699015
"8811","chr6.134245000.134250000","chr6.134400000.134405000",155000,29,8.043747e-14,134245000,134400000,134250000,134405000,"chr6",270784,5,22,11,38,"chr6",1,0.129160806375996
"8812","chr6.13335000.13340000","chr6.13535000.13540000",200000,32,9.055165e-19,13335000,13535000,13340000,13540000,"chr6",270813,1,2,5,8,"chr6",1,0.0300046882325363
"8813","chr6.56915000.56920000","chr6.57170000.57175000",255000,14,0.0001071815,56915000,57170000,56920000,57175000,"chr6",270820,1,12,11,24,"chr6",1,0.0393811533052039
"8814","chr6.109340000.109345000","chr6.109380000.109385000",40000,27,0.001181139,109340000,109380000,109345000,109385000,"chr6",270887,0,3,0,3,"chr6",1,0.00949367088607595
"8815","chr6.15420000.15425000","chr6.15490000.15495000",70000,24,2.340075e-05,15420000,15490000,15425000,15495000,"chr6",270982,0,0,4,4,"chr6",1,0.0112517580872011
"8816","chr6.26215000.26220000","chr6.26285000.26290000",70000,26,1.934617e-06,26215000,26285000,26220000,26290000,"chr6",270985,5,4,5,14,"chr6",1,0.0426629160806376
"8817","chr6.15250000.15255000","chr6.15325000.15330000",75000,21,0.0003303043,15250000,15325000,15255000,15330000,"chr6",270993,2,5,6,13,"chr6",1,0.0319971870604782
"8818","chr6.134640000.134645000","chr6.134885000.134890000",245000,12,0.002504867,134640000,134885000,134645000,134890000,"chr6",271007,0,2,1,3,"chr6",1,0.00421940928270042
"8819","chr6.134515000.134520000","chr6.134620000.134625000",105000,17,0.001335707,134515000,134620000,134520000,134625000,"chr6",271023,0,2,2,4,"chr6",1,0.00796999531176746
"8820","chr6.3280000.3285000","chr6.4005000.4010000",725000,9,0.000571348,3280000,4005000,3285000,4010000,"chr6",271051,0,1,3,4,"chr6",1,0.00421940928270042
"8821","chr6.158645000.158650000","chr6.159000000.159005000",355000,10,0.005076648,158645000,1.59e+08,158650000,159005000,"chr6",271062,0,3,1,4,"chr6",1,0.0046882325363338
"8822","chr6.139135000.139140000","chr6.139585000.139590000",450000,9,0.007080125,139135000,139585000,139140000,139590000,"chr6",271158,0,2,0,2,"chr6",1,0.00210970464135021
"8823","chr6.134885000.134890000","chr6.135140000.135145000",255000,12,0.00191407,134885000,135140000,134890000,135145000,"chr6",271172,3,7,5,15,"chr6",1,0.0210970464135021
"8824","chr6.31650000.31655000","chr6.31860000.31865000",210000,14,0.0004857598,31650000,31860000,31655000,31865000,"chr6",271190,0,4,3,7,"chr6",1,0.0114861697140178
"8825","chr6.17860000.17865000","chr6.18100000.18105000",240000,17,1.397687e-06,17860000,18100000,17865000,18105000,"chr6",271206,1,13,7,21,"chr6",1,0.0418424753867792
"8826","chr6.36385000.36390000","chr6.36660000.36665000",275000,12,0.001215086,36385000,36660000,36390000,36665000,"chr6",271207,0,7,3,10,"chr6",1,0.0140646976090014
"8827","chr6.154730000.154735000","chr6.154865000.154870000",135000,14,0.007483355,154730000,154865000,154735000,154870000,"chr6",271215,0,6,8,14,"chr6",1,0.0229723394280356
"8828","chr6.26125000.26130000","chr6.26185000.26190000",60000,20,0.007808024,26125000,26185000,26130000,26190000,"chr6",271241,4,14,8,26,"chr6",1,0.0609470229723394
"8829","chr6.135025000.135030000","chr6.135140000.135145000",115000,18,0.0001982416,135025000,135140000,135030000,135145000,"chr6",271331,2,3,1,6,"chr6",1,0.0126582278481013
"8830","chr6.17815000.17820000","chr6.18120000.18125000",305000,16,8.028338e-07,17815000,18120000,17820000,18125000,"chr6",271341,3,3,9,15,"chr6",1,0.0281293952180028
"8831","chr6.17865000.17870000","chr6.18095000.18100000",230000,12,0.00363063,17865000,18095000,17870000,18100000,"chr6",271363,1,1,1,3,"chr6",1,0.00421940928270042
"8832","chr6.111030000.111035000","chr6.111255000.111260000",225000,13,0.001148837,111030000,111255000,111035000,111260000,"chr6",271378,2,6,8,16,"chr6",1,0.0243788091889358
"8833","chr6.35520000.35525000","chr6.35735000.35740000",215000,14,0.0004029034,35520000,35735000,35525000,35740000,"chr6",271381,0,3,0,3,"chr6",1,0.00492264416315049
"8834","chr6.2950000.2955000","chr6.2990000.2995000",40000,51,8.460385e-17,2950000,2990000,2955000,2995000,"chr6",271388,3,7,6,16,"chr6",1,0.0956399437412096
"8835","chr6.16335000.16340000","chr6.17085000.17090000",750000,11,8.875783e-06,16335000,17085000,16340000,17090000,"chr6",271405,0,5,3,8,"chr6",1,0.0103141115799344
"8836","chr6.42725000.42730000","chr6.42840000.42845000",115000,17,0.0006733273,42725000,42840000,42730000,42845000,"chr6",271408,3,25,28,56,"chr6",1,0.111579934364744
"8837","chr6.35580000.35585000","chr6.35600000.35605000",20000,43,7.615044e-05,35580000,35600000,35585000,35605000,"chr6",271413,3,6,4,13,"chr6",1,0.0655180496952649
"8838","chr6.134885000.134890000","chr6.134910000.134915000",25000,46,3.563132e-07,134885000,134910000,134890000,134915000,"chr6",271459,3,7,5,15,"chr6",1,0.0808720112517581
"8839","chr6.138115000.138120000","chr6.138230000.138235000",115000,15,0.006219749,138115000,138230000,138120000,138235000,"chr6",271462,0,8,3,11,"chr6",1,0.0193389592123769
"8840","chr6.31805000.31810000","chr6.31825000.31830000",20000,56,3.398093e-10,31805000,31825000,31810000,31830000,"chr6",271471,3,13,14,30,"chr6",1,0.19690576652602
"8841","chr6.16330000.16335000","chr6.16635000.16640000",305000,11,0.002702006,16330000,16635000,16335000,16640000,"chr6",271488,1,2,5,8,"chr6",1,0.0103141115799344
"8842","chr6.148505000.148510000","chr6.148770000.148775000",265000,11,0.005701523,148505000,148770000,148510000,148775000,"chr6",271512,0,6,3,9,"chr6",1,0.0116033755274262
"8843","chr6.13410000.13415000","chr6.13455000.13460000",45000,27,0.0002769738,13410000,13455000,13415000,13460000,"chr6",271517,0,5,2,7,"chr6",1,0.0221518987341772
"8844","chr6.17905000.17910000","chr6.18120000.18125000",215000,12,0.005449888,17905000,18120000,17910000,18125000,"chr6",271525,5,3,8,16,"chr6",1,0.0225035161744023
"8845","chr6.136720000.136725000","chr6.136745000.136750000",25000,34,0.006369861,136720000,136745000,136725000,136750000,"chr6",271531,1,5,4,10,"chr6",1,0.0398499765588373
"8846","chr6.24580000.24585000","chr6.24645000.24650000",65000,25,1.92953e-05,24580000,24645000,24585000,24650000,"chr6",271533,0,2,0,2,"chr6",1,0.00586029067041725
"8847","chr6.32865000.32870000","chr6.32890000.32895000",25000,42,1.469486e-05,32865000,32890000,32870000,32895000,"chr6",271536,2,6,6,14,"chr6",1,0.0689170182841069
"8848","chr6.34155000.34160000","chr6.34410000.34415000",255000,14,0.0001071815,34155000,34410000,34160000,34415000,"chr6",271568,7,26,22,55,"chr6",1,0.0902484763244257
"8849","chr6.24645000.24650000","chr6.24665000.24670000",20000,51,6.10445e-08,24645000,24665000,24650000,24670000,"chr6",271577,0,3,2,5,"chr6",1,0.029887482419128
"8850","chr6.83870000.83875000","chr6.84225000.84230000",355000,10,0.005076648,83870000,84225000,83875000,84230000,"chr6",271602,0,3,1,4,"chr6",1,0.0046882325363338
"8851","chr6.42700000.42705000","chr6.42815000.42820000",115000,18,0.0001982416,42700000,42815000,42705000,42820000,"chr6",271626,7,28,26,61,"chr6",1,0.128691983122363
"8852","chr6.128410000.128415000","chr6.128550000.128555000",140000,14,0.006219749,128410000,128550000,128415000,128555000,"chr6",271629,1,1,1,3,"chr6",1,0.00492264416315049
"8853","chr6.32865000.32870000","chr6.32895000.32900000",30000,31,0.002960758,32865000,32895000,32870000,32900000,"chr6",271655,2,3,4,9,"chr6",1,0.0327004219409283
"8854","chr6.35600000.35605000","chr6.35685000.35690000",85000,19,0.0008640958,35600000,35685000,35605000,35690000,"chr6",271659,0,6,2,8,"chr6",1,0.0178152836380684
"8855","chr6.134500000.134505000","chr6.134540000.134545000",40000,29,0.0001935403,134500000,134540000,134505000,134545000,"chr6",271699,0,5,4,9,"chr6",1,0.0305907172995781
"8856","chr6.38190000.38195000","chr6.38225000.38230000",35000,34,1.479594e-05,38190000,38225000,38195000,38230000,"chr6",271721,2,3,4,9,"chr6",1,0.0358649789029536
"8857","chr6.15255000.15260000","chr6.15395000.15400000",140000,31,7.26328e-15,15255000,15395000,15260000,15400000,"chr6",271732,0,7,2,9,"chr6",1,0.0327004219409283
"8858","chr6.3135000.3140000","chr6.3205000.3210000",70000,22,0.0002318073,3135000,3205000,3140000,3210000,"chr6",271855,3,6,6,15,"chr6",1,0.0386779184247539
"8859","chr6.3940000.3945000","chr6.3975000.3980000",35000,38,2.136305e-07,3940000,3975000,3945000,3980000,"chr6",271882,0,5,1,6,"chr6",1,0.0267229254571027
"8860","chr6.17830000.17835000","chr6.18120000.18125000",290000,22,7.804743e-12,17830000,18120000,17835000,18125000,"chr6",271889,2,3,4,9,"chr6",1,0.0232067510548523
"8861","chr6.108585000.108590000","chr6.108610000.108615000",25000,45,9.308319e-07,108585000,108610000,108590000,108615000,"chr6",271891,0,1,0,1,"chr6",1,0.00527426160337553
"8862","chr6.149545000.149550000","chr6.149750000.149755000",205000,20,4.26317e-08,149545000,149750000,149550000,149755000,"chr6",271907,2,11,14,27,"chr6",1,0.0632911392405063
"8863","chr6.157355000.157360000","chr6.157455000.157460000",100000,19,0.0001929429,157355000,157455000,157360000,157460000,"chr6",271929,2,8,5,15,"chr6",1,0.0334036568213783
"8864","chr6.34150000.34155000","chr6.34380000.34385000",230000,15,5.469659e-05,34150000,34380000,34155000,34385000,"chr6",271967,2,5,7,14,"chr6",1,0.0246132208157525
"8865","chr6.17165000.17170000","chr6.17585000.17590000",420000,11,0.0004970603,17165000,17585000,17170000,17590000,"chr6",272004,2,4,7,13,"chr6",1,0.0167604313173933
"8866","chr6.3135000.3140000","chr6.3990000.3995000",855000,7,0.007658088,3135000,3990000,3140000,3995000,"chr6",272018,3,6,5,14,"chr6",1,0.0114861697140178
"8867","chr6.36385000.36390000","chr6.37210000.37215000",825000,7,0.009030593,36385000,37210000,36390000,37215000,"chr6",272024,0,15,8,23,"chr6",1,0.0188701359587436
"8868","chr6.28860000.28865000","chr6.28980000.28985000",120000,21,2.296452e-06,28860000,28980000,28865000,28985000,"chr6",272040,0,5,1,6,"chr6",1,0.0147679324894515
"8869","chr6.134510000.134515000","chr6.134560000.134565000",50000,25,0.0005592628,134510000,134560000,134515000,134565000,"chr6",272043,0,1,1,2,"chr6",1,0.00586029067041725
"8870","chr6.17865000.17870000","chr6.17945000.17950000",80000,20,0.0005181948,17865000,17945000,17870000,17950000,"chr6",272062,1,1,1,3,"chr6",1,0.0070323488045007
"8871","chr6.39330000.39335000","chr6.39890000.39895000",560000,9,0.002477219,39330000,39890000,39335000,39895000,"chr6",272069,3,2,6,11,"chr6",1,0.0116033755274262
"8872","chr6.111360000.111365000","chr6.111550000.111555000",190000,15,0.0002576869,111360000,111550000,111365000,111555000,"chr6",272105,4,6,1,11,"chr6",1,0.0193389592123769
"8873","chr6.35520000.35525000","chr6.35710000.35715000",190000,15,0.0002576869,35520000,35710000,35525000,35715000,"chr6",272125,9,16,15,40,"chr6",1,0.070323488045007
"8874","chr6.53030000.53035000","chr6.53250000.53255000",220000,13,0.001338848,53030000,53250000,53035000,53255000,"chr6",272130,0,1,2,3,"chr6",1,0.00457102672292546
"8875","chr6.129930000.129935000","chr6.130070000.130075000",140000,28,2.662151e-12,129930000,130070000,129935000,130075000,"chr6",272145,2,0,2,4,"chr6",1,0.0131270511017346
"8876","chr6.6675000.6680000","chr6.6720000.6725000",45000,24,0.003929417,6675000,6720000,6680000,6725000,"chr6",272167,2,0,0,2,"chr6",1,0.00562587904360056
"8877","chr6.99120000.99125000","chr6.99270000.99275000",150000,14,0.004271906,99120000,99270000,99125000,99275000,"chr6",272202,0,2,1,3,"chr6",1,0.00492264416315049
"8878","chr6.157780000.157785000","chr6.158005000.158010000",225000,16,1.39202e-05,157780000,158005000,157785000,158010000,"chr6",272213,0,10,0,10,"chr6",1,0.0187529301453352
"8879","chr6.15260000.15265000","chr6.15490000.15495000",230000,18,3.889022e-07,15260000,15490000,15265000,15495000,"chr6",272217,0,0,4,4,"chr6",1,0.00843881856540084
"8880","chr6.34160000.34165000","chr6.34790000.34795000",630000,8,0.006395702,34160000,34790000,34165000,34795000,"chr6",272228,3,14,14,31,"chr6",1,0.0290670417252696
"8881","chr6.13350000.13355000","chr6.13405000.13410000",55000,27,2.113861e-05,13350000,13405000,13355000,13410000,"chr6",272253,0,2,6,8,"chr6",1,0.0253164556962025
"8882","chr6.157870000.157875000","chr6.158000000.158005000",130000,21,1.061453e-06,157870000,1.58e+08,157875000,158005000,"chr6",272259,0,1,2,3,"chr6",1,0.00738396624472574
"8883","chr6.53035000.53040000","chr6.53280000.53285000",245000,13,0.0006330558,53035000,53280000,53040000,53285000,"chr6",272299,0,2,1,3,"chr6",1,0.00457102672292546
"8884","chr6.149545000.149550000","chr6.149745000.149750000",200000,17,8.604292e-06,149545000,149745000,149550000,149750000,"chr6",272307,1,11,14,26,"chr6",1,0.0518049695264885
"8885","chr6.26205000.26210000","chr6.26285000.26290000",80000,26,2.772576e-07,26205000,26285000,26210000,26290000,"chr6",272323,0,4,5,9,"chr6",1,0.0274261603375527
"8886","chr6.26100000.26105000","chr6.26200000.26205000",100000,18,0.0006301579,26100000,26200000,26105000,26205000,"chr6",272346,1,6,2,9,"chr6",1,0.0189873417721519
"8887","chr6.13355000.13360000","chr6.13550000.13555000",195000,16,5.016749e-05,13355000,13550000,13360000,13555000,"chr6",272374,1,5,0,6,"chr6",1,0.0112517580872011
"8888","chr6.13905000.13910000","chr6.14140000.14145000",235000,55,4.598425e-48,13905000,14140000,13910000,14145000,"chr6",272378,0,0,2,2,"chr6",1,0.012892639474918
"8889","chr6.154470000.154475000","chr6.154675000.154680000",205000,13,0.002119166,154470000,154675000,154475000,154680000,"chr6",272447,1,13,8,22,"chr6",1,0.0335208626347867
"8890","chr6.16510000.16515000","chr6.16720000.16725000",210000,19,1.859361e-07,16510000,16720000,16515000,16725000,"chr6",272457,1,1,1,3,"chr6",1,0.00668073136427567
"8891","chr6.12955000.12960000","chr6.12975000.12980000",20000,43,7.615044e-05,12955000,12975000,12960000,12980000,"chr6",272509,2,3,5,10,"chr6",1,0.0503984997655884
"8892","chr6.53725000.53730000","chr6.53745000.53750000",20000,45,1.479594e-05,53725000,53745000,53730000,53750000,"chr6",272532,0,6,4,10,"chr6",1,0.0527426160337553
"8893","chr6.26270000.26275000","chr6.26550000.26555000",280000,11,0.004199105,26270000,26550000,26275000,26555000,"chr6",272558,0,1,0,1,"chr6",1,0.0012892639474918
"8894","chr6.138485000.138490000","chr6.138515000.138520000",30000,37,2.013492e-05,138485000,138515000,138490000,138520000,"chr6",272598,2,3,3,8,"chr6",1,0.0346929207688701
"8895","chr6.155220000.155225000","chr6.155240000.155245000",20000,39,0.001426362,155220000,155240000,155225000,155245000,"chr6",272612,1,3,2,6,"chr6",1,0.0274261603375527
"8896","chr6.158245000.158250000","chr6.158280000.158285000",35000,30,0.0005922996,158245000,158280000,158250000,158285000,"chr6",272627,0,4,7,11,"chr6",1,0.0386779184247539
"8897","chr6.12975000.12980000","chr6.13180000.13185000",205000,12,0.007127411,12975000,13180000,12980000,13185000,"chr6",272651,0,3,3,6,"chr6",1,0.00843881856540084
"8898","chr6.111030000.111035000","chr6.111100000.111105000",70000,29,3.352765e-08,111030000,111100000,111035000,111105000,"chr6",272770,5,9,8,22,"chr6",1,0.0747773089545241
"8899","chr6.10720000.10725000","chr6.10745000.10750000",25000,92,1.854206e-35,10720000,10745000,10725000,10750000,"chr6",272781,1,2,2,5,"chr6",1,0.0539146741678387
"8900","chr6.31365000.31370000","chr6.31405000.31410000",40000,60,2.241316e-23,31365000,31405000,31370000,31410000,"chr6",272810,0,4,3,7,"chr6",1,0.0492264416315049
"8901","chr6.34195000.34200000","chr6.34345000.34350000",150000,15,0.001345451,34195000,34345000,34200000,34350000,"chr6",272838,0,5,12,17,"chr6",1,0.029887482419128
"8902","chr6.3740000.3745000","chr6.4005000.4010000",265000,17,5.054734e-07,3740000,4005000,3745000,4010000,"chr6",272885,1,3,1,5,"chr6",1,0.00996249413970933
"8903","chr6.139145000.139150000","chr6.139580000.139585000",435000,9,0.00818327,139145000,139580000,139150000,139585000,"chr6",272889,1,3,1,5,"chr6",1,0.00527426160337553
"8904","chr6.3195000.3200000","chr6.3245000.3250000",50000,23,0.003375895,3195000,3245000,3200000,3250000,"chr6",272902,0,3,1,4,"chr6",1,0.0107829348335677
"8905","chr6.31620000.31625000","chr6.31790000.31795000",170000,13,0.006513716,31620000,31790000,31625000,31795000,"chr6",272903,0,6,6,12,"chr6",1,0.0182841068917018
"8906","chr6.2990000.2995000","chr6.3065000.3070000",75000,25,2.660327e-06,2990000,3065000,2995000,3070000,"chr6",272914,0,4,2,6,"chr6",1,0.0175808720112518
"8907","chr6.27125000.27130000","chr6.27815000.27820000",690000,12,2.116311e-06,27125000,27815000,27130000,27820000,"chr6",272935,2,5,7,14,"chr6",1,0.019690576652602
"8908","chr6.109425000.109430000","chr6.109490000.109495000",65000,20,0.003746171,109425000,109490000,109430000,109495000,"chr6",272941,1,6,0,7,"chr6",1,0.0164088138771683
"8909","chr6.13325000.13330000","chr6.13565000.13570000",240000,13,0.0007231554,13325000,13565000,13330000,13570000,"chr6",272951,0,1,0,1,"chr6",1,0.00152367557430849
"8910","chr6.16330000.16335000","chr6.16495000.16500000",165000,15,0.0007119341,16330000,16495000,16335000,16500000,"chr6",272964,1,3,1,5,"chr6",1,0.00879043600562588
"8911","chr6.34160000.34165000","chr6.34345000.34350000",185000,13,0.004005289,34160000,34345000,34165000,34350000,"chr6",272978,9,24,22,55,"chr6",1,0.0838021565869667
"8912","chr6.161615000.161620000","chr6.161675000.161680000",60000,22,0.001313581,161615000,161675000,161620000,161680000,"chr6",272983,0,2,0,2,"chr6",1,0.00515705578996718
"8913","chr6.30715000.30720000","chr6.30765000.30770000",50000,28,2.651746e-05,30715000,30765000,30720000,30770000,"chr6",273028,0,3,6,9,"chr6",1,0.029535864978903
"8914","chr6.16335000.16340000","chr6.16550000.16555000",215000,12,0.005449888,16335000,16550000,16340000,16555000,"chr6",273035,0,5,9,14,"chr6",1,0.019690576652602
"8915","chr6.158245000.158250000","chr6.158300000.158305000",55000,24,0.0004989935,158245000,158300000,158250000,158305000,"chr6",273036,3,0,2,5,"chr6",1,0.0140646976090014
"8916","chr6.134530000.134535000","chr6.135200000.135205000",670000,9,0.0009022344,134530000,135200000,134535000,135205000,"chr6",273081,0,0,4,4,"chr6",1,0.00421940928270042
"8917","chr6.3160000.3165000","chr6.3205000.3210000",45000,29,3.740718e-05,3160000,3205000,3165000,3210000,"chr6",273092,3,7,6,16,"chr6",1,0.0543834974214721
"8918","chr6.134510000.134515000","chr6.134640000.134645000",130000,15,0.00308896,134510000,134640000,134515000,134645000,"chr6",273191,0,2,1,3,"chr6",1,0.00527426160337553
"8919","chr6.110825000.110830000","chr6.111265000.111270000",440000,11,0.0003781226,110825000,111265000,110830000,111270000,"chr6",273295,0,4,4,8,"chr6",1,0.0103141115799344
"8920","chr6.125110000.125115000","chr6.125145000.125150000",35000,30,0.0005922996,125110000,125145000,125115000,125150000,"chr6",273341,2,4,3,9,"chr6",1,0.0316455696202532
"8921","chr6.31680000.31685000","chr6.31815000.31820000",135000,18,5.87959e-05,31680000,31815000,31685000,31820000,"chr6",273347,1,8,6,15,"chr6",1,0.0316455696202532
"8922","chr6.143000000.143005000","chr6.143805000.143810000",805000,8,0.001881143,1.43e+08,143805000,143005000,143810000,"chr6",273404,0,2,0,2,"chr6",1,0.00187529301453352
"8923","chr6.11065000.11070000","chr6.11495000.11500000",430000,14,2.077534e-06,11065000,11495000,11070000,11500000,"chr6",273444,0,0,4,4,"chr6",1,0.00656352555086732
"8924","chr6.53050000.53055000","chr6.53100000.53105000",50000,26,0.0002097868,53050000,53100000,53055000,53105000,"chr6",273453,3,9,5,17,"chr6",1,0.0518049695264885
"8925","chr6.148875000.148880000","chr6.149860000.149865000",985000,7,0.003483448,148875000,149860000,148880000,149865000,"chr6",273464,0,4,4,8,"chr6",1,0.00656352555086732
"8926","chr6.3210000.3215000","chr6.3245000.3250000",35000,33,3.919978e-05,3210000,3245000,3215000,3250000,"chr6",273492,3,9,9,21,"chr6",1,0.0812236286919831
"8927","chr6.38030000.38035000","chr6.38640000.38645000",610000,8,0.007483355,38030000,38640000,38035000,38645000,"chr6",273599,5,7,5,17,"chr6",1,0.0159399906235349
"8928","chr6.170230000.170235000","chr6.170540000.170545000",310000,12,0.000577775,170230000,170540000,170235000,170545000,"chr6",273601,1,2,1,4,"chr6",1,0.00562587904360056
"8929","chr6.149550000.149555000","chr6.149745000.149750000",195000,12,0.009418563,149550000,149745000,149555000,149750000,"chr6",273702,1,17,17,35,"chr6",1,0.0492264416315049
"8930","chr6.43630000.43635000","chr6.44045000.44050000",415000,21,7.552249e-13,43630000,44045000,43635000,44050000,"chr6",273722,0,2,1,3,"chr6",1,0.00738396624472574
"8931","chr6.136715000.136720000","chr6.136840000.136845000",125000,15,0.003840393,136715000,136840000,136720000,136845000,"chr6",273724,3,5,6,14,"chr6",1,0.0246132208157525
"8932","chr6.13685000.13690000","chr6.13905000.13910000",220000,16,1.690938e-05,13685000,13905000,13690000,13910000,"chr6",273770,0,4,2,6,"chr6",1,0.0112517580872011
"8933","chr6.53020000.53025000","chr6.53345000.53350000",325000,15,2.861605e-06,53020000,53345000,53025000,53350000,"chr6",273796,0,2,1,3,"chr6",1,0.00527426160337553
"8934","chr6.128130000.128135000","chr6.129055000.129060000",925000,7,0.005146782,128130000,129055000,128135000,129060000,"chr6",273885,0,5,5,10,"chr6",1,0.00820440693858415
"8935","chr6.15385000.15390000","chr6.15490000.15495000",105000,16,0.003896423,15385000,15490000,15390000,15495000,"chr6",273918,0,0,4,4,"chr6",1,0.00750117205813408
"8936","chr6.157780000.157785000","chr6.158320000.158325000",540000,9,0.002960758,157780000,158320000,157785000,158325000,"chr6",273936,0,3,0,3,"chr6",1,0.00316455696202532
"8937","chr6.39345000.39350000","chr6.39725000.39730000",380000,14,5.448201e-06,39345000,39725000,39350000,39730000,"chr6",273974,0,1,2,3,"chr6",1,0.00492264416315049
"8938","chr6.134285000.134290000","chr6.134400000.134405000",115000,17,0.0006733273,134285000,134400000,134290000,134405000,"chr6",273984,5,4,11,20,"chr6",1,0.0398499765588373
"8939","chr6.3190000.3195000","chr6.3245000.3250000",55000,29,2.077534e-06,3190000,3245000,3195000,3250000,"chr6",273988,0,8,11,19,"chr6",1,0.0645804031879981
"8940","chr6.157820000.157825000","chr6.158005000.158010000",185000,13,0.004005289,157820000,158005000,157825000,158010000,"chr6",274009,4,12,7,23,"chr6",1,0.0350445382090952
"8941","chr6.37820000.37825000","chr6.38220000.38225000",400000,11,0.0006472299,37820000,38220000,37825000,38225000,"chr6",274110,0,6,2,8,"chr6",1,0.0103141115799344
"8942","chr6.31775000.31780000","chr6.31860000.31865000",85000,17,0.006589942,31775000,31860000,31780000,31865000,"chr6",274222,0,1,2,3,"chr6",1,0.0059774964838256
"8943","chr6.111705000.111710000","chr6.111795000.111800000",90000,23,3.493892e-06,111705000,111795000,111710000,111800000,"chr6",274247,0,3,2,5,"chr6",1,0.0134786685419597
"8944","chr6.136640000.136645000","chr6.136835000.136840000",195000,12,0.009418563,136640000,136835000,136645000,136840000,"chr6",274295,1,6,2,9,"chr6",1,0.0126582278481013
"8945","chr6.28105000.28110000","chr6.28215000.28220000",110000,25,1.316435e-08,28105000,28215000,28110000,28220000,"chr6",274338,1,6,3,10,"chr6",1,0.0293014533520863
"8946","chr6.17815000.17820000","chr6.17985000.17990000",170000,22,1.208698e-08,17815000,17985000,17820000,17990000,"chr6",274381,3,4,2,9,"chr6",1,0.0232067510548523
"8947","chr6.16330000.16335000","chr6.17085000.17090000",755000,14,9.458604e-09,16330000,17085000,16335000,17090000,"chr6",274384,1,6,3,10,"chr6",1,0.0164088138771683
"8948","chr6.16370000.16375000","chr6.16685000.16690000",315000,10,0.008579001,16370000,16685000,16375000,16690000,"chr6",274405,2,3,0,5,"chr6",1,0.00586029067041725
"8949","chr6.129055000.129060000","chr6.129580000.129585000",525000,12,1.93897e-05,129055000,129580000,129060000,129585000,"chr6",274411,0,2,0,2,"chr6",1,0.00281293952180028
"8950","chr6.28860000.28865000","chr6.28950000.28955000",90000,36,1.998593e-15,28860000,28950000,28865000,28955000,"chr6",274425,1,7,1,9,"chr6",1,0.0379746835443038
"8951","chr6.53020000.53025000","chr6.53355000.53360000",335000,14,1.357701e-05,53020000,53355000,53025000,53360000,"chr6",274437,0,4,8,12,"chr6",1,0.019690576652602
"8952","chr6.25230000.25235000","chr6.25555000.25560000",325000,10,0.007483355,25230000,25555000,25235000,25560000,"chr6",274451,0,2,0,2,"chr6",1,0.0023441162681669
"8953","chr6.26040000.26045000","chr6.26120000.26125000",80000,22,5.206096e-05,26040000,26120000,26045000,26125000,"chr6",274452,0,3,4,7,"chr6",1,0.0180496952648851
"8954","chr6.53355000.53360000","chr6.53410000.53415000",55000,30,6.111367e-07,53355000,53410000,53360000,53415000,"chr6",274464,0,4,4,8,"chr6",1,0.0281293952180028
"8955","chr6.134520000.134525000","chr6.134910000.134915000",390000,17,1.203887e-08,134520000,134910000,134525000,134915000,"chr6",274484,3,9,5,17,"chr6",1,0.0338724800750117
"8956","chr6.6720000.6725000","chr6.7240000.7245000",520000,20,3.86146e-13,6720000,7240000,6725000,7245000,"chr6",274510,2,0,0,2,"chr6",1,0.0046882325363338
"8957","chr6.18120000.18125000","chr6.18150000.18155000",30000,30,0.005980343,18120000,18150000,18125000,18155000,"chr6",274641,7,3,9,19,"chr6",1,0.0668073136427567
"8958","chr6.26195000.26200000","chr6.26215000.26220000",20000,42,0.0001659547,26195000,26215000,26200000,26220000,"chr6",274643,5,13,13,31,"chr6",1,0.152601969057665
"8959","chr6.15325000.15330000","chr6.15385000.15390000",60000,20,0.007808024,15325000,15385000,15330000,15390000,"chr6",274649,5,5,6,16,"chr6",1,0.0375058602906704
"8960","chr6.26310000.26315000","chr6.26660000.26665000",350000,11,0.001317138,26310000,26660000,26315000,26665000,"chr6",274652,3,9,7,19,"chr6",1,0.0244960150023441
"8961","chr6.24575000.24580000","chr6.24695000.24700000",120000,33,1.712913e-15,24575000,24695000,24580000,24700000,"chr6",274665,1,1,1,3,"chr6",1,0.0116033755274262
"8962","chr6.16555000.16560000","chr6.16725000.16730000",170000,16,0.0001547714,16555000,16725000,16560000,16730000,"chr6",274730,0,5,0,5,"chr6",1,0.00937646507266761
"8963","chr6.27075000.27080000","chr6.27820000.27825000",745000,10,7.259043e-05,27075000,27820000,27080000,27825000,"chr6",274788,3,8,5,16,"chr6",1,0.0187529301453352
"8964","chr6.136985000.136990000","chr6.137095000.137100000",110000,18,0.0002859613,136985000,137095000,136990000,137100000,"chr6",274857,1,3,3,7,"chr6",1,0.0147679324894515
"8965","chr6.3330000.3335000","chr6.3430000.3435000",100000,16,0.005454981,3330000,3430000,3335000,3435000,"chr6",274884,0,3,0,3,"chr6",1,0.00562587904360056
"8966","chr6.13335000.13340000","chr6.13555000.13560000",220000,13,0.001338848,13335000,13555000,13340000,13560000,"chr6",274926,4,9,10,23,"chr6",1,0.0350445382090952
"8967","chr6.134235000.134240000","chr6.134285000.134290000",50000,28,2.651746e-05,134235000,134285000,134240000,134290000,"chr6",274931,3,4,9,16,"chr6",1,0.0525082044069386
"8968","chr6.149010000.149015000","chr6.149030000.149035000",20000,42,0.0001659547,149010000,149030000,149015000,149035000,"chr6",274947,2,3,2,7,"chr6",1,0.0344585091420534
"8969","chr6.37805000.37810000","chr6.38645000.38650000",840000,8,0.00148561,37805000,38645000,37810000,38650000,"chr6",274960,3,6,2,11,"chr6",1,0.0103141115799344
"8970","chr6.111210000.111215000","chr6.111265000.111270000",55000,35,7.744266e-10,111210000,111265000,111215000,111270000,"chr6",275089,0,2,4,6,"chr6",1,0.0246132208157525
"8971","chr6.24430000.24435000","chr6.24695000.24700000",265000,14,7.939078e-05,24430000,24695000,24435000,24700000,"chr6",275135,4,13,12,29,"chr6",1,0.0475855602437881
"8972","chr6.17815000.17820000","chr6.18155000.18160000",340000,10,0.006135482,17815000,18155000,17820000,18160000,"chr6",275138,3,17,13,33,"chr6",1,0.0386779184247539
"8973","chr6.15660000.15665000","chr6.16330000.16335000",670000,11,2.116122e-05,15660000,16330000,15665000,16335000,"chr6",275212,4,13,6,23,"chr6",1,0.0296530707923113
"8974","chr6.53355000.53360000","chr6.53500000.53505000",145000,15,0.001633642,53355000,53500000,53360000,53505000,"chr6",275214,5,13,11,29,"chr6",1,0.0509845288326301
"8975","chr6.11170000.11175000","chr6.11250000.11255000",80000,19,0.001487732,11170000,11250000,11175000,11255000,"chr6",275223,0,2,1,3,"chr6",1,0.00668073136427567
"8976","chr6.34155000.34160000","chr6.34415000.34420000",260000,11,0.006289337,34155000,34415000,34160000,34420000,"chr6",275243,10,28,24,62,"chr6",1,0.0799343647444913
"8977","chr6.166360000.166365000","chr6.166380000.166385000",20000,38,0.002817976,166360000,166380000,166365000,166385000,"chr6",275369,0,6,2,8,"chr6",1,0.0356305672761369
"8978","chr6.157865000.157870000","chr6.158000000.158005000",135000,16,0.0007626282,157865000,1.58e+08,157870000,158005000,"chr6",275381,0,1,2,3,"chr6",1,0.00562587904360056
"8979","chr6.34315000.34320000","chr6.34370000.34375000",55000,24,0.0004989935,34315000,34370000,34320000,34375000,"chr6",275421,2,0,7,9,"chr6",1,0.0253164556962025
"8980","chr6.149410000.149415000","chr6.149745000.149750000",335000,12,0.000366144,149410000,149745000,149415000,149750000,"chr6",275429,1,17,18,36,"chr6",1,0.0506329113924051
"8981","chr6.112035000.112040000","chr6.112335000.112340000",300000,19,2.847032e-09,112035000,112335000,112040000,112340000,"chr6",275432,1,1,2,4,"chr6",1,0.00890764181903422
"8982","chr6.135835000.135840000","chr6.136530000.136535000",695000,8,0.004000535,135835000,136530000,135840000,136535000,"chr6",275447,0,0,2,2,"chr6",1,0.00187529301453352
"8983","chr6.4155000.4160000","chr6.4935000.4940000",780000,9,0.0003670286,4155000,4935000,4160000,4940000,"chr6",275458,0,0,3,3,"chr6",1,0.00316455696202532
"8984","chr6.17815000.17820000","chr6.18100000.18105000",285000,17,2.412783e-07,17815000,18100000,17820000,18105000,"chr6",275476,1,13,7,21,"chr6",1,0.0418424753867792
"8985","chr6.15690000.15695000","chr6.16200000.16205000",510000,37,2.256484e-34,15690000,16200000,15695000,16205000,"chr6",275491,0,6,8,14,"chr6",1,0.0607126113455227
"8986","chr6.157780000.157785000","chr6.158030000.158035000",250000,11,0.007749285,157780000,158030000,157785000,158035000,"chr6",275526,0,1,0,1,"chr6",1,0.0012892639474918
"8987","chr6.37815000.37820000","chr6.38010000.38015000",195000,12,0.009418563,37815000,38010000,37820000,38015000,"chr6",275545,0,2,1,3,"chr6",1,0.00421940928270042
"8988","chr6.17830000.17835000","chr6.17865000.17870000",35000,28,0.002985581,17830000,17865000,17835000,17870000,"chr6",275609,1,1,1,3,"chr6",1,0.00984528832630099
"8989","chr6.111220000.111225000","chr6.111260000.111265000",40000,30,7.566497e-05,111220000,111260000,111225000,111265000,"chr6",275615,4,7,8,19,"chr6",1,0.0668073136427567
"8990","chr6.161675000.161680000","chr6.161770000.161775000",95000,23,1.781351e-06,161675000,161770000,161680000,161775000,"chr6",275620,1,2,3,6,"chr6",1,0.0161744022503516
"8991","chr6.163285000.163290000","chr6.163645000.163650000",360000,10,0.004767617,163285000,163645000,163290000,163650000,"chr6",275627,1,2,1,4,"chr6",1,0.0046882325363338
"8992","chr6.154470000.154475000","chr6.154730000.154735000",260000,17,6.134132e-07,154470000,154730000,154475000,154735000,"chr6",275631,0,6,8,14,"chr6",1,0.0278949835911861
"8993","chr6.149430000.149435000","chr6.149715000.149720000",285000,11,0.003840393,149430000,149715000,149435000,149720000,"chr6",275660,3,13,5,21,"chr6",1,0.0270745428973277
"8994","chr6.26220000.26225000","chr6.26270000.26275000",50000,25,0.0005592628,26220000,26270000,26225000,26275000,"chr6",275664,0,2,0,2,"chr6",1,0.00586029067041725
"8995","chr6.34160000.34165000","chr6.34370000.34375000",210000,17,5.429176e-06,34160000,34370000,34165000,34375000,"chr6",275713,2,9,14,25,"chr6",1,0.0498124706985466
"8996","chr6.53410000.53415000","chr6.53505000.53510000",95000,40,1.947348e-19,53410000,53505000,53415000,53510000,"chr6",275746,0,0,3,3,"chr6",1,0.0140646976090014
"8997","chr6.36385000.36390000","chr6.36440000.36445000",55000,21,0.007492585,36385000,36440000,36390000,36445000,"chr6",275803,5,3,9,17,"chr6",1,0.0418424753867792
"8998","chr6.134500000.134505000","chr6.134560000.134565000",60000,30,1.328357e-07,134500000,134560000,134505000,134565000,"chr6",275836,0,1,1,2,"chr6",1,0.0070323488045007
"8999","chr6.3205000.3210000","chr6.3245000.3250000",40000,33,3.366466e-06,3205000,3245000,3210000,3250000,"chr6",275862,4,7,6,17,"chr6",1,0.0657524613220816
"9000","chr6.26285000.26290000","chr6.26305000.26310000",20000,44,3.396597e-05,26285000,26305000,26290000,26310000,"chr6",275897,5,4,5,14,"chr6",1,0.0721987810595406
"9001","chr6.135025000.135030000","chr6.135055000.135060000",30000,42,1.330966e-07,135025000,135055000,135030000,135060000,"chr6",275902,2,3,1,6,"chr6",1,0.029535864978903
"9002","chr6.53020000.53025000","chr6.53280000.53285000",260000,15,1.893153e-05,53020000,53280000,53025000,53285000,"chr6",275913,0,4,3,7,"chr6",1,0.0123066104078762
"9003","chr6.24575000.24580000","chr6.24665000.24670000",90000,27,1.047025e-08,24575000,24665000,24580000,24670000,"chr6",275915,0,1,1,2,"chr6",1,0.00632911392405063
"9004","chr6.37685000.37690000","chr6.38120000.38125000",435000,11,0.0004034828,37685000,38120000,37690000,38125000,"chr6",275940,3,1,4,8,"chr6",1,0.0103141115799344
"9005","chr6.26065000.26070000","chr6.26120000.26125000",55000,30,6.111367e-07,26065000,26120000,26070000,26125000,"chr6",275954,0,3,4,7,"chr6",1,0.0246132208157525
"9006","chr6.17095000.17100000","chr6.17705000.17710000",610000,8,0.007483355,17095000,17705000,17100000,17710000,"chr6",275966,0,5,6,11,"chr6",1,0.0103141115799344
"9007","chr6.2890000.2895000","chr6.2930000.2935000",40000,36,1.109589e-07,2890000,2930000,2895000,2935000,"chr6",275970,1,3,1,5,"chr6",1,0.0210970464135021
"9008","chr6.134445000.134450000","chr6.134465000.134470000",20000,50,1.607791e-07,134445000,134465000,134450000,134470000,"chr6",275993,0,3,2,5,"chr6",1,0.0293014533520863
"9009","chr6.39330000.39335000","chr6.39790000.39795000",460000,9,0.006388194,39330000,39790000,39335000,39795000,"chr6",275994,0,1,3,4,"chr6",1,0.00421940928270042
"9010","chr6.13685000.13690000","chr6.13705000.13710000",20000,40,0.0007119341,13685000,13705000,13690000,13710000,"chr6",276010,4,11,18,33,"chr6",1,0.154711673699015
"9011","chr6.111055000.111060000","chr6.111260000.111265000",205000,13,0.002119166,111055000,111260000,111060000,111265000,"chr6",276017,3,8,11,22,"chr6",1,0.0335208626347867
"9012","chr6.143270000.143275000","chr6.143770000.143775000",500000,12,2.794229e-05,143270000,143770000,143275000,143775000,"chr6",276019,0,4,1,5,"chr6",1,0.0070323488045007
"9013","chr6.131415000.131420000","chr6.131440000.131445000",25000,37,0.0008178929,131415000,131440000,131420000,131445000,"chr6",276062,1,2,5,8,"chr6",1,0.0346929207688701
"9014","chr6.15320000.15325000","chr6.15490000.15495000",170000,18,8.51929e-06,15320000,15490000,15325000,15495000,"chr6",276071,0,0,4,4,"chr6",1,0.00843881856540084
"9015","chr6.3245000.3250000","chr6.4015000.4020000",770000,8,0.00242563,3245000,4015000,3250000,4020000,"chr6",276099,3,9,10,22,"chr6",1,0.0206282231598687
"9016","chr6.157105000.157110000","chr6.157440000.157445000",335000,12,0.000366144,157105000,157440000,157110000,157445000,"chr6",276121,0,2,1,3,"chr6",1,0.00421940928270042
"9017","chr6.27175000.27180000","chr6.27515000.27520000",340000,10,0.006135482,27175000,27515000,27180000,27520000,"chr6",276149,0,4,6,10,"chr6",1,0.0117205813408345
"9018","chr6.134880000.134885000","chr6.134910000.134915000",30000,31,0.002960758,134880000,134910000,134885000,134915000,"chr6",276156,1,5,5,11,"chr6",1,0.0399671823722457
"9019","chr6.30625000.30630000","chr6.30690000.30695000",65000,19,0.009047489,30625000,30690000,30630000,30695000,"chr6",276205,3,24,23,50,"chr6",1,0.111345522737928
"9020","chr6.26285000.26290000","chr6.26310000.26315000",25000,47,1.309885e-07,26285000,26310000,26290000,26315000,"chr6",276238,3,4,5,12,"chr6",1,0.0661040787623066
"9021","chr6.136770000.136775000","chr6.136840000.136845000",70000,24,2.340075e-05,136770000,136840000,136775000,136845000,"chr6",276249,3,5,6,14,"chr6",1,0.0393811533052039
"9022","chr6.149450000.149455000","chr6.149745000.149750000",295000,14,3.451758e-05,149450000,149745000,149455000,149750000,"chr6",276256,1,4,9,14,"chr6",1,0.0229723394280356
"9023","chr6.53050000.53055000","chr6.53260000.53265000",210000,12,0.006222837,53050000,53260000,53055000,53265000,"chr6",276285,0,6,3,9,"chr6",1,0.0126582278481013
"9024","chr6.3125000.3130000","chr6.4005000.4010000",880000,7,0.006595894,3125000,4005000,3130000,4010000,"chr6",276292,1,13,8,22,"chr6",1,0.0180496952648851
"9025","chr6.31615000.31620000","chr6.31775000.31780000",160000,14,0.002960758,31615000,31775000,31620000,31780000,"chr6",276313,1,1,2,4,"chr6",1,0.00656352555086732
"9026","chr6.3280000.3285000","chr6.3805000.3810000",525000,9,0.003382287,3280000,3805000,3285000,3810000,"chr6",276320,0,1,3,4,"chr6",1,0.00421940928270042
"9027","chr6.16295000.16300000","chr6.16555000.16560000",260000,11,0.006289337,16295000,16555000,16300000,16560000,"chr6",276328,5,1,2,8,"chr6",1,0.0103141115799344
"9028","chr6.36875000.36880000","chr6.36955000.36960000",80000,19,0.001487732,36875000,36955000,36880000,36960000,"chr6",276335,0,1,2,3,"chr6",1,0.00668073136427567
"9029","chr6.12895000.12900000","chr6.13325000.13330000",430000,15,2.91042e-07,12895000,13325000,12900000,13330000,"chr6",276337,0,2,1,3,"chr6",1,0.00527426160337553
"9030","chr6.16720000.16725000","chr6.17080000.17085000",360000,10,0.004767617,16720000,17080000,16725000,17085000,"chr6",276366,1,1,1,3,"chr6",1,0.00351617440225035
"9031","chr6.111705000.111710000","chr6.111970000.111975000",265000,14,7.939078e-05,111705000,111970000,111710000,111975000,"chr6",276371,0,2,3,5,"chr6",1,0.00820440693858415
"9032","chr6.108890000.108895000","chr6.109380000.109385000",490000,9,0.004785622,108890000,109380000,108895000,109385000,"chr6",276399,0,5,0,5,"chr6",1,0.00527426160337553
"9033","chr6.134560000.134565000","chr6.135055000.135060000",495000,11,0.0001806549,134560000,135055000,134565000,135060000,"chr6",276435,0,1,1,2,"chr6",1,0.00257852789498359
"9034","chr6.39345000.39350000","chr6.39650000.39655000",305000,13,0.000137848,39345000,39650000,39350000,39655000,"chr6",276464,0,2,2,4,"chr6",1,0.00609470229723394
"9035","chr6.35270000.35275000","chr6.35415000.35420000",145000,17,0.0001319731,35270000,35415000,35275000,35420000,"chr6",276477,4,4,5,13,"chr6",1,0.0259024847632443
"9036","chr6.37690000.37695000","chr6.38435000.38440000",745000,9,0.0004895052,37690000,38435000,37695000,38440000,"chr6",276478,0,1,1,2,"chr6",1,0.00210970464135021
"9037","chr6.26205000.26210000","chr6.26280000.26285000",75000,29,1.013392e-08,26205000,26280000,26210000,26285000,"chr6",276512,0,4,5,9,"chr6",1,0.0305907172995781
"9038","chr6.31680000.31685000","chr6.31735000.31740000",55000,34,3.167742e-09,31680000,31735000,31685000,31740000,"chr6",276579,0,3,1,4,"chr6",1,0.0159399906235349
"9039","chr6.132295000.132300000","chr6.132530000.132535000",235000,18,3.061033e-07,132295000,132530000,132300000,132535000,"chr6",276587,0,3,4,7,"chr6",1,0.0147679324894515
"9040","chr6.132500000.132505000","chr6.132530000.132535000",30000,33,0.0006400976,132500000,132530000,132505000,132535000,"chr6",276619,0,2,4,6,"chr6",1,0.0232067510548523
"9041","chr6.28635000.28640000","chr6.28980000.28985000",345000,10,0.005746584,28635000,28980000,28640000,28985000,"chr6",276622,0,3,3,6,"chr6",1,0.0070323488045007
"9042","chr6.149405000.149410000","chr6.149755000.149760000",350000,34,1.810889e-26,149405000,149755000,149410000,149760000,"chr6",276697,0,3,2,5,"chr6",1,0.0199249882794187
"9043","chr6.3000000.3005000","chr6.3050000.3055000",50000,60,3.220478e-27,3e+06,3050000,3005000,3055000,"chr6",276768,2,9,11,22,"chr6",1,0.154711673699015
"9044","chr6.30585000.30590000","chr6.30615000.30620000",30000,31,0.002960758,30585000,30615000,30590000,30620000,"chr6",276773,0,2,2,4,"chr6",1,0.0145335208626348
"9045","chr6.52285000.52290000","chr6.52360000.52365000",75000,27,1.788903e-07,52285000,52360000,52290000,52365000,"chr6",276797,2,0,1,3,"chr6",1,0.00949367088607595
"9046","chr6.111010000.111015000","chr6.111210000.111215000",200000,13,0.00250774,111010000,111210000,111015000,111215000,"chr6",276803,2,2,4,8,"chr6",1,0.0121894045944679
"9047","chr6.167895000.167900000","chr6.168310000.168315000",415000,11,0.0005294253,167895000,168310000,167900000,168315000,"chr6",276807,0,2,0,2,"chr6",1,0.00257852789498359
"9048","chr6.157755000.157760000","chr6.158010000.158015000",255000,13,0.0004857598,157755000,158010000,157760000,158015000,"chr6",276847,2,9,6,17,"chr6",1,0.0259024847632443
"9049","chr6.34150000.34155000","chr6.34605000.34610000",455000,12,5.545051e-05,34150000,34605000,34155000,34610000,"chr6",276853,2,5,7,14,"chr6",1,0.019690576652602
"9050","chr6.26100000.26105000","chr6.26195000.26200000",95000,21,2.651746e-05,26100000,26195000,26105000,26200000,"chr6",276903,5,13,13,31,"chr6",1,0.0763009845288326
"9051","chr6.27130000.27135000","chr6.27750000.27755000",620000,8,0.006921365,27130000,27750000,27135000,27755000,"chr6",276908,1,6,5,12,"chr6",1,0.0112517580872011
"9052","chr6.17885000.17890000","chr6.18095000.18100000",210000,13,0.001800439,17885000,18095000,17890000,18100000,"chr6",276921,2,8,9,19,"chr6",1,0.0289498359118612
"9053","chr6.134515000.134520000","chr6.135200000.135205000",685000,8,0.004284741,134515000,135200000,134520000,135205000,"chr6",276953,0,2,2,4,"chr6",1,0.00375058602906704
"9054","chr6.157755000.157760000","chr6.158025000.158030000",270000,11,0.005168928,157755000,158025000,157760000,158030000,"chr6",276964,0,6,5,11,"chr6",1,0.0141819034224098
"9055","chr6.27125000.27130000","chr6.27790000.27795000",665000,8,0.004994238,27125000,27790000,27130000,27795000,"chr6",276999,0,4,4,8,"chr6",1,0.00750117205813408
"9056","chr6.26285000.26290000","chr6.27125000.27130000",840000,11,3.489748e-06,26285000,27125000,26290000,27130000,"chr6",277002,2,4,5,11,"chr6",1,0.0141819034224098
"9057","chr6.26180000.26185000","chr6.26570000.26575000",390000,12,0.0001506113,26180000,26570000,26185000,26575000,"chr6",277008,2,12,10,24,"chr6",1,0.0337552742616034
"9058","chr6.145030000.145035000","chr6.145075000.145080000",45000,23,0.008672865,145030000,145075000,145035000,145080000,"chr6",277030,1,0,3,4,"chr6",1,0.0107829348335677
"9059","chr6.3845000.3850000","chr6.3940000.3945000",95000,22,7.021292e-06,3845000,3940000,3850000,3945000,"chr6",277056,0,1,0,1,"chr6",1,0.00257852789498359
"9060","chr6.158645000.158650000","chr6.159105000.159110000",460000,13,8.13e-06,158645000,159105000,158650000,159110000,"chr6",277058,1,1,1,3,"chr6",1,0.00457102672292546
"9061","chr6.24580000.24585000","chr6.24765000.24770000",185000,25,1.41345e-11,24580000,24765000,24585000,24770000,"chr6",277105,0,2,0,2,"chr6",1,0.00586029067041725
"9062","chr6.26310000.26315000","chr6.26550000.26555000",240000,36,6.334977e-25,26310000,26550000,26315000,26555000,"chr6",277119,0,1,7,8,"chr6",1,0.0337552742616034
"9063","chr6.17010000.17015000","chr6.17085000.17090000",75000,20,0.0009604426,17010000,17085000,17015000,17090000,"chr6",277136,1,6,3,10,"chr6",1,0.023441162681669
"9064","chr6.73125000.73130000","chr6.73285000.73290000",160000,15,0.0008765327,73125000,73285000,73130000,73290000,"chr6",277156,0,3,1,4,"chr6",1,0.0070323488045007
"9065","chr6.34155000.34160000","chr6.34610000.34615000",455000,11,0.0003076522,34155000,34610000,34160000,34615000,"chr6",277174,6,21,24,51,"chr6",1,0.0657524613220816
"9066","chr6.142470000.142475000","chr6.142710000.142715000",240000,15,3.761688e-05,142470000,142710000,142475000,142715000,"chr6",277193,1,3,3,7,"chr6",1,0.0123066104078762
"9067","chr6.134500000.134505000","chr6.134910000.134915000",410000,16,5.904898e-08,134500000,134910000,134505000,134915000,"chr6",277196,3,5,5,13,"chr6",1,0.0243788091889358
"9068","chr6.26435000.26440000","chr6.26550000.26555000",115000,15,0.006219749,26435000,26550000,26440000,26555000,"chr6",277216,0,1,9,10,"chr6",1,0.0175808720112518
"9069","chr6.13615000.13620000","chr6.13685000.13690000",70000,29,3.352765e-08,13615000,13685000,13620000,13690000,"chr6",277217,6,9,12,27,"chr6",1,0.0917721518987342
"9070","chr6.42710000.42715000","chr6.42840000.42845000",130000,19,1.972107e-05,42710000,42840000,42715000,42845000,"chr6",277224,3,19,23,45,"chr6",1,0.100210970464135
"9071","chr6.3120000.3125000","chr6.3250000.3255000",130000,28,7.508999e-12,3120000,3250000,3125000,3255000,"chr6",277229,1,0,0,1,"chr6",1,0.00328176277543366
"9072","chr6.17860000.17865000","chr6.17985000.17990000",125000,37,1.855633e-19,17860000,17985000,17865000,17990000,"chr6",277256,3,4,2,9,"chr6",1,0.0390295358649789
"9073","chr6.15325000.15330000","chr6.15440000.15445000",115000,19,5.551494e-05,15325000,15440000,15330000,15445000,"chr6",277258,0,5,6,11,"chr6",1,0.0244960150023441
"9074","chr6.26205000.26210000","chr6.26240000.26245000",35000,27,0.006289337,26205000,26240000,26210000,26245000,"chr6",277276,0,4,5,9,"chr6",1,0.0284810126582278
"9075","chr6.12455000.12460000","chr6.12475000.12480000",20000,39,0.001426362,12455000,12475000,12460000,12480000,"chr6",277284,0,2,3,5,"chr6",1,0.0228551336146273
"9076","chr6.15260000.15265000","chr6.15420000.15425000",160000,15,0.0008765327,15260000,15420000,15265000,15425000,"chr6",277324,6,12,8,26,"chr6",1,0.0457102672292546
"9077","chr6.31615000.31620000","chr6.31825000.31830000",210000,18,1.033846e-06,31615000,31825000,31620000,31830000,"chr6",277327,3,13,14,30,"chr6",1,0.0632911392405063
"9078","chr6.30645000.30650000","chr6.30675000.30680000",30000,33,0.0006400976,30645000,30675000,30650000,30680000,"chr6",277335,0,6,3,9,"chr6",1,0.0348101265822785
"9079","chr6.15265000.15270000","chr6.15325000.15330000",60000,24,0.0001730704,15265000,15325000,15270000,15330000,"chr6",277339,3,3,1,7,"chr6",1,0.019690576652602
"9080","chr6.42700000.42705000","chr6.42840000.42845000",140000,20,2.453018e-06,42700000,42840000,42705000,42845000,"chr6",277349,3,25,26,54,"chr6",1,0.126582278481013
"9081","chr6.158475000.158480000","chr6.158495000.158500000",20000,39,0.001426362,158475000,158495000,158480000,158500000,"chr6",277364,3,4,4,11,"chr6",1,0.05028129395218
"9082","chr6.30655000.30660000","chr6.30690000.30695000",35000,54,1.148336e-16,30655000,30690000,30660000,30695000,"chr6",277367,2,14,12,28,"chr6",1,0.177215189873418
"9083","chr6.30645000.30650000","chr6.31055000.31060000",410000,11,0.0005678185,30645000,31055000,30650000,31060000,"chr6",277389,0,6,3,9,"chr6",1,0.0116033755274262
"9084","chr6.34980000.34985000","chr6.35020000.35025000",40000,44,3.205729e-12,34980000,35020000,34985000,35025000,"chr6",277406,0,2,2,4,"chr6",1,0.0206282231598687
"9085","chr6.7275000.7280000","chr6.7390000.7395000",115000,15,0.006219749,7275000,7390000,7280000,7395000,"chr6",277456,4,8,10,22,"chr6",1,0.0386779184247539
"9086","chr6.43685000.43690000","chr6.44045000.44050000",360000,10,0.004767617,43685000,44045000,43690000,44050000,"chr6",277472,0,2,1,3,"chr6",1,0.00351617440225035
"9087","chr6.37685000.37690000","chr6.37965000.37970000",280000,19,6.319485e-09,37685000,37965000,37690000,37970000,"chr6",277488,4,2,6,12,"chr6",1,0.0267229254571027
"9088","chr6.6720000.6725000","chr6.7275000.7280000",555000,9,0.002578828,6720000,7275000,6725000,7280000,"chr6",277512,2,0,0,2,"chr6",1,0.00210970464135021
"9089","chr6.10510000.10515000","chr6.10760000.10765000",250000,16,5.172591e-06,10510000,10760000,10515000,10765000,"chr6",277612,4,7,6,17,"chr6",1,0.0318799812470699
"9090","chr6.134305000.134310000","chr6.134370000.134375000",65000,21,0.001439076,134305000,134370000,134310000,134375000,"chr6",277636,6,12,11,29,"chr6",1,0.0713783403656821
"9091","chr6.2850000.2855000","chr6.2970000.2975000",120000,20,9.658193e-06,2850000,2970000,2855000,2975000,"chr6",277689,1,7,3,11,"chr6",1,0.0257852789498359
"9092","chr6.31365000.31370000","chr6.31460000.31465000",95000,33,1.588492e-13,31365000,31460000,31370000,31465000,"chr6",277690,1,2,3,6,"chr6",1,0.0232067510548523
"9093","chr6.157860000.157865000","chr6.158025000.158030000",165000,13,0.007734444,157860000,158025000,157865000,158030000,"chr6",277693,0,6,5,11,"chr6",1,0.0167604313173933
"9094","chr6.136965000.136970000","chr6.137095000.137100000",130000,22,2.270638e-07,136965000,137095000,136970000,137100000,"chr6",277711,1,3,3,7,"chr6",1,0.0180496952648851
"9095","chr6.156555000.156560000","chr6.156580000.156585000",25000,34,0.006369861,156555000,156580000,156560000,156585000,"chr6",277748,1,3,3,7,"chr6",1,0.0278949835911861
"9096","chr6.16620000.16625000","chr6.16725000.16730000",105000,17,0.001335707,16620000,16725000,16625000,16730000,"chr6",277761,0,5,0,5,"chr6",1,0.00996249413970933
"9097","chr6.13330000.13335000","chr6.13535000.13540000",205000,21,6.922675e-09,13330000,13535000,13335000,13540000,"chr6",277802,0,2,1,3,"chr6",1,0.00738396624472574
"9098","chr6.56770000.56775000","chr6.56810000.56815000",40000,27,0.001181139,56770000,56810000,56775000,56815000,"chr6",277813,0,4,0,4,"chr6",1,0.0126582278481013
"9099","chr6.134900000.134905000","chr6.135140000.135145000",240000,11,0.009613542,134900000,135140000,134905000,135145000,"chr6",277831,3,8,5,16,"chr6",1,0.0206282231598687
"9100","chr6.17705000.17710000","chr6.18265000.18270000",560000,11,7.843237e-05,17705000,18265000,17710000,18270000,"chr6",277847,0,3,1,4,"chr6",1,0.00515705578996718
"9101","chr6.89685000.89690000","chr6.90035000.90040000",350000,12,0.0002848833,89685000,90035000,89690000,90040000,"chr6",277871,0,5,5,10,"chr6",1,0.0140646976090014
"9102","chr6.83825000.83830000","chr6.83875000.83880000",50000,24,0.00140844,83825000,83875000,83830000,83880000,"chr6",277901,2,4,3,9,"chr6",1,0.0253164556962025
"9103","chr6.44135000.44140000","chr6.44235000.44240000",100000,20,5.591745e-05,44135000,44235000,44140000,44240000,"chr6",277933,0,3,6,9,"chr6",1,0.0210970464135021
"9104","chr6.16510000.16515000","chr6.16700000.16705000",190000,16,6.231356e-05,16510000,16700000,16515000,16705000,"chr6",277946,0,3,4,7,"chr6",1,0.0131270511017346
"9105","chr6.118935000.118940000","chr6.119125000.119130000",190000,13,0.003407933,118935000,119125000,118940000,119130000,"chr6",277948,0,4,1,5,"chr6",1,0.00761837787154243
"9106","chr6.34155000.34160000","chr6.34345000.34350000",190000,15,0.0002576869,34155000,34345000,34160000,34350000,"chr6",277959,9,24,22,55,"chr6",1,0.0966947960618847
"9107","chr6.157940000.157945000","chr6.158005000.158010000",65000,19,0.009047489,157940000,158005000,157945000,158010000,"chr6",277975,0,3,1,4,"chr6",1,0.00890764181903422
"9108","chr6.136720000.136725000","chr6.136760000.136765000",40000,25,0.005943794,136720000,136760000,136725000,136765000,"chr6",277976,3,6,3,12,"chr6",1,0.0351617440225035
"9109","chr6.16330000.16335000","chr6.16405000.16410000",75000,47,1.187459e-22,16330000,16405000,16335000,16410000,"chr6",278036,3,7,10,20,"chr6",1,0.110173464603844
"9110","chr6.166755000.166760000","chr6.166795000.166800000",40000,31,2.750654e-05,166755000,166795000,166760000,166800000,"chr6",278103,0,2,1,3,"chr6",1,0.0109001406469761
"9111","chr6.17865000.17870000","chr6.17985000.17990000",120000,36,3.496996e-18,17865000,17985000,17870000,17990000,"chr6",278112,1,1,1,3,"chr6",1,0.0126582278481013
"9112","chr6.4460000.4465000","chr6.4805000.4810000",345000,11,0.001406608,4460000,4805000,4465000,4810000,"chr6",278114,1,0,1,2,"chr6",1,0.00257852789498359
"9113","chr6.31805000.31810000","chr6.31860000.31865000",55000,25,0.0001818139,31805000,31860000,31810000,31865000,"chr6",278128,0,4,3,7,"chr6",1,0.0205110173464604
"9114","chr6.149645000.149650000","chr6.149750000.149755000",105000,17,0.001335707,149645000,149750000,149650000,149755000,"chr6",278137,2,3,3,8,"chr6",1,0.0159399906235349
"9115","chr6.131180000.131185000","chr6.131440000.131445000",260000,13,0.0004195353,131180000,131440000,131185000,131445000,"chr6",278174,2,2,5,9,"chr6",1,0.0137130801687764
"9116","chr6.150090000.150095000","chr6.150130000.150135000",40000,28,0.0004907997,150090000,150130000,150095000,150135000,"chr6",278199,6,7,17,30,"chr6",1,0.0984528832630098
"9117","chr6.129595000.129600000","chr6.129660000.129665000",65000,19,0.009047489,129595000,129660000,129600000,129665000,"chr6",278201,1,5,4,10,"chr6",1,0.0222691045475856
"9118","chr6.136715000.136720000","chr6.136770000.136775000",55000,22,0.003206695,136715000,136770000,136720000,136775000,"chr6",278207,5,15,14,34,"chr6",1,0.0876699484294421
"9119","chr6.27125000.27130000","chr6.27865000.27870000",740000,23,2.616627e-19,27125000,27865000,27130000,27870000,"chr6",278251,2,1,5,8,"chr6",1,0.0215658696671355
"9120","chr6.157895000.157900000","chr6.157940000.157945000",45000,34,1.293185e-07,157895000,157940000,157900000,157945000,"chr6",278266,0,2,1,3,"chr6",1,0.0119549929676512
"9121","chr6.134510000.134515000","chr6.135140000.135145000",630000,13,5.541955e-07,134510000,135140000,134515000,135145000,"chr6",278277,3,5,5,13,"chr6",1,0.0198077824660103
"9122","chr6.37685000.37690000","chr6.37725000.37730000",40000,36,1.109589e-07,37685000,37725000,37690000,37730000,"chr6",278285,4,4,7,15,"chr6",1,0.0632911392405063
"9123","chr6.16330000.16335000","chr6.16410000.16415000",80000,28,1.535717e-08,16330000,16410000,16335000,16415000,"chr6",278329,1,2,1,4,"chr6",1,0.0131270511017346
"9124","chr6.108860000.108865000","chr6.109690000.109695000",830000,7,0.008744715,108860000,109690000,108865000,109695000,"chr6",278345,0,2,1,3,"chr6",1,0.00246132208157525
"9125","chr6.42980000.42985000","chr6.43020000.43025000",40000,27,0.001181139,42980000,43020000,42985000,43025000,"chr6",278401,7,14,31,52,"chr6",1,0.164556962025316
"9126","chr6.135035000.135040000","chr6.135055000.135060000",20000,45,1.479594e-05,135035000,135055000,135040000,135060000,"chr6",278439,2,5,5,12,"chr6",1,0.0632911392405063
"9127","chr6.134500000.134505000","chr6.134550000.134555000",50000,24,0.00140844,134500000,134550000,134505000,134555000,"chr6",278453,2,5,4,11,"chr6",1,0.0309423347398031
"9128","chr6.3845000.3850000","chr6.4005000.4010000",160000,20,6.801276e-07,3845000,4005000,3850000,4010000,"chr6",278467,0,1,0,1,"chr6",1,0.0023441162681669
"9129","chr6.31690000.31695000","chr6.31805000.31810000",115000,21,3.493892e-06,31690000,31805000,31695000,31810000,"chr6",278474,2,0,4,6,"chr6",1,0.0147679324894515
"9130","chr6.10950000.10955000","chr6.11495000.11500000",545000,18,2.824134e-11,10950000,11495000,10955000,11500000,"chr6",278481,0,0,4,4,"chr6",1,0.00843881856540084
"9131","chr6.155025000.155030000","chr6.155095000.155100000",70000,22,0.0002318073,155025000,155095000,155030000,155100000,"chr6",278496,2,4,1,7,"chr6",1,0.0180496952648851
"9132","chr6.157355000.157360000","chr6.157485000.157490000",130000,20,4.757806e-06,157355000,157485000,157360000,157490000,"chr6",278530,2,6,3,11,"chr6",1,0.0257852789498359
"9133","chr6.134480000.134485000","chr6.135140000.135145000",660000,30,1.206169e-27,134480000,135140000,134485000,135145000,"chr6",278592,1,13,5,19,"chr6",1,0.0668073136427567
"9134","chr6.10510000.10515000","chr6.10690000.10695000",180000,25,2.116736e-11,10510000,10690000,10515000,10695000,"chr6",278606,4,7,6,17,"chr6",1,0.0498124706985466
"9135","chr6.53030000.53035000","chr6.53285000.53290000",255000,14,0.0001071815,53030000,53285000,53035000,53290000,"chr6",278608,1,5,4,10,"chr6",1,0.0164088138771683
"9136","chr6.16330000.16335000","chr6.16965000.16970000",635000,17,4.557019e-11,16330000,16965000,16335000,16970000,"chr6",278620,3,4,2,9,"chr6",1,0.0179324894514768
"9137","chr6.37670000.37675000","chr6.38435000.38440000",765000,9,0.0004145624,37670000,38435000,37675000,38440000,"chr6",278660,2,2,2,6,"chr6",1,0.00632911392405063
"9138","chr6.26055000.26060000","chr6.26095000.26100000",40000,33,3.366466e-06,26055000,26095000,26060000,26100000,"chr6",278674,0,5,9,14,"chr6",1,0.0541490857946554
"9139","chr6.53030000.53035000","chr6.53280000.53285000",250000,13,0.0005511993,53030000,53280000,53035000,53285000,"chr6",278721,1,4,3,8,"chr6",1,0.0121894045944679
"9140","chr6.11270000.11275000","chr6.11315000.11320000",45000,23,0.008672865,11270000,11315000,11275000,11320000,"chr6",278724,1,1,0,2,"chr6",1,0.00539146741678387
"9141","chr6.17860000.17865000","chr6.17885000.17890000",25000,36,0.00167179,17860000,17885000,17865000,17890000,"chr6",278759,2,20,21,43,"chr6",1,0.181434599156118
"9142","chr6.158375000.158380000","chr6.158475000.158480000",100000,17,0.001910446,158375000,158475000,158380000,158480000,"chr6",278811,0,2,1,3,"chr6",1,0.0059774964838256
"9143","chr6.143270000.143275000","chr6.143320000.143325000",50000,32,2.539278e-07,143270000,143320000,143275000,143325000,"chr6",278838,0,4,1,5,"chr6",1,0.0187529301453352
"9144","chr6.17865000.17870000","chr6.18150000.18155000",285000,14,4.54602e-05,17865000,18150000,17870000,18155000,"chr6",278849,1,1,1,3,"chr6",1,0.00492264416315049
"9145","chr6.15310000.15315000","chr6.15385000.15390000",75000,18,0.006748519,15310000,15385000,15315000,15390000,"chr6",278877,0,6,7,13,"chr6",1,0.0274261603375527
"9146","chr6.3285000.3290000","chr6.3385000.3390000",100000,16,0.005454981,3285000,3385000,3290000,3390000,"chr6",278878,0,4,3,7,"chr6",1,0.0131270511017346
"9147","chr6.26270000.26275000","chr6.26310000.26315000",40000,30,7.566497e-05,26270000,26310000,26275000,26315000,"chr6",278899,0,2,0,2,"chr6",1,0.0070323488045007
"9148","chr6.130615000.130620000","chr6.131005000.131010000",390000,11,0.0007380716,130615000,131005000,130620000,131010000,"chr6",278908,0,2,0,2,"chr6",1,0.00257852789498359
"9149","chr6.3930000.3935000","chr6.3975000.3980000",45000,31,4.326025e-06,3930000,3975000,3935000,3980000,"chr6",278988,2,13,11,26,"chr6",1,0.0944678856071261
"9150","chr6.37670000.37675000","chr6.38180000.38185000",510000,9,0.003919333,37670000,38180000,37675000,38185000,"chr6",278990,1,2,2,5,"chr6",1,0.00527426160337553
"9151","chr6.149405000.149410000","chr6.149750000.149755000",345000,36,8.089118e-29,149405000,149750000,149410000,149755000,"chr6",279016,0,3,2,5,"chr6",1,0.0210970464135021
"9152","chr6.113970000.113975000","chr6.114165000.114170000",195000,14,0.0008147436,113970000,114165000,113975000,114170000,"chr6",279037,1,9,3,13,"chr6",1,0.0213314580403188
"9153","chr6.4350000.4355000","chr6.4605000.4610000",255000,11,0.0069718,4350000,4605000,4355000,4610000,"chr6",279056,0,2,0,2,"chr6",1,0.00257852789498359
"9154","chr6.27125000.27130000","chr6.27440000.27445000",315000,11,0.002256852,27125000,27440000,27130000,27445000,"chr6",279078,2,5,7,14,"chr6",1,0.0180496952648851
"9155","chr6.129575000.129580000","chr6.129595000.129600000",20000,36,0.009530062,129575000,129595000,129580000,129600000,"chr6",279080,1,3,3,7,"chr6",1,0.029535864978903
"9156","chr6.24910000.24915000","chr6.25015000.25020000",105000,21,8.960961e-06,24910000,25015000,24915000,25020000,"chr6",279109,1,10,5,16,"chr6",1,0.0393811533052039
"9157","chr6.2750000.2755000","chr6.2920000.2925000",170000,13,0.006513716,2750000,2920000,2755000,2925000,"chr6",279117,0,1,1,2,"chr6",1,0.00304735114861697
"9158","chr6.26205000.26210000","chr6.26320000.26325000",115000,18,0.0001982416,26205000,26320000,26210000,26325000,"chr6",279128,0,4,5,9,"chr6",1,0.0189873417721519
"9159","chr6.2845000.2850000","chr6.2970000.2975000",125000,16,0.001254039,2845000,2970000,2850000,2975000,"chr6",279145,1,7,3,11,"chr6",1,0.0206282231598687
"9160","chr6.157100000.157105000","chr6.157180000.157185000",80000,19,0.001487732,157100000,157180000,157105000,157185000,"chr6",279200,0,4,1,5,"chr6",1,0.0111345522737928
"9161","chr6.28635000.28640000","chr6.28985000.28990000",350000,10,0.00539413,28635000,28985000,28640000,28990000,"chr6",279201,2,3,3,8,"chr6",1,0.00937646507266761
"9162","chr6.26360000.26365000","chr6.26420000.26425000",60000,20,0.007808024,26360000,26420000,26365000,26425000,"chr6",279214,0,1,2,3,"chr6",1,0.0070323488045007
"9163","chr6.134500000.134505000","chr6.134640000.134645000",140000,28,2.662151e-12,134500000,134640000,134505000,134645000,"chr6",279218,0,2,1,3,"chr6",1,0.00984528832630099
"9164","chr6.13395000.13400000","chr6.13455000.13460000",60000,22,0.001313581,13395000,13455000,13400000,13460000,"chr6",279232,2,5,6,13,"chr6",1,0.0335208626347867
"9165","chr6.56785000.56790000","chr6.56810000.56815000",25000,38,0.000389857,56785000,56810000,56790000,56815000,"chr6",279248,2,4,6,12,"chr6",1,0.0534458509142053
"9166","chr6.147825000.147830000","chr6.148470000.148475000",645000,9,0.001130877,147825000,148470000,147830000,148475000,"chr6",279334,0,2,1,3,"chr6",1,0.00316455696202532
"9167","chr6.163280000.163285000","chr6.163925000.163930000",645000,8,0.005772119,163280000,163925000,163285000,163930000,"chr6",279341,0,2,0,2,"chr6",1,0.00187529301453352
"9168","chr6.26435000.26440000","chr6.26530000.26535000",95000,22,7.021292e-06,26435000,26530000,26440000,26535000,"chr6",279346,2,5,8,15,"chr6",1,0.0386779184247539
"9169","chr6.158405000.158410000","chr6.158480000.158485000",75000,19,0.002672369,158405000,158480000,158410000,158485000,"chr6",279374,0,0,7,7,"chr6",1,0.0155883731833099
"9170","chr6.26470000.26475000","chr6.26570000.26575000",100000,20,5.591745e-05,26470000,26570000,26475000,26575000,"chr6",279381,3,8,5,16,"chr6",1,0.0375058602906704
"9171","chr6.26400000.26405000","chr6.26435000.26440000",35000,53,5.231394e-16,26400000,26435000,26405000,26440000,"chr6",279400,2,9,10,21,"chr6",1,0.130450070323488
"9172","chr6.27155000.27160000","chr6.27865000.27870000",710000,10,0.0001000098,27155000,27865000,27160000,27870000,"chr6",279401,5,1,5,11,"chr6",1,0.012892639474918
"9173","chr6.83865000.83870000","chr6.84225000.84230000",360000,14,7.968921e-06,83865000,84225000,83870000,84230000,"chr6",279465,0,2,1,3,"chr6",1,0.00492264416315049
"9174","chr6.31165000.31170000","chr6.31365000.31370000",200000,16,3.97442e-05,31165000,31365000,31170000,31370000,"chr6",279471,1,4,3,8,"chr6",1,0.0150023441162682
"9175","chr6.149430000.149435000","chr6.149830000.149835000",400000,11,0.0006472299,149430000,149830000,149435000,149835000,"chr6",279488,3,11,5,19,"chr6",1,0.0244960150023441
"9176","chr6.37965000.37970000","chr6.38220000.38225000",255000,14,0.0001071815,37965000,38220000,37970000,38225000,"chr6",279497,4,2,6,12,"chr6",1,0.019690576652602
"9177","chr6.37710000.37715000","chr6.38555000.38560000",845000,7,0.008007548,37710000,38555000,37715000,38560000,"chr6",279527,0,5,1,6,"chr6",1,0.00492264416315049
"9178","chr6.27125000.27130000","chr6.27145000.27150000",20000,49,4.206323e-07,27125000,27145000,27130000,27150000,"chr6",279557,0,5,3,8,"chr6",1,0.0459446788560713
"9179","chr6.6675000.6680000","chr6.7275000.7280000",600000,10,0.0003035352,6675000,7275000,6680000,7280000,"chr6",279568,2,12,11,25,"chr6",1,0.0293014533520863
"9180","chr6.11250000.11255000","chr6.11495000.11500000",245000,13,0.0006330558,11250000,11495000,11255000,11500000,"chr6",279572,0,0,1,1,"chr6",1,0.00152367557430849
"9181","chr6.134640000.134645000","chr6.134910000.134915000",270000,12,0.001357449,134640000,134910000,134645000,134915000,"chr6",279592,0,2,1,3,"chr6",1,0.00421940928270042
"9182","chr6.17600000.17605000","chr6.18265000.18270000",665000,14,3.585763e-08,17600000,18265000,17605000,18270000,"chr6",279610,3,3,1,7,"chr6",1,0.0114861697140178
"9183","chr6.24575000.24580000","chr6.24765000.24770000",190000,22,2.941765e-09,24575000,24765000,24580000,24770000,"chr6",279650,1,1,1,3,"chr6",1,0.00773558368495077
"9184","chr6.11095000.11100000","chr6.11125000.11130000",30000,33,0.0006400976,11095000,11125000,11100000,11130000,"chr6",279689,1,9,5,15,"chr6",1,0.0580168776371308
"9185","chr6.110825000.110830000","chr6.111210000.111215000",385000,12,0.000163514,110825000,111210000,110830000,111215000,"chr6",279696,2,2,4,8,"chr6",1,0.0112517580872011
"9186","chr6.111010000.111015000","chr6.111265000.111270000",255000,11,0.0069718,111010000,111265000,111015000,111270000,"chr6",279707,0,4,4,8,"chr6",1,0.0103141115799344
"9187","chr6.43245000.43250000","chr6.43305000.43310000",60000,20,0.007808024,43245000,43305000,43250000,43310000,"chr6",279723,2,8,4,14,"chr6",1,0.0328176277543366
"9188","chr6.134465000.134470000","chr6.134900000.134905000",435000,9,0.00818327,134465000,134900000,134470000,134905000,"chr6",279761,0,3,2,5,"chr6",1,0.00527426160337553
"9189","chr6.74405000.74410000","chr6.75285000.75290000",880000,7,0.006595894,74405000,75285000,74410000,75290000,"chr6",279766,3,3,3,9,"chr6",1,0.00738396624472574
"9190","chr6.13395000.13400000","chr6.13410000.13415000",15000,41,0.0003488147,13395000,13410000,13400000,13415000,"chr6",279779,0,5,2,7,"chr6",1,0.033638068448195
"9191","chr6.26125000.26130000","chr6.26205000.26210000",80000,22,5.206096e-05,26125000,26205000,26130000,26210000,"chr6",279909,0,4,5,9,"chr6",1,0.0232067510548523
"9192","chr6.26170000.26175000","chr6.26285000.26290000",115000,15,0.006219749,26170000,26285000,26175000,26290000,"chr6",279914,2,4,5,11,"chr6",1,0.0193389592123769
"9193","chr6.150730000.150735000","chr6.151025000.151030000",295000,11,0.003195669,150730000,151025000,150735000,151030000,"chr6",279923,1,8,14,23,"chr6",1,0.0296530707923113
"9194","chr6.154500000.154505000","chr6.154730000.154735000",230000,16,1.125926e-05,154500000,154730000,154505000,154735000,"chr6",279942,0,6,8,14,"chr6",1,0.0262541022034693
"9195","chr6.26170000.26175000","chr6.26570000.26575000",400000,11,0.0006472299,26170000,26570000,26175000,26575000,"chr6",279973,2,5,11,18,"chr6",1,0.0232067510548523
"9196","chr6.31700000.31705000","chr6.31735000.31740000",35000,27,0.006289337,31700000,31735000,31705000,31740000,"chr6",280012,0,3,1,4,"chr6",1,0.0126582278481013
"9197","chr6.108860000.108865000","chr6.109340000.109345000",480000,14,8.151413e-07,108860000,109340000,108865000,109345000,"chr6",280022,1,3,1,5,"chr6",1,0.00820440693858415
"9198","chr6.53345000.53350000","chr6.53495000.53500000",150000,14,0.004271906,53345000,53495000,53350000,53500000,"chr6",280045,1,2,1,4,"chr6",1,0.00656352555086732
"9199","chr6.132280000.132285000","chr6.132530000.132535000",250000,15,2.651746e-05,132280000,132530000,132285000,132535000,"chr6",280082,0,3,4,7,"chr6",1,0.0123066104078762
"9200","chr6.17155000.17160000","chr6.17600000.17605000",445000,14,1.569216e-06,17155000,17600000,17160000,17605000,"chr6",280129,1,6,5,12,"chr6",1,0.019690576652602
"9201","chr6.7390000.7395000","chr6.7590000.7595000",200000,14,0.0006806497,7390000,7590000,7395000,7595000,"chr6",280152,1,0,1,2,"chr6",1,0.00328176277543366
"9202","chr6.111680000.111685000","chr6.111970000.111975000",290000,18,3.043262e-08,111680000,111970000,111685000,111975000,"chr6",280173,0,2,3,5,"chr6",1,0.0105485232067511
"9203","chr6.158200000.158205000","chr6.158300000.158305000",100000,17,0.001910446,158200000,158300000,158205000,158305000,"chr6",280174,1,0,2,3,"chr6",1,0.0059774964838256
"9204","chr6.26285000.26290000","chr6.26530000.26535000",245000,13,0.0006330558,26285000,26530000,26290000,26535000,"chr6",280181,5,4,5,14,"chr6",1,0.0213314580403188
"9205","chr6.26360000.26365000","chr6.26570000.26575000",210000,12,0.006222837,26360000,26570000,26365000,26575000,"chr6",280247,4,3,12,19,"chr6",1,0.0267229254571027
"9206","chr6.131205000.131210000","chr6.131440000.131445000",235000,34,1.737326e-22,131205000,131440000,131210000,131445000,"chr6",280274,2,1,5,8,"chr6",1,0.0318799812470699
"9207","chr6.35315000.35320000","chr6.35375000.35380000",60000,37,5.386759e-12,35315000,35375000,35320000,35380000,"chr6",280286,3,7,9,19,"chr6",1,0.0823956868260666
"9208","chr6.157875000.157880000","chr6.157925000.157930000",50000,26,0.0002097868,157875000,157925000,157880000,157930000,"chr6",280292,2,0,3,5,"chr6",1,0.0152367557430849
"9209","chr6.3750000.3755000","chr6.3990000.3995000",240000,13,0.0007231554,3750000,3990000,3755000,3995000,"chr6",280313,0,2,1,3,"chr6",1,0.00457102672292546
"9210","chr6.134500000.134505000","chr6.134520000.134525000",20000,48,1.054553e-06,134500000,134520000,134505000,134525000,"chr6",280366,3,5,6,14,"chr6",1,0.0787623066104079
"9211","chr6.31615000.31620000","chr6.31790000.31795000",175000,14,0.001683742,31615000,31790000,31620000,31795000,"chr6",280399,4,19,18,41,"chr6",1,0.0672761368963901
"9212","chr6.26205000.26210000","chr6.27125000.27130000",920000,8,0.0008565646,26205000,27125000,26210000,27130000,"chr6",280414,0,4,5,9,"chr6",1,0.00843881856540084
"9213","chr6.13405000.13410000","chr6.13535000.13540000",130000,17,0.0002859613,13405000,13535000,13410000,13540000,"chr6",280427,0,2,5,7,"chr6",1,0.0139474917955931
"9214","chr6.15260000.15265000","chr6.15325000.15330000",65000,30,3.101156e-08,15260000,15325000,15265000,15330000,"chr6",280468,5,5,6,16,"chr6",1,0.0562587904360056
"9215","chr6.136705000.136710000","chr6.136835000.136840000",130000,19,1.972107e-05,136705000,136835000,136710000,136840000,"chr6",280520,4,8,17,29,"chr6",1,0.0645804031879981
"9216","chr6.17830000.17835000","chr6.18100000.18105000",270000,21,1.708477e-10,17830000,18100000,17835000,18105000,"chr6",280530,1,8,4,13,"chr6",1,0.0319971870604782
"9217","chr6.35325000.35330000","chr6.35410000.35415000",85000,17,0.006589942,35325000,35410000,35330000,35415000,"chr6",280531,0,5,6,11,"chr6",1,0.0219174871073605
"9218","chr6.158220000.158225000","chr6.158265000.158270000",45000,28,0.0001029385,158220000,158265000,158225000,158270000,"chr6",280566,2,8,9,19,"chr6",1,0.0623534927332396
"9219","chr6.110980000.110985000","chr6.111265000.111270000",285000,13,0.0002187489,110980000,111265000,110985000,111270000,"chr6",280582,0,4,4,8,"chr6",1,0.0121894045944679
"9220","chr6.26605000.26610000","chr6.27440000.27445000",835000,7,0.00853743,26605000,27440000,26610000,27445000,"chr6",280592,1,7,5,13,"chr6",1,0.0106657290201594
"9221","chr6.24280000.24285000","chr6.24385000.24390000",105000,17,0.001335707,24280000,24385000,24285000,24390000,"chr6",280605,2,15,9,26,"chr6",1,0.0518049695264885
"9222","chr6.28215000.28220000","chr6.28250000.28255000",35000,27,0.006289337,28215000,28250000,28220000,28255000,"chr6",280629,1,6,3,10,"chr6",1,0.0316455696202532
"9223","chr6.136640000.136645000","chr6.136855000.136860000",215000,23,7.588019e-11,136640000,136855000,136645000,136860000,"chr6",280801,1,5,2,8,"chr6",1,0.0215658696671355
"9224","chr6.30690000.30695000","chr6.30765000.30770000",75000,18,0.006748519,30690000,30765000,30695000,30770000,"chr6",280811,5,3,6,14,"chr6",1,0.029535864978903
"9225","chr6.31775000.31780000","chr6.31825000.31830000",50000,25,0.0005592628,31775000,31825000,31780000,31830000,"chr6",280820,1,1,2,4,"chr6",1,0.0117205813408345
"9226","chr6.5140000.5145000","chr6.5260000.5265000",120000,15,0.004837722,5140000,5260000,5145000,5265000,"chr6",280826,1,0,1,2,"chr6",1,0.00351617440225035
"9227","chr6.42545000.42550000","chr6.42615000.42620000",70000,21,0.0006733273,42545000,42615000,42550000,42620000,"chr6",280877,4,9,9,22,"chr6",1,0.0541490857946554
"9228","chr6.26055000.26060000","chr6.26195000.26200000",140000,15,0.002020592,26055000,26195000,26060000,26200000,"chr6",280912,0,7,9,16,"chr6",1,0.0281293952180028
"9229","chr6.2845000.2850000","chr6.2990000.2995000",145000,29,2.263488e-13,2845000,2990000,2850000,2995000,"chr6",280920,1,7,6,14,"chr6",1,0.0475855602437881
"9230","chr6.26215000.26220000","chr6.26570000.26575000",355000,10,0.005076648,26215000,26570000,26220000,26575000,"chr6",280928,4,14,12,30,"chr6",1,0.0351617440225035
"9231","chr6.2850000.2855000","chr6.2915000.2920000",65000,25,1.92953e-05,2850000,2915000,2855000,2920000,"chr6",280934,9,25,13,47,"chr6",1,0.137716830754805
"9232","chr6.118965000.118970000","chr6.119125000.119130000",160000,13,0.009047489,118965000,119125000,118970000,119130000,"chr6",280949,0,3,1,4,"chr6",1,0.00609470229723394
"9233","chr6.25275000.25280000","chr6.25490000.25495000",215000,22,5.460137e-10,25275000,25490000,25280000,25495000,"chr6",280971,2,0,0,2,"chr6",1,0.00515705578996718
"9234","chr6.13405000.13410000","chr6.13550000.13555000",145000,20,1.781351e-06,13405000,13550000,13410000,13555000,"chr6",280996,0,2,6,8,"chr6",1,0.0187529301453352
"9235","chr6.26180000.26185000","chr6.27145000.27150000",965000,13,6.465914e-09,26180000,27145000,26185000,27150000,"chr6",281017,0,7,3,10,"chr6",1,0.0152367557430849
"9236","chr6.111085000.111090000","chr6.111205000.111210000",120000,15,0.004837722,111085000,111205000,111090000,111210000,"chr6",281048,3,9,8,20,"chr6",1,0.0351617440225035
"9237","chr6.28655000.28660000","chr6.28980000.28985000",325000,12,0.0004383063,28655000,28980000,28660000,28985000,"chr6",281085,0,5,6,11,"chr6",1,0.0154711673699015
"9238","chr6.36420000.36425000","chr6.37165000.37170000",745000,8,0.00286202,36420000,37165000,36425000,37170000,"chr6",281093,5,12,12,29,"chr6",1,0.0271917487107361
"9239","chr6.142680000.142685000","chr6.142700000.142705000",20000,36,0.009530062,142680000,142700000,142685000,142705000,"chr6",281111,2,1,2,5,"chr6",1,0.0210970464135021
"9240","chr6.125970000.125975000","chr6.125995000.126000000",25000,41,3.451758e-05,125970000,125995000,125975000,1.26e+08,"chr6",281112,1,0,1,2,"chr6",1,0.00961087669948429
"9241","chr6.3115000.3120000","chr6.3995000.4000000",880000,8,0.00114669,3115000,3995000,3120000,4e+06,"chr6",281120,1,7,5,13,"chr6",1,0.0121894045944679
"9242","chr6.27130000.27135000","chr6.27770000.27775000",640000,13,4.820223e-07,27130000,27770000,27135000,27775000,"chr6",281129,1,6,5,12,"chr6",1,0.0182841068917018
"9243","chr6.26280000.26285000","chr6.26570000.26575000",290000,12,0.0008640958,26280000,26570000,26285000,26575000,"chr6",281147,1,7,5,13,"chr6",1,0.0182841068917018
"9244","chr6.134530000.134535000","chr6.134640000.134645000",110000,15,0.008000267,134530000,134640000,134535000,134645000,"chr6",281160,0,0,1,1,"chr6",1,0.00175808720112518
"9245","chr6.110995000.111000000","chr6.111255000.111260000",260000,11,0.006289337,110995000,111255000,1.11e+08,111260000,"chr6",281187,2,6,17,25,"chr6",1,0.0322315986872949
"9246","chr6.131205000.131210000","chr6.131385000.131390000",180000,17,2.276163e-05,131205000,131385000,131210000,131390000,"chr6",281232,1,1,4,6,"chr6",1,0.0119549929676512
"9247","chr6.26125000.26130000","chr6.26180000.26185000",55000,39,2.051019e-12,26125000,26180000,26130000,26185000,"chr6",281292,2,12,8,22,"chr6",1,0.10056258790436
"9248","chr6.53435000.53440000","chr6.53480000.53485000",45000,23,0.008672865,53435000,53480000,53440000,53485000,"chr6",281336,2,2,2,6,"chr6",1,0.0161744022503516
"9249","chr6.3125000.3130000","chr6.4015000.4020000",890000,7,0.006271152,3125000,4015000,3130000,4020000,"chr6",281359,3,12,10,25,"chr6",1,0.0205110173464604
"9250","chr6.128520000.128525000","chr6.128740000.128745000",220000,12,0.004767617,128520000,128740000,128525000,128745000,"chr6",281385,0,0,1,1,"chr6",1,0.00140646976090014
"9251","chr6.110825000.110830000","chr6.111255000.111260000",430000,14,2.077534e-06,110825000,111255000,110830000,111260000,"chr6",281444,2,6,17,25,"chr6",1,0.0410220346929208
"9252","chr6.13445000.13450000","chr6.13555000.13560000",110000,16,0.002870974,13445000,13555000,13450000,13560000,"chr6",281457,2,1,2,5,"chr6",1,0.00937646507266761
"9253","chr6.26400000.26405000","chr6.26530000.26535000",130000,24,8.822323e-09,26400000,26530000,26405000,26535000,"chr6",281503,4,5,8,17,"chr6",1,0.0478199718706048
"9254","chr6.53050000.53055000","chr6.53285000.53290000",235000,22,1.528944e-10,53050000,53285000,53055000,53290000,"chr6",281506,3,6,5,14,"chr6",1,0.0360993905297703
"9255","chr6.26400000.26405000","chr6.26470000.26475000",70000,34,1.722729e-11,26400000,26470000,26405000,26475000,"chr6",281537,3,8,5,16,"chr6",1,0.0637599624941397
"9256","chr6.134510000.134515000","chr6.134530000.134535000",20000,37,0.005260689,134510000,134530000,134515000,134535000,"chr6",281608,0,0,4,4,"chr6",1,0.0173464603844351
"9257","chr6.15250000.15255000","chr6.15420000.15425000",170000,13,0.006513716,15250000,15420000,15255000,15425000,"chr6",281632,2,14,6,22,"chr6",1,0.0335208626347867
"9258","chr6.31680000.31685000","chr6.31700000.31705000",20000,48,1.054553e-06,31680000,31700000,31685000,31705000,"chr6",281653,1,8,6,15,"chr6",1,0.0843881856540084
"9259","chr6.31115000.31120000","chr6.31155000.31160000",40000,26,0.002722566,31115000,31155000,31120000,31160000,"chr6",281663,2,3,2,7,"chr6",1,0.0213314580403188
"9260","chr6.16335000.16340000","chr6.16410000.16415000",75000,18,0.006748519,16335000,16410000,16340000,16415000,"chr6",281725,0,2,1,3,"chr6",1,0.00632911392405063
"9261","chr6.134515000.134520000","chr6.134900000.134905000",385000,11,0.0007946151,134515000,134900000,134520000,134905000,"chr6",281731,0,2,2,4,"chr6",1,0.00515705578996718
"9262","chr6.27475000.27480000","chr6.27865000.27870000",390000,10,0.00331223,27475000,27865000,27480000,27870000,"chr6",281732,4,1,5,10,"chr6",1,0.0117205813408345
"9263","chr6.157105000.157110000","chr6.157355000.157360000",250000,12,0.002184215,157105000,157355000,157110000,157360000,"chr6",281761,0,2,1,3,"chr6",1,0.00421940928270042
"9264","chr6.110015000.110020000","chr6.110725000.110730000",710000,10,0.0001000098,110015000,110725000,110020000,110730000,"chr6",281794,0,3,3,6,"chr6",1,0.0070323488045007
"9265","chr6.34150000.34155000","chr6.34370000.34375000",220000,15,7.877136e-05,34150000,34370000,34155000,34375000,"chr6",281801,2,5,7,14,"chr6",1,0.0246132208157525
"9266","chr6.26530000.26535000","chr6.26550000.26555000",20000,76,2.875319e-21,26530000,26550000,26535000,26555000,"chr6",281805,0,1,8,9,"chr6",1,0.080168776371308
"9267","chr6.136605000.136610000","chr6.136640000.136645000",35000,28,0.002985581,136605000,136640000,136610000,136645000,"chr6",281808,1,6,2,9,"chr6",1,0.029535864978903
"9268","chr6.18265000.18270000","chr6.18320000.18325000",55000,22,0.003206695,18265000,18320000,18270000,18325000,"chr6",281830,4,3,1,8,"chr6",1,0.0206282231598687
"9269","chr6.132295000.132300000","chr6.132500000.132505000",205000,12,0.007127411,132295000,132500000,132300000,132505000,"chr6",281878,0,2,4,6,"chr6",1,0.00843881856540084
"9270","chr6.131305000.131310000","chr6.131415000.131420000",110000,15,0.008000267,131305000,131415000,131310000,131420000,"chr6",281901,1,9,5,15,"chr6",1,0.0263713080168776
"9271","chr6.157105000.157110000","chr6.157430000.157435000",325000,10,0.007483355,157105000,157430000,157110000,157435000,"chr6",281929,0,2,1,3,"chr6",1,0.00351617440225035
"9272","chr6.26380000.26385000","chr6.26550000.26555000",170000,13,0.006513716,26380000,26550000,26385000,26555000,"chr6",281981,0,1,5,6,"chr6",1,0.00914205344585091
"9273","chr6.37785000.37790000","chr6.38670000.38675000",885000,7,0.006415741,37785000,38670000,37790000,38675000,"chr6",281986,4,4,4,12,"chr6",1,0.00984528832630099
"9274","chr6.15690000.15695000","chr6.16205000.16210000",515000,23,1.875379e-16,15690000,16205000,15695000,16210000,"chr6",281996,0,6,8,14,"chr6",1,0.0377402719174871
"9275","chr6.53050000.53055000","chr6.53345000.53350000",295000,15,6.38924e-06,53050000,53345000,53055000,53350000,"chr6",282041,1,2,1,4,"chr6",1,0.0070323488045007
"9276","chr6.31825000.31830000","chr6.31860000.31865000",35000,28,0.002985581,31825000,31860000,31830000,31865000,"chr6",282051,0,4,3,7,"chr6",1,0.0229723394280356
"9277","chr6.111085000.111090000","chr6.111210000.111215000",125000,19,2.725089e-05,111085000,111210000,111090000,111215000,"chr6",282073,2,2,4,8,"chr6",1,0.0178152836380684
"9278","chr6.36755000.36760000","chr6.36965000.36970000",210000,14,0.0004857598,36755000,36965000,36760000,36970000,"chr6",282075,2,2,3,7,"chr6",1,0.0114861697140178
"9279","chr6.110940000.110945000","chr6.110990000.110995000",50000,26,0.0002097868,110940000,110990000,110945000,110995000,"chr6",282076,14,36,22,72,"chr6",1,0.219409282700422
"9280","chr6.158650000.158655000","chr6.158920000.158925000",270000,14,6.939039e-05,158650000,158920000,158655000,158925000,"chr6",282088,1,15,6,22,"chr6",1,0.0360993905297703
"9281","chr6.136965000.136970000","chr6.137075000.137080000",110000,15,0.008000267,136965000,137075000,136970000,137080000,"chr6",282138,2,3,5,10,"chr6",1,0.0175808720112518
"9282","chr6.52990000.52995000","chr6.53355000.53360000",365000,10,0.004466007,52990000,53355000,52995000,53360000,"chr6",282225,4,10,11,25,"chr6",1,0.0293014533520863
"9283","chr6.2950000.2955000","chr6.2970000.2975000",20000,66,2.396921e-15,2950000,2970000,2955000,2975000,"chr6",282240,1,7,3,11,"chr6",1,0.0850914205344585
"9284","chr6.136150000.136155000","chr6.136350000.136355000",200000,13,0.00250774,136150000,136350000,136155000,136355000,"chr6",282246,0,4,3,7,"chr6",1,0.0106657290201594
"9285","chr6.111065000.111070000","chr6.111260000.111265000",195000,13,0.002934017,111065000,111260000,111070000,111265000,"chr6",282248,2,7,4,13,"chr6",1,0.0198077824660103
"9286","chr6.26125000.26130000","chr6.26155000.26160000",30000,106,5.570529e-54,26125000,26155000,26130000,26160000,"chr6",282252,2,5,7,14,"chr6",1,0.173933427097984
"9287","chr6.111570000.111575000","chr6.111815000.111820000",245000,11,0.008670633,111570000,111815000,111575000,111820000,"chr6",282274,2,1,1,4,"chr6",1,0.00515705578996718
"9288","chr6.10510000.10515000","chr6.10800000.10805000",290000,30,4.086629e-20,10510000,10800000,10515000,10805000,"chr6",282321,2,7,6,15,"chr6",1,0.0527426160337553
"9289","chr6.10510000.10515000","chr6.10720000.10725000",210000,21,5.067485e-09,10510000,10720000,10515000,10725000,"chr6",282337,4,7,6,17,"chr6",1,0.0418424753867792
"9290","chr6.157860000.157865000","chr6.158005000.158010000",145000,15,0.001633642,157860000,158005000,157865000,158010000,"chr6",282355,2,6,9,17,"chr6",1,0.029887482419128
"9291","chr6.129925000.129930000","chr6.130070000.130075000",145000,15,0.001633642,129925000,130070000,129930000,130075000,"chr6",282375,2,1,2,5,"chr6",1,0.00879043600562588
"9292","chr6.38010000.38015000","chr6.38220000.38225000",210000,12,0.006222837,38010000,38220000,38015000,38225000,"chr6",282416,5,6,9,20,"chr6",1,0.0281293952180028
"9293","chr6.3135000.3140000","chr6.3245000.3250000",110000,16,0.002870974,3135000,3245000,3140000,3250000,"chr6",282417,3,6,10,19,"chr6",1,0.0356305672761369
"9294","chr6.38145000.38150000","chr6.38180000.38185000",35000,31,0.0002492805,38145000,38180000,38150000,38185000,"chr6",282446,1,5,3,9,"chr6",1,0.0327004219409283
"9295","chr6.25260000.25265000","chr6.25490000.25495000",230000,21,1.518364e-09,25260000,25490000,25265000,25495000,"chr6",282482,2,0,0,2,"chr6",1,0.00492264416315049
"9296","chr6.158650000.158655000","chr6.159000000.159005000",350000,11,0.001317138,158650000,1.59e+08,158655000,159005000,"chr6",282484,0,4,1,5,"chr6",1,0.00644631973745898
"9297","chr6.16315000.16320000","chr6.16555000.16560000",240000,11,0.009613542,16315000,16555000,16320000,16560000,"chr6",282490,7,9,8,24,"chr6",1,0.0309423347398031
"9298","chr6.149410000.149415000","chr6.149720000.149725000",310000,12,0.000577775,149410000,149720000,149415000,149725000,"chr6",282492,5,17,20,42,"chr6",1,0.0590717299578059
"9299","chr6.27790000.27795000","chr6.27835000.27840000",45000,23,0.008672865,27790000,27835000,27795000,27840000,"chr6",282507,0,4,4,8,"chr6",1,0.0215658696671355
"9300","chr6.17880000.17885000","chr6.17985000.17990000",105000,24,1.15788e-07,17880000,17985000,17885000,17990000,"chr6",282540,3,4,2,9,"chr6",1,0.0253164556962025
"9301","chr6.16330000.16335000","chr6.17080000.17085000",750000,15,8.761458e-10,16330000,17080000,16335000,17085000,"chr6",282548,5,6,5,16,"chr6",1,0.0281293952180028
"9302","chr6.30765000.30770000","chr6.31080000.31085000",315000,10,0.008579001,30765000,31080000,30770000,31085000,"chr6",282600,5,3,6,14,"chr6",1,0.0164088138771683
"9303","chr6.149960000.149965000","chr6.150015000.150020000",55000,21,0.007492585,149960000,150015000,149965000,150020000,"chr6",282615,0,3,1,4,"chr6",1,0.00984528832630099
"9304","chr6.36385000.36390000","chr6.36665000.36670000",280000,11,0.004199105,36385000,36665000,36390000,36670000,"chr6",282616,1,5,3,9,"chr6",1,0.0116033755274262
"9305","chr6.134500000.134505000","chr6.134900000.134905000",400000,17,9.386051e-09,134500000,134900000,134505000,134905000,"chr6",282621,3,5,6,14,"chr6",1,0.0278949835911861
"9306","chr6.134885000.134890000","chr6.134900000.134905000",15000,36,0.009530062,134885000,134900000,134890000,134905000,"chr6",282714,3,7,6,16,"chr6",1,0.0675105485232067
"9307","chr6.17885000.17890000","chr6.18120000.18125000",235000,23,2.01713e-11,17885000,18120000,17890000,18125000,"chr6",282720,2,3,9,14,"chr6",1,0.0377402719174871
"9308","chr6.17155000.17160000","chr6.17800000.17805000",645000,11,2.815678e-05,17155000,17800000,17160000,17805000,"chr6",282728,1,6,8,15,"chr6",1,0.0193389592123769
"9309","chr6.14800000.14805000","chr6.15620000.15625000",820000,7,0.009242015,14800000,15620000,14805000,15625000,"chr6",282778,1,7,3,11,"chr6",1,0.00902484763244257
"9310","chr6.34155000.34160000","chr6.34390000.34395000",235000,28,3.619924e-16,34155000,34390000,34160000,34395000,"chr6",282783,6,14,4,24,"chr6",1,0.0787623066104079
"9311","chr6.157870000.157875000","chr6.158005000.158010000",135000,14,0.007483355,157870000,158005000,157875000,158010000,"chr6",282800,5,9,6,20,"chr6",1,0.0328176277543366
"9312","chr6.28105000.28110000","chr6.28250000.28255000",145000,14,0.005181923,28105000,28250000,28110000,28255000,"chr6",282866,3,6,8,17,"chr6",1,0.0278949835911861
"9313","chr6.13905000.13910000","chr6.14075000.14080000",170000,25,4.859295e-11,13905000,14075000,13910000,14080000,"chr6",282878,0,4,2,6,"chr6",1,0.0175808720112518
"9314","chr6.109315000.109320000","chr6.109340000.109345000",25000,34,0.006369861,109315000,109340000,109320000,109345000,"chr6",282889,1,3,1,5,"chr6",1,0.0199249882794187
"9315","chr6.116370000.116375000","chr6.116410000.116415000",40000,26,0.002722566,116370000,116410000,116375000,116415000,"chr6",282891,0,3,5,8,"chr6",1,0.0243788091889358
"9316","chr6.20095000.20100000","chr6.20530000.20535000",435000,17,4.0182e-09,20095000,20530000,20100000,20535000,"chr6",282892,0,4,5,9,"chr6",1,0.0179324894514768
"9317","chr6.26120000.26125000","chr6.26215000.26220000",95000,18,0.0009696025,26120000,26215000,26125000,26220000,"chr6",282965,0,3,4,7,"chr6",1,0.0147679324894515
"9318","chr6.113610000.113615000","chr6.114165000.114170000",555000,11,8.280248e-05,113610000,114165000,113615000,114170000,"chr6",282975,2,4,3,9,"chr6",1,0.0116033755274262
"9319","chr6.149430000.149435000","chr6.149750000.149755000",320000,15,3.25906e-06,149430000,149750000,149435000,149755000,"chr6",282993,2,13,5,20,"chr6",1,0.0351617440225035
"9320","chr6.149410000.149415000","chr6.149750000.149755000",340000,15,1.997198e-06,149410000,149750000,149415000,149755000,"chr6",283016,2,17,20,39,"chr6",1,0.0685654008438819
"9321","chr6.17705000.17710000","chr6.17865000.17870000",160000,13,0.009047489,17705000,17865000,17710000,17870000,"chr6",283064,0,1,1,2,"chr6",1,0.00304735114861697
"9322","chr6.109925000.109930000","chr6.110320000.110325000",395000,10,0.003129371,109925000,110320000,109930000,110325000,"chr6",283086,0,2,0,2,"chr6",1,0.0023441162681669
"9323","chr6.13445000.13450000","chr6.13705000.13710000",260000,12,0.001686933,13445000,13705000,13450000,13710000,"chr6",283106,2,1,2,5,"chr6",1,0.0070323488045007
"9324","chr6.3125000.3130000","chr6.3250000.3255000",125000,40,2.458032e-22,3125000,3250000,3130000,3255000,"chr6",283109,1,0,0,1,"chr6",1,0.0046882325363338
"9325","chr6.134500000.134505000","chr6.135050000.135055000",550000,11,8.852172e-05,134500000,135050000,134505000,135055000,"chr6",283119,2,3,1,6,"chr6",1,0.00773558368495077
"9326","chr6.136350000.136355000","chr6.136545000.136550000",195000,14,0.0008147436,136350000,136545000,136355000,136550000,"chr6",283148,1,3,4,8,"chr6",1,0.0131270511017346
"9327","chr6.31700000.31705000","chr6.31815000.31820000",115000,15,0.006219749,31700000,31815000,31705000,31820000,"chr6",283157,2,10,13,25,"chr6",1,0.0439521800281294
"9328","chr6.27125000.27130000","chr6.27835000.27840000",710000,11,1.3757e-05,27125000,27835000,27130000,27840000,"chr6",283173,2,5,7,14,"chr6",1,0.0180496952648851
"9329","chr6.150025000.150030000","chr6.150075000.150080000",50000,26,0.0002097868,150025000,150075000,150030000,150080000,"chr6",283197,1,1,1,3,"chr6",1,0.00914205344585091
"9330","chr6.17040000.17045000","chr6.17095000.17100000",55000,22,0.003206695,17040000,17095000,17045000,17100000,"chr6",283212,0,5,4,9,"chr6",1,0.0232067510548523
"9331","chr6.28655000.28660000","chr6.28975000.28980000",320000,17,7.660639e-08,28655000,28975000,28660000,28980000,"chr6",283222,0,6,6,12,"chr6",1,0.0239099859353024
"9332","chr6.10555000.10560000","chr6.10690000.10695000",135000,16,0.0007626282,10555000,10690000,10560000,10695000,"chr6",283230,1,1,3,5,"chr6",1,0.00937646507266761
"9333","chr6.26120000.26125000","chr6.26200000.26205000",80000,23,1.497665e-05,26120000,26200000,26125000,26205000,"chr6",283251,0,3,2,5,"chr6",1,0.0134786685419597
"9334","chr6.147220000.147225000","chr6.147545000.147550000",325000,11,0.001903583,147220000,147545000,147225000,147550000,"chr6",283291,0,2,0,2,"chr6",1,0.00257852789498359
"9335","chr6.136790000.136795000","chr6.136840000.136845000",50000,37,3.398093e-10,136790000,136840000,136795000,136845000,"chr6",283306,2,5,6,13,"chr6",1,0.056375996249414
"9336","chr6.149405000.149410000","chr6.149715000.149720000",310000,15,4.235343e-06,149405000,149715000,149410000,149720000,"chr6",283371,0,3,2,5,"chr6",1,0.00879043600562588
"9337","chr6.26120000.26125000","chr6.26195000.26200000",75000,24,9.624623e-06,26120000,26195000,26125000,26200000,"chr6",283386,0,3,4,7,"chr6",1,0.019690576652602
"9338","chr6.26205000.26210000","chr6.26570000.26575000",365000,11,0.001054337,26205000,26570000,26210000,26575000,"chr6",283396,0,4,5,9,"chr6",1,0.0116033755274262
"9339","chr6.161580000.161585000","chr6.161770000.161775000",190000,21,1.80757e-08,161580000,161770000,161585000,161775000,"chr6",283492,0,2,4,6,"chr6",1,0.0147679324894515
"9340","chr6.17155000.17160000","chr6.17585000.17590000",430000,24,2.603476e-16,17155000,17585000,17160000,17590000,"chr6",283496,1,6,8,15,"chr6",1,0.0421940928270042
"9341","chr6.150355000.150360000","chr6.150730000.150735000",375000,10,0.00394479,150355000,150730000,150360000,150735000,"chr6",283500,1,3,2,6,"chr6",1,0.0070323488045007
"9342","chr6.131205000.131210000","chr6.131425000.131430000",220000,24,7.195276e-12,131205000,131425000,131210000,131430000,"chr6",283525,2,0,1,3,"chr6",1,0.00843881856540084
"9343","chr6.3120000.3125000","chr6.3245000.3250000",125000,28,1.295916e-11,3120000,3245000,3125000,3250000,"chr6",283558,1,9,12,22,"chr6",1,0.0721987810595406
"9344","chr6.111815000.111820000","chr6.111850000.111855000",35000,32,0.0001004907,111815000,111850000,111820000,111855000,"chr6",283596,2,1,1,4,"chr6",1,0.0150023441162682
"9345","chr6.10695000.10700000","chr6.10745000.10750000",50000,39,1.922799e-11,10695000,10745000,10700000,10750000,"chr6",283602,0,2,2,4,"chr6",1,0.0182841068917018
"9346","chr6.16335000.16340000","chr6.16530000.16535000",195000,12,0.009418563,16335000,16530000,16340000,16535000,"chr6",283621,0,1,0,1,"chr6",1,0.00140646976090014
"9347","chr6.13410000.13415000","chr6.13570000.13575000",160000,15,0.0008765327,13410000,13570000,13415000,13575000,"chr6",283656,0,5,2,7,"chr6",1,0.0123066104078762
"9348","chr6.37670000.37675000","chr6.38320000.38325000",650000,9,0.001079569,37670000,38320000,37675000,38325000,"chr6",283703,1,2,1,4,"chr6",1,0.00421940928270042
"9349","chr6.136150000.136155000","chr6.136640000.136645000",490000,9,0.004785622,136150000,136640000,136155000,136645000,"chr6",283707,0,4,2,6,"chr6",1,0.00632911392405063
"9350","chr6.150075000.150080000","chr6.150125000.150130000",50000,33,7.178978e-08,150075000,150125000,150080000,150130000,"chr6",283710,0,2,2,4,"chr6",1,0.0154711673699015
"9351","chr6.150730000.150735000","chr6.151015000.151020000",285000,11,0.003840393,150730000,151015000,150735000,151020000,"chr6",283712,1,8,14,23,"chr6",1,0.0296530707923113
"9352","chr6.3740000.3745000","chr6.3885000.3890000",145000,27,1.085948e-11,3740000,3885000,3745000,3890000,"chr6",283759,1,3,1,5,"chr6",1,0.0158227848101266
"9353","chr6.30880000.30885000","chr6.31065000.31070000",185000,13,0.004005289,30880000,31065000,30885000,31070000,"chr6",283856,2,0,1,3,"chr6",1,0.00457102672292546
"9354","chr6.134285000.134290000","chr6.134370000.134375000",85000,28,5.728199e-09,134285000,134370000,134290000,134375000,"chr6",283890,6,4,11,21,"chr6",1,0.0689170182841069
"9355","chr6.26065000.26070000","chr6.26570000.26575000",505000,9,0.004109948,26065000,26570000,26070000,26575000,"chr6",283896,2,4,6,12,"chr6",1,0.0126582278481013
"9356","chr6.25265000.25270000","chr6.25490000.25495000",225000,20,1.348906e-08,25265000,25490000,25270000,25495000,"chr6",283918,2,0,0,2,"chr6",1,0.0046882325363338
"9357","chr6.11095000.11100000","chr6.11495000.11500000",400000,23,9.65717e-15,11095000,11495000,11100000,11500000,"chr6",283934,0,0,4,4,"chr6",1,0.0107829348335677
"9358","chr6.13355000.13360000","chr6.13410000.13415000",55000,25,0.0001818139,13355000,13410000,13360000,13415000,"chr6",283940,0,5,0,5,"chr6",1,0.0146507266760431
"9359","chr6.26565000.26570000","chr6.27440000.27445000",875000,7,0.006792988,26565000,27440000,26570000,27445000,"chr6",283957,2,7,13,22,"chr6",1,0.0180496952648851
"9360","chr6.34160000.34165000","chr6.34380000.34385000",220000,32,1.129728e-19,34160000,34380000,34165000,34385000,"chr6",283976,9,14,23,46,"chr6",1,0.172526957337084
"9361","chr6.2750000.2755000","chr6.2990000.2995000",240000,11,0.009613542,2750000,2990000,2755000,2995000,"chr6",284056,2,1,6,9,"chr6",1,0.0116033755274262
"9362","chr6.16635000.16640000","chr6.16720000.16725000",85000,17,0.006589942,16635000,16720000,16640000,16725000,"chr6",284091,1,1,1,3,"chr6",1,0.0059774964838256
"9363","chr6.161585000.161590000","chr6.161675000.161680000",90000,17,0.004284741,161585000,161675000,161590000,161680000,"chr6",284133,2,3,3,8,"chr6",1,0.0159399906235349
"9364","chr6.111055000.111060000","chr6.111265000.111270000",210000,12,0.006222837,111055000,111265000,111060000,111270000,"chr6",284136,0,4,4,8,"chr6",1,0.0112517580872011
"9365","chr6.111030000.111035000","chr6.111155000.111160000",125000,17,0.0003746708,111030000,111155000,111035000,111160000,"chr6",284194,2,5,5,12,"chr6",1,0.0239099859353024
"9366","chr6.134620000.134625000","chr6.135035000.135040000",415000,10,0.002498841,134620000,135035000,134625000,135040000,"chr6",284206,1,4,4,9,"chr6",1,0.0105485232067511
"9367","chr6.10695000.10700000","chr6.10755000.10760000",60000,21,0.003287302,10695000,10755000,10700000,10760000,"chr6",284214,0,4,7,11,"chr6",1,0.0270745428973277
"9368","chr6.16510000.16515000","chr6.17040000.17045000",530000,9,0.003237994,16510000,17040000,16515000,17045000,"chr6",284266,0,5,4,9,"chr6",1,0.00949367088607595
"9369","chr6.26550000.26555000","chr6.27440000.27445000",890000,9,0.0001539277,26550000,27440000,26555000,27445000,"chr6",284282,0,1,9,10,"chr6",1,0.0105485232067511
"9370","chr6.17705000.17710000","chr6.18155000.18160000",450000,10,0.00162023,17705000,18155000,17710000,18160000,"chr6",284332,0,5,8,13,"chr6",1,0.0152367557430849
"9371","chr6.157875000.157880000","chr6.158320000.158325000",445000,11,0.0003519427,157875000,158320000,157880000,158325000,"chr6",284357,0,3,0,3,"chr6",1,0.00386779184247539
"9372","chr6.11095000.11100000","chr6.11140000.11145000",45000,30,1.311401e-05,11095000,11140000,11100000,11145000,"chr6",284387,0,8,5,13,"chr6",1,0.0457102672292546
"9373","chr7.37025000.37030000","chr7.37230000.37235000",205000,17,3.655079e-06,37025000,37230000,37030000,37235000,"chr7",284538,1,2,3,6,"chr7",1,0.0119549929676512
"9374","chr7.98020000.98025000","chr7.98460000.98465000",440000,10,0.001341093,98020000,98460000,98025000,98465000,"chr7",284553,9,14,10,33,"chr7",1,0.0386779184247539
"9375","chr7.134295000.134300000","chr7.134605000.134610000",310000,12,0.0003776456,134295000,134605000,134300000,134610000,"chr7",284582,3,7,4,14,"chr7",1,0.019690576652602
"9376","chr7.5600000.5605000","chr7.5675000.5680000",75000,24,4.553127e-06,5600000,5675000,5605000,5680000,"chr7",284583,2,8,3,13,"chr7",1,0.0365682137834037
"9377","chr7.73985000.73990000","chr7.74060000.74065000",75000,18,0.004067044,73985000,74060000,73990000,74065000,"chr7",284628,6,12,20,38,"chr7",1,0.080168776371308
"9378","chr7.5615000.5620000","chr7.5710000.5715000",95000,20,5.091508e-05,5615000,5710000,5620000,5715000,"chr7",284653,3,8,5,16,"chr7",1,0.0375058602906704
"9379","chr7.37250000.37255000","chr7.37490000.37495000",240000,12,0.001817981,37250000,37490000,37255000,37495000,"chr7",284660,0,3,2,5,"chr7",1,0.0070323488045007
"9380","chr7.5670000.5675000","chr7.5695000.5700000",25000,38,0.0001564123,5670000,5695000,5675000,5700000,"chr7",284707,4,6,4,14,"chr7",1,0.0623534927332396
"9381","chr7.5560000.5565000","chr7.5710000.5715000",150000,25,1.120804e-10,5560000,5710000,5565000,5715000,"chr7",284738,3,8,5,16,"chr7",1,0.046882325363338
"9382","chr7.137590000.137595000","chr7.137625000.137630000",35000,35,2.120793e-06,137590000,137625000,137595000,137630000,"chr7",284761,1,3,2,6,"chr7",1,0.0246132208157525
"9383","chr7.5555000.5560000","chr7.5710000.5715000",155000,29,2.73917e-14,5555000,5710000,5560000,5715000,"chr7",284776,3,6,5,14,"chr7",1,0.0475855602437881
"9384","chr7.111740000.111745000","chr7.111760000.111765000",20000,42,5.491611e-05,111740000,111760000,111745000,111765000,"chr7",284820,3,5,8,16,"chr7",1,0.0787623066104079
"9385","chr7.117020000.117025000","chr7.117815000.117820000",795000,7,0.007816045,117020000,117815000,117025000,117820000,"chr7",284852,1,0,1,2,"chr7",1,0.00164088138771683
"9386","chr7.44635000.44640000","chr7.44885000.44890000",250000,11,0.00523021,44635000,44885000,44640000,44890000,"chr7",284903,1,4,13,18,"chr7",1,0.0232067510548523
"9387","chr7.5670000.5675000","chr7.5745000.5750000",75000,25,1.218218e-06,5670000,5745000,5675000,5750000,"chr7",284970,8,21,21,50,"chr7",1,0.146507266760431
"9388","chr7.44635000.44640000","chr7.44895000.44900000",260000,11,0.004209802,44635000,44895000,44640000,44900000,"chr7",284972,1,4,13,18,"chr7",1,0.0232067510548523
"9389","chr7.75960000.75965000","chr7.75995000.76000000",35000,29,0.0006655918,75960000,75995000,75965000,7.6e+07,"chr7",284987,6,10,18,34,"chr7",1,0.115564932020628
"9390","chr7.66920000.66925000","chr7.67625000.67630000",705000,8,0.00276956,66920000,67625000,66925000,67630000,"chr7",285066,6,23,19,48,"chr7",1,0.0450070323488045
"9391","chr7.5615000.5620000","chr7.5745000.5750000",130000,19,1.064094e-05,5615000,5745000,5620000,5750000,"chr7",285069,8,21,21,50,"chr7",1,0.111345522737928
"9392","chr7.151925000.151930000","chr7.152420000.152425000",495000,10,0.0007042362,151925000,152420000,151930000,152425000,"chr7",285120,0,13,6,19,"chr7",1,0.0222691045475856
"9393","chr7.104770000.104775000","chr7.104900000.104905000",130000,14,0.005856061,104770000,104900000,104775000,104905000,"chr7",285125,0,1,2,3,"chr7",1,0.00492264416315049
"9394","chr7.5530000.5535000","chr7.5665000.5670000",135000,18,3.233722e-05,5530000,5665000,5535000,5670000,"chr7",285154,2,3,2,7,"chr7",1,0.0147679324894515
"9395","chr7.44630000.44635000","chr7.44920000.44925000",290000,14,2.429754e-05,44630000,44920000,44635000,44925000,"chr7",285262,2,3,10,15,"chr7",1,0.0246132208157525
"9396","chr7.111755000.111760000","chr7.111800000.111805000",45000,26,0.0003455231,111755000,111800000,111760000,111805000,"chr7",285301,0,1,5,6,"chr7",1,0.0182841068917018
"9397","chr7.105285000.105290000","chr7.105650000.105655000",365000,15,7.185607e-07,105285000,105650000,105290000,105655000,"chr7",285319,1,6,3,10,"chr7",1,0.0175808720112518
"9398","chr7.95730000.95735000","chr7.96715000.96720000",985000,9,3.836174e-05,95730000,96715000,95735000,96720000,"chr7",285454,0,1,0,1,"chr7",1,0.00105485232067511
"9399","chr7.80095000.80100000","chr7.80885000.80890000",790000,7,0.008111581,80095000,80885000,80100000,80890000,"chr7",285532,0,3,3,6,"chr7",1,0.00492264416315049
"9400","chr7.26645000.26650000","chr7.26665000.26670000",20000,36,0.004179201,26645000,26665000,26650000,26670000,"chr7",285536,0,3,2,5,"chr7",1,0.0210970464135021
"9401","chr7.129240000.129245000","chr7.129555000.129560000",315000,12,0.0003455231,129240000,129555000,129245000,129560000,"chr7",285599,7,14,10,31,"chr7",1,0.0436005625879044
"9402","chr7.37310000.37315000","chr7.37490000.37495000",180000,13,0.003037322,37310000,37490000,37315000,37495000,"chr7",285629,0,4,2,6,"chr7",1,0.00914205344585091
"9403","chr7.855000.860000","chr7.910000.915000",55000,22,0.00174694,855000,910000,860000,915000,"chr7",285637,3,9,11,23,"chr7",1,0.0593061415846226
"9404","chr7.129240000.129245000","chr7.129470000.129475000",230000,16,6.237669e-06,129240000,129470000,129245000,129475000,"chr7",285641,6,14,11,31,"chr7",1,0.0581340834505391
"9405","chr7.77570000.77575000","chr7.78560000.78565000",990000,8,0.0003028893,77570000,78560000,77575000,78565000,"chr7",285652,0,0,2,2,"chr7",1,0.00187529301453352
"9406","chr7.129295000.129300000","chr7.129660000.129665000",365000,14,4.633631e-06,129295000,129660000,129300000,129665000,"chr7",285689,3,3,8,14,"chr7",1,0.0229723394280356
"9407","chr7.55590000.55595000","chr7.55640000.55645000",50000,23,0.001817981,55590000,55640000,55595000,55645000,"chr7",285734,0,9,8,17,"chr7",1,0.0458274730426629
"9408","chr7.74065000.74070000","chr7.74090000.74095000",25000,36,0.0007257094,74065000,74090000,74070000,74095000,"chr7",285774,2,11,19,32,"chr7",1,0.135021097046413
"9409","chr7.100670000.100675000","chr7.100690000.100695000",20000,39,0.0005470821,100670000,100690000,100675000,100695000,"chr7",285819,3,10,9,22,"chr7",1,0.10056258790436
"9410","chr7.5605000.5610000","chr7.5665000.5670000",60000,28,7.252869e-07,5605000,5665000,5610000,5670000,"chr7",285827,2,9,11,22,"chr7",1,0.0721987810595406
"9411","chr7.5615000.5620000","chr7.5820000.5825000",205000,12,0.004654933,5615000,5820000,5620000,5825000,"chr7",285837,7,36,34,77,"chr7",1,0.108298171589311
"9412","chr7.4715000.4720000","chr7.4770000.4775000",55000,22,0.00174694,4715000,4770000,4720000,4775000,"chr7",285875,2,8,9,19,"chr7",1,0.0489920300046882
"9413","chr7.105810000.105815000","chr7.106110000.106115000",300000,12,0.0004623516,105810000,106110000,105815000,106115000,"chr7",285906,1,4,3,8,"chr7",1,0.0112517580872011
"9414","chr7.129875000.129880000","chr7.130440000.130445000",565000,9,0.00174694,129875000,130440000,129880000,130445000,"chr7",285908,0,0,3,3,"chr7",1,0.00316455696202532
"9415","chr7.137460000.137465000","chr7.137720000.137725000",260000,11,0.004209802,137460000,137720000,137465000,137725000,"chr7",285971,0,1,4,5,"chr7",1,0.00644631973745898
"9416","chr7.74040000.74045000","chr7.74080000.74085000",40000,30,3.33137e-05,74040000,74080000,74045000,74085000,"chr7",285977,8,16,11,35,"chr7",1,0.123066104078762
"9417","chr7.111850000.111855000","chr7.111870000.111875000",20000,38,0.001104282,111850000,111870000,111855000,111875000,"chr7",286023,0,2,1,3,"chr7",1,0.0133614627285513
"9418","chr7.137625000.137630000","chr7.137670000.137675000",45000,32,5.474532e-07,137625000,137670000,137630000,137675000,"chr7",286030,1,1,0,2,"chr7",1,0.00750117205813408
"9419","chr7.66200000.66205000","chr7.66305000.66310000",105000,18,0.0002447182,66200000,66305000,66205000,66310000,"chr7",286042,3,14,11,28,"chr7",1,0.0590717299578059
"9420","chr7.129295000.129300000","chr7.129635000.129640000",340000,12,0.0002277545,129295000,129635000,129300000,129640000,"chr7",286060,2,3,5,10,"chr7",1,0.0140646976090014
"9421","chr7.5605000.5610000","chr7.5670000.5675000",65000,46,1.870962e-20,5605000,5670000,5610000,5675000,"chr7",286081,7,17,11,35,"chr7",1,0.188701359587436
"9422","chr7.99615000.99620000","chr7.99645000.99650000",30000,58,3.569674e-17,99615000,99645000,99620000,99650000,"chr7",286174,0,4,3,7,"chr7",1,0.0475855602437881
"9423","chr7.51245000.51250000","chr7.51285000.51290000",40000,27,0.0005823026,51245000,51285000,51250000,51290000,"chr7",286196,0,2,3,5,"chr7",1,0.0158227848101266
"9424","chr7.117070000.117075000","chr7.117805000.117810000",735000,8,0.002212557,117070000,117805000,117075000,117810000,"chr7",286219,0,1,1,2,"chr7",1,0.00187529301453352
"9425","chr7.100555000.100560000","chr7.100605000.100610000",50000,115,7.82613e-85,100555000,100605000,100560000,100610000,"chr7",286252,10,26,27,63,"chr7",1,0.84915611814346
"9426","chr7.6245000.6250000","chr7.6270000.6275000",25000,37,0.0003455231,6245000,6270000,6250000,6275000,"chr7",286278,3,0,2,5,"chr7",1,0.0216830754805438
"9427","chr7.11090000.11095000","chr7.11250000.11255000",160000,17,3.446256e-05,11090000,11250000,11095000,11255000,"chr7",286293,0,7,3,10,"chr7",1,0.0199249882794187
"9428","chr7.129875000.129880000","chr7.130520000.130525000",645000,9,0.0008182911,129875000,130520000,129880000,130525000,"chr7",286300,0,0,1,1,"chr7",1,0.00105485232067511
"9429","chr7.73840000.73845000","chr7.73985000.73990000",145000,24,1.072874e-09,73840000,73985000,73845000,73990000,"chr7",286321,3,12,14,29,"chr7",1,0.0815752461322082
"9430","chr7.105385000.105390000","chr7.105650000.105655000",265000,13,0.0002309465,105385000,105650000,105390000,105655000,"chr7",286413,0,4,3,7,"chr7",1,0.0106657290201594
"9431","chr7.36510000.36515000","chr7.37180000.37185000",670000,8,0.003601624,36510000,37180000,36515000,37185000,"chr7",286417,1,0,2,3,"chr7",1,0.00281293952180028
"9432","chr7.100085000.100090000","chr7.100145000.100150000",60000,25,2.766458e-05,100085000,100145000,100090000,100150000,"chr7",286454,7,22,24,53,"chr7",1,0.155297702766057
"9433","chr7.5615000.5620000","chr7.5670000.5675000",55000,28,2.914072e-06,5615000,5670000,5620000,5675000,"chr7",286463,11,42,38,91,"chr7",1,0.298640412564463
"9434","chr7.100555000.100560000","chr7.100610000.100615000",55000,22,0.00174694,100555000,100610000,100560000,100615000,"chr7",286515,10,36,27,73,"chr7",1,0.188232536333802
"9435","chr7.24335000.24340000","chr7.24700000.24705000",365000,12,0.0001506728,24335000,24700000,24340000,24705000,"chr7",286550,2,6,6,14,"chr7",1,0.019690576652602
"9436","chr7.111635000.111640000","chr7.111735000.111740000",100000,22,1.957479e-06,111635000,111735000,111640000,111740000,"chr7",286582,1,5,6,12,"chr7",1,0.0309423347398031
"9437","chr7.71420000.71425000","chr7.71440000.71445000",20000,35,0.007707517,71420000,71440000,71425000,71445000,"chr7",286664,2,6,1,9,"chr7",1,0.0369198312236287
"9438","chr7.30545000.30550000","chr7.30595000.30600000",50000,22,0.004297703,30545000,30595000,30550000,30600000,"chr7",286668,1,3,5,9,"chr7",1,0.0232067510548523
"9439","chr7.2795000.2800000","chr7.2875000.2880000",80000,21,8.910063e-05,2795000,2875000,2800000,2880000,"chr7",286680,8,7,4,19,"chr7",1,0.0467651195499297
"9440","chr7.95405000.95410000","chr7.95435000.95440000",30000,31,0.001458307,95405000,95435000,95410000,95440000,"chr7",286703,0,2,1,3,"chr7",1,0.0109001406469761
"9441","chr7.105320000.105325000","chr7.105650000.105655000",330000,12,0.0002664078,105320000,105650000,105325000,105655000,"chr7",286706,1,6,3,10,"chr7",1,0.0140646976090014
"9442","chr7.35790000.35795000","chr7.35835000.35840000",45000,24,0.00211632,35790000,35835000,35795000,35840000,"chr7",286712,1,5,3,9,"chr7",1,0.0253164556962025
"9443","chr7.75570000.75575000","chr7.75600000.75605000",30000,31,0.001458307,75570000,75600000,75575000,75605000,"chr7",286716,6,19,11,36,"chr7",1,0.130801687763713
"9444","chr7.100115000.100120000","chr7.100145000.100150000",30000,35,5.18901e-05,100115000,100145000,100120000,100150000,"chr7",286721,9,24,25,58,"chr7",1,0.23792780121894
"9445","chr7.104795000.104800000","chr7.104900000.104905000",105000,15,0.006911981,104795000,104900000,104800000,104905000,"chr7",286763,2,2,2,6,"chr7",1,0.0105485232067511
"9446","chr7.36035000.36040000","chr7.36260000.36265000",225000,11,0.009286263,36035000,36260000,36040000,36265000,"chr7",286801,4,2,3,9,"chr7",1,0.0116033755274262
"9447","chr7.117070000.117075000","chr7.117765000.117770000",695000,9,0.0005334827,117070000,117765000,117075000,117770000,"chr7",286835,1,4,2,7,"chr7",1,0.00738396624472574
"9448","chr7.100075000.100080000","chr7.100165000.100170000",90000,19,0.0002879098,100075000,100165000,100080000,100170000,"chr7",286836,8,9,19,36,"chr7",1,0.080168776371308
"9449","chr7.44640000.44645000","chr7.44895000.44900000",255000,16,2.364254e-06,44640000,44895000,44645000,44900000,"chr7",286846,4,12,22,38,"chr7",1,0.0712611345522738
"9450","chr7.5560000.5565000","chr7.5745000.5750000",185000,28,1.05467e-14,5560000,5745000,5565000,5750000,"chr7",286871,5,21,21,47,"chr7",1,0.154242850445382
"9451","chr7.5555000.5560000","chr7.5745000.5750000",190000,29,7.163865e-16,5555000,5745000,5560000,5750000,"chr7",286912,3,6,10,19,"chr7",1,0.0645804031879981
"9452","chr7.65955000.65960000","chr7.66305000.66310000",350000,23,2.822599e-14,65955000,66305000,65960000,66310000,"chr7",286934,0,9,2,11,"chr7",1,0.0296530707923113
"9453","chr7.98195000.98200000","chr7.98215000.98220000",20000,38,0.001104282,98195000,98215000,98200000,98220000,"chr7",286941,0,8,5,13,"chr7",1,0.0578996718237225
"9454","chr7.5595000.5600000","chr7.5745000.5750000",150000,17,5.738583e-05,5595000,5745000,5600000,5750000,"chr7",287012,8,4,3,15,"chr7",1,0.029887482419128
"9455","chr7.140175000.140180000","chr7.140345000.140350000",170000,18,4.517794e-06,140175000,140345000,140180000,140350000,"chr7",287044,3,5,8,16,"chr7",1,0.0337552742616034
"9456","chr7.132995000.133000000","chr7.133820000.133825000",825000,8,0.001140917,132995000,133820000,1.33e+08,133825000,"chr7",287082,0,2,2,4,"chr7",1,0.00375058602906704
"9457","chr7.5590000.5595000","chr7.5820000.5825000",230000,12,0.002350543,5590000,5820000,5595000,5825000,"chr7",287137,2,5,15,22,"chr7",1,0.0309423347398031
"9458","chr7.56030000.56035000","chr7.56115000.56120000",85000,17,0.004067044,56030000,56115000,56035000,56120000,"chr7",287198,5,16,20,41,"chr7",1,0.0816924519456165
"9459","chr7.44640000.44645000","chr7.44920000.44925000",280000,17,1.550363e-07,44640000,44920000,44645000,44925000,"chr7",287239,2,21,29,52,"chr7",1,0.103609939052977
"9460","chr7.22185000.22190000","chr7.22220000.22225000",35000,40,6.939528e-09,22185000,22220000,22190000,22225000,"chr7",287252,0,1,1,2,"chr7",1,0.00937646507266761
"9461","chr7.22185000.22190000","chr7.22300000.22305000",115000,16,0.001302303,22185000,22300000,22190000,22305000,"chr7",287262,0,1,2,3,"chr7",1,0.00562587904360056
"9462","chr7.100075000.100080000","chr7.100145000.100150000",70000,33,2.747441e-11,100075000,100145000,100080000,100150000,"chr7",287330,8,20,21,49,"chr7",1,0.189521800281294
"9463","chr7.154255000.154260000","chr7.154370000.154375000",115000,28,1.678088e-11,154255000,154370000,154260000,154375000,"chr7",287333,0,7,3,10,"chr7",1,0.0328176277543366
"9464","chr7.92420000.92425000","chr7.92445000.92450000",25000,33,0.005861433,92420000,92445000,92425000,92450000,"chr7",287343,1,3,3,7,"chr7",1,0.0270745428973277
"9465","chr7.105285000.105290000","chr7.105690000.105695000",405000,12,8.228132e-05,105285000,105690000,105290000,105695000,"chr7",287396,4,7,6,17,"chr7",1,0.0239099859353024
"9466","chr7.35775000.35780000","chr7.35790000.35795000",15000,37,0.002176787,35775000,35790000,35780000,35795000,"chr7",287404,0,2,1,3,"chr7",1,0.0130098452883263
"9467","chr7.73665000.73670000","chr7.73735000.73740000",70000,22,0.0001195867,73665000,73735000,73670000,73740000,"chr7",287405,3,10,16,29,"chr7",1,0.0747773089545241
"9468","chr7.148395000.148400000","chr7.148575000.148580000",180000,14,0.0008545015,148395000,148575000,148400000,148580000,"chr7",287425,8,7,13,28,"chr7",1,0.0459446788560713
"9469","chr7.29330000.29335000","chr7.29350000.29355000",20000,42,5.491611e-05,29330000,29350000,29335000,29355000,"chr7",287447,1,8,6,15,"chr7",1,0.0738396624472574
"9470","chr7.2590000.2595000","chr7.2735000.2740000",145000,13,0.009845682,2590000,2735000,2595000,2740000,"chr7",287459,2,5,2,9,"chr7",1,0.0137130801687764
"9471","chr7.72875000.72880000","chr7.72925000.72930000",50000,24,0.0007217265,72875000,72925000,72880000,72930000,"chr7",287487,1,5,1,7,"chr7",1,0.019690576652602
"9472","chr7.92250000.92255000","chr7.92460000.92465000",210000,32,9.583597e-20,92250000,92460000,92255000,92465000,"chr7",287511,2,6,6,14,"chr7",1,0.0525082044069386
"9473","chr7.137590000.137595000","chr7.137700000.137705000",110000,21,2.87347e-06,137590000,137700000,137595000,137705000,"chr7",287516,1,4,2,7,"chr7",1,0.0172292545710267
"9474","chr7.78165000.78170000","chr7.78395000.78400000",230000,11,0.008168733,78165000,78395000,78170000,78400000,"chr7",287579,0,0,1,1,"chr7",1,0.0012892639474918
"9475","chr7.6100000.6105000","chr7.6395000.6400000",295000,10,0.008140023,6100000,6395000,6105000,6400000,"chr7",287586,2,18,23,43,"chr7",1,0.0503984997655884
"9476","chr7.6180000.6185000","chr7.6370000.6375000",190000,15,0.0001506728,6180000,6370000,6185000,6375000,"chr7",287607,6,11,8,25,"chr7",1,0.0439521800281294
"9477","chr7.129740000.129745000","chr7.130520000.130525000",780000,8,0.001588898,129740000,130520000,129745000,130525000,"chr7",287632,0,2,1,3,"chr7",1,0.00281293952180028
"9478","chr7.29350000.29355000","chr7.29370000.29375000",20000,35,0.007707517,29350000,29370000,29355000,29375000,"chr7",287640,0,8,3,11,"chr7",1,0.0451242381622128
"9479","chr7.5155000.5160000","chr7.5175000.5180000",20000,35,0.007707517,5155000,5175000,5160000,5180000,"chr7",287642,4,17,26,47,"chr7",1,0.192803563056728
"9480","chr7.73855000.73860000","chr7.74030000.74035000",175000,16,6.95567e-05,73855000,74030000,73860000,74035000,"chr7",287655,5,10,13,28,"chr7",1,0.0525082044069386
"9481","chr7.23230000.23235000","chr7.23275000.23280000",45000,26,0.0003455231,23230000,23275000,23235000,23280000,"chr7",287687,3,10,2,15,"chr7",1,0.0457102672292546
"9482","chr7.23595000.23600000","chr7.23710000.23715000",115000,15,0.003963222,23595000,23710000,23600000,23715000,"chr7",287738,0,6,1,7,"chr7",1,0.0123066104078762
"9483","chr7.5405000.5410000","chr7.5495000.5500000",90000,19,0.0002879098,5405000,5495000,5410000,5500000,"chr7",287750,5,15,17,37,"chr7",1,0.0823956868260666
"9484","chr7.73865000.73870000","chr7.74065000.74070000",200000,12,0.005344264,73865000,74065000,73870000,74070000,"chr7",287770,0,5,2,7,"chr7",1,0.00984528832630099
"9485","chr7.5530000.5535000","chr7.5590000.5595000",60000,26,8.578064e-06,5530000,5590000,5535000,5595000,"chr7",287785,2,3,2,7,"chr7",1,0.0213314580403188
"9486","chr7.44625000.44630000","chr7.44920000.44925000",295000,17,9.31643e-08,44625000,44920000,44630000,44925000,"chr7",287794,2,13,8,23,"chr7",1,0.0458274730426629
"9487","chr7.134950000.134955000","chr7.135270000.135275000",320000,11,0.001424285,134950000,135270000,134955000,135275000,"chr7",287825,5,9,10,24,"chr7",1,0.0309423347398031
"9488","chr7.51285000.51290000","chr7.51305000.51310000",20000,37,0.002176787,51285000,51305000,51290000,51310000,"chr7",287865,1,3,2,6,"chr7",1,0.0260196905766526
"9489","chr7.1840000.1845000","chr7.2240000.2245000",400000,9,0.008829516,1840000,2240000,1845000,2245000,"chr7",287867,1,3,1,5,"chr7",1,0.00527426160337553
"9490","chr7.137820000.137825000","chr7.138580000.138585000",760000,7,0.009802533,137820000,138580000,137825000,138585000,"chr7",288016,2,7,5,14,"chr7",1,0.0114861697140178
"9491","chr7.44640000.44645000","chr7.44680000.44685000",40000,26,0.001406709,44640000,44680000,44645000,44685000,"chr7",288122,9,13,16,38,"chr7",1,0.115799343647445
"9492","chr7.51270000.51275000","chr7.51305000.51310000",35000,32,4.471954e-05,51270000,51305000,51275000,51310000,"chr7",288151,1,3,2,6,"chr7",1,0.0225035161744023
"9493","chr7.78135000.78140000","chr7.78420000.78425000",285000,12,0.0006265093,78135000,78420000,78140000,78425000,"chr7",288200,1,0,2,3,"chr7",1,0.00421940928270042
"9494","chr7.22155000.22160000","chr7.22295000.22300000",140000,18,2.441446e-05,22155000,22295000,22160000,22300000,"chr7",288299,0,1,1,2,"chr7",1,0.00421940928270042
"9495","chr7.134950000.134955000","chr7.135280000.135285000",330000,13,5.239962e-05,134950000,135280000,134955000,135285000,"chr7",288316,0,1,2,3,"chr7",1,0.00457102672292546
"9496","chr7.69930000.69935000","chr7.69990000.69995000",60000,22,0.0006823538,69930000,69990000,69935000,69995000,"chr7",288335,1,2,2,5,"chr7",1,0.012892639474918
"9497","chr7.44810000.44815000","chr7.45135000.45140000",325000,10,0.005289393,44810000,45135000,44815000,45140000,"chr7",288445,5,23,24,52,"chr7",1,0.0609470229723394
"9498","chr7.101540000.101545000","chr7.101680000.101685000",140000,14,0.003981961,101540000,101680000,101545000,101685000,"chr7",288488,6,15,13,34,"chr7",1,0.0557899671823722
"9499","chr7.111635000.111640000","chr7.111950000.111955000",315000,11,0.00152594,111635000,111950000,111640000,111955000,"chr7",288545,6,11,8,25,"chr7",1,0.0322315986872949
"9500","chr7.78135000.78140000","chr7.78375000.78380000",240000,17,7.486166e-07,78135000,78375000,78140000,78380000,"chr7",288604,0,0,3,3,"chr7",1,0.0059774964838256
"9501","chr7.95400000.95405000","chr7.95475000.95480000",75000,20,0.0005334827,95400000,95475000,95405000,95480000,"chr7",288607,0,3,0,3,"chr7",1,0.0070323488045007
"9502","chr7.137820000.137825000","chr7.138165000.138170000",345000,10,0.004094908,137820000,138165000,137825000,138170000,"chr7",288624,2,7,5,14,"chr7",1,0.0164088138771683
"9503","chr7.137625000.137630000","chr7.137700000.137705000",75000,18,0.004067044,137625000,137700000,137630000,137705000,"chr7",288641,1,3,6,10,"chr7",1,0.0210970464135021
"9504","chr7.36035000.36040000","chr7.36365000.36370000",330000,15,1.541656e-06,36035000,36365000,36040000,36370000,"chr7",288655,2,2,1,5,"chr7",1,0.00879043600562588
"9505","chr7.133070000.133075000","chr7.133880000.133885000",810000,7,0.007104769,133070000,133880000,133075000,133885000,"chr7",288660,3,1,1,5,"chr7",1,0.00410220346929208
"9506","chr7.134350000.134355000","chr7.134605000.134610000",255000,11,0.004686834,134350000,134605000,134355000,134610000,"chr7",288701,2,7,16,25,"chr7",1,0.0322315986872949
"9507","chr7.35750000.35755000","chr7.36010000.36015000",260000,27,1.87255e-16,35750000,36010000,35755000,36015000,"chr7",288719,1,0,5,6,"chr7",1,0.0189873417721519
"9508","chr7.6055000.6060000","chr7.6315000.6320000",260000,12,0.001104282,6055000,6315000,6060000,6320000,"chr7",288722,5,28,20,53,"chr7",1,0.0745428973277075
"9509","chr7.106030000.106035000","chr7.106050000.106055000",20000,35,0.007707517,106030000,106050000,106035000,106055000,"chr7",288751,0,5,1,6,"chr7",1,0.0246132208157525
"9510","chr7.5835000.5840000","chr7.5855000.5860000",20000,40,0.0002631097,5835000,5855000,5840000,5860000,"chr7",288774,8,17,26,51,"chr7",1,0.239099859353024
"9511","chr7.111730000.111735000","chr7.111840000.111845000",110000,16,0.001756896,111730000,111840000,111735000,111845000,"chr7",288885,1,4,2,7,"chr7",1,0.0131270511017346
"9512","chr7.38315000.38320000","chr7.38335000.38340000",20000,42,5.491611e-05,38315000,38335000,38320000,38340000,"chr7",288905,0,3,2,5,"chr7",1,0.0246132208157525
"9513","chr7.5605000.5610000","chr7.5695000.5700000",90000,33,1.578063e-13,5605000,5695000,5610000,5700000,"chr7",288927,4,6,4,14,"chr7",1,0.0541490857946554
"9514","chr7.127230000.127235000","chr7.127285000.127290000",55000,20,0.00985274,127230000,127285000,127235000,127290000,"chr7",288934,1,2,1,4,"chr7",1,0.00937646507266761
"9515","chr7.148260000.148265000","chr7.148660000.148665000",400000,10,0.002136785,148260000,148660000,148265000,148665000,"chr7",288943,0,8,9,17,"chr7",1,0.0199249882794187
"9516","chr7.149555000.149560000","chr7.149740000.149745000",185000,12,0.008260206,149555000,149740000,149560000,149745000,"chr7",288956,4,12,10,26,"chr7",1,0.0365682137834037
"9517","chr7.5405000.5410000","chr7.5530000.5535000",125000,16,0.0007417762,5405000,5530000,5410000,5535000,"chr7",289010,4,3,2,9,"chr7",1,0.0168776371308017
"9518","chr7.5600000.5605000","chr7.5745000.5750000",145000,31,1.284608e-15,5600000,5745000,5605000,5750000,"chr7",289062,8,21,21,50,"chr7",1,0.181669010782935
"9519","chr7.44895000.44900000","chr7.45030000.45035000",135000,14,0.004782504,44895000,45030000,44900000,45035000,"chr7",289116,4,12,22,38,"chr7",1,0.0623534927332396
"9520","chr7.92250000.92255000","chr7.92680000.92685000",430000,19,2.923636e-11,92250000,92680000,92255000,92685000,"chr7",289287,0,3,3,6,"chr7",1,0.0133614627285513
"9521","chr7.73985000.73990000","chr7.74045000.74050000",60000,20,0.004497771,73985000,74045000,73990000,74050000,"chr7",289290,2,4,4,10,"chr7",1,0.023441162681669
"9522","chr7.4725000.4730000","chr7.4795000.4800000",70000,24,1.112739e-05,4725000,4795000,4730000,4800000,"chr7",289339,4,8,13,25,"chr7",1,0.070323488045007
"9523","chr7.101680000.101685000","chr7.101810000.101815000",130000,15,0.001910926,101680000,101810000,101685000,101815000,"chr7",289395,3,9,7,19,"chr7",1,0.0334036568213783
"9524","chr7.74040000.74045000","chr7.74060000.74065000",20000,38,0.001104282,74040000,74060000,74045000,74065000,"chr7",289454,6,16,14,36,"chr7",1,0.160337552742616
"9525","chr7.130755000.130760000","chr7.131005000.131010000",250000,11,0.00523021,130755000,131005000,130760000,131010000,"chr7",289464,1,4,5,10,"chr7",1,0.012892639474918
"9526","chr7.29855000.29860000","chr7.29915000.29920000",60000,24,8.545768e-05,29855000,29915000,29860000,29920000,"chr7",289469,1,1,0,2,"chr7",1,0.00562587904360056
"9527","chr7.16755000.16760000","chr7.16925000.16930000",170000,16,8.870301e-05,16755000,16925000,16760000,16930000,"chr7",289489,0,1,1,2,"chr7",1,0.00375058602906704
"9528","chr7.104820000.104825000","chr7.104990000.104995000",170000,14,0.001261702,104820000,104990000,104825000,104995000,"chr7",289528,0,2,1,3,"chr7",1,0.00492264416315049
"9529","chr7.36525000.36530000","chr7.37235000.37240000",710000,19,2.713211e-14,36525000,37235000,36530000,37240000,"chr7",289530,1,3,2,6,"chr7",1,0.0133614627285513
"9530","chr7.35715000.35720000","chr7.36385000.36390000",670000,10,0.0001053494,35715000,36385000,35720000,36390000,"chr7",289552,0,8,1,9,"chr7",1,0.0105485232067511
"9531","chr7.140680000.140685000","chr7.141230000.141235000",550000,8,0.009289967,140680000,141230000,140685000,141235000,"chr7",289569,3,3,2,8,"chr7",1,0.00750117205813408
"9532","chr7.72445000.72450000","chr7.72790000.72795000",345000,10,0.004094908,72445000,72790000,72450000,72795000,"chr7",289572,0,3,3,6,"chr7",1,0.0070323488045007
"9533","chr7.30555000.30560000","chr7.30595000.30600000",40000,28,0.0002378575,30555000,30595000,30560000,30600000,"chr7",289586,1,4,5,10,"chr7",1,0.0328176277543366
"9534","chr7.22185000.22190000","chr7.22225000.22230000",40000,26,0.001406709,22185000,22225000,22190000,22230000,"chr7",289602,0,5,2,7,"chr7",1,0.0213314580403188
"9535","chr7.44810000.44815000","chr7.44885000.44890000",75000,18,0.004067044,44810000,44885000,44815000,44890000,"chr7",289612,1,20,18,39,"chr7",1,0.0822784810126582
"9536","chr7.78250000.78255000","chr7.78350000.78355000",100000,15,0.009373683,78250000,78350000,78255000,78355000,"chr7",289618,0,1,1,2,"chr7",1,0.00351617440225035
"9537","chr7.1125000.1130000","chr7.1180000.1185000",55000,20,0.00985274,1125000,1180000,1130000,1185000,"chr7",289620,4,19,23,46,"chr7",1,0.107829348335677
"9538","chr7.66095000.66100000","chr7.66455000.66460000",360000,12,0.0001624094,66095000,66455000,66100000,66460000,"chr7",289689,7,14,17,38,"chr7",1,0.0534458509142053
"9539","chr7.73715000.73720000","chr7.73790000.73795000",75000,22,5.491611e-05,73715000,73790000,73720000,73795000,"chr7",289709,2,2,2,6,"chr7",1,0.0154711673699015
"9540","chr7.111760000.111765000","chr7.111845000.111850000",85000,19,0.0004960118,111760000,111845000,111765000,111850000,"chr7",289784,1,3,0,4,"chr7",1,0.00890764181903422
"9541","chr7.28315000.28320000","chr7.28925000.28930000",610000,8,0.005748931,28315000,28925000,28320000,28930000,"chr7",289789,0,2,2,4,"chr7",1,0.00375058602906704
"9542","chr7.111635000.111640000","chr7.111860000.111865000",225000,14,0.0001705939,111635000,111860000,111640000,111865000,"chr7",289794,0,10,3,13,"chr7",1,0.0213314580403188
"9543","chr7.104795000.104800000","chr7.105125000.105130000",330000,10,0.004933786,104795000,105125000,104800000,105130000,"chr7",289799,2,2,2,6,"chr7",1,0.0070323488045007
"9544","chr7.865000.870000","chr7.900000.905000",35000,31,0.0001140788,865000,9e+05,870000,905000,"chr7",289811,1,5,1,7,"chr7",1,0.0254336615096109
"9545","chr7.44695000.44700000","chr7.45030000.45035000",335000,10,0.004638952,44695000,45030000,44700000,45035000,"chr7",289830,1,13,4,18,"chr7",1,0.0210970464135021
"9546","chr7.117375000.117380000","chr7.117470000.117475000",95000,18,0.000564117,117375000,117470000,117380000,117475000,"chr7",289836,0,3,6,9,"chr7",1,0.0189873417721519
"9547","chr7.51265000.51270000","chr7.51305000.51310000",40000,30,3.33137e-05,51265000,51305000,51270000,51310000,"chr7",289859,0,3,2,5,"chr7",1,0.0175808720112518
"9548","chr7.22155000.22160000","chr7.22300000.22305000",145000,18,1.84075e-05,22155000,22300000,22160000,22305000,"chr7",289892,0,1,2,3,"chr7",1,0.00632911392405063
"9549","chr7.131145000.131150000","chr7.131165000.131170000",20000,41,0.0001211885,131145000,131165000,131150000,131170000,"chr7",289970,5,13,9,27,"chr7",1,0.129746835443038
"9550","chr7.5615000.5620000","chr7.5695000.5700000",80000,22,2.656176e-05,5615000,5695000,5620000,5700000,"chr7",289999,4,6,4,14,"chr7",1,0.0360993905297703
"9551","chr7.116500000.116505000","chr7.116590000.116595000",90000,17,0.002606837,116500000,116590000,116505000,116595000,"chr7",290160,0,2,1,3,"chr7",1,0.0059774964838256
"9552","chr7.101245000.101250000","chr7.101880000.101885000",635000,8,0.004695034,101245000,101880000,101250000,101885000,"chr7",290231,4,7,5,16,"chr7",1,0.0150023441162682
"9553","chr7.44635000.44640000","chr7.44845000.44850000",210000,16,1.443512e-05,44635000,44845000,44640000,44850000,"chr7",290286,1,4,13,18,"chr7",1,0.0337552742616034
"9554","chr7.131005000.131010000","chr7.131075000.131080000",70000,18,0.007017412,131005000,131075000,131010000,131080000,"chr7",290401,1,4,2,7,"chr7",1,0.0147679324894515
"9555","chr7.134605000.134610000","chr7.134645000.134650000",40000,29,9.020623e-05,134605000,134645000,134610000,134650000,"chr7",290505,2,7,13,22,"chr7",1,0.0747773089545241
"9556","chr7.131640000.131645000","chr7.131920000.131925000",280000,12,0.0006932697,131640000,131920000,131645000,131925000,"chr7",290522,0,5,1,6,"chr7",1,0.00843881856540084
"9557","chr7.24700000.24705000","chr7.24755000.24760000",55000,20,0.00985274,24700000,24755000,24705000,24760000,"chr7",290530,1,4,7,12,"chr7",1,0.0281293952180028
"9558","chr7.104820000.104825000","chr7.104900000.104905000",80000,17,0.006379927,104820000,104900000,104825000,104905000,"chr7",290555,0,2,1,3,"chr7",1,0.0059774964838256
"9559","chr7.28685000.28690000","chr7.28705000.28710000",20000,35,0.007707517,28685000,28705000,28690000,28710000,"chr7",290580,0,0,3,3,"chr7",1,0.0123066104078762
"9560","chr7.32955000.32960000","chr7.33130000.33135000",175000,21,2.239404e-08,32955000,33130000,32960000,33135000,"chr7",290680,6,10,8,24,"chr7",1,0.0590717299578059
"9561","chr7.66030000.66035000","chr7.66110000.66115000",80000,19,0.0008424217,66030000,66110000,66035000,66115000,"chr7",290697,3,4,11,18,"chr7",1,0.040084388185654
"9562","chr7.137460000.137465000","chr7.137820000.137825000",360000,10,0.003402153,137460000,137820000,137465000,137825000,"chr7",290749,2,1,5,8,"chr7",1,0.00937646507266761
"9563","chr7.66040000.66045000","chr7.66095000.66100000",55000,20,0.00985274,66040000,66095000,66045000,66100000,"chr7",290781,5,11,21,37,"chr7",1,0.0867323019221753
"9564","chr7.22860000.22865000","chr7.23085000.23090000",225000,13,0.0007042362,22860000,23085000,22865000,23090000,"chr7",290834,4,10,8,22,"chr7",1,0.0335208626347867
"9565","chr7.41980000.41985000","chr7.42880000.42885000",900000,29,2.339605e-30,41980000,42880000,41985000,42885000,"chr7",290837,1,1,0,2,"chr7",1,0.00679793717768401
"9566","chr7.124025000.124030000","chr7.124365000.124370000",340000,11,0.001038591,124025000,124365000,124030000,124370000,"chr7",290845,0,1,5,6,"chr7",1,0.00773558368495077
"9567","chr7.18465000.18470000","chr7.18505000.18510000",40000,27,0.0005823026,18465000,18505000,18470000,18510000,"chr7",290860,0,2,4,6,"chr7",1,0.0189873417721519
"9568","chr7.35975000.35980000","chr7.36365000.36370000",390000,12,0.0001025322,35975000,36365000,35980000,36370000,"chr7",290877,2,3,1,6,"chr7",1,0.00843881856540084
"9569","chr7.24445000.24450000","chr7.24700000.24705000",255000,11,0.004686834,24445000,24700000,24450000,24705000,"chr7",290900,2,6,9,17,"chr7",1,0.0219174871073605
"9570","chr7.69515000.69520000","chr7.70090000.70095000",575000,8,0.007511413,69515000,70090000,69520000,70095000,"chr7",290983,2,11,10,23,"chr7",1,0.0215658696671355
"9571","chr7.107815000.107820000","chr7.108095000.108100000",280000,11,0.002839683,107815000,108095000,107820000,108100000,"chr7",290990,4,10,6,20,"chr7",1,0.0257852789498359
"9572","chr7.71305000.71310000","chr7.71775000.71780000",470000,9,0.004332514,71305000,71775000,71310000,71780000,"chr7",291045,1,11,8,20,"chr7",1,0.0210970464135021
"9573","chr7.2605000.2610000","chr7.2680000.2685000",75000,18,0.004067044,2605000,2680000,2610000,2685000,"chr7",291050,3,3,8,14,"chr7",1,0.029535864978903
"9574","chr7.130895000.130900000","chr7.130985000.130990000",90000,17,0.002606837,130895000,130985000,130900000,130990000,"chr7",291060,1,2,0,3,"chr7",1,0.0059774964838256
"9575","chr7.111680000.111685000","chr7.111760000.111765000",80000,25,5.041684e-07,111680000,111760000,111685000,111765000,"chr7",291070,4,7,3,14,"chr7",1,0.0410220346929208
"9576","chr7.78250000.78255000","chr7.78375000.78380000",125000,24,6.191422e-09,78250000,78375000,78255000,78380000,"chr7",291106,0,3,1,4,"chr7",1,0.0112517580872011
"9577","chr7.95200000.95205000","chr7.95510000.95515000",310000,10,0.006533851,95200000,95510000,95205000,95515000,"chr7",291114,1,2,1,4,"chr7",1,0.0046882325363338
"9578","chr7.12715000.12720000","chr7.13260000.13265000",545000,8,0.009682184,12715000,13260000,12720000,13265000,"chr7",291141,3,8,2,13,"chr7",1,0.0121894045944679
"9579","chr7.129240000.129245000","chr7.129485000.129490000",245000,11,0.005861433,129240000,129485000,129245000,129490000,"chr7",291142,3,14,14,31,"chr7",1,0.0399671823722457
"9580","chr7.129655000.129660000","chr7.130405000.130410000",750000,9,0.0003276619,129655000,130405000,129660000,130410000,"chr7",291161,3,3,2,8,"chr7",1,0.00843881856540084
"9581","chr7.111755000.111760000","chr7.111840000.111845000",85000,17,0.004067044,111755000,111840000,111760000,111845000,"chr7",291190,0,1,2,3,"chr7",1,0.0059774964838256
"9582","chr7.98655000.98660000","chr7.98935000.98940000",280000,17,1.550363e-07,98655000,98935000,98660000,98940000,"chr7",291191,2,11,4,17,"chr7",1,0.0338724800750117
"9583","chr7.2570000.2575000","chr7.2715000.2720000",145000,15,0.0009975075,2570000,2715000,2575000,2720000,"chr7",291223,0,2,0,2,"chr7",1,0.00351617440225035
"9584","chr7.104820000.104825000","chr7.104975000.104980000",155000,14,0.002219975,104820000,104975000,104825000,104980000,"chr7",291258,0,2,1,3,"chr7",1,0.00492264416315049
"9585","chr7.5560000.5565000","chr7.5675000.5680000",115000,17,0.000396453,5560000,5675000,5565000,5680000,"chr7",291259,2,8,3,13,"chr7",1,0.0259024847632443
"9586","chr7.5555000.5560000","chr7.5675000.5680000",120000,14,0.008840921,5555000,5675000,5560000,5680000,"chr7",291280,2,6,3,11,"chr7",1,0.0180496952648851
"9587","chr7.5470000.5475000","chr7.5745000.5750000",275000,15,6.791439e-06,5470000,5745000,5475000,5750000,"chr7",291289,3,13,15,31,"chr7",1,0.0545007032348805
"9588","chr7.65950000.65955000","chr7.66205000.66210000",255000,12,0.001246925,65950000,66205000,65955000,66210000,"chr7",291337,2,10,12,24,"chr7",1,0.0337552742616034
"9589","chr7.5595000.5600000","chr7.5710000.5715000",115000,23,8.463771e-08,5595000,5710000,5600000,5715000,"chr7",291419,3,4,3,10,"chr7",1,0.0269573370839194
"9590","chr7.95405000.95410000","chr7.95430000.95435000",25000,35,0.001519389,95405000,95430000,95410000,95435000,"chr7",291446,0,2,1,3,"chr7",1,0.0123066104078762
"9591","chr7.26150000.26155000","chr7.26395000.26400000",245000,11,0.005861433,26150000,26395000,26155000,26400000,"chr7",291538,1,2,0,3,"chr7",1,0.00386779184247539
"9592","chr7.5565000.5570000","chr7.5670000.5675000",105000,20,1.847853e-05,5565000,5670000,5570000,5675000,"chr7",291663,11,44,38,93,"chr7",1,0.218002812939522
"9593","chr7.141350000.141355000","chr7.141430000.141435000",80000,29,1.305642e-09,141350000,141430000,141355000,141435000,"chr7",291720,0,1,0,1,"chr7",1,0.00339896858884201
"9594","chr7.5605000.5610000","chr7.5630000.5635000",25000,36,0.0007257094,5605000,5630000,5610000,5635000,"chr7",291729,4,12,5,21,"chr7",1,0.0886075949367089
"9595","chr7.39670000.39675000","chr7.39725000.39730000",55000,23,0.0006714546,39670000,39725000,39675000,39730000,"chr7",291807,1,2,1,4,"chr7",1,0.0107829348335677
"9596","chr7.5450000.5455000","chr7.5505000.5510000",55000,21,0.004210319,5450000,5505000,5455000,5510000,"chr7",291810,11,34,29,74,"chr7",1,0.182137834036568
"9597","chr7.725000.730000","chr7.745000.750000",20000,45,4.31274e-06,725000,745000,730000,750000,"chr7",291838,0,2,0,2,"chr7",1,0.0105485232067511
"9598","chr7.101180000.101185000","chr7.101900000.101905000",720000,11,8.262238e-06,101180000,101900000,101185000,101905000,"chr7",291907,8,21,15,44,"chr7",1,0.056727613689639
"9599","chr7.117380000.117385000","chr7.117470000.117475000",90000,16,0.00705063,117380000,117470000,117385000,117475000,"chr7",292004,0,3,6,9,"chr7",1,0.0168776371308017
"9600","chr7.5530000.5535000","chr7.5855000.5860000",325000,11,0.001312213,5530000,5855000,5535000,5860000,"chr7",292026,4,3,2,9,"chr7",1,0.0116033755274262
"9601","chr7.1030000.1035000","chr7.1180000.1185000",150000,13,0.008260206,1030000,1180000,1035000,1185000,"chr7",292031,0,3,2,5,"chr7",1,0.00761837787154243
"9602","chr7.92135000.92140000","chr7.92680000.92685000",545000,8,0.009682184,92135000,92680000,92140000,92685000,"chr7",292032,0,3,3,6,"chr7",1,0.00562587904360056
"9603","chr7.4715000.4720000","chr7.4780000.4785000",65000,21,0.0007779944,4715000,4780000,4720000,4785000,"chr7",292094,5,11,13,29,"chr7",1,0.0713783403656821
"9604","chr7.28955000.28960000","chr7.29145000.29150000",190000,13,0.002161851,28955000,29145000,28960000,29150000,"chr7",292243,0,1,0,1,"chr7",1,0.00152367557430849
"9605","chr7.66095000.66100000","chr7.66205000.66210000",110000,25,5.802048e-09,66095000,66205000,66100000,66210000,"chr7",292250,5,10,13,28,"chr7",1,0.0820440693858415
"9606","chr7.29320000.29325000","chr7.29370000.29375000",50000,26,0.0001009853,29320000,29370000,29325000,29375000,"chr7",292258,0,8,3,11,"chr7",1,0.0335208626347867
"9607","chr7.37490000.37495000","chr7.37900000.37905000",410000,12,7.592976e-05,37490000,37900000,37495000,37905000,"chr7",292294,0,3,1,4,"chr7",1,0.00562587904360056
"9608","chr7.129295000.129300000","chr7.129330000.129335000",35000,29,0.0006655918,129295000,129330000,129300000,129335000,"chr7",292472,5,3,8,16,"chr7",1,0.0543834974214721
"9609","chr7.139355000.139360000","chr7.139430000.139435000",75000,22,5.491611e-05,139355000,139430000,139360000,139435000,"chr7",292521,3,13,7,23,"chr7",1,0.0593061415846226
"9610","chr7.5570000.5575000","chr7.5595000.5600000",25000,35,0.001519389,5570000,5595000,5575000,5600000,"chr7",292545,8,4,3,15,"chr7",1,0.0615330520393812
"9611","chr7.129315000.129320000","chr7.129635000.129640000",320000,10,0.005683939,129315000,129635000,129320000,129640000,"chr7",292553,2,6,5,13,"chr7",1,0.0152367557430849
"9612","chr7.30775000.30780000","chr7.31170000.31175000",395000,10,0.002251595,30775000,31170000,30780000,31175000,"chr7",292644,1,4,1,6,"chr7",1,0.0070323488045007
"9613","chr7.147245000.147250000","chr7.147635000.147640000",390000,9,0.009783085,147245000,147635000,147250000,147640000,"chr7",292649,1,3,6,10,"chr7",1,0.0105485232067511
"9614","chr7.139370000.139375000","chr7.139420000.139425000",50000,33,2.596267e-08,139370000,139420000,139375000,139425000,"chr7",292708,1,7,1,9,"chr7",1,0.0348101265822785
"9615","chr7.30205000.30210000","chr7.30320000.30325000",115000,20,7.687023e-06,30205000,30320000,30210000,30325000,"chr7",292910,0,2,1,3,"chr7",1,0.0070323488045007
"9616","chr7.24700000.24705000","chr7.24720000.24725000",20000,42,5.491611e-05,24700000,24720000,24705000,24725000,"chr7",293105,0,3,0,3,"chr7",1,0.0147679324894515
"9617","chr7.4740000.4745000","chr7.4780000.4785000",40000,41,5.70743e-11,4740000,4780000,4745000,4785000,"chr7",293114,3,11,12,26,"chr7",1,0.124941397093296
"9618","chr7.129660000.129665000","chr7.130520000.130525000",860000,7,0.005284106,129660000,130520000,129665000,130525000,"chr7",293122,0,2,1,3,"chr7",1,0.00246132208157525
"9619","chr7.28470000.28475000","chr7.28740000.28745000",270000,16,1.380954e-06,28470000,28740000,28475000,28745000,"chr7",293158,4,5,5,14,"chr7",1,0.0262541022034693
"9620","chr7.141400000.141405000","chr7.141430000.141435000",30000,30,0.00305535,141400000,141430000,141405000,141435000,"chr7",293189,1,1,0,2,"chr7",1,0.0070323488045007
"9621","chr7.96775000.96780000","chr7.97470000.97475000",695000,13,1.413759e-07,96775000,97470000,96780000,97475000,"chr7",293198,0,3,2,5,"chr7",1,0.00761837787154243
"9622","chr7.22150000.22155000","chr7.22290000.22295000",140000,48,1.432545e-32,22150000,22290000,22155000,22295000,"chr7",293210,0,0,5,5,"chr7",1,0.0281293952180028
"9623","chr7.66140000.66145000","chr7.66455000.66460000",315000,10,0.006086509,66140000,66455000,66145000,66460000,"chr7",293277,4,8,4,16,"chr7",1,0.0187529301453352
"9624","chr7.30320000.30325000","chr7.30500000.30505000",180000,12,0.009682184,30320000,30500000,30325000,30505000,"chr7",293311,0,2,1,3,"chr7",1,0.00421940928270042
"9625","chr7.139520000.139525000","chr7.139680000.139685000",160000,14,0.001832506,139520000,139680000,139525000,139685000,"chr7",293367,2,0,1,3,"chr7",1,0.00492264416315049
"9626","chr7.45025000.45030000","chr7.45150000.45155000",125000,27,3.133738e-11,45025000,45150000,45030000,45155000,"chr7",293393,0,6,3,9,"chr7",1,0.0284810126582278
"9627","chr7.131025000.131030000","chr7.131075000.131080000",50000,31,3.362536e-07,131025000,131075000,131030000,131080000,"chr7",293419,3,5,2,10,"chr7",1,0.036333802156587
"9628","chr7.130995000.131000000","chr7.131025000.131030000",30000,31,0.001458307,130995000,131025000,1.31e+08,131030000,"chr7",293490,0,3,0,3,"chr7",1,0.0109001406469761
"9629","chr7.5380000.5385000","chr7.5505000.5510000",125000,14,0.007055032,5380000,5505000,5385000,5510000,"chr7",293497,11,32,31,74,"chr7",1,0.121425222691045
"9630","chr7.134515000.134520000","chr7.134605000.134610000",90000,17,0.002606837,134515000,134605000,134520000,134610000,"chr7",293505,3,7,6,16,"chr7",1,0.0318799812470699
"9631","chr7.128385000.128390000","chr7.128460000.128465000",75000,22,5.491611e-05,128385000,128460000,128390000,128465000,"chr7",293527,3,2,8,13,"chr7",1,0.0335208626347867
"9632","chr7.23225000.23230000","chr7.23530000.23535000",305000,12,0.0004178462,23225000,23530000,23230000,23535000,"chr7",293535,2,14,12,28,"chr7",1,0.0393811533052039
"9633","chr7.31190000.31195000","chr7.31260000.31265000",70000,18,0.007017412,31190000,31260000,31195000,31265000,"chr7",293537,0,0,2,2,"chr7",1,0.00421940928270042
"9634","chr7.1610000.1615000","chr7.2415000.2420000",805000,7,0.007340438,1610000,2415000,1615000,2420000,"chr7",293541,5,15,12,32,"chr7",1,0.0262541022034693
"9635","chr7.105720000.105725000","chr7.105805000.105810000",85000,17,0.004067044,105720000,105805000,105725000,105810000,"chr7",293589,2,0,0,2,"chr7",1,0.00398499765588373
"9636","chr7.4685000.4690000","chr7.4735000.4740000",50000,23,0.001817981,4685000,4735000,4690000,4740000,"chr7",293652,1,5,7,13,"chr7",1,0.0350445382090952
"9637","chr7.10970000.10975000","chr7.11250000.11255000",280000,19,3.113535e-09,10970000,11250000,10975000,11255000,"chr7",293674,0,6,0,6,"chr7",1,0.0133614627285513
"9638","chr7.5605000.5610000","chr7.5690000.5695000",85000,28,2.258283e-09,5605000,5690000,5610000,5695000,"chr7",293709,0,3,5,8,"chr7",1,0.0262541022034693
"9639","chr7.130755000.130760000","chr7.131165000.131170000",410000,10,0.001892432,130755000,131165000,130760000,131170000,"chr7",293779,5,14,9,28,"chr7",1,0.0328176277543366
"9640","chr7.154110000.154115000","chr7.154200000.154205000",90000,20,8.870301e-05,154110000,154200000,154115000,154205000,"chr7",293798,0,2,0,2,"chr7",1,0.0046882325363338
"9641","chr7.36010000.36015000","chr7.36365000.36370000",355000,20,2.583345e-11,36010000,36365000,36015000,36370000,"chr7",293865,2,3,1,6,"chr7",1,0.0140646976090014
"9642","chr7.75485000.75490000","chr7.75640000.75645000",155000,15,0.000656297,75485000,75640000,75490000,75645000,"chr7",293866,4,13,6,23,"chr7",1,0.040436005625879
"9643","chr7.38260000.38265000","chr7.38370000.38375000",110000,25,5.802048e-09,38260000,38370000,38265000,38375000,"chr7",293876,1,3,2,6,"chr7",1,0.0175808720112518
"9644","chr7.5525000.5530000","chr7.5710000.5715000",185000,14,0.0007109472,5525000,5710000,5530000,5715000,"chr7",293900,3,8,5,16,"chr7",1,0.0262541022034693
"9645","chr7.29315000.29320000","chr7.29375000.29380000",60000,30,5.106847e-08,29315000,29375000,29320000,29380000,"chr7",294001,0,0,3,3,"chr7",1,0.0105485232067511
"9646","chr7.90240000.90245000","chr7.90675000.90680000",435000,9,0.006213825,90240000,90675000,90245000,90680000,"chr7",294020,1,0,1,2,"chr7",1,0.00210970464135021
"9647","chr7.68935000.68940000","chr7.69500000.69505000",565000,9,0.00174694,68935000,69500000,68940000,69505000,"chr7",294156,2,10,13,25,"chr7",1,0.0263713080168776
"9648","chr7.5820000.5825000","chr7.5855000.5860000",35000,40,6.939528e-09,5820000,5855000,5825000,5860000,"chr7",294197,7,36,34,77,"chr7",1,0.360993905297703
"9649","chr7.2680000.2685000","chr7.2720000.2725000",40000,26,0.001406709,2680000,2720000,2685000,2725000,"chr7",294238,6,11,13,30,"chr7",1,0.0914205344585091
"9650","chr7.22365000.22370000","chr7.22385000.22390000",20000,40,0.0002631097,22365000,22385000,22370000,22390000,"chr7",294241,0,3,0,3,"chr7",1,0.0140646976090014
"9651","chr7.5675000.5680000","chr7.5745000.5750000",70000,23,3.745658e-05,5675000,5745000,5680000,5750000,"chr7",294281,2,8,3,13,"chr7",1,0.0350445382090952
"9652","chr7.117680000.117685000","chr7.117730000.117735000",50000,22,0.004297703,117680000,117730000,117685000,117735000,"chr7",294323,0,0,2,2,"chr7",1,0.00515705578996718
"9653","chr7.105285000.105290000","chr7.105645000.105650000",360000,12,0.0001624094,105285000,105645000,105290000,105650000,"chr7",294329,5,14,16,35,"chr7",1,0.0492264416315049
"9654","chr7.2380000.2385000","chr7.2450000.2455000",70000,21,0.0003571728,2380000,2450000,2385000,2455000,"chr7",294359,0,15,3,18,"chr7",1,0.0443037974683544
"9655","chr7.90975000.90980000","chr7.91230000.91235000",255000,11,0.004686834,90975000,91230000,90980000,91235000,"chr7",294369,1,0,1,2,"chr7",1,0.00257852789498359
"9656","chr7.134140000.134145000","chr7.134295000.134300000",155000,15,0.000656297,134140000,134295000,134145000,134300000,"chr7",294451,4,14,4,22,"chr7",1,0.0386779184247539
"9657","chr7.38260000.38265000","chr7.38335000.38340000",75000,23,1.624945e-05,38260000,38335000,38265000,38340000,"chr7",294459,0,3,2,5,"chr7",1,0.0134786685419597
"9658","chr7.41980000.41985000","chr7.42960000.42965000",980000,7,0.002350543,41980000,42960000,41985000,42965000,"chr7",294460,1,1,0,2,"chr7",1,0.00164088138771683
"9659","chr7.98035000.98040000","chr7.98430000.98435000",395000,9,0.009289967,98035000,98430000,98040000,98435000,"chr7",294475,7,19,31,57,"chr7",1,0.060126582278481
"9660","chr7.111635000.111640000","chr7.111770000.111775000",135000,19,7.81911e-06,111635000,111770000,111640000,111775000,"chr7",294477,6,11,8,25,"chr7",1,0.0556727613689639
"9661","chr7.105690000.105695000","chr7.105755000.105760000",65000,25,9.002226e-06,105690000,105755000,105695000,105760000,"chr7",294499,1,2,3,6,"chr7",1,0.0175808720112518
"9662","chr7.78420000.78425000","chr7.78570000.78575000",150000,13,0.008260206,78420000,78570000,78425000,78575000,"chr7",294575,0,1,0,1,"chr7",1,0.00152367557430849
"9663","chr7.35750000.35755000","chr7.35850000.35855000",100000,21,7.913082e-06,35750000,35850000,35755000,35855000,"chr7",294658,1,0,3,4,"chr7",1,0.00984528832630099
"9664","chr7.111800000.111805000","chr7.111840000.111845000",40000,33,1.34012e-06,111800000,111840000,111805000,111845000,"chr7",294677,0,3,2,5,"chr7",1,0.0193389592123769
"9665","chr7.5745000.5750000","chr7.5835000.5840000",90000,22,6.774109e-06,5745000,5835000,5750000,5840000,"chr7",294678,8,17,21,46,"chr7",1,0.118612283169245
"9666","chr7.128395000.128400000","chr7.128415000.128420000",20000,37,0.002176787,128395000,128415000,128400000,128420000,"chr7",294718,3,6,8,17,"chr7",1,0.073722456633849
"9667","chr7.111635000.111640000","chr7.111845000.111850000",210000,13,0.001122768,111635000,111845000,111640000,111850000,"chr7",294939,1,3,0,4,"chr7",1,0.00609470229723394
"9668","chr7.99840000.99845000","chr7.99925000.99930000",85000,20,0.000156116,99840000,99925000,99845000,99930000,"chr7",294992,0,3,0,3,"chr7",1,0.0070323488045007
"9669","chr7.22155000.22160000","chr7.22290000.22295000",135000,15,0.001530673,22155000,22290000,22160000,22295000,"chr7",295062,0,0,2,2,"chr7",1,0.00351617440225035
"9670","chr7.6055000.6060000","chr7.6365000.6370000",310000,12,0.0003776456,6055000,6365000,6060000,6370000,"chr7",295100,5,28,20,53,"chr7",1,0.0745428973277075
"9671","chr7.36010000.36015000","chr7.36185000.36190000",175000,13,0.00355792,36010000,36185000,36015000,36190000,"chr7",295119,2,10,4,16,"chr7",1,0.0243788091889358
"9672","chr7.100075000.100080000","chr7.100155000.100160000",80000,28,6.191422e-09,100075000,100155000,100080000,100160000,"chr7",295168,3,3,3,9,"chr7",1,0.029535864978903
"9673","chr7.36195000.36200000","chr7.36315000.36320000",120000,24,1.010412e-08,36195000,36315000,36200000,36320000,"chr7",295237,2,12,12,26,"chr7",1,0.0731364275668073
"9674","chr7.105720000.105725000","chr7.105760000.105765000",40000,28,0.0002378575,105720000,105760000,105725000,105765000,"chr7",295255,0,4,2,6,"chr7",1,0.019690576652602
"9675","chr7.44625000.44630000","chr7.44885000.44890000",260000,36,2.086586e-26,44625000,44885000,44630000,44890000,"chr7",295261,1,13,8,22,"chr7",1,0.0928270042194093
"9676","chr7.100505000.100510000","chr7.100705000.100710000",200000,15,0.0001003067,100505000,100705000,100510000,100710000,"chr7",295300,9,28,19,56,"chr7",1,0.0984528832630098
"9677","chr7.81685000.81690000","chr7.82160000.82165000",475000,12,2.857822e-05,81685000,82160000,81690000,82165000,"chr7",295502,0,3,2,5,"chr7",1,0.0070323488045007
"9678","chr7.4680000.4685000","chr7.4715000.4720000",35000,39,2.295656e-08,4680000,4715000,4685000,4720000,"chr7",295506,5,24,14,43,"chr7",1,0.196554149085795
"9679","chr7.140355000.140360000","chr7.140580000.140585000",225000,14,0.0001705939,140355000,140580000,140360000,140585000,"chr7",295554,6,11,18,35,"chr7",1,0.0574308485700891
"9680","chr7.151570000.151575000","chr7.151630000.151635000",60000,22,0.0006823538,151570000,151630000,151575000,151635000,"chr7",295582,1,6,6,13,"chr7",1,0.0335208626347867
"9681","chr7.129875000.129880000","chr7.130070000.130075000",195000,16,2.801884e-05,129875000,130070000,129880000,130075000,"chr7",295654,0,0,3,3,"chr7",1,0.00562587904360056
"9682","chr7.16450000.16455000","chr7.16615000.16620000",165000,20,2.426363e-07,16450000,16615000,16455000,16620000,"chr7",295760,1,8,6,15,"chr7",1,0.0351617440225035
"9683","chr7.130865000.130870000","chr7.130980000.130985000",115000,15,0.003963222,130865000,130980000,130870000,130985000,"chr7",295787,0,2,1,3,"chr7",1,0.00527426160337553
"9684","chr7.4725000.4730000","chr7.4775000.4780000",50000,27,3.508869e-05,4725000,4775000,4730000,4780000,"chr7",295804,4,8,13,25,"chr7",1,0.0791139240506329
"9685","chr7.66095000.66100000","chr7.66305000.66310000",210000,14,0.0002870934,66095000,66305000,66100000,66310000,"chr7",295824,3,14,11,28,"chr7",1,0.0459446788560713
"9686","chr7.22255000.22260000","chr7.22485000.22490000",230000,11,0.008168733,22255000,22485000,22260000,22490000,"chr7",295860,3,8,6,17,"chr7",1,0.0219174871073605
"9687","chr7.130715000.130720000","chr7.131025000.131030000",310000,12,0.0003776456,130715000,131025000,130720000,131030000,"chr7",295917,5,10,2,17,"chr7",1,0.0239099859353024
"9688","chr7.74060000.74065000","chr7.74080000.74085000",20000,36,0.004179201,74060000,74080000,74065000,74085000,"chr7",295933,6,19,11,36,"chr7",1,0.151898734177215
"9689","chr7.55530000.55535000","chr7.55590000.55595000",60000,21,0.001817981,55530000,55590000,55535000,55595000,"chr7",295961,0,1,1,2,"chr7",1,0.00492264416315049
"9690","chr7.51270000.51275000","chr7.51430000.51435000",160000,15,0.0005334827,51270000,51430000,51275000,51435000,"chr7",296001,2,5,5,12,"chr7",1,0.0210970464135021
"9691","chr7.66305000.66310000","chr7.66455000.66460000",150000,18,1.380867e-05,66305000,66455000,66310000,66460000,"chr7",296025,3,14,11,28,"chr7",1,0.0590717299578059
"9692","chr7.129295000.129300000","chr7.129655000.129660000",360000,10,0.003402153,129295000,129655000,129300000,129660000,"chr7",296028,5,3,8,16,"chr7",1,0.0187529301453352
"9693","chr7.5635000.5640000","chr7.5670000.5675000",35000,51,2.096491e-15,5635000,5670000,5640000,5675000,"chr7",296102,5,17,22,44,"chr7",1,0.263009845288326
"9694","chr7.130910000.130915000","chr7.130980000.130985000",70000,22,0.0001195867,130910000,130980000,130915000,130985000,"chr7",296234,0,2,1,3,"chr7",1,0.00773558368495077
"9695","chr7.66110000.66115000","chr7.66205000.66210000",95000,21,1.380867e-05,66110000,66205000,66115000,66210000,"chr7",296272,5,10,13,28,"chr7",1,0.0689170182841069
"9696","chr7.102740000.102745000","chr7.102930000.102935000",190000,12,0.007093495,102740000,102930000,102745000,102935000,"chr7",296275,1,2,0,3,"chr7",1,0.00421940928270042
"9697","chr7.5675000.5680000","chr7.5695000.5700000",20000,59,1.764756e-12,5675000,5695000,5680000,5700000,"chr7",296285,2,6,3,11,"chr7",1,0.0760665729020159
"9698","chr7.134420000.134425000","chr7.134605000.134610000",185000,14,0.0007109472,134420000,134605000,134425000,134610000,"chr7",296322,1,7,1,9,"chr7",1,0.0147679324894515
"9699","chr7.107825000.107830000","chr7.108140000.108145000",315000,13,7.040308e-05,107825000,108140000,107830000,108145000,"chr7",296345,1,4,2,7,"chr7",1,0.0106657290201594
"9700","chr7.77570000.77575000","chr7.78135000.78140000",565000,9,0.00174694,77570000,78135000,77575000,78140000,"chr7",296454,1,0,6,7,"chr7",1,0.00738396624472574
"9701","chr7.148260000.148265000","chr7.148575000.148580000",315000,12,0.0003455231,148260000,148575000,148265000,148580000,"chr7",296482,0,12,10,22,"chr7",1,0.0309423347398031
"9702","chr7.29145000.29150000","chr7.29375000.29380000",230000,11,0.008168733,29145000,29375000,29150000,29380000,"chr7",296495,0,5,0,5,"chr7",1,0.00644631973745898
"9703","chr7.29035000.29040000","chr7.29405000.29410000",370000,11,0.0006823538,29035000,29405000,29040000,29410000,"chr7",296504,1,0,1,2,"chr7",1,0.00257852789498359
"9704","chr7.128110000.128115000","chr7.128425000.128430000",315000,10,0.006086509,128110000,128425000,128115000,128430000,"chr7",296531,1,5,2,8,"chr7",1,0.00937646507266761
"9705","chr7.75570000.75575000","chr7.75625000.75630000",55000,22,0.00174694,75570000,75625000,75575000,75630000,"chr7",296591,5,17,11,33,"chr7",1,0.0850914205344585
"9706","chr7.56070000.56075000","chr7.56115000.56120000",45000,42,6.939039e-13,56070000,56115000,56075000,56120000,"chr7",296603,8,18,21,47,"chr7",1,0.231364275668073
"9707","chr7.24480000.24485000","chr7.24700000.24705000",220000,12,0.00306361,24480000,24700000,24485000,24705000,"chr7",296614,0,2,3,5,"chr7",1,0.0070323488045007
"9708","chr7.36080000.36085000","chr7.36365000.36370000",285000,10,0.009627553,36080000,36365000,36085000,36370000,"chr7",296643,2,1,1,4,"chr7",1,0.0046882325363338
"9709","chr7.130520000.130525000","chr7.130715000.130720000",195000,12,0.006213825,130520000,130715000,130525000,130720000,"chr7",296654,0,2,1,3,"chr7",1,0.00421940928270042
"9710","chr7.100850000.100855000","chr7.100895000.100900000",45000,26,0.0003455231,100850000,100895000,100855000,100900000,"chr7",296694,7,23,32,62,"chr7",1,0.188935771214252
"9711","chr7.154215000.154220000","chr7.154255000.154260000",40000,30,3.33137e-05,154215000,154255000,154220000,154260000,"chr7",296725,1,2,2,5,"chr7",1,0.0175808720112518
"9712","chr7.37250000.37255000","chr7.37270000.37275000",20000,37,0.002176787,37250000,37270000,37255000,37275000,"chr7",296758,0,3,4,7,"chr7",1,0.0303563056727614
"9713","chr7.92180000.92185000","chr7.92485000.92490000",305000,11,0.001817981,92180000,92485000,92185000,92490000,"chr7",296775,1,2,1,4,"chr7",1,0.00515705578996718
"9714","chr7.129875000.129880000","chr7.130355000.130360000",480000,11,0.0001571225,129875000,130355000,129880000,130360000,"chr7",296794,0,0,3,3,"chr7",1,0.00386779184247539
"9715","chr7.154110000.154115000","chr7.154545000.154550000",435000,9,0.006213825,154110000,154545000,154115000,154550000,"chr7",296803,0,3,0,3,"chr7",1,0.00316455696202532
"9716","chr7.140260000.140265000","chr7.140325000.140330000",65000,19,0.005289393,140260000,140325000,140265000,140330000,"chr7",296836,0,10,10,20,"chr7",1,0.0445382090951711
"9717","chr7.44920000.44925000","chr7.45020000.45025000",100000,15,0.009373683,44920000,45020000,44925000,45025000,"chr7",296936,2,10,10,22,"chr7",1,0.0386779184247539
"9718","chr7.5820000.5825000","chr7.5870000.5875000",50000,22,0.004297703,5820000,5870000,5825000,5875000,"chr7",296938,7,36,34,77,"chr7",1,0.198546647913737
"9719","chr7.104805000.104810000","chr7.104820000.104825000",15000,36,0.004179201,104805000,104820000,104810000,104825000,"chr7",296990,0,2,0,2,"chr7",1,0.00843881856540084
"9720","chr7.127390000.127395000","chr7.127690000.127695000",300000,11,0.001971347,127390000,127690000,127395000,127695000,"chr7",297002,1,5,5,11,"chr7",1,0.0141819034224098
"9721","chr7.44630000.44635000","chr7.44770000.44775000",140000,15,0.001246925,44630000,44770000,44635000,44775000,"chr7",297017,4,3,10,17,"chr7",1,0.029887482419128
"9722","chr7.73855000.73860000","chr7.73985000.73990000",130000,27,1.816512e-11,73855000,73985000,73860000,73990000,"chr7",297056,5,12,16,33,"chr7",1,0.104430379746835
"9723","chr7.101775000.101780000","chr7.101810000.101815000",35000,29,0.0006655918,101775000,101810000,101780000,101815000,"chr7",297065,3,9,7,19,"chr7",1,0.0645804031879981
"9724","chr7.43035000.43040000","chr7.43325000.43330000",290000,10,0.008840921,43035000,43325000,43040000,43330000,"chr7",297096,0,2,1,3,"chr7",1,0.00351617440225035
"9725","chr7.99105000.99110000","chr7.99575000.99580000",470000,9,0.004332514,99105000,99575000,99110000,99580000,"chr7",297104,1,8,5,14,"chr7",1,0.0147679324894515
"9726","chr7.10940000.10945000","chr7.11250000.11255000",310000,12,0.0003776456,10940000,11250000,10945000,11255000,"chr7",297105,0,6,3,9,"chr7",1,0.0126582278481013
"9727","chr7.35730000.35735000","chr7.35850000.35855000",120000,23,5.146195e-08,35730000,35850000,35735000,35855000,"chr7",297130,1,4,1,6,"chr7",1,0.0161744022503516
"9728","chr7.2005000.2010000","chr7.2060000.2065000",55000,24,0.0002524413,2005000,2060000,2010000,2065000,"chr7",297158,0,7,6,13,"chr7",1,0.0365682137834037
"9729","chr7.73605000.73610000","chr7.74080000.74085000",475000,10,0.0008805943,73605000,74080000,73610000,74085000,"chr7",297168,8,19,11,38,"chr7",1,0.0445382090951711
"9730","chr7.130715000.130720000","chr7.131145000.131150000",430000,12,5.538288e-05,130715000,131145000,130720000,131150000,"chr7",297197,5,13,9,27,"chr7",1,0.0379746835443038
"9731","chr7.64560000.64565000","chr7.65250000.65255000",690000,8,0.003093324,64560000,65250000,64565000,65255000,"chr7",297215,0,18,16,34,"chr7",1,0.0318799812470699
"9732","chr7.129400000.129405000","chr7.129620000.129625000",220000,13,0.0008182911,129400000,129620000,129405000,129625000,"chr7",297268,4,13,9,26,"chr7",1,0.0396155649320206
"9733","chr7.30200000.30205000","chr7.30465000.30470000",265000,15,9.340192e-06,30200000,30465000,30205000,30470000,"chr7",297279,0,3,3,6,"chr7",1,0.0105485232067511
"9734","chr7.148015000.148020000","chr7.148095000.148100000",80000,19,0.0008424217,148015000,148095000,148020000,148100000,"chr7",297296,0,5,6,11,"chr7",1,0.0244960150023441
"9735","chr7.44680000.44685000","chr7.44770000.44775000",90000,18,0.000888016,44680000,44770000,44685000,44775000,"chr7",297323,9,13,16,38,"chr7",1,0.080168776371308
"9736","chr7.37250000.37255000","chr7.37320000.37325000",70000,29,1.287626e-08,37250000,37320000,37255000,37325000,"chr7",297455,0,3,10,13,"chr7",1,0.0441865916549461
"9737","chr7.130715000.130720000","chr7.131150000.131155000",435000,9,0.006213825,130715000,131150000,130720000,131155000,"chr7",297475,5,20,20,45,"chr7",1,0.0474683544303797
"9738","chr7.37025000.37030000","chr7.37235000.37240000",210000,14,0.0002870934,37025000,37235000,37030000,37240000,"chr7",297478,1,2,4,7,"chr7",1,0.0114861697140178
"9739","chr7.100080000.100085000","chr7.100155000.100160000",75000,20,0.0005334827,100080000,100155000,100085000,100160000,"chr7",297595,3,3,3,9,"chr7",1,0.0210970464135021
"9740","chr7.75485000.75490000","chr7.75660000.75665000",175000,13,0.00355792,75485000,75660000,75490000,75665000,"chr7",297603,4,13,6,23,"chr7",1,0.0350445382090952
"9741","chr7.134350000.134355000","chr7.134600000.134605000",250000,12,0.001416254,134350000,134600000,134355000,134605000,"chr7",297688,1,2,6,9,"chr7",1,0.0126582278481013
"9742","chr7.134350000.134355000","chr7.134645000.134650000",295000,17,9.31643e-08,134350000,134645000,134355000,134650000,"chr7",297705,2,13,13,28,"chr7",1,0.0557899671823722
"9743","chr7.129490000.129495000","chr7.129620000.129625000",130000,14,0.005856061,129490000,129620000,129495000,129625000,"chr7",297706,1,12,7,20,"chr7",1,0.0328176277543366
"9744","chr7.16450000.16455000","chr7.16470000.16475000",20000,35,0.007707517,16450000,16470000,16455000,16475000,"chr7",297727,0,1,3,4,"chr7",1,0.0164088138771683
"9745","chr7.5665000.5670000","chr7.5745000.5750000",80000,22,2.656176e-05,5665000,5745000,5670000,5750000,"chr7",297824,2,9,11,22,"chr7",1,0.056727613689639
"9746","chr7.95200000.95205000","chr7.95260000.95265000",60000,20,0.004497771,95200000,95260000,95205000,95265000,"chr7",297874,0,2,1,3,"chr7",1,0.0070323488045007
"9747","chr7.4685000.4690000","chr7.4725000.4730000",40000,27,0.0005823026,4685000,4725000,4690000,4730000,"chr7",297949,4,8,13,25,"chr7",1,0.0791139240506329
"9748","chr7.98655000.98660000","chr7.98920000.98925000",265000,14,4.800053e-05,98655000,98920000,98660000,98925000,"chr7",298058,0,13,4,17,"chr7",1,0.0278949835911861
"9749","chr7.44625000.44630000","chr7.45030000.45035000",405000,9,0.008319421,44625000,45030000,44630000,45035000,"chr7",298064,9,13,8,30,"chr7",1,0.0316455696202532
"9750","chr7.139430000.139435000","chr7.139450000.139455000",20000,50,3.718074e-08,139430000,139450000,139435000,139455000,"chr7",298075,2,13,7,22,"chr7",1,0.12892639474918
"9751","chr7.148385000.148390000","chr7.148575000.148580000",190000,16,3.501739e-05,148385000,148575000,148390000,148580000,"chr7",298109,1,7,1,9,"chr7",1,0.0168776371308017
"9752","chr7.134950000.134955000","chr7.135240000.135245000",290000,12,0.000564117,134950000,135240000,134955000,135245000,"chr7",298114,0,3,2,5,"chr7",1,0.0070323488045007
"9753","chr7.55550000.55555000","chr7.55590000.55595000",40000,31,1.180997e-05,55550000,55590000,55555000,55595000,"chr7",298120,0,2,0,2,"chr7",1,0.00726676043131739
"9754","chr7.128110000.128115000","chr7.128300000.128305000",190000,16,3.501739e-05,128110000,128300000,128115000,128305000,"chr7",298148,1,4,2,7,"chr7",1,0.0131270511017346
"9755","chr7.139025000.139030000","chr7.139105000.139110000",80000,23,7.503991e-06,139025000,139105000,139030000,139110000,"chr7",298172,4,14,11,29,"chr7",1,0.0781762775433661
"9756","chr7.5530000.5535000","chr7.5600000.5605000",70000,18,0.007017412,5530000,5600000,5535000,5605000,"chr7",298203,4,3,2,9,"chr7",1,0.0189873417721519
"9757","chr7.129875000.129880000","chr7.130140000.130145000",265000,14,4.800053e-05,129875000,130140000,129880000,130145000,"chr7",298232,0,0,1,1,"chr7",1,0.00164088138771683
"9758","chr7.117375000.117380000","chr7.117735000.117740000",360000,11,0.0007791517,117375000,117735000,117380000,117740000,"chr7",298284,2,3,2,7,"chr7",1,0.00902484763244257
"9759","chr7.44640000.44645000","chr7.45150000.45155000",510000,14,3.129452e-07,44640000,45150000,44645000,45155000,"chr7",298299,3,6,3,12,"chr7",1,0.019690576652602
"9760","chr7.73985000.73990000","chr7.74065000.74070000",80000,21,8.910063e-05,73985000,74065000,73990000,74070000,"chr7",298329,4,12,19,35,"chr7",1,0.0861462728551336
"9761","chr7.5605000.5610000","chr7.5675000.5680000",70000,48,3.061187e-23,5605000,5675000,5610000,5680000,"chr7",298377,2,8,3,13,"chr7",1,0.0731364275668073
"9762","chr7.5605000.5610000","chr7.5710000.5715000",105000,47,5.655716e-28,5605000,5710000,5610000,5715000,"chr7",298426,3,8,5,16,"chr7",1,0.0881387716830755
"9763","chr7.95205000.95210000","chr7.95260000.95265000",55000,21,0.004210319,95205000,95260000,95210000,95265000,"chr7",298435,0,1,2,3,"chr7",1,0.00738396624472574
"9764","chr7.5530000.5535000","chr7.5670000.5675000",140000,14,0.003981961,5530000,5670000,5535000,5675000,"chr7",298470,4,3,2,9,"chr7",1,0.0147679324894515
"9765","chr7.152025000.152030000","chr7.152415000.152420000",390000,10,0.002395626,152025000,152415000,152030000,152420000,"chr7",298503,6,6,21,33,"chr7",1,0.0386779184247539
"9766","chr7.51140000.51145000","chr7.51160000.51165000",20000,46,1.756288e-06,51140000,51160000,51145000,51165000,"chr7",298571,0,4,1,5,"chr7",1,0.0269573370839194
"9767","chr7.95100000.95105000","chr7.95305000.95310000",205000,14,0.0003455231,95100000,95305000,95105000,95310000,"chr7",298634,1,3,1,5,"chr7",1,0.00820440693858415
"9768","chr7.78135000.78140000","chr7.78775000.78780000",640000,9,0.000856389,78135000,78775000,78140000,78780000,"chr7",298638,0,0,6,6,"chr7",1,0.00632911392405063
"9769","chr7.30275000.30280000","chr7.30595000.30600000",320000,13,6.386341e-05,30275000,30595000,30280000,30600000,"chr7",298716,0,2,1,3,"chr7",1,0.00457102672292546
"9770","chr7.5140000.5145000","chr7.5175000.5180000",35000,27,0.003347901,5140000,5175000,5145000,5180000,"chr7",298719,4,16,25,45,"chr7",1,0.142405063291139
"9771","chr7.151995000.152000000","chr7.152415000.152420000",420000,9,0.007104769,151995000,152415000,1.52e+08,152420000,"chr7",298742,5,7,9,21,"chr7",1,0.0221518987341772
"9772","chr7.154110000.154115000","chr7.154255000.154260000",145000,14,0.003260262,154110000,154255000,154115000,154260000,"chr7",298788,0,3,0,3,"chr7",1,0.00492264416315049
"9773","chr7.6540000.6545000","chr7.6615000.6620000",75000,19,0.001517752,6540000,6615000,6545000,6620000,"chr7",298881,6,14,17,37,"chr7",1,0.0823956868260666
"9774","chr7.104845000.104850000","chr7.104975000.104980000",130000,15,0.001910926,104845000,104975000,104850000,104980000,"chr7",298897,1,6,7,14,"chr7",1,0.0246132208157525
"9775","chr7.75990000.75995000","chr7.76005000.76010000",15000,38,0.001104282,75990000,76005000,75995000,76010000,"chr7",298906,4,10,2,16,"chr7",1,0.0712611345522738
"9776","chr7.73840000.73845000","chr7.74080000.74085000",240000,11,0.006533851,73840000,74080000,73845000,74085000,"chr7",298919,3,17,11,31,"chr7",1,0.0399671823722457
"9777","chr7.2380000.2385000","chr7.2400000.2405000",20000,37,0.002176787,2380000,2400000,2385000,2405000,"chr7",298922,0,10,3,13,"chr7",1,0.056375996249414
"9778","chr7.100215000.100220000","chr7.100235000.100240000",20000,37,0.002176787,100215000,100235000,100220000,100240000,"chr7",298930,0,5,2,7,"chr7",1,0.0303563056727614
"9779","chr7.127290000.127295000","chr7.127980000.127985000",690000,9,0.0005539433,127290000,127980000,127295000,127985000,"chr7",298931,1,0,2,3,"chr7",1,0.00316455696202532
"9780","chr7.81685000.81690000","chr7.82230000.82235000",545000,13,1.380954e-06,81685000,82230000,81690000,82235000,"chr7",298932,0,1,1,2,"chr7",1,0.00304735114861697
"9781","chr7.98920000.98925000","chr7.99035000.99040000",115000,16,0.001302303,98920000,99035000,98925000,99040000,"chr7",298970,0,12,5,17,"chr7",1,0.0318799812470699
"9782","chr7.105320000.105325000","chr7.105645000.105650000",325000,13,5.736298e-05,105320000,105645000,105325000,105650000,"chr7",298991,3,23,17,43,"chr7",1,0.0655180496952649
"9783","chr7.139370000.139375000","chr7.139430000.139435000",60000,28,7.252869e-07,139370000,139430000,139375000,139435000,"chr7",298997,1,7,1,9,"chr7",1,0.029535864978903
"9784","chr7.111635000.111640000","chr7.111730000.111735000",95000,21,1.380867e-05,111635000,111730000,111640000,111735000,"chr7",299137,2,11,6,19,"chr7",1,0.0467651195499297
"9785","chr7.129375000.129380000","chr7.129555000.129560000",180000,12,0.009682184,129375000,129555000,129380000,129560000,"chr7",299138,3,10,6,19,"chr7",1,0.0267229254571027
"9786","chr7.74010000.74015000","chr7.74065000.74070000",55000,21,0.004210319,74010000,74065000,74015000,74070000,"chr7",299148,3,11,9,23,"chr7",1,0.0566104078762307
"9787","chr7.47310000.47315000","chr7.47835000.47840000",525000,13,1.906268e-06,47310000,47835000,47315000,47840000,"chr7",299187,0,1,2,3,"chr7",1,0.00457102672292546
"9788","chr7.77655000.77660000","chr7.78135000.78140000",480000,9,0.003981961,77655000,78135000,77660000,78140000,"chr7",299216,1,0,6,7,"chr7",1,0.00738396624472574
"9789","chr7.36530000.36535000","chr7.37225000.37230000",695000,8,0.00301312,36530000,37225000,36535000,37230000,"chr7",299239,0,3,2,5,"chr7",1,0.0046882325363338
"9790","chr7.56070000.56075000","chr7.56120000.56125000",50000,23,0.001817981,56070000,56120000,56075000,56125000,"chr7",299299,2,12,7,21,"chr7",1,0.0566104078762307
"9791","chr7.30205000.30210000","chr7.30515000.30520000",310000,10,0.006533851,30205000,30515000,30210000,30520000,"chr7",299309,0,6,7,13,"chr7",1,0.0152367557430849
"9792","chr7.105690000.105695000","chr7.105765000.105770000",75000,24,4.553127e-06,105690000,105765000,105695000,105770000,"chr7",299326,3,7,2,12,"chr7",1,0.0337552742616034
"9793","chr7.25285000.25290000","chr7.25885000.25890000",600000,8,0.006213825,25285000,25885000,25290000,25890000,"chr7",299340,4,5,1,10,"chr7",1,0.00937646507266761
"9794","chr7.22585000.22590000","chr7.22885000.22890000",300000,11,0.001971347,22585000,22885000,22590000,22890000,"chr7",299376,2,11,6,19,"chr7",1,0.0244960150023441
"9795","chr7.5525000.5530000","chr7.5590000.5595000",65000,20,0.002113865,5525000,5590000,5530000,5595000,"chr7",299397,2,5,15,22,"chr7",1,0.0515705578996718
"9796","chr7.96730000.96735000","chr7.97470000.97475000",740000,12,7.464323e-07,96730000,97470000,96735000,97475000,"chr7",299471,0,3,2,5,"chr7",1,0.0070323488045007
"9797","chr7.101245000.101250000","chr7.101915000.101920000",670000,8,0.003601624,101245000,101915000,101250000,101920000,"chr7",299489,4,8,5,17,"chr7",1,0.0159399906235349
"9798","chr7.66205000.66210000","chr7.66305000.66310000",100000,19,0.0001086091,66205000,66305000,66210000,66310000,"chr7",299497,3,10,11,24,"chr7",1,0.0534458509142053
"9799","chr7.131040000.131045000","chr7.131075000.131080000",35000,27,0.003347901,131040000,131075000,131045000,131080000,"chr7",299512,0,5,2,7,"chr7",1,0.0221518987341772
"9800","chr7.137280000.137285000","chr7.137590000.137595000",310000,12,0.0003776456,137280000,137590000,137285000,137595000,"chr7",299633,0,3,2,5,"chr7",1,0.0070323488045007
"9801","chr7.154125000.154130000","chr7.154165000.154170000",40000,27,0.0005823026,154125000,154165000,154130000,154170000,"chr7",299643,2,3,8,13,"chr7",1,0.0411392405063291
"9802","chr7.116950000.116955000","chr7.117020000.117025000",70000,40,1.549451e-16,116950000,117020000,116955000,117025000,"chr7",299735,2,6,2,10,"chr7",1,0.046882325363338
"9803","chr7.73855000.73860000","chr7.74040000.74045000",185000,15,0.0001845148,73855000,74040000,73860000,74045000,"chr7",299737,5,16,14,35,"chr7",1,0.0615330520393812
"9804","chr7.133820000.133825000","chr7.134015000.134020000",195000,12,0.006213825,133820000,134015000,133825000,134020000,"chr7",299761,0,2,2,4,"chr7",1,0.00562587904360056
"9805","chr7.120430000.120435000","chr7.120720000.120725000",290000,11,0.002351004,120430000,120720000,120435000,120725000,"chr7",299801,3,3,5,11,"chr7",1,0.0141819034224098
"9806","chr7.129740000.129745000","chr7.130405000.130410000",665000,10,0.0001111401,129740000,130405000,129745000,130410000,"chr7",299833,3,3,2,8,"chr7",1,0.00937646507266761
"9807","chr7.5450000.5455000","chr7.5710000.5715000",260000,11,0.004209802,5450000,5710000,5455000,5715000,"chr7",299894,3,8,5,16,"chr7",1,0.0206282231598687
"9808","chr7.128865000.128870000","chr7.128955000.128960000",90000,22,6.774109e-06,128865000,128955000,128870000,128960000,"chr7",299925,3,2,1,6,"chr7",1,0.0154711673699015
"9809","chr7.100545000.100550000","chr7.100625000.100630000",80000,18,0.002398881,100545000,100625000,100550000,100630000,"chr7",299932,1,4,1,6,"chr7",1,0.0126582278481013
"9810","chr7.7680000.7685000","chr7.8220000.8225000",540000,14,1.844665e-07,7680000,8220000,7685000,8225000,"chr7",299939,0,5,2,7,"chr7",1,0.0114861697140178
"9811","chr7.29270000.29275000","chr7.29405000.29410000",135000,17,0.0001246245,29270000,29405000,29275000,29410000,"chr7",299976,0,1,1,2,"chr7",1,0.00398499765588373
"9812","chr7.74285000.74290000","chr7.74490000.74495000",205000,17,3.655079e-06,74285000,74490000,74290000,74495000,"chr7",299989,8,17,12,37,"chr7",1,0.073722456633849
"9813","chr7.24335000.24340000","chr7.24715000.24720000",380000,10,0.00268837,24335000,24715000,24340000,24720000,"chr7",300027,0,2,1,3,"chr7",1,0.00351617440225035
"9814","chr7.111760000.111765000","chr7.111835000.111840000",75000,18,0.004067044,111760000,111835000,111765000,111840000,"chr7",300043,0,2,0,2,"chr7",1,0.00421940928270042
"9815","chr7.44640000.44645000","chr7.44885000.44890000",245000,28,5.34301e-17,44640000,44885000,44645000,44890000,"chr7",300057,1,20,18,39,"chr7",1,0.127988748241913
"9816","chr7.92250000.92255000","chr7.92485000.92490000",235000,11,0.007218533,92250000,92485000,92255000,92490000,"chr7",300067,2,9,6,17,"chr7",1,0.0219174871073605
"9817","chr7.5230000.5235000","chr7.5505000.5510000",275000,11,0.003114216,5230000,5505000,5235000,5510000,"chr7",300072,4,8,6,18,"chr7",1,0.0232067510548523
"9818","chr7.106975000.106980000","chr7.107010000.107015000",35000,30,0.0002820606,106975000,107010000,106980000,107015000,"chr7",300095,5,6,16,27,"chr7",1,0.0949367088607595
"9819","chr7.6180000.6185000","chr7.6365000.6370000",185000,17,9.715461e-06,6180000,6365000,6185000,6370000,"chr7",300103,6,11,8,25,"chr7",1,0.0498124706985466
"9820","chr7.5530000.5535000","chr7.5745000.5750000",215000,37,2.058537e-25,5530000,5745000,5535000,5750000,"chr7",300115,4,3,2,9,"chr7",1,0.0390295358649789
"9821","chr7.98035000.98040000","chr7.98460000.98465000",425000,9,0.00689684,98035000,98460000,98040000,98465000,"chr7",300180,7,14,10,31,"chr7",1,0.0327004219409283
"9822","chr7.147995000.148000000","chr7.148095000.148100000",100000,15,0.009373683,147995000,148095000,1.48e+08,148100000,"chr7",300250,0,11,13,24,"chr7",1,0.0421940928270042
"9823","chr7.5560000.5565000","chr7.5690000.5695000",130000,15,0.001910926,5560000,5690000,5565000,5695000,"chr7",300344,0,3,5,8,"chr7",1,0.0140646976090014
"9824","chr7.98020000.98025000","chr7.98430000.98435000",410000,9,0.007900409,98020000,98430000,98025000,98435000,"chr7",300350,12,19,28,59,"chr7",1,0.0622362869198312
"9825","chr7.75530000.75535000","chr7.75660000.75665000",130000,18,4.38465e-05,75530000,75660000,75535000,75665000,"chr7",300398,8,24,21,53,"chr7",1,0.111814345991561
"9826","chr7.128170000.128175000","chr7.128425000.128430000",255000,11,0.004686834,128170000,128425000,128175000,128430000,"chr7",300409,3,9,7,19,"chr7",1,0.0244960150023441
"9827","chr7.55530000.55535000","chr7.55640000.55645000",110000,16,0.001756896,55530000,55640000,55535000,55645000,"chr7",300467,0,1,1,2,"chr7",1,0.00375058602906704
"9828","chr7.74040000.74045000","chr7.74070000.74075000",30000,36,2.079132e-05,74040000,74070000,74045000,74075000,"chr7",300490,8,16,14,38,"chr7",1,0.160337552742616
"9829","chr7.140175000.140180000","chr7.140355000.140360000",180000,20,9.31643e-08,140175000,140355000,140180000,140360000,"chr7",300541,3,9,8,20,"chr7",1,0.046882325363338
"9830","chr7.5530000.5535000","chr7.5605000.5610000",75000,23,1.624945e-05,5530000,5605000,5535000,5610000,"chr7",300565,4,3,2,9,"chr7",1,0.0242616033755274
"9831","chr7.73840000.73845000","chr7.74065000.74070000",225000,17,1.437635e-06,73840000,74065000,73845000,74070000,"chr7",300605,3,17,14,34,"chr7",1,0.0677449601500234
"9832","chr7.22185000.22190000","chr7.22485000.22490000",300000,10,0.007511413,22185000,22485000,22190000,22490000,"chr7",300633,0,5,2,7,"chr7",1,0.00820440693858415
"9833","chr7.130755000.130760000","chr7.130990000.130995000",235000,12,0.002071562,130755000,130990000,130760000,130995000,"chr7",300636,2,17,9,28,"chr7",1,0.0393811533052039
"9834","chr7.105255000.105260000","chr7.105650000.105655000",395000,10,0.002251595,105255000,105650000,105260000,105655000,"chr7",300659,1,6,3,10,"chr7",1,0.0117205813408345
"9835","chr7.19745000.19750000","chr7.20350000.20355000",605000,12,4.401686e-06,19745000,20350000,19750000,20355000,"chr7",300678,0,1,2,3,"chr7",1,0.00421940928270042
"9836","chr7.36035000.36040000","chr7.36185000.36190000",150000,14,0.002691352,36035000,36185000,36040000,36190000,"chr7",300693,2,2,3,7,"chr7",1,0.0114861697140178
"9837","chr7.73985000.73990000","chr7.74030000.74035000",45000,38,2.27566e-10,73985000,74030000,73990000,74035000,"chr7",300695,7,10,13,30,"chr7",1,0.133614627285513
"9838","chr7.66095000.66100000","chr7.66200000.66205000",105000,20,1.847853e-05,66095000,66200000,66100000,66205000,"chr7",300782,9,42,37,88,"chr7",1,0.206282231598687
"9839","chr7.5560000.5565000","chr7.5665000.5670000",105000,16,0.002398881,5560000,5665000,5565000,5670000,"chr7",300796,2,9,11,22,"chr7",1,0.0412564463197375
"9840","chr7.95400000.95405000","chr7.95510000.95515000",110000,15,0.005140847,95400000,95510000,95405000,95515000,"chr7",300841,1,2,1,4,"chr7",1,0.0070323488045007
"9841","chr7.102175000.102180000","chr7.102270000.102275000",95000,70,1.373222e-51,102175000,102270000,102180000,102275000,"chr7",300914,3,2,5,10,"chr7",1,0.0820440693858415
"9842","chr7.2770000.2775000","chr7.2795000.2800000",25000,35,0.001519389,2770000,2795000,2775000,2800000,"chr7",300988,4,7,4,15,"chr7",1,0.0615330520393812
"9843","chr7.101180000.101185000","chr7.101880000.101885000",700000,8,0.002881642,101180000,101880000,101185000,101885000,"chr7",301044,4,7,5,16,"chr7",1,0.0150023441162682
"9844","chr7.30430000.30435000","chr7.30500000.30505000",70000,19,0.002760284,30430000,30500000,30435000,30505000,"chr7",301075,0,3,2,5,"chr7",1,0.0111345522737928
"9845","chr7.95260000.95265000","chr7.95305000.95310000",45000,23,0.004836897,95260000,95305000,95265000,95310000,"chr7",301077,0,4,1,5,"chr7",1,0.0134786685419597
"9846","chr7.73840000.73845000","chr7.74030000.74035000",190000,14,0.0005925602,73840000,74030000,73845000,74035000,"chr7",301094,3,10,13,26,"chr7",1,0.0426629160806376
"9847","chr7.36210000.36215000","chr7.36260000.36265000",50000,26,0.0001009853,36210000,36260000,36215000,36265000,"chr7",301135,1,4,3,8,"chr7",1,0.0243788091889358
"9848","chr7.100490000.100495000","chr7.100745000.100750000",255000,14,6.487149e-05,100490000,100745000,100495000,100750000,"chr7",301197,8,11,18,37,"chr7",1,0.0607126113455227
"9849","chr7.4685000.4690000","chr7.4715000.4720000",30000,58,3.569674e-17,4685000,4715000,4690000,4720000,"chr7",301266,4,13,13,30,"chr7",1,0.20393811533052
"9850","chr7.128340000.128345000","chr7.128395000.128400000",55000,22,0.00174694,128340000,128395000,128345000,128400000,"chr7",301271,2,6,5,13,"chr7",1,0.0335208626347867
"9851","chr7.30320000.30325000","chr7.30550000.30555000",230000,11,0.008168733,30320000,30550000,30325000,30555000,"chr7",301341,0,2,1,3,"chr7",1,0.00386779184247539
"9852","chr7.28470000.28475000","chr7.28685000.28690000",215000,12,0.003524226,28470000,28685000,28475000,28690000,"chr7",301410,0,0,4,4,"chr7",1,0.00562587904360056
"9853","chr7.44920000.44925000","chr7.45150000.45155000",230000,18,1.967664e-07,44920000,45150000,44925000,45155000,"chr7",301434,2,6,3,11,"chr7",1,0.0232067510548523
"9854","chr7.74030000.74035000","chr7.74080000.74085000",50000,26,0.0001009853,74030000,74080000,74035000,74085000,"chr7",301453,7,10,11,28,"chr7",1,0.0853258321612752
"9855","chr7.56060000.56065000","chr7.56100000.56105000",40000,24,0.007017412,56060000,56100000,56065000,56105000,"chr7",301536,0,3,2,5,"chr7",1,0.0140646976090014
"9856","chr7.104760000.104765000","chr7.104880000.104885000",120000,20,5.093783e-06,104760000,104880000,104765000,104885000,"chr7",301593,0,1,2,3,"chr7",1,0.0070323488045007
"9857","chr7.4930000.4935000","chr7.5045000.5050000",115000,18,0.0001140788,4930000,5045000,4935000,5050000,"chr7",301703,3,20,14,37,"chr7",1,0.0780590717299578
"9858","chr7.129340000.129345000","chr7.129620000.129625000",280000,11,0.002839683,129340000,129620000,129345000,129625000,"chr7",301744,0,0,6,6,"chr7",1,0.00773558368495077
"9859","chr7.95435000.95440000","chr7.95475000.95480000",40000,35,1.298962e-07,95435000,95475000,95440000,95480000,"chr7",301776,0,3,0,3,"chr7",1,0.0123066104078762
"9860","chr7.90530000.90535000","chr7.90595000.90600000",65000,20,0.002113865,90530000,90595000,90535000,90600000,"chr7",301824,0,0,3,3,"chr7",1,0.0070323488045007
"9861","chr7.4735000.4740000","chr7.4775000.4780000",40000,24,0.007017412,4735000,4775000,4740000,4780000,"chr7",301909,1,5,7,13,"chr7",1,0.0365682137834037
"9862","chr7.28315000.28320000","chr7.28645000.28650000",330000,11,0.001210742,28315000,28645000,28320000,28650000,"chr7",301952,1,2,2,5,"chr7",1,0.00644631973745898
"9863","chr7.56070000.56075000","chr7.56105000.56110000",35000,30,0.0002820606,56070000,56105000,56075000,56110000,"chr7",301966,1,9,10,20,"chr7",1,0.070323488045007
"9864","chr7.51245000.51250000","chr7.51265000.51270000",20000,45,4.31274e-06,51245000,51265000,51250000,51270000,"chr7",302041,0,2,3,5,"chr7",1,0.0263713080168776
"9865","chr7.1840000.1845000","chr7.2380000.2385000",540000,9,0.00220043,1840000,2380000,1845000,2385000,"chr7",302066,0,3,1,4,"chr7",1,0.00421940928270042
"9866","chr7.130790000.130795000","chr7.130900000.130905000",110000,16,0.001756896,130790000,130900000,130795000,130905000,"chr7",302070,0,6,5,11,"chr7",1,0.0206282231598687
"9867","chr7.7890000.7895000","chr7.7910000.7915000",20000,37,0.002176787,7890000,7910000,7895000,7915000,"chr7",302146,2,0,1,3,"chr7",1,0.0130098452883263
"9868","chr7.35765000.35770000","chr7.35790000.35795000",25000,35,0.001519389,35765000,35790000,35770000,35795000,"chr7",302169,1,5,3,9,"chr7",1,0.0369198312236287
"9869","chr7.44680000.44685000","chr7.44810000.44815000",130000,17,0.0001640299,44680000,44810000,44685000,44815000,"chr7",302177,9,13,16,38,"chr7",1,0.0757149554617909
"9870","chr7.28470000.28475000","chr7.28620000.28625000",150000,13,0.008260206,28470000,28620000,28475000,28625000,"chr7",302186,4,5,5,14,"chr7",1,0.0213314580403188
"9871","chr7.71305000.71310000","chr7.71780000.71785000",475000,11,0.0001685112,71305000,71780000,71310000,71785000,"chr7",302228,1,2,2,5,"chr7",1,0.00644631973745898
"9872","chr7.5560000.5565000","chr7.5695000.5700000",135000,14,0.004782504,5560000,5695000,5565000,5700000,"chr7",302238,4,6,4,14,"chr7",1,0.0229723394280356
"9873","chr7.22150000.22155000","chr7.22485000.22490000",335000,12,0.0002463301,22150000,22485000,22155000,22490000,"chr7",302274,3,3,5,11,"chr7",1,0.0154711673699015
"9874","chr7.104770000.104775000","chr7.105130000.105135000",360000,12,0.0001624094,104770000,105130000,104775000,105135000,"chr7",302349,0,1,0,1,"chr7",1,0.00140646976090014
"9875","chr7.22220000.22225000","chr7.22290000.22295000",70000,34,5.408255e-12,22220000,22290000,22225000,22295000,"chr7",302483,0,0,1,1,"chr7",1,0.00398499765588373
"9876","chr7.4655000.4660000","chr7.4780000.4785000",125000,15,0.002398881,4655000,4780000,4660000,4785000,"chr7",302491,5,10,13,28,"chr7",1,0.0492264416315049
"9877","chr7.29795000.29800000","chr7.30115000.30120000",320000,11,0.001424285,29795000,30115000,29800000,30120000,"chr7",302618,1,1,1,3,"chr7",1,0.00386779184247539
"9878","chr7.95200000.95205000","chr7.95305000.95310000",105000,22,1.117547e-06,95200000,95305000,95205000,95310000,"chr7",302679,1,2,1,4,"chr7",1,0.0103141115799344
"9879","chr7.66505000.66510000","chr7.66770000.66775000",265000,19,5.929155e-09,66505000,66770000,66510000,66775000,"chr7",302712,7,7,16,30,"chr7",1,0.0668073136427567
"9880","chr7.5650000.5655000","chr7.5670000.5675000",20000,37,0.002176787,5650000,5670000,5655000,5675000,"chr7",302743,4,13,16,33,"chr7",1,0.143108298171589
"9881","chr7.30200000.30205000","chr7.30590000.30595000",390000,12,0.0001025322,30200000,30590000,30205000,30595000,"chr7",302788,0,3,7,10,"chr7",1,0.0140646976090014
"9882","chr7.101185000.101190000","chr7.101880000.101885000",695000,11,1.098128e-05,101185000,101880000,101190000,101885000,"chr7",302792,4,7,5,16,"chr7",1,0.0206282231598687
"9883","chr7.2705000.2710000","chr7.2875000.2880000",170000,16,8.870301e-05,2705000,2875000,2710000,2880000,"chr7",302796,2,8,5,15,"chr7",1,0.0281293952180028
"9884","chr7.73855000.73860000","chr7.74065000.74070000",210000,19,9.198139e-08,73855000,74065000,73860000,74070000,"chr7",302854,4,21,16,41,"chr7",1,0.0913033286451008
"9885","chr7.104820000.104825000","chr7.104880000.104885000",60000,29,1.956723e-07,104820000,104880000,104825000,104885000,"chr7",302889,0,2,1,3,"chr7",1,0.010196905766526
"9886","chr7.73665000.73670000","chr7.73705000.73710000",40000,33,1.34012e-06,73665000,73705000,73670000,73710000,"chr7",302984,4,18,16,38,"chr7",1,0.146976090014065
"9887","chr7.5895000.5900000","chr7.6370000.6375000",475000,12,2.857822e-05,5895000,6370000,5900000,6375000,"chr7",302999,13,27,24,64,"chr7",1,0.090014064697609
"9888","chr7.1565000.1570000","chr7.2380000.2385000",815000,7,0.007017412,1565000,2380000,1570000,2385000,"chr7",303002,0,15,3,18,"chr7",1,0.0147679324894515
"9889","chr7.5605000.5610000","chr7.5745000.5750000",140000,35,4.737892e-19,5605000,5745000,5610000,5750000,"chr7",303024,7,17,11,35,"chr7",1,0.143577121425223
"9890","chr7.2775000.2780000","chr7.2795000.2800000",20000,45,4.31274e-06,2775000,2795000,2780000,2800000,"chr7",303072,8,7,4,19,"chr7",1,0.100210970464135
"9891","chr7.28620000.28625000","chr7.28645000.28650000",25000,42,5.023057e-06,28620000,28645000,28625000,28650000,"chr7",303077,4,5,2,11,"chr7",1,0.0541490857946554
"9892","chr7.29320000.29325000","chr7.29375000.29380000",55000,38,2.632752e-12,29320000,29375000,29325000,29380000,"chr7",303081,0,8,5,13,"chr7",1,0.0578996718237225
"9893","chr7.111635000.111640000","chr7.111680000.111685000",45000,24,0.00211632,111635000,111680000,111640000,111685000,"chr7",303105,4,7,3,14,"chr7",1,0.0393811533052039
"9894","chr7.30500000.30505000","chr7.30555000.30560000",55000,22,0.00174694,30500000,30555000,30505000,30560000,"chr7",303107,0,3,2,5,"chr7",1,0.012892639474918
"9895","chr7.74030000.74035000","chr7.74065000.74070000",35000,51,2.096491e-15,74030000,74065000,74035000,74070000,"chr7",303160,4,10,13,27,"chr7",1,0.161392405063291
"9896","chr7.38260000.38265000","chr7.38380000.38385000",120000,14,0.008840921,38260000,38380000,38265000,38385000,"chr7",303166,1,2,2,5,"chr7",1,0.00820440693858415
"9897","chr7.4685000.4690000","chr7.4705000.4710000",20000,36,0.004179201,4685000,4705000,4690000,4710000,"chr7",303210,3,13,13,29,"chr7",1,0.122362869198312
"9898","chr7.5190000.5195000","chr7.5210000.5215000",20000,45,4.31274e-06,5190000,5210000,5195000,5215000,"chr7",303228,2,6,5,13,"chr7",1,0.0685654008438819
"9899","chr7.51245000.51250000","chr7.51305000.51310000",60000,27,2.542958e-06,51245000,51305000,51250000,51310000,"chr7",303286,0,2,2,4,"chr7",1,0.0126582278481013
"9900","chr7.860000.865000","chr7.910000.915000",50000,22,0.004297703,860000,910000,865000,915000,"chr7",303301,3,10,7,20,"chr7",1,0.0515705578996718
"9901","chr7.2605000.2610000","chr7.2705000.2710000",100000,17,0.001143854,2605000,2705000,2610000,2710000,"chr7",303304,2,3,5,10,"chr7",1,0.0199249882794187
"9902","chr7.5405000.5410000","chr7.5525000.5530000",120000,23,5.146195e-08,5405000,5525000,5410000,5530000,"chr7",303312,7,12,15,34,"chr7",1,0.0916549460853258
"9903","chr7.100610000.100615000","chr7.100670000.100675000",60000,22,0.0006823538,100610000,100670000,100615000,100675000,"chr7",303369,6,12,9,27,"chr7",1,0.069620253164557
"9904","chr7.129340000.129345000","chr7.129640000.129645000",300000,13,9.735257e-05,129340000,129640000,129345000,129645000,"chr7",303381,0,0,6,6,"chr7",1,0.00914205344585091
"9905","chr7.158500000.158505000","chr7.158610000.158615000",110000,15,0.005140847,158500000,158610000,158505000,158615000,"chr7",303410,0,2,2,4,"chr7",1,0.0070323488045007
"9906","chr7.137590000.137595000","chr7.137690000.137695000",100000,62,2.17239e-43,137590000,137690000,137595000,137695000,"chr7",303419,0,1,2,3,"chr7",1,0.0218002812939522
"9907","chr7.18550000.18555000","chr7.18580000.18585000",30000,33,0.0002900128,18550000,18580000,18555000,18585000,"chr7",303428,0,0,2,2,"chr7",1,0.00773558368495077
"9908","chr7.73705000.73710000","chr7.73790000.73795000",85000,27,1.091863e-08,73705000,73790000,73710000,73795000,"chr7",303481,4,16,17,37,"chr7",1,0.117088607594937
"9909","chr7.51140000.51145000","chr7.51210000.51215000",70000,20,0.0010221,51140000,51210000,51145000,51215000,"chr7",303559,0,3,1,4,"chr7",1,0.00937646507266761
"9910","chr7.95330000.95335000","chr7.95510000.95515000",180000,14,0.0008545015,95330000,95510000,95335000,95515000,"chr7",303587,0,2,0,2,"chr7",1,0.00328176277543366
"9911","chr7.5175000.5180000","chr7.5210000.5215000",35000,34,6.053946e-06,5175000,5210000,5180000,5215000,"chr7",303607,2,6,5,13,"chr7",1,0.0518049695264885
"9912","chr7.75955000.75960000","chr7.76005000.76010000",50000,25,0.0002799273,75955000,76005000,75960000,76010000,"chr7",303661,8,13,20,41,"chr7",1,0.120135958743554
"9913","chr7.131025000.131030000","chr7.131165000.131170000",140000,14,0.003981961,131025000,131165000,131030000,131170000,"chr7",303691,5,10,2,17,"chr7",1,0.0278949835911861
"9914","chr7.139355000.139360000","chr7.139420000.139425000",65000,26,2.584767e-06,139355000,139420000,139360000,139425000,"chr7",303707,2,15,11,28,"chr7",1,0.0853258321612752
"9915","chr7.2795000.2800000","chr7.2885000.2890000",90000,20,8.870301e-05,2795000,2885000,2800000,2890000,"chr7",303746,6,7,4,17,"chr7",1,0.0398499765588373
"9916","chr7.99615000.99620000","chr7.100405000.100410000",790000,7,0.008111581,99615000,100405000,99620000,100410000,"chr7",303788,1,11,10,22,"chr7",1,0.0180496952648851
"9917","chr7.28685000.28690000","chr7.28740000.28745000",55000,27,9.515214e-06,28685000,28740000,28690000,28745000,"chr7",303790,0,0,4,4,"chr7",1,0.0126582278481013
"9918","chr7.56070000.56075000","chr7.56100000.56105000",30000,38,2.981751e-06,56070000,56100000,56075000,56105000,"chr7",303835,8,18,21,47,"chr7",1,0.209329582747304
"9919","chr7.6220000.6225000","chr7.6245000.6250000",25000,40,2.976563e-05,6220000,6245000,6225000,6250000,"chr7",303910,5,5,13,23,"chr7",1,0.107829348335677
"9920","chr7.130790000.130795000","chr7.130985000.130990000",195000,15,0.0001215023,130790000,130985000,130795000,130990000,"chr7",303977,3,5,10,18,"chr7",1,0.0316455696202532
"9921","chr7.66040000.66045000","chr7.66140000.66145000",100000,15,0.009373683,66040000,66140000,66045000,66145000,"chr7",303995,4,8,4,16,"chr7",1,0.0281293952180028
"9922","chr7.151895000.151900000","chr7.152420000.152425000",525000,10,0.0005086335,151895000,152420000,151900000,152425000,"chr7",304058,1,7,12,20,"chr7",1,0.023441162681669
"9923","chr7.5570000.5575000","chr7.5710000.5715000",140000,19,5.724415e-06,5570000,5710000,5575000,5715000,"chr7",304066,3,8,5,16,"chr7",1,0.0356305672761369
"9924","chr7.74010000.74015000","chr7.74030000.74035000",20000,37,0.002176787,74010000,74030000,74015000,74035000,"chr7",304144,3,10,9,22,"chr7",1,0.0954055321143929
"9925","chr7.70315000.70320000","chr7.71180000.71185000",865000,13,1.307477e-08,70315000,71180000,70320000,71185000,"chr7",304179,0,2,2,4,"chr7",1,0.00609470229723394
"9926","chr7.129875000.129880000","chr7.130405000.130410000",530000,17,2.607988e-10,129875000,130405000,129880000,130410000,"chr7",304214,0,0,2,2,"chr7",1,0.00398499765588373
"9927","chr7.5565000.5570000","chr7.5590000.5595000",25000,38,0.0001564123,5565000,5590000,5570000,5595000,"chr7",304230,2,5,15,22,"chr7",1,0.0979840600093765
"9928","chr7.130755000.130760000","chr7.131025000.131030000",270000,13,0.0002012296,130755000,131025000,130760000,131030000,"chr7",304323,5,10,2,17,"chr7",1,0.0259024847632443
"9929","chr7.111635000.111640000","chr7.111760000.111765000",125000,35,3.960852e-18,111635000,111760000,111640000,111765000,"chr7",304366,6,7,8,21,"chr7",1,0.0861462728551336
"9930","chr7.98655000.98660000","chr7.98760000.98765000",105000,15,0.006911981,98655000,98760000,98660000,98765000,"chr7",304386,1,10,4,15,"chr7",1,0.0263713080168776
"9931","chr7.73725000.73730000","chr7.73790000.73795000",65000,21,0.0007779944,73725000,73790000,73730000,73795000,"chr7",304409,9,16,17,42,"chr7",1,0.10337552742616
"9932","chr7.22225000.22230000","chr7.22290000.22295000",65000,30,1.152398e-08,22225000,22290000,22230000,22295000,"chr7",304544,0,0,8,8,"chr7",1,0.0281293952180028
"9933","chr7.820000.825000","chr7.910000.915000",90000,21,2.507967e-05,820000,910000,825000,915000,"chr7",304557,0,1,0,1,"chr7",1,0.00246132208157525
"9934","chr7.128865000.128870000","chr7.129655000.129660000",790000,7,0.008111581,128865000,129655000,128870000,129660000,"chr7",304581,3,2,1,6,"chr7",1,0.00492264416315049
"9935","chr7.111635000.111640000","chr7.111910000.111915000",275000,12,0.0007748615,111635000,111910000,111640000,111915000,"chr7",304593,6,9,8,23,"chr7",1,0.0323488045007032
"9936","chr7.99035000.99040000","chr7.99105000.99110000",70000,23,3.745658e-05,99035000,99105000,99040000,99110000,"chr7",304595,2,12,5,19,"chr7",1,0.0512189404594468
"9937","chr7.139290000.139295000","chr7.139680000.139685000",390000,14,2.893975e-06,139290000,139680000,139295000,139685000,"chr7",304664,2,0,1,3,"chr7",1,0.00492264416315049
"9938","chr7.117375000.117380000","chr7.117815000.117820000",440000,13,7.798902e-06,117375000,117815000,117380000,117820000,"chr7",304681,1,0,1,2,"chr7",1,0.00304735114861697
"9939","chr7.5600000.5605000","chr7.5670000.5675000",70000,19,0.002760284,5600000,5670000,5605000,5675000,"chr7",304720,11,39,37,87,"chr7",1,0.193741209563994
"9940","chr7.104880000.104885000","chr7.104900000.104905000",20000,50,3.718074e-08,104880000,104900000,104885000,104905000,"chr7",304746,0,3,3,6,"chr7",1,0.0351617440225035
"9941","chr7.16615000.16620000","chr7.16925000.16930000",310000,10,0.006533851,16615000,16925000,16620000,16930000,"chr7",304761,0,1,1,2,"chr7",1,0.0023441162681669
"9942","chr7.5635000.5640000","chr7.5695000.5700000",60000,27,2.542958e-06,5635000,5695000,5640000,5700000,"chr7",304805,4,6,4,14,"chr7",1,0.0443037974683544
"9943","chr7.128865000.128870000","chr7.129240000.129245000",375000,10,0.002856441,128865000,129240000,128870000,129245000,"chr7",304877,3,2,1,6,"chr7",1,0.0070323488045007
"9944","chr7.2575000.2580000","chr7.2715000.2720000",140000,26,4.374666e-11,2575000,2715000,2580000,2720000,"chr7",304881,0,2,0,2,"chr7",1,0.00609470229723394
"9945","chr7.5565000.5570000","chr7.5675000.5680000",110000,16,0.001756896,5565000,5675000,5570000,5680000,"chr7",304882,2,8,3,13,"chr7",1,0.0243788091889358
"9946","chr7.140475000.140480000","chr7.140580000.140585000",105000,15,0.006911981,140475000,140580000,140480000,140585000,"chr7",304886,5,11,18,34,"chr7",1,0.059774964838256
"9947","chr7.154145000.154150000","chr7.154200000.154205000",55000,25,8.870301e-05,154145000,154200000,154150000,154205000,"chr7",304932,0,2,2,4,"chr7",1,0.0117205813408345
"9948","chr7.129315000.129320000","chr7.129420000.129425000",105000,17,0.0007806216,129315000,129420000,129320000,129425000,"chr7",304955,4,10,7,21,"chr7",1,0.0418424753867792
"9949","chr7.2380000.2385000","chr7.2435000.2440000",55000,20,0.00985274,2380000,2435000,2385000,2440000,"chr7",304984,0,12,3,15,"chr7",1,0.0351617440225035
"9950","chr7.43610000.43615000","chr7.43870000.43875000",260000,11,0.004209802,43610000,43870000,43615000,43875000,"chr7",305018,1,4,1,6,"chr7",1,0.00773558368495077
"9951","chr7.111485000.111490000","chr7.112050000.112055000",565000,12,7.753415e-06,111485000,112050000,111490000,112055000,"chr7",305159,1,1,6,8,"chr7",1,0.0112517580872011
"9952","chr7.137765000.137770000","chr7.138435000.138440000",670000,12,1.82651e-06,137765000,138435000,137770000,138440000,"chr7",305167,4,10,3,17,"chr7",1,0.0239099859353024
"9953","chr7.5555000.5560000","chr7.5595000.5600000",40000,24,0.007017412,5555000,5595000,5560000,5600000,"chr7",305205,3,4,3,10,"chr7",1,0.0281293952180028
"9954","chr7.73715000.73720000","chr7.73735000.73740000",20000,46,1.756288e-06,73715000,73735000,73720000,73740000,"chr7",305224,2,2,2,6,"chr7",1,0.0323488045007032
"9955","chr7.44625000.44630000","chr7.44810000.44815000",185000,13,0.002547834,44625000,44810000,44630000,44815000,"chr7",305283,9,13,8,30,"chr7",1,0.0457102672292546
"9956","chr7.24875000.24880000","chr7.25125000.25130000",250000,11,0.00523021,24875000,25125000,24880000,25130000,"chr7",305365,2,5,3,10,"chr7",1,0.012892639474918
"9957","chr7.22190000.22195000","chr7.22485000.22490000",295000,11,0.002155437,22190000,22485000,22195000,22490000,"chr7",305376,0,2,2,4,"chr7",1,0.00515705578996718
"9958","chr7.6055000.6060000","chr7.6370000.6375000",315000,11,0.00152594,6055000,6370000,6060000,6375000,"chr7",305386,5,28,20,53,"chr7",1,0.0683309892170652
"9959","chr7.5590000.5595000","chr7.5710000.5715000",120000,28,8.918897e-12,5590000,5710000,5595000,5715000,"chr7",305393,2,5,5,12,"chr7",1,0.0393811533052039
"9960","chr7.5525000.5530000","chr7.5745000.5750000",220000,23,2.221821e-11,5525000,5745000,5530000,5750000,"chr7",305396,7,12,15,34,"chr7",1,0.0916549460853258
"9961","chr7.158485000.158490000","chr7.158650000.158655000",165000,13,0.004959395,158485000,158650000,158490000,158655000,"chr7",305424,0,3,2,5,"chr7",1,0.00761837787154243
"9962","chr7.44640000.44645000","chr7.44845000.44850000",205000,13,0.001332286,44640000,44845000,44645000,44850000,"chr7",305486,4,15,16,35,"chr7",1,0.053328645100797
"9963","chr7.73855000.73860000","chr7.74010000.74015000",155000,21,9.030253e-08,73855000,74010000,73860000,74015000,"chr7",305520,3,11,9,23,"chr7",1,0.0566104078762307
"9964","chr7.129500000.129505000","chr7.129660000.129665000",160000,14,0.001832506,129500000,129660000,129505000,129665000,"chr7",305523,3,11,7,21,"chr7",1,0.0344585091420534
"9965","chr7.36190000.36195000","chr7.36300000.36305000",110000,15,0.005140847,36190000,36300000,36195000,36305000,"chr7",305639,1,0,2,3,"chr7",1,0.00527426160337553
"9966","chr7.134440000.134445000","chr7.134600000.134605000",160000,13,0.005891496,134440000,134600000,134445000,134605000,"chr7",305724,1,2,3,6,"chr7",1,0.00914205344585091
"9967","chr7.74045000.74050000","chr7.74065000.74070000",20000,40,0.0002631097,74045000,74065000,74050000,74070000,"chr7",305761,2,4,4,10,"chr7",1,0.046882325363338
"9968","chr7.44640000.44645000","chr7.44810000.44815000",170000,15,0.0003455231,44640000,44810000,44645000,44815000,"chr7",305774,12,31,29,72,"chr7",1,0.126582278481013
"9969","chr7.51255000.51260000","chr7.51355000.51360000",100000,15,0.009373683,51255000,51355000,51260000,51360000,"chr7",305859,0,3,1,4,"chr7",1,0.0070323488045007
"9970","chr7.95435000.95440000","chr7.95510000.95515000",75000,18,0.004067044,95435000,95510000,95440000,95515000,"chr7",305888,1,2,1,4,"chr7",1,0.00843881856540084
"9971","chr7.95430000.95435000","chr7.95510000.95515000",80000,23,7.503991e-06,95430000,95510000,95435000,95515000,"chr7",305902,1,2,1,4,"chr7",1,0.0107829348335677
"9972","chr7.154215000.154220000","chr7.154370000.154375000",155000,13,0.007017412,154215000,154370000,154220000,154375000,"chr7",305906,0,2,2,4,"chr7",1,0.00609470229723394
"9973","chr7.154715000.154720000","chr7.155070000.155075000",355000,10,0.003611198,154715000,155070000,154720000,155075000,"chr7",305924,0,0,3,3,"chr7",1,0.00351617440225035
"9974","chr7.22190000.22195000","chr7.22300000.22305000",110000,29,5.504736e-12,22190000,22300000,22195000,22305000,"chr7",306008,0,1,2,3,"chr7",1,0.010196905766526
"9975","chr7.5615000.5620000","chr7.5675000.5680000",60000,27,2.542958e-06,5615000,5675000,5620000,5680000,"chr7",306135,2,8,3,13,"chr7",1,0.0411392405063291
"9976","chr7.30200000.30205000","chr7.30550000.30555000",350000,17,1.878684e-08,30200000,30550000,30205000,30555000,"chr7",306187,0,7,8,15,"chr7",1,0.029887482419128
"9977","chr7.30205000.30210000","chr7.30545000.30550000",340000,10,0.004324959,30205000,30545000,30210000,30550000,"chr7",306222,0,3,5,8,"chr7",1,0.00937646507266761
"9978","chr7.139290000.139295000","chr7.139430000.139435000",140000,14,0.003981961,139290000,139430000,139295000,139435000,"chr7",306251,3,13,7,23,"chr7",1,0.0377402719174871
"9979","chr7.95405000.95410000","chr7.95475000.95480000",70000,18,0.007017412,95405000,95475000,95410000,95480000,"chr7",306255,0,2,0,2,"chr7",1,0.00421940928270042
"9980","chr7.1610000.1615000","chr7.2400000.2405000",790000,11,3.746724e-06,1610000,2400000,1615000,2405000,"chr7",306282,5,10,12,27,"chr7",1,0.0348101265822785
"9981","chr7.129315000.129320000","chr7.129340000.129345000",25000,36,0.0007257094,129315000,129340000,129320000,129345000,"chr7",306315,0,0,6,6,"chr7",1,0.0253164556962025
"9982","chr7.22255000.22260000","chr7.22290000.22295000",35000,66,4.145099e-26,22255000,22290000,22260000,22295000,"chr7",306353,0,0,6,6,"chr7",1,0.0464135021097046
"9983","chr7.48085000.48090000","chr7.48105000.48110000",20000,36,0.004179201,48085000,48105000,48090000,48110000,"chr7",306363,0,2,1,3,"chr7",1,0.0126582278481013
"9984","chr7.102745000.102750000","chr7.102990000.102995000",245000,12,0.001586599,102745000,102990000,102750000,102995000,"chr7",306411,0,0,1,1,"chr7",1,0.00140646976090014
"9985","chr7.97925000.97930000","chr7.98035000.98040000",110000,18,0.0001632589,97925000,98035000,97930000,98040000,"chr7",306412,2,3,2,7,"chr7",1,0.0147679324894515
"9986","chr7.92250000.92255000","chr7.92445000.92450000",195000,20,3.679786e-08,92250000,92445000,92255000,92450000,"chr7",306482,2,3,3,8,"chr7",1,0.0187529301453352
"9987","chr7.5235000.5240000","chr7.5405000.5410000",170000,18,4.517794e-06,5235000,5405000,5240000,5410000,"chr7",306485,8,38,17,63,"chr7",1,0.132911392405063
"9988","chr7.128425000.128430000","chr7.128455000.128460000",30000,30,0.00305535,128425000,128455000,128430000,128460000,"chr7",306491,2,5,7,14,"chr7",1,0.0492264416315049
"9989","chr7.22185000.22190000","chr7.22290000.22295000",105000,36,1.759014e-17,22185000,22290000,22190000,22295000,"chr7",306502,0,0,2,2,"chr7",1,0.00843881856540084
"9990","chr7.1610000.1615000","chr7.2375000.2380000",765000,10,4.052458e-05,1610000,2375000,1615000,2380000,"chr7",306520,3,1,0,4,"chr7",1,0.0046882325363338
"9991","chr7.101780000.101785000","chr7.101810000.101815000",30000,30,0.00305535,101780000,101810000,101785000,101815000,"chr7",306574,3,9,7,19,"chr7",1,0.0668073136427567
"9992","chr7.39670000.39675000","chr7.39765000.39770000",95000,18,0.000564117,39670000,39765000,39675000,39770000,"chr7",306584,8,17,22,47,"chr7",1,0.0991561181434599
"9993","chr7.140515000.140520000","chr7.140580000.140585000",65000,21,0.0007779944,140515000,140580000,140520000,140585000,"chr7",306594,3,8,1,12,"chr7",1,0.029535864978903
"9994","chr7.5395000.5400000","chr7.5745000.5750000",350000,10,0.003869126,5395000,5745000,5400000,5750000,"chr7",306599,8,21,21,50,"chr7",1,0.0586029067041725
"9995","chr7.5615000.5620000","chr7.5665000.5670000",50000,21,0.009838551,5615000,5665000,5620000,5670000,"chr7",306617,2,9,11,22,"chr7",1,0.0541490857946554
"9996","chr7.1610000.1615000","chr7.2245000.2250000",635000,17,2.696166e-11,1610000,2245000,1615000,2250000,"chr7",306653,5,15,10,30,"chr7",1,0.059774964838256
"9997","chr7.104770000.104775000","chr7.104975000.104980000",205000,14,0.0003455231,104770000,104975000,104775000,104980000,"chr7",306779,0,1,2,3,"chr7",1,0.00492264416315049
"9998","chr7.74280000.74285000","chr7.74490000.74495000",210000,30,1.065954e-17,74280000,74490000,74285000,74495000,"chr7",306783,13,25,27,65,"chr7",1,0.228551336146273
"9999","chr7.30320000.30325000","chr7.30595000.30600000",275000,16,1.169254e-06,30320000,30595000,30325000,30600000,"chr7",306799,0,2,1,3,"chr7",1,0.00562587904360056
"10000","chr7.104880000.104885000","chr7.105060000.105065000",180000,14,0.0008545015,104880000,105060000,104885000,105065000,"chr7",306824,0,3,3,6,"chr7",1,0.00984528832630099
"10001","chr7.28000000.28005000","chr7.28035000.28040000",35000,31,0.0001140788,2.8e+07,28035000,28005000,28040000,"chr7",306855,1,1,0,2,"chr7",1,0.00726676043131739
"10002","chr7.99975000.99980000","chr7.100000000.100005000",25000,43,1.971233e-06,99975000,1e+08,99980000,100005000,"chr7",307073,1,10,3,14,"chr7",1,0.0705578996718237
"10003","chr7.111360000.111365000","chr7.112130000.112135000",770000,7,0.009242951,111360000,112130000,111365000,112135000,"chr7",307083,1,2,7,10,"chr7",1,0.00820440693858415
"10004","chr7.32940000.32945000","chr7.32955000.32960000",15000,35,0.007707517,32940000,32955000,32945000,32960000,"chr7",307169,4,10,8,22,"chr7",1,0.0902484763244257
"10005","chr7.78375000.78380000","chr7.78395000.78400000",20000,43,2.429754e-05,78375000,78395000,78380000,78400000,"chr7",307186,0,2,1,3,"chr7",1,0.0151195499296765
"10006","chr7.35760000.35765000","chr7.35790000.35795000",30000,31,0.001458307,35760000,35790000,35765000,35795000,"chr7",307196,1,4,3,8,"chr7",1,0.0290670417252696
"10007","chr7.99415000.99420000","chr7.99435000.99440000",20000,35,0.007707517,99415000,99435000,99420000,99440000,"chr7",307246,2,9,10,21,"chr7",1,0.0861462728551336
"10008","chr7.104805000.104810000","chr7.104990000.104995000",185000,13,0.002547834,104805000,104990000,104810000,104995000,"chr7",307304,0,2,0,2,"chr7",1,0.00304735114861697
"10009","chr7.151225000.151230000","chr7.151315000.151320000",90000,17,0.002606837,151225000,151315000,151230000,151320000,"chr7",307317,3,14,8,25,"chr7",1,0.0498124706985466
"10010","chr7.38260000.38265000","chr7.38365000.38370000",105000,17,0.0007806216,38260000,38365000,38265000,38370000,"chr7",307363,0,6,0,6,"chr7",1,0.0119549929676512
"10011","chr7.5745000.5750000","chr7.5820000.5825000",75000,23,1.624945e-05,5745000,5820000,5750000,5825000,"chr7",307367,7,21,21,49,"chr7",1,0.132090951711205
"10012","chr7.22860000.22865000","chr7.22885000.22890000",25000,52,1.450579e-10,22860000,22885000,22865000,22890000,"chr7",307436,4,10,14,28,"chr7",1,0.17065166432255
"10013","chr7.6170000.6175000","chr7.6370000.6375000",200000,14,0.000411658,6170000,6370000,6175000,6375000,"chr7",307438,9,20,21,50,"chr7",1,0.0820440693858415
"10014","chr7.137280000.137285000","chr7.137690000.137695000",410000,10,0.001892432,137280000,137690000,137285000,137695000,"chr7",307538,0,1,4,5,"chr7",1,0.00586029067041725
"10015","chr7.128110000.128115000","chr7.128505000.128510000",395000,9,0.009289967,128110000,128505000,128115000,128510000,"chr7",307542,1,5,2,8,"chr7",1,0.00843881856540084
"10016","chr7.39665000.39670000","chr7.39745000.39750000",80000,18,0.002398881,39665000,39745000,39670000,39750000,"chr7",307573,1,5,3,9,"chr7",1,0.0189873417721519
"10017","chr7.75570000.75575000","chr7.75595000.75600000",25000,33,0.005861433,75570000,75595000,75575000,75600000,"chr7",307699,4,13,11,28,"chr7",1,0.108298171589311
"10018","chr7.111525000.111530000","chr7.111840000.111845000",315000,13,7.040308e-05,111525000,111840000,111530000,111845000,"chr7",307705,1,0,0,1,"chr7",1,0.00152367557430849
"10019","chr7.158610000.158615000","chr7.158650000.158655000",40000,28,0.0002378575,158610000,158650000,158615000,158655000,"chr7",307732,1,7,2,10,"chr7",1,0.0328176277543366
"10020","chr7.31485000.31490000","chr7.32245000.32250000",760000,7,0.009802533,31485000,32245000,31490000,32250000,"chr7",307734,0,1,1,2,"chr7",1,0.00164088138771683
"10021","chr7.23630000.23635000","chr7.23710000.23715000",80000,20,0.0002839108,23630000,23710000,23635000,23715000,"chr7",307771,0,6,1,7,"chr7",1,0.0164088138771683
"10022","chr7.30200000.30205000","chr7.30320000.30325000",120000,27,5.504036e-11,30200000,30320000,30205000,30325000,"chr7",307782,0,2,1,3,"chr7",1,0.00949367088607595
"10023","chr7.5235000.5240000","chr7.5505000.5510000",270000,12,0.0008633957,5235000,5505000,5240000,5510000,"chr7",307820,8,37,37,82,"chr7",1,0.115330520393812
"10024","chr7.51245000.51250000","chr7.51270000.51275000",25000,37,0.0003455231,51245000,51270000,51250000,51275000,"chr7",307849,0,2,3,5,"chr7",1,0.0216830754805438
"10025","chr7.64550000.64555000","chr7.65240000.65245000",690000,14,1.497608e-08,64550000,65240000,64555000,65245000,"chr7",307865,3,9,10,22,"chr7",1,0.0360993905297703
"10026","chr7.51140000.51145000","chr7.51185000.51190000",45000,30,5.531672e-06,51140000,51185000,51145000,51190000,"chr7",307889,0,2,1,3,"chr7",1,0.0105485232067511
"10027","chr7.130900000.130905000","chr7.130985000.130990000",85000,20,0.000156116,130900000,130985000,130905000,130990000,"chr7",307931,0,5,5,10,"chr7",1,0.023441162681669
"10028","chr7.101240000.101245000","chr7.101915000.101920000",675000,9,0.0006314139,101240000,101915000,101245000,101920000,"chr7",307934,4,8,5,17,"chr7",1,0.0179324894514768
"10029","chr7.7715000.7720000","chr7.8170000.8175000",455000,9,0.005066037,7715000,8170000,7720000,8175000,"chr7",307943,1,1,2,4,"chr7",1,0.00421940928270042
"10030","chr7.36195000.36200000","chr7.36300000.36305000",105000,28,6.93541e-11,36195000,36300000,36200000,36305000,"chr7",307999,1,3,2,6,"chr7",1,0.019690576652602
"10031","chr7.129875000.129880000","chr7.130135000.130140000",260000,11,0.004209802,129875000,130135000,129880000,130140000,"chr7",308001,0,0,3,3,"chr7",1,0.00386779184247539
"10032","chr7.5820000.5825000","chr7.6480000.6485000",660000,9,0.0007177724,5820000,6480000,5825000,6485000,"chr7",308018,6,18,12,36,"chr7",1,0.0379746835443038
"10033","chr7.82570000.82575000","chr7.82600000.82605000",30000,30,0.00305535,82570000,82600000,82575000,82605000,"chr7",308024,0,7,2,9,"chr7",1,0.0316455696202532
"10034","chr7.111635000.111640000","chr7.111855000.111860000",220000,17,1.799304e-06,111635000,111855000,111640000,111860000,"chr7",308039,2,0,5,7,"chr7",1,0.0139474917955931
"10035","chr7.4715000.4720000","chr7.4795000.4800000",80000,36,8.871924e-15,4715000,4795000,4720000,4800000,"chr7",308048,4,16,24,44,"chr7",1,0.185654008438819
"10036","chr7.5605000.5610000","chr7.5820000.5825000",215000,12,0.003524226,5605000,5820000,5610000,5825000,"chr7",308054,7,17,11,35,"chr7",1,0.0492264416315049
"10037","chr7.44635000.44640000","chr7.44795000.44800000",160000,18,7.912065e-06,44635000,44795000,44640000,44800000,"chr7",308191,1,4,13,18,"chr7",1,0.0379746835443038
"10038","chr7.5870000.5875000","chr7.6315000.6320000",445000,9,0.005618732,5870000,6315000,5875000,6320000,"chr7",308266,17,37,48,102,"chr7",1,0.107594936708861
"10039","chr7.36510000.36515000","chr7.37025000.37030000",515000,11,0.0001003067,36510000,37025000,36515000,37030000,"chr7",308267,1,1,2,4,"chr7",1,0.00515705578996718
"10040","chr7.22190000.22195000","chr7.22295000.22300000",105000,28,6.93541e-11,22190000,22295000,22195000,22300000,"chr7",308271,0,2,1,3,"chr7",1,0.00984528832630099
"10041","chr7.17945000.17950000","chr7.18345000.18350000",400000,10,0.002136785,17945000,18345000,17950000,18350000,"chr7",308311,0,2,0,2,"chr7",1,0.0023441162681669
"10042","chr7.29560000.29565000","chr7.29855000.29860000",295000,11,0.002155437,29560000,29855000,29565000,29860000,"chr7",308327,1,1,0,2,"chr7",1,0.00257852789498359
"10043","chr7.4725000.4730000","chr7.4770000.4775000",45000,24,0.00211632,4725000,4770000,4730000,4775000,"chr7",308366,2,8,9,19,"chr7",1,0.0534458509142053
"10044","chr7.815000.820000","chr7.865000.870000",50000,24,0.0007217265,815000,865000,820000,870000,"chr7",308415,1,5,1,7,"chr7",1,0.019690576652602
"10045","chr7.137790000.137795000","chr7.138580000.138585000",790000,7,0.008111581,137790000,138580000,137795000,138585000,"chr7",308470,1,7,2,10,"chr7",1,0.00820440693858415
"10046","chr7.1610000.1615000","chr7.2380000.2385000",770000,11,4.656125e-06,1610000,2380000,1615000,2385000,"chr7",308492,0,15,3,18,"chr7",1,0.0232067510548523
"10047","chr7.5710000.5715000","chr7.5745000.5750000",35000,50,9.410683e-15,5710000,5745000,5715000,5750000,"chr7",308504,3,8,5,16,"chr7",1,0.093764650726676
"10048","chr7.129470000.129475000","chr7.129640000.129645000",170000,16,8.870301e-05,129470000,129640000,129475000,129645000,"chr7",308509,4,4,8,16,"chr7",1,0.0300046882325363
"10049","chr7.151585000.151590000","chr7.151685000.151690000",100000,17,0.001143854,151585000,151685000,151590000,151690000,"chr7",308609,1,2,4,7,"chr7",1,0.0139474917955931
"10050","chr7.5560000.5565000","chr7.5755000.5760000",195000,17,5.909629e-06,5560000,5755000,5565000,5760000,"chr7",308734,4,6,5,15,"chr7",1,0.029887482419128
"10051","chr7.44630000.44635000","chr7.44845000.44850000",215000,17,2.270862e-06,44630000,44845000,44635000,44850000,"chr7",308769,4,3,10,17,"chr7",1,0.0338724800750117
"10052","chr7.44885000.44890000","chr7.45030000.45035000",145000,13,0.009845682,44885000,45030000,44890000,45035000,"chr7",308784,1,20,18,39,"chr7",1,0.0594233473980309
"10053","chr7.140260000.140265000","chr7.140300000.140305000",40000,26,0.001406709,140260000,140300000,140265000,140305000,"chr7",308796,5,15,15,35,"chr7",1,0.106657290201594
"10054","chr7.5560000.5565000","chr7.5670000.5675000",110000,25,5.802048e-09,5560000,5670000,5565000,5675000,"chr7",308823,5,23,33,61,"chr7",1,0.178738865447726
"10055","chr7.30205000.30210000","chr7.30595000.30600000",390000,12,0.0001025322,30205000,30595000,30210000,30600000,"chr7",308883,0,4,5,9,"chr7",1,0.0126582278481013
"10056","chr7.140580000.140585000","chr7.140645000.140650000",65000,21,0.0007779944,140580000,140645000,140585000,140650000,"chr7",308905,6,11,18,35,"chr7",1,0.0861462728551336
"10057","chr7.5450000.5455000","chr7.5470000.5475000",20000,42,5.491611e-05,5450000,5470000,5455000,5475000,"chr7",308923,3,13,15,31,"chr7",1,0.152601969057665
"10058","chr7.137625000.137630000","chr7.137660000.137665000",35000,42,5.717453e-10,137625000,137660000,137630000,137665000,"chr7",308928,1,3,3,7,"chr7",1,0.0344585091420534
"10059","chr7.134125000.134130000","chr7.134295000.134300000",170000,18,4.517794e-06,134125000,134295000,134130000,134300000,"chr7",308961,3,7,4,14,"chr7",1,0.029535864978903
"10060","chr7.39665000.39670000","chr7.39765000.39770000",100000,16,0.003390678,39665000,39765000,39670000,39770000,"chr7",309030,1,5,3,9,"chr7",1,0.0168776371308017
"10061","chr7.154200000.154205000","chr7.154370000.154375000",170000,21,3.173826e-08,154200000,154370000,154205000,154375000,"chr7",309037,0,2,2,4,"chr7",1,0.00984528832630099
"10062","chr7.140260000.140265000","chr7.140315000.140320000",55000,22,0.00174694,140260000,140315000,140265000,140320000,"chr7",309059,0,4,2,6,"chr7",1,0.0154711673699015
"10063","chr7.5570000.5575000","chr7.5745000.5750000",175000,21,2.239404e-08,5570000,5745000,5575000,5750000,"chr7",309082,8,21,21,50,"chr7",1,0.123066104078762
"10064","chr7.104880000.104885000","chr7.105140000.105145000",260000,12,0.001104282,104880000,105140000,104885000,105145000,"chr7",309235,0,3,3,6,"chr7",1,0.00843881856540084
"10065","chr7.129295000.129300000","chr7.129485000.129490000",190000,15,0.0001506728,129295000,129485000,129300000,129490000,"chr7",309255,3,3,8,14,"chr7",1,0.0246132208157525
"10066","chr7.73840000.73845000","chr7.74090000.74095000",250000,12,0.001416254,73840000,74090000,73845000,74095000,"chr7",309311,2,11,14,27,"chr7",1,0.0379746835443038
"10067","chr7.5565000.5570000","chr7.5745000.5750000",180000,19,5.104215e-07,5565000,5745000,5570000,5750000,"chr7",309336,8,21,21,50,"chr7",1,0.111345522737928
"10068","chr7.36520000.36525000","chr7.37230000.37235000",710000,12,1.098055e-06,36520000,37230000,36525000,37235000,"chr7",309338,1,5,3,9,"chr7",1,0.0126582278481013
"10069","chr7.4685000.4690000","chr7.4780000.4785000",95000,25,4.426731e-08,4685000,4780000,4690000,4785000,"chr7",309351,4,11,13,28,"chr7",1,0.0820440693858415
"10070","chr7.134325000.134330000","chr7.134890000.134895000",565000,8,0.008157193,134325000,134890000,134330000,134895000,"chr7",309369,0,1,0,1,"chr7",1,0.00093764650726676
"10071","chr7.111635000.111640000","chr7.111840000.111845000",205000,41,2.071529e-29,111635000,111840000,111640000,111845000,"chr7",309375,1,4,2,7,"chr7",1,0.033638068448195
"10072","chr7.101180000.101185000","chr7.101915000.101920000",735000,15,6.343601e-10,101180000,101915000,101185000,101920000,"chr7",309376,4,8,5,17,"chr7",1,0.029887482419128
"10073","chr7.100075000.100080000","chr7.100130000.100135000",55000,22,0.00174694,100075000,100130000,100080000,100135000,"chr7",309423,8,20,21,49,"chr7",1,0.126347866854196
"10074","chr7.111840000.111845000","chr7.112050000.112055000",210000,18,5.328073e-07,111840000,112050000,111845000,112055000,"chr7",309434,1,1,2,4,"chr7",1,0.00843881856540084
"10075","chr7.36520000.36525000","chr7.37235000.37240000",715000,10,6.670929e-05,36520000,37235000,36525000,37240000,"chr7",309452,1,6,5,12,"chr7",1,0.0140646976090014
"10076","chr7.111740000.111745000","chr7.111840000.111845000",100000,16,0.003390678,111740000,111840000,111745000,111845000,"chr7",309474,1,4,2,7,"chr7",1,0.0131270511017346
"10077","chr7.16465000.16470000","chr7.16615000.16620000",150000,15,0.0008005985,16465000,16615000,16470000,16620000,"chr7",309504,1,1,2,4,"chr7",1,0.0070323488045007
"10078","chr7.11020000.11025000","chr7.11250000.11255000",230000,16,6.237669e-06,11020000,11250000,11025000,11255000,"chr7",309531,0,7,3,10,"chr7",1,0.0187529301453352
"10079","chr7.129500000.129505000","chr7.129555000.129560000",55000,23,0.0006714546,129500000,129555000,129505000,129560000,"chr7",309565,4,11,7,22,"chr7",1,0.0593061415846226
"10080","chr7.111740000.111745000","chr7.111845000.111850000",105000,15,0.006911981,111740000,111845000,111745000,111850000,"chr7",309600,1,3,0,4,"chr7",1,0.0070323488045007
"10081","chr7.30200000.30205000","chr7.30555000.30560000",355000,10,0.003611198,30200000,30555000,30205000,30560000,"chr7",309782,0,9,9,18,"chr7",1,0.0210970464135021
"10082","chr7.5210000.5215000","chr7.5235000.5240000",25000,36,0.0007257094,5210000,5235000,5215000,5240000,"chr7",309788,2,6,5,13,"chr7",1,0.0548523206751055
"10083","chr7.71245000.71250000","chr7.72090000.72095000",845000,10,1.826798e-05,71245000,72090000,71250000,72095000,"chr7",309793,1,7,4,12,"chr7",1,0.0140646976090014
"10084","chr7.29145000.29150000","chr7.29370000.29375000",225000,15,3.768933e-05,29145000,29370000,29150000,29375000,"chr7",309796,0,5,0,5,"chr7",1,0.00879043600562588
"10085","chr7.100505000.100510000","chr7.100690000.100695000",185000,12,0.008260206,100505000,100690000,100510000,100695000,"chr7",309826,3,10,9,22,"chr7",1,0.0309423347398031
"10086","chr7.44630000.44635000","chr7.44885000.44890000",255000,22,2.045618e-11,44630000,44885000,44635000,44890000,"chr7",309858,1,3,10,14,"chr7",1,0.0360993905297703
"10087","chr7.16130000.16135000","chr7.16470000.16475000",340000,13,4.38465e-05,16130000,16470000,16135000,16475000,"chr7",309868,0,1,3,4,"chr7",1,0.00609470229723394
"10088","chr7.81765000.81770000","chr7.82230000.82235000",465000,9,0.004585908,81765000,82230000,81770000,82235000,"chr7",309875,0,1,1,2,"chr7",1,0.00210970464135021
"10089","chr7.6220000.6225000","chr7.6365000.6370000",145000,14,0.003260262,6220000,6365000,6225000,6370000,"chr7",309971,8,12,26,46,"chr7",1,0.0754805438349742
"10090","chr7.5745000.5750000","chr7.5780000.5785000",35000,27,0.003347901,5745000,5780000,5750000,5785000,"chr7",310016,8,21,21,50,"chr7",1,0.158227848101266
"10091","chr7.137310000.137315000","chr7.137590000.137595000",280000,12,0.0006932697,137310000,137590000,137315000,137595000,"chr7",310095,1,4,2,7,"chr7",1,0.00984528832630099
"10092","chr7.75155000.75160000","chr7.75235000.75240000",80000,18,0.002398881,75155000,75235000,75160000,75240000,"chr7",310162,5,19,12,36,"chr7",1,0.0759493670886076
"10093","chr7.111635000.111640000","chr7.112045000.112050000",410000,10,0.001892432,111635000,112045000,111640000,112050000,"chr7",310167,5,5,7,17,"chr7",1,0.0199249882794187
"10094","chr7.66205000.66210000","chr7.66455000.66460000",250000,12,0.001416254,66205000,66455000,66210000,66460000,"chr7",310168,5,10,13,28,"chr7",1,0.0393811533052039
"10095","chr7.98920000.98925000","chr7.98955000.98960000",35000,27,0.003347901,98920000,98955000,98925000,98960000,"chr7",310178,0,9,5,14,"chr7",1,0.0443037974683544
"10096","chr7.36485000.36490000","chr7.36985000.36990000",500000,11,0.0001211885,36485000,36985000,36490000,36990000,"chr7",310366,0,2,1,3,"chr7",1,0.00386779184247539
"10097","chr7.78135000.78140000","chr7.78415000.78420000",280000,11,0.002839683,78135000,78415000,78140000,78420000,"chr7",310407,1,0,2,3,"chr7",1,0.00386779184247539
"10098","chr7.154145000.154150000","chr7.154165000.154170000",20000,37,0.002176787,154145000,154165000,154150000,154170000,"chr7",310409,2,6,5,13,"chr7",1,0.056375996249414
"10099","chr7.111635000.111640000","chr7.111755000.111760000",120000,21,1.169254e-06,111635000,111755000,111640000,111760000,"chr7",310414,0,1,5,6,"chr7",1,0.0147679324894515
"10100","chr7.111635000.111640000","chr7.111850000.111855000",215000,12,0.003524226,111635000,111850000,111640000,111855000,"chr7",310415,3,11,8,22,"chr7",1,0.0309423347398031
"10101","chr7.1170000.1175000","chr7.1190000.1195000",20000,35,0.007707517,1170000,1190000,1175000,1195000,"chr7",310425,2,5,3,10,"chr7",1,0.0410220346929208
"10102","chr7.65955000.65960000","chr7.66205000.66210000",250000,15,1.528946e-05,65955000,66205000,65960000,66210000,"chr7",310455,0,9,2,11,"chr7",1,0.0193389592123769
"10103","chr7.140580000.140585000","chr7.140670000.140675000",90000,17,0.002606837,140580000,140670000,140585000,140675000,"chr7",310483,1,7,5,13,"chr7",1,0.0259024847632443
"10104","chr7.73665000.73670000","chr7.73790000.73795000",125000,21,7.853831e-07,73665000,73790000,73670000,73795000,"chr7",310484,9,16,16,41,"chr7",1,0.100914205344585
"10105","chr7.73855000.73860000","chr7.74045000.74050000",190000,14,0.0005925602,73855000,74045000,73860000,74050000,"chr7",310579,2,4,4,10,"chr7",1,0.0164088138771683
"10106","chr7.44635000.44640000","chr7.44920000.44925000",285000,12,0.0006265093,44635000,44920000,44640000,44925000,"chr7",310670,1,4,13,18,"chr7",1,0.0253164556962025
"10107","chr7.111845000.111850000","chr7.112045000.112050000",200000,13,0.001549951,111845000,112045000,111850000,112050000,"chr7",310675,1,3,0,4,"chr7",1,0.00609470229723394
"10108","chr7.37270000.37275000","chr7.37320000.37325000",50000,34,6.910324e-09,37270000,37320000,37275000,37325000,"chr7",310725,0,6,4,10,"chr7",1,0.0398499765588373
"10109","chr7.107815000.107820000","chr7.108145000.108150000",330000,10,0.004933786,107815000,108145000,107820000,108150000,"chr7",310771,0,4,2,6,"chr7",1,0.0070323488045007
"10110","chr7.74040000.74045000","chr7.74065000.74070000",25000,59,2.59715e-14,74040000,74065000,74045000,74070000,"chr7",310800,4,16,14,34,"chr7",1,0.23511486169714
"10111","chr7.35750000.35755000","chr7.35835000.35840000",85000,30,8.89543e-11,35750000,35835000,35755000,35840000,"chr7",310807,1,0,4,5,"chr7",1,0.0175808720112518
"10112","chr7.44625000.44630000","chr7.45025000.45030000",400000,9,0.008829516,44625000,45025000,44630000,45030000,"chr7",310862,0,6,3,9,"chr7",1,0.00949367088607595
"10113","chr7.107815000.107820000","chr7.108140000.108145000",325000,14,1.041746e-05,107815000,108140000,107820000,108145000,"chr7",310880,1,4,2,7,"chr7",1,0.0114861697140178
"10114","chr7.22885000.22890000","chr7.23085000.23090000",200000,13,0.001549951,22885000,23085000,22890000,23090000,"chr7",310918,4,10,8,22,"chr7",1,0.0335208626347867
"10115","chr7.865000.870000","chr7.910000.915000",45000,31,1.768481e-06,865000,910000,870000,915000,"chr7",310921,1,5,1,7,"chr7",1,0.0254336615096109
"10116","chr7.100480000.100485000","chr7.100705000.100710000",225000,11,0.009286263,100480000,100705000,100485000,100710000,"chr7",310976,8,23,23,54,"chr7",1,0.069620253164557
"10117","chr7.78415000.78420000","chr7.78560000.78565000",145000,16,0.0002842677,78415000,78560000,78420000,78565000,"chr7",311003,0,0,2,2,"chr7",1,0.00375058602906704
"10118","chr7.37270000.37275000","chr7.37490000.37495000",220000,20,8.348851e-09,37270000,37490000,37275000,37495000,"chr7",311049,0,4,2,6,"chr7",1,0.0140646976090014
"10119","chr7.51245000.51250000","chr7.51320000.51325000",75000,21,0.0001748615,51245000,51320000,51250000,51325000,"chr7",311094,0,2,3,5,"chr7",1,0.0123066104078762
"10120","chr7.73680000.73685000","chr7.73705000.73710000",25000,35,0.001519389,73680000,73705000,73685000,73710000,"chr7",311142,4,12,11,27,"chr7",1,0.110759493670886
"10121","chr7.78250000.78255000","chr7.78395000.78400000",145000,13,0.009845682,78250000,78395000,78255000,78400000,"chr7",311180,0,2,1,3,"chr7",1,0.00457102672292546
"10122","chr7.5530000.5535000","chr7.5675000.5680000",145000,20,9.002112e-07,5530000,5675000,5535000,5680000,"chr7",311182,2,3,2,7,"chr7",1,0.0164088138771683
"10123","chr7.95400000.95405000","chr7.95430000.95435000",30000,44,4.38561e-09,95400000,95430000,95405000,95435000,"chr7",311222,2,5,12,19,"chr7",1,0.0979840600093765
"10124","chr7.51265000.51270000","chr7.51285000.51290000",20000,51,1.327808e-08,51265000,51285000,51270000,51290000,"chr7",311256,0,4,3,7,"chr7",1,0.0418424753867792
"10125","chr7.138165000.138170000","chr7.138185000.138190000",20000,42,5.491611e-05,138165000,138185000,138170000,138190000,"chr7",311270,2,8,9,19,"chr7",1,0.0935302390998594
"10126","chr7.5675000.5680000","chr7.5710000.5715000",35000,33,1.665176e-05,5675000,5710000,5680000,5715000,"chr7",311287,2,8,3,13,"chr7",1,0.05028129395218
"10127","chr7.51245000.51250000","chr7.51430000.51435000",185000,29,1.180734e-15,51245000,51430000,51250000,51435000,"chr7",311326,0,2,3,5,"chr7",1,0.01699484294421
"10128","chr7.36525000.36530000","chr7.37025000.37030000",500000,17,5.182472e-10,36525000,37025000,36530000,37030000,"chr7",311382,2,2,2,6,"chr7",1,0.0119549929676512
"10129","chr7.103840000.103845000","chr7.104495000.104500000",655000,8,0.004067044,103840000,104495000,103845000,104500000,"chr7",311385,3,7,3,13,"chr7",1,0.0121894045944679
"10130","chr7.75990000.75995000","chr7.76020000.76025000",30000,50,2.543911e-12,75990000,76020000,75995000,76025000,"chr7",311471,4,10,2,16,"chr7",1,0.093764650726676
"10131","chr7.100545000.100550000","chr7.100610000.100615000",65000,32,6.039131e-10,100545000,100610000,100550000,100615000,"chr7",311506,1,4,1,6,"chr7",1,0.0225035161744023
"10132","chr7.4750000.4755000","chr7.4780000.4785000",30000,38,2.981751e-06,4750000,4780000,4755000,4785000,"chr7",311526,3,8,12,23,"chr7",1,0.102437880918894
"10133","chr7.35750000.35755000","chr7.36385000.36390000",635000,11,2.246904e-05,35750000,36385000,35755000,36390000,"chr7",311538,1,0,5,6,"chr7",1,0.00773558368495077
"10134","chr7.36010000.36015000","chr7.36210000.36215000",200000,13,0.001549951,36010000,36210000,36015000,36215000,"chr7",311543,1,4,3,8,"chr7",1,0.0121894045944679
"10135","chr7.152125000.152130000","chr7.152145000.152150000",20000,36,0.004179201,152125000,152145000,152130000,152150000,"chr7",311771,1,5,5,11,"chr7",1,0.0464135021097046
"10136","chr7.98655000.98660000","chr7.98865000.98870000",210000,18,5.328073e-07,98655000,98865000,98660000,98870000,"chr7",311781,2,9,3,14,"chr7",1,0.029535864978903
"10137","chr7.101055000.101060000","chr7.101075000.101080000",20000,35,0.007707517,101055000,101075000,101060000,101080000,"chr7",311787,5,5,7,17,"chr7",1,0.0697374589779653
"10138","chr7.148275000.148280000","chr7.148660000.148665000",385000,14,3.174815e-06,148275000,148660000,148280000,148665000,"chr7",311849,0,0,3,3,"chr7",1,0.00492264416315049
"10139","chr7.74030000.74035000","chr7.74090000.74095000",60000,26,8.578064e-06,74030000,74090000,74035000,74095000,"chr7",311874,2,10,13,25,"chr7",1,0.0761837787154243
"10140","chr7.5405000.5410000","chr7.5505000.5510000",100000,15,0.009373683,5405000,5505000,5410000,5510000,"chr7",311894,11,37,17,65,"chr7",1,0.114275668073136
"10141","chr7.127230000.127235000","chr7.127290000.127295000",60000,34,1.635362e-10,127230000,127290000,127235000,127295000,"chr7",311903,2,0,1,3,"chr7",1,0.0119549929676512
"10142","chr7.47565000.47570000","chr7.47755000.47760000",190000,12,0.007093495,47565000,47755000,47570000,47760000,"chr7",311906,1,8,12,21,"chr7",1,0.029535864978903
"10143","chr7.830000.835000","chr7.900000.905000",70000,19,0.002760284,830000,9e+05,835000,905000,"chr7",311910,3,5,4,12,"chr7",1,0.0267229254571027
"10144","chr7.101600000.101605000","chr7.101780000.101785000",180000,13,0.003037322,101600000,101780000,101605000,101785000,"chr7",311932,4,18,11,33,"chr7",1,0.05028129395218
"10145","chr7.22190000.22195000","chr7.22220000.22225000",30000,44,4.38561e-09,22190000,22220000,22195000,22225000,"chr7",311952,0,1,1,2,"chr7",1,0.0103141115799344
"10146","chr7.101600000.101605000","chr7.101740000.101745000",140000,14,0.003981961,101600000,101740000,101605000,101745000,"chr7",311975,4,12,11,27,"chr7",1,0.0443037974683544
"10147","chr7.36950000.36955000","chr7.36985000.36990000",35000,34,6.053946e-06,36950000,36985000,36955000,36990000,"chr7",312002,0,0,3,3,"chr7",1,0.0119549929676512
"10148","chr7.30205000.30210000","chr7.30500000.30505000",295000,13,0.0001092397,30205000,30500000,30210000,30505000,"chr7",312089,0,3,2,5,"chr7",1,0.00761837787154243
"10149","chr7.36365000.36370000","chr7.36385000.36390000",20000,49,1.006661e-07,36365000,36385000,36370000,36390000,"chr7",312106,2,3,1,6,"chr7",1,0.0344585091420534
"10150","chr7.154200000.154205000","chr7.154255000.154260000",55000,20,0.00985274,154200000,154255000,154205000,154260000,"chr7",312176,0,2,2,4,"chr7",1,0.00937646507266761
"10151","chr7.22290000.22295000","chr7.22485000.22490000",195000,15,0.0001215023,22290000,22485000,22295000,22490000,"chr7",312208,0,0,8,8,"chr7",1,0.0140646976090014
"10152","chr7.90710000.90715000","chr7.91260000.91265000",550000,12,9.55368e-06,90710000,91260000,90715000,91265000,"chr7",312216,2,1,0,3,"chr7",1,0.00421940928270042
"10153","chr7.41980000.41985000","chr7.42885000.42890000",905000,8,0.0006264121,41980000,42885000,41985000,42890000,"chr7",312224,1,1,0,2,"chr7",1,0.00187529301453352
"10154","chr7.129925000.129930000","chr7.130430000.130435000",505000,9,0.003093324,129925000,130430000,129930000,130435000,"chr7",312274,3,1,3,7,"chr7",1,0.00738396624472574
"10155","chr7.51255000.51260000","chr7.51310000.51315000",55000,20,0.00985274,51255000,51310000,51260000,51315000,"chr7",312298,0,3,1,4,"chr7",1,0.00937646507266761
"10156","chr7.56075000.56080000","chr7.56100000.56105000",25000,46,1.020854e-07,56075000,56100000,56080000,56105000,"chr7",312303,3,24,19,46,"chr7",1,0.248007501172058
"10157","chr7.137590000.137595000","chr7.137670000.137675000",80000,25,5.041684e-07,137590000,137670000,137595000,137675000,"chr7",312375,1,1,0,2,"chr7",1,0.00586029067041725
"10158","chr7.5600000.5605000","chr7.5710000.5715000",110000,37,8.020978e-19,5600000,5710000,5605000,5715000,"chr7",312422,3,8,5,16,"chr7",1,0.0693858415377403
"10159","chr7.7635000.7640000","chr7.8315000.8320000",680000,11,1.303424e-05,7635000,8315000,7640000,8320000,"chr7",312435,0,2,1,3,"chr7",1,0.00386779184247539
"10160","chr7.39620000.39625000","chr7.39985000.39990000",365000,15,7.185607e-07,39620000,39985000,39625000,39990000,"chr7",312464,0,1,2,3,"chr7",1,0.00527426160337553
"10161","chr7.100085000.100090000","chr7.100155000.100160000",70000,27,2.202131e-07,100085000,100155000,100090000,100160000,"chr7",312486,3,3,3,9,"chr7",1,0.0284810126582278
"10162","chr7.22150000.22155000","chr7.22255000.22260000",105000,19,6.926977e-05,22150000,22255000,22155000,22260000,"chr7",312495,3,3,5,11,"chr7",1,0.0244960150023441
"10163","chr7.104760000.104765000","chr7.104990000.104995000",230000,13,0.0006067963,104760000,104990000,104765000,104995000,"chr7",312591,0,1,2,3,"chr7",1,0.00457102672292546
"10164","chr7.5530000.5535000","chr7.5560000.5565000",30000,35,5.18901e-05,5530000,5560000,5535000,5565000,"chr7",312609,4,3,2,9,"chr7",1,0.0369198312236287
"10165","chr7.131075000.131080000","chr7.131145000.131150000",70000,22,0.0001195867,131075000,131145000,131080000,131150000,"chr7",312611,3,5,2,10,"chr7",1,0.0257852789498359
"10166","chr7.22425000.22430000","chr7.22485000.22490000",60000,30,5.106847e-08,22425000,22485000,22430000,22490000,"chr7",312617,2,4,12,18,"chr7",1,0.0632911392405063
"10167","chr7.111485000.111490000","chr7.112045000.112050000",560000,8,0.00849776,111485000,112045000,111490000,112050000,"chr7",312662,4,5,7,16,"chr7",1,0.0150023441162682
"10168","chr7.75525000.75530000","chr7.75570000.75575000",45000,25,0.0008633957,75525000,75570000,75530000,75575000,"chr7",312676,5,19,11,35,"chr7",1,0.102555086732302
"10169","chr7.112420000.112425000","chr7.112525000.112530000",105000,16,0.002398881,112420000,112525000,112425000,112530000,"chr7",312756,1,8,3,12,"chr7",1,0.0225035161744023
"10170","chr7.128340000.128345000","chr7.128360000.128365000",20000,40,0.0002631097,128340000,128360000,128345000,128365000,"chr7",312762,1,1,5,7,"chr7",1,0.0328176277543366
"10171","chr7.36195000.36200000","chr7.36260000.36265000",65000,23,9.289351e-05,36195000,36260000,36200000,36265000,"chr7",312804,2,15,12,29,"chr7",1,0.0781762775433661
"10172","chr7.129315000.129320000","chr7.129655000.129660000",340000,12,0.0002277545,129315000,129655000,129320000,129660000,"chr7",312965,7,10,7,24,"chr7",1,0.0337552742616034
"10173","chr7.154200000.154205000","chr7.154565000.154570000",365000,11,0.0007257094,154200000,154565000,154205000,154570000,"chr7",312968,0,2,2,4,"chr7",1,0.00515705578996718
"10174","chr7.5635000.5640000","chr7.5710000.5715000",75000,19,0.001517752,5635000,5710000,5640000,5715000,"chr7",312977,3,8,5,16,"chr7",1,0.0356305672761369
"10175","chr7.65960000.65965000","chr7.66770000.66775000",810000,7,0.007104769,65960000,66770000,65965000,66775000,"chr7",312986,4,7,11,22,"chr7",1,0.0180496952648851
"10176","chr7.35985000.35990000","chr7.36365000.36370000",380000,14,3.511968e-06,35985000,36365000,35990000,36370000,"chr7",313006,2,3,1,6,"chr7",1,0.00984528832630099
"10177","chr7.4680000.4685000","chr7.4780000.4785000",100000,24,1.006661e-07,4680000,4780000,4685000,4785000,"chr7",313063,5,11,13,29,"chr7",1,0.0815752461322082
"10178","chr7.5450000.5455000","chr7.5745000.5750000",295000,11,0.002155437,5450000,5745000,5455000,5750000,"chr7",313093,8,21,21,50,"chr7",1,0.0644631973745898
"10179","chr7.3730000.3735000","chr7.3905000.3910000",175000,13,0.00355792,3730000,3905000,3735000,3910000,"chr7",313098,0,5,0,5,"chr7",1,0.00761837787154243
"10180","chr7.75485000.75490000","chr7.75635000.75640000",150000,16,0.0002283313,75485000,75635000,75490000,75640000,"chr7",313106,3,9,6,18,"chr7",1,0.0337552742616034
"10181","chr7.71630000.71635000","chr7.71780000.71785000",150000,18,1.380867e-05,71630000,71780000,71635000,71785000,"chr7",313119,1,2,2,5,"chr7",1,0.0105485232067511
"10182","chr7.135210000.135215000","chr7.135240000.135245000",30000,29,0.006213825,135210000,135240000,135215000,135245000,"chr7",313144,0,3,2,5,"chr7",1,0.01699484294421
"10183","chr7.49780000.49785000","chr7.49820000.49825000",40000,24,0.007017412,49780000,49820000,49785000,49825000,"chr7",313148,1,2,2,5,"chr7",1,0.0140646976090014
"10184","chr7.5405000.5410000","chr7.5485000.5490000",80000,17,0.006379927,5405000,5485000,5410000,5490000,"chr7",313178,10,33,17,60,"chr7",1,0.119549929676512
"10185","chr7.5530000.5535000","chr7.5595000.5600000",65000,35,5.557386e-12,5530000,5595000,5535000,5600000,"chr7",313213,4,3,2,9,"chr7",1,0.0369198312236287
"10186","chr7.5650000.5655000","chr7.5745000.5750000",95000,19,0.0001748615,5650000,5745000,5655000,5750000,"chr7",313217,4,13,16,33,"chr7",1,0.0734880450070323
"10187","chr7.5745000.5750000","chr7.5810000.5815000",65000,23,9.289351e-05,5745000,5810000,5750000,5815000,"chr7",313231,8,21,21,50,"chr7",1,0.134786685419597
"10188","chr7.129655000.129660000","chr7.130430000.130435000",775000,9,0.0002652387,129655000,130430000,129660000,130435000,"chr7",313253,3,1,3,7,"chr7",1,0.00738396624472574
"10189","chr7.7635000.7640000","chr7.8220000.8225000",585000,13,7.413284e-07,7635000,8220000,7640000,8225000,"chr7",313281,4,5,2,11,"chr7",1,0.0167604313173933
"10190","chr7.137590000.137595000","chr7.137660000.137665000",70000,23,3.745658e-05,137590000,137660000,137595000,137665000,"chr7",313323,1,3,2,6,"chr7",1,0.0161744022503516
"10191","chr7.129330000.129335000","chr7.129635000.129640000",305000,10,0.007017412,129330000,129635000,129335000,129640000,"chr7",313347,2,6,5,13,"chr7",1,0.0152367557430849
"10192","chr7.151010000.151015000","chr7.151050000.151055000",40000,31,1.180997e-05,151010000,151050000,151015000,151055000,"chr7",313372,2,4,2,8,"chr7",1,0.0290670417252696
"10193","chr7.147280000.147285000","chr7.147785000.147790000",505000,9,0.003093324,147280000,147785000,147285000,147790000,"chr7",313386,3,4,2,9,"chr7",1,0.00949367088607595
"10194","chr7.83305000.83310000","chr7.83345000.83350000",40000,24,0.007017412,83305000,83345000,83310000,83350000,"chr7",313500,0,3,0,3,"chr7",1,0.00843881856540084
"10195","chr7.129885000.129890000","chr7.130440000.130445000",555000,8,0.008864356,129885000,130440000,129890000,130445000,"chr7",313525,5,8,12,25,"chr7",1,0.023441162681669
"10196","chr7.129620000.129625000","chr7.129640000.129645000",20000,36,0.004179201,129620000,129640000,129625000,129645000,"chr7",313552,4,4,8,16,"chr7",1,0.0675105485232067
"10197","chr7.2775000.2780000","chr7.2875000.2880000",100000,17,0.001143854,2775000,2875000,2780000,2880000,"chr7",313553,8,23,17,48,"chr7",1,0.0956399437412096
"10198","chr7.5635000.5640000","chr7.5675000.5680000",40000,39,8.527234e-10,5635000,5675000,5640000,5680000,"chr7",313562,2,8,3,13,"chr7",1,0.0594233473980309
"10199","chr7.2060000.2065000","chr7.2375000.2380000",315000,10,0.006086509,2060000,2375000,2065000,2380000,"chr7",313588,0,1,0,1,"chr7",1,0.00117205813408345
"10200","chr7.105905000.105910000","chr7.106050000.106055000",145000,13,0.009845682,105905000,106050000,105910000,106055000,"chr7",313622,3,8,5,16,"chr7",1,0.0243788091889358
"10201","chr7.22190000.22195000","chr7.22255000.22260000",65000,24,2.976482e-05,22190000,22255000,22195000,22260000,"chr7",313651,0,2,2,4,"chr7",1,0.0112517580872011
"10202","chr7.37490000.37495000","chr7.37555000.37560000",65000,23,9.289351e-05,37490000,37555000,37495000,37560000,"chr7",313675,0,1,2,3,"chr7",1,0.00808720112517581
"10203","chr7.5525000.5530000","chr7.5670000.5675000",145000,15,0.0009975075,5525000,5670000,5530000,5675000,"chr7",313694,7,12,15,34,"chr7",1,0.059774964838256
"10204","chr7.5670000.5675000","chr7.5690000.5695000",20000,35,0.007707517,5670000,5690000,5675000,5695000,"chr7",313767,0,3,5,8,"chr7",1,0.0328176277543366
"10205","chr7.100085000.100090000","chr7.100115000.100120000",30000,29,0.006213825,100085000,100115000,100090000,100120000,"chr7",313817,7,22,24,53,"chr7",1,0.180145335208626
"10206","chr7.22365000.22370000","chr7.22485000.22490000",120000,15,0.00305535,22365000,22485000,22370000,22490000,"chr7",313845,0,3,1,4,"chr7",1,0.0070323488045007
"10207","chr7.100215000.100220000","chr7.100270000.100275000",55000,21,0.004210319,100215000,100270000,100220000,100275000,"chr7",313870,0,5,2,7,"chr7",1,0.0172292545710267
"10208","chr7.69560000.69565000","chr7.69990000.69995000",430000,10,0.001515307,69560000,69990000,69565000,69995000,"chr7",313966,8,5,11,24,"chr7",1,0.0281293952180028
"10209","chr7.44885000.44890000","chr7.44920000.44925000",35000,41,2.001137e-09,44885000,44920000,44890000,44925000,"chr7",314006,1,20,18,39,"chr7",1,0.187412095639944
"10210","chr7.5570000.5575000","chr7.5590000.5595000",20000,52,4.684966e-09,5570000,5590000,5575000,5595000,"chr7",314028,2,5,15,22,"chr7",1,0.134083450539147
"10211","chr7.137320000.137325000","chr7.137545000.137550000",225000,13,0.0007042362,137320000,137545000,137325000,137550000,"chr7",314033,1,2,0,3,"chr7",1,0.00457102672292546
"10212","chr7.66030000.66035000","chr7.66305000.66310000",275000,11,0.003114216,66030000,66305000,66035000,66310000,"chr7",314139,3,4,11,18,"chr7",1,0.0232067510548523
"10213","chr7.44625000.44630000","chr7.44895000.44900000",270000,13,0.0002012296,44625000,44895000,44630000,44900000,"chr7",314149,4,12,8,24,"chr7",1,0.0365682137834037
"10214","chr7.2400000.2405000","chr7.2435000.2440000",35000,31,0.0001140788,2400000,2435000,2405000,2440000,"chr7",314162,6,10,9,25,"chr7",1,0.0908345053914674
"10215","chr7.35715000.35720000","chr7.35905000.35910000",190000,20,4.985924e-08,35715000,35905000,35720000,35910000,"chr7",314183,0,6,1,7,"chr7",1,0.0164088138771683
"10216","chr7.128650000.128655000","chr7.128670000.128675000",20000,39,0.0005470821,128650000,128670000,128655000,128675000,"chr7",314188,2,0,3,5,"chr7",1,0.0228551336146273
"10217","chr7.24700000.24705000","chr7.24730000.24735000",30000,30,0.00305535,24700000,24730000,24705000,24735000,"chr7",314294,0,3,2,5,"chr7",1,0.0175808720112518
"10218","chr7.22190000.22195000","chr7.22225000.22230000",35000,35,2.120793e-06,22190000,22225000,22195000,22230000,"chr7",314317,0,2,2,4,"chr7",1,0.0164088138771683
"10219","chr7.5235000.5240000","chr7.5670000.5675000",435000,9,0.006213825,5235000,5670000,5240000,5675000,"chr7",314342,8,44,37,89,"chr7",1,0.0938818565400844
"10220","chr7.148575000.148580000","chr7.148660000.148665000",85000,24,8.927325e-07,148575000,148660000,148580000,148665000,"chr7",314385,1,8,9,18,"chr7",1,0.0506329113924051
"10221","chr7.19745000.19750000","chr7.20380000.20385000",635000,17,2.696166e-11,19745000,20380000,19750000,20385000,"chr7",314401,0,0,2,2,"chr7",1,0.00398499765588373
"10222","chr7.5590000.5595000","chr7.5855000.5860000",265000,11,0.003841663,5590000,5855000,5595000,5860000,"chr7",314471,2,5,15,22,"chr7",1,0.0283638068448195
"10223","chr7.22860000.22865000","chr7.23180000.23185000",320000,10,0.005683939,22860000,23180000,22865000,23185000,"chr7",314550,0,6,9,15,"chr7",1,0.0175808720112518
"10224","chr7.43905000.43910000","chr7.43950000.43955000",45000,25,0.0008633957,43905000,43950000,43910000,43955000,"chr7",314577,3,5,3,11,"chr7",1,0.0322315986872949
"10225","chr7.44625000.44630000","chr7.44640000.44645000",15000,47,7.015212e-07,44625000,44640000,44630000,44645000,"chr7",314685,9,13,8,30,"chr7",1,0.165260196905767
"10226","chr7.111360000.111365000","chr7.112125000.112130000",765000,7,0.009519608,111360000,112125000,111365000,112130000,"chr7",314693,1,1,0,2,"chr7",1,0.00164088138771683
"10227","chr7.130715000.130720000","chr7.130985000.130990000",270000,16,1.380954e-06,130715000,130985000,130720000,130990000,"chr7",314724,3,5,10,18,"chr7",1,0.0337552742616034
"10228","chr7.128860000.128865000","chr7.128955000.128960000",95000,19,0.0001748615,128860000,128955000,128865000,128960000,"chr7",314773,7,12,13,32,"chr7",1,0.0712611345522738
"10229","chr7.44630000.44635000","chr7.44810000.44815000",180000,15,0.0002309465,44630000,44810000,44635000,44815000,"chr7",314807,4,3,10,17,"chr7",1,0.029887482419128
"10230","chr7.30560000.30565000","chr7.30595000.30600000",35000,27,0.003347901,30560000,30595000,30565000,30600000,"chr7",314854,1,4,5,10,"chr7",1,0.0316455696202532
"10231","chr7.860000.865000","chr7.880000.885000",20000,37,0.002176787,860000,880000,865000,885000,"chr7",314889,2,4,5,11,"chr7",1,0.0477027660571964
"10232","chr7.51255000.51260000","chr7.51315000.51320000",60000,31,1.286533e-08,51255000,51315000,51260000,51320000,"chr7",314902,0,3,1,4,"chr7",1,0.0145335208626348
"10233","chr7.105690000.105695000","chr7.105760000.105765000",70000,27,2.202131e-07,105690000,105760000,105695000,105765000,"chr7",314909,0,4,2,6,"chr7",1,0.0189873417721519
"10234","chr7.66140000.66145000","chr7.66205000.66210000",65000,22,0.0002799273,66140000,66205000,66145000,66210000,"chr7",314947,4,8,4,16,"chr7",1,0.0412564463197375
"10235","chr7.30555000.30560000","chr7.30590000.30595000",35000,33,1.665176e-05,30555000,30590000,30560000,30595000,"chr7",315043,0,3,7,10,"chr7",1,0.0386779184247539
"10236","chr7.137625000.137630000","chr7.137655000.137660000",30000,40,3.808281e-07,137625000,137655000,137630000,137660000,"chr7",315048,0,3,5,8,"chr7",1,0.0375058602906704
"10237","chr7.30200000.30205000","chr7.30515000.30520000",315000,10,0.006086509,30200000,30515000,30205000,30520000,"chr7",315114,0,6,9,15,"chr7",1,0.0175808720112518
"10238","chr7.45030000.45035000","chr7.45150000.45155000",120000,15,0.00305535,45030000,45150000,45035000,45155000,"chr7",315138,3,6,3,12,"chr7",1,0.0210970464135021
"10239","chr7.105760000.105765000","chr7.106050000.106055000",290000,11,0.002351004,105760000,106050000,105765000,106055000,"chr7",315144,0,4,2,6,"chr7",1,0.00773558368495077
"10240","chr7.104770000.104775000","chr7.105125000.105130000",355000,13,3.299241e-05,104770000,105125000,104775000,105130000,"chr7",315160,0,1,2,3,"chr7",1,0.00457102672292546
"10241","chr7.111485000.111490000","chr7.112130000.112135000",645000,8,0.004329931,111485000,112130000,111490000,112135000,"chr7",315163,3,2,8,13,"chr7",1,0.0121894045944679
"10242","chr7.28470000.28475000","chr7.29145000.29150000",675000,8,0.003464801,28470000,29145000,28475000,29150000,"chr7",315174,0,5,0,5,"chr7",1,0.0046882325363338
"10243","chr7.44810000.44815000","chr7.44845000.44850000",35000,26,0.007017412,44810000,44845000,44815000,44850000,"chr7",315177,4,15,16,35,"chr7",1,0.106657290201594
"10244","chr7.30200000.30205000","chr7.30595000.30600000",395000,13,1.655726e-05,30200000,30595000,30205000,30600000,"chr7",315232,0,4,5,9,"chr7",1,0.0137130801687764
"10245","chr7.44895000.44900000","chr7.44920000.44925000",25000,40,2.976563e-05,44895000,44920000,44900000,44925000,"chr7",315240,2,12,22,36,"chr7",1,0.168776371308017
"10246","chr7.4725000.4730000","chr7.4780000.4785000",55000,50,2.995233e-21,4725000,4780000,4730000,4785000,"chr7",315241,4,8,13,25,"chr7",1,0.146507266760431
"10247","chr7.35750000.35755000","chr7.35905000.35910000",155000,19,2.274079e-06,35750000,35905000,35755000,35910000,"chr7",315253,1,0,5,6,"chr7",1,0.0133614627285513
"10248","chr7.65955000.65960000","chr7.66140000.66145000",185000,13,0.002547834,65955000,66140000,65960000,66145000,"chr7",315279,0,8,2,10,"chr7",1,0.0152367557430849
"10249","chr7.36480000.36485000","chr7.37025000.37030000",545000,9,0.00211632,36480000,37025000,36485000,37030000,"chr7",315300,2,2,2,6,"chr7",1,0.00632911392405063
"10250","chr7.75530000.75535000","chr7.75625000.75630000",95000,17,0.001727891,75530000,75625000,75535000,75630000,"chr7",315318,5,17,11,33,"chr7",1,0.0657524613220816
"10251","chr7.7635000.7640000","chr7.7680000.7685000",45000,23,0.004836897,7635000,7680000,7640000,7685000,"chr7",315399,0,5,4,9,"chr7",1,0.0242616033755274
"10252","chr7.5405000.5410000","chr7.5475000.5480000",70000,18,0.007017412,5405000,5475000,5410000,5480000,"chr7",315453,3,5,13,21,"chr7",1,0.0443037974683544
"10253","chr7.5560000.5565000","chr7.5835000.5840000",275000,12,0.0007748615,5560000,5835000,5565000,5840000,"chr7",315468,5,17,26,48,"chr7",1,0.0675105485232067
"10254","chr7.92245000.92250000","chr7.92680000.92685000",435000,17,2.367139e-09,92245000,92680000,92250000,92685000,"chr7",315504,0,3,3,6,"chr7",1,0.0119549929676512
"10255","chr7.127290000.127295000","chr7.127705000.127710000",415000,10,0.001796917,127290000,127705000,127295000,127710000,"chr7",315506,0,0,1,1,"chr7",1,0.00117205813408345
"10256","chr7.116940000.116945000","chr7.117020000.117025000",80000,17,0.006379927,116940000,117020000,116945000,117025000,"chr7",315513,2,6,2,10,"chr7",1,0.0199249882794187
"10257","chr7.36525000.36530000","chr7.37225000.37230000",700000,16,9.407851e-11,36525000,37225000,36530000,37230000,"chr7",315514,0,3,2,5,"chr7",1,0.00937646507266761
"10258","chr7.22300000.22305000","chr7.22485000.22490000",185000,12,0.008260206,22300000,22485000,22305000,22490000,"chr7",315547,0,1,5,6,"chr7",1,0.00843881856540084
"10259","chr7.29320000.29325000","chr7.29350000.29355000",30000,35,5.18901e-05,29320000,29350000,29325000,29355000,"chr7",315613,0,8,5,13,"chr7",1,0.053328645100797
"10260","chr7.117375000.117380000","chr7.117725000.117730000",350000,10,0.003869126,117375000,117725000,117380000,117730000,"chr7",315616,2,3,4,9,"chr7",1,0.0105485232067511
"10261","chr7.95025000.95030000","chr7.95105000.95110000",80000,18,0.002398881,95025000,95105000,95030000,95110000,"chr7",315647,0,3,4,7,"chr7",1,0.0147679324894515
"10262","chr7.5870000.5875000","chr7.6480000.6485000",610000,8,0.005748931,5870000,6480000,5875000,6485000,"chr7",315654,6,18,12,36,"chr7",1,0.0337552742616034
"10263","chr7.130910000.130915000","chr7.131005000.131010000",95000,17,0.001727891,130910000,131005000,130915000,131010000,"chr7",315658,1,4,5,10,"chr7",1,0.0199249882794187
"10264","chr7.5590000.5595000","chr7.5665000.5670000",75000,18,0.004067044,5590000,5665000,5595000,5670000,"chr7",315722,2,5,11,18,"chr7",1,0.0379746835443038
"10265","chr7.129500000.129505000","chr7.129640000.129645000",140000,14,0.003981961,129500000,129640000,129505000,129645000,"chr7",315724,4,4,7,15,"chr7",1,0.0246132208157525
"10266","chr7.22355000.22360000","chr7.22485000.22490000",130000,15,0.001910926,22355000,22485000,22360000,22490000,"chr7",315748,0,0,6,6,"chr7",1,0.0105485232067511
"10267","chr7.4930000.4935000","chr7.5140000.5145000",210000,13,0.001122768,4930000,5140000,4935000,5145000,"chr7",315781,4,16,25,45,"chr7",1,0.0685654008438819
"10268","chr7.129365000.129370000","chr7.129655000.129660000",290000,11,0.002351004,129365000,129655000,129370000,129660000,"chr7",315826,0,7,4,11,"chr7",1,0.0141819034224098
"10269","chr7.158485000.158490000","chr7.158765000.158770000",280000,14,3.130827e-05,158485000,158765000,158490000,158770000,"chr7",315857,0,3,3,6,"chr7",1,0.00984528832630099
"10270","chr7.134455000.134460000","chr7.134615000.134620000",160000,13,0.005891496,134455000,134615000,134460000,134620000,"chr7",315873,3,2,4,9,"chr7",1,0.0137130801687764
"10271","chr7.75530000.75535000","chr7.75600000.75605000",70000,22,0.0001195867,75530000,75600000,75535000,75605000,"chr7",315884,8,24,19,51,"chr7",1,0.131504922644163
"10272","chr7.29330000.29335000","chr7.29375000.29380000",45000,23,0.004836897,29330000,29375000,29335000,29380000,"chr7",315915,0,11,6,17,"chr7",1,0.0458274730426629
"10273","chr7.4725000.4730000","chr7.4750000.4755000",25000,53,4.479915e-11,4725000,4750000,4730000,4755000,"chr7",316000,3,8,12,23,"chr7",1,0.142873886544773
"10274","chr7.116950000.116955000","chr7.116985000.116990000",35000,32,4.471954e-05,116950000,116985000,116955000,116990000,"chr7",316071,1,9,2,12,"chr7",1,0.0450070323488045
"10275","chr7.99075000.99080000","chr7.99625000.99630000",550000,10,0.0003785578,99075000,99625000,99080000,99630000,"chr7",316095,3,4,1,8,"chr7",1,0.00937646507266761
"10276","chr7.4895000.4900000","chr7.5190000.5195000",295000,11,0.002155437,4895000,5190000,4900000,5195000,"chr7",316131,0,12,11,23,"chr7",1,0.0296530707923113
"10277","chr7.74030000.74035000","chr7.74060000.74065000",30000,37,7.944158e-06,74030000,74060000,74035000,74065000,"chr7",316135,6,10,13,29,"chr7",1,0.125761837787154
"10278","chr7.36525000.36530000","chr7.36950000.36955000",425000,12,5.986465e-05,36525000,36950000,36530000,36955000,"chr7",316195,0,0,2,2,"chr7",1,0.00281293952180028
"10279","chr7.5590000.5595000","chr7.5675000.5680000",85000,20,0.000156116,5590000,5675000,5595000,5680000,"chr7",316216,2,5,3,10,"chr7",1,0.023441162681669
"10280","chr7.104770000.104775000","chr7.105060000.105065000",290000,12,0.000564117,104770000,105060000,104775000,105065000,"chr7",316232,0,1,2,3,"chr7",1,0.00421940928270042
"10281","chr7.106810000.106815000","chr7.107205000.107210000",395000,11,0.0004955699,106810000,107205000,106815000,107210000,"chr7",316244,0,1,0,1,"chr7",1,0.0012892639474918
"10282","chr7.5585000.5590000","chr7.5710000.5715000",125000,14,0.007055032,5585000,5710000,5590000,5715000,"chr7",316276,3,8,5,16,"chr7",1,0.0262541022034693
"10283","chr7.44630000.44635000","chr7.44865000.44870000",235000,15,2.614673e-05,44630000,44865000,44635000,44870000,"chr7",316369,3,3,10,16,"chr7",1,0.0281293952180028
"10284","chr7.141015000.141020000","chr7.141050000.141055000",35000,26,0.007017412,141015000,141050000,141020000,141055000,"chr7",316406,0,5,1,6,"chr7",1,0.0182841068917018
"10285","chr7.7525000.7530000","chr7.7565000.7570000",40000,26,0.001406709,7525000,7565000,7530000,7570000,"chr7",316408,0,2,0,2,"chr7",1,0.00609470229723394
"10286","chr7.30550000.30555000","chr7.30595000.30600000",45000,29,1.655606e-05,30550000,30595000,30555000,30600000,"chr7",316420,1,4,5,10,"chr7",1,0.0339896858884201
"10287","chr7.37270000.37275000","chr7.37310000.37315000",40000,25,0.003179814,37270000,37310000,37275000,37315000,"chr7",316424,0,4,2,6,"chr7",1,0.0175808720112518
"10288","chr7.51255000.51260000","chr7.51305000.51310000",50000,25,0.0002799273,51255000,51305000,51260000,51310000,"chr7",316428,0,3,1,4,"chr7",1,0.0117205813408345
"10289","chr7.5240000.5245000","chr7.5745000.5750000",505000,11,0.0001140788,5240000,5745000,5245000,5750000,"chr7",316460,5,13,14,32,"chr7",1,0.0412564463197375
"10290","chr7.111635000.111640000","chr7.111690000.111695000",55000,20,0.00985274,111635000,111690000,111640000,111695000,"chr7",316494,3,6,5,14,"chr7",1,0.0328176277543366
"10291","chr7.111855000.111860000","chr7.111915000.111920000",60000,20,0.004497771,111855000,111915000,111860000,111920000,"chr7",316496,0,0,4,4,"chr7",1,0.00937646507266761
"10292","chr7.70310000.70315000","chr7.71180000.71185000",870000,13,1.228859e-08,70310000,71180000,70315000,71185000,"chr7",316521,2,13,9,24,"chr7",1,0.0365682137834037
"10293","chr7.100075000.100080000","chr7.100270000.100275000",195000,17,5.909629e-06,100075000,100270000,100080000,100275000,"chr7",316579,1,16,9,26,"chr7",1,0.0518049695264885
"10294","chr7.111760000.111765000","chr7.112050000.112055000",290000,12,0.000564117,111760000,112050000,111765000,112055000,"chr7",316592,1,1,6,8,"chr7",1,0.0112517580872011
"10295","chr7.4685000.4690000","chr7.4795000.4800000",110000,17,0.0005541852,4685000,4795000,4690000,4800000,"chr7",316606,4,13,13,30,"chr7",1,0.059774964838256
"10296","chr7.129295000.129300000","chr7.129640000.129645000",345000,12,0.0002079679,129295000,129640000,129300000,129645000,"chr7",316616,4,3,8,15,"chr7",1,0.0210970464135021
"10297","chr7.2790000.2795000","chr7.2875000.2880000",85000,19,0.0004960118,2790000,2875000,2795000,2880000,"chr7",316617,4,10,13,27,"chr7",1,0.060126582278481
"10298","chr7.69930000.69935000","chr7.69985000.69990000",55000,23,0.0006714546,69930000,69985000,69935000,69990000,"chr7",316633,1,2,2,5,"chr7",1,0.0134786685419597
"10299","chr7.100490000.100495000","chr7.100725000.100730000",235000,14,0.0001215023,100490000,100725000,100495000,100730000,"chr7",316665,10,19,22,51,"chr7",1,0.0836849507735584
"10300","chr7.35730000.35735000","chr7.36365000.36370000",635000,8,0.004695034,35730000,36365000,35735000,36370000,"chr7",316686,1,3,1,5,"chr7",1,0.0046882325363338
"10301","chr7.44675000.44680000","chr7.44885000.44890000",210000,12,0.004067044,44675000,44885000,44680000,44890000,"chr7",316712,0,7,3,10,"chr7",1,0.0140646976090014
"10302","chr7.129500000.129505000","chr7.129655000.129660000",155000,13,0.007017412,129500000,129655000,129505000,129660000,"chr7",316766,4,11,7,22,"chr7",1,0.0335208626347867
"10303","chr7.2590000.2595000","chr7.2705000.2710000",115000,17,0.000396453,2590000,2705000,2595000,2710000,"chr7",316840,2,8,5,15,"chr7",1,0.029887482419128
"10304","chr7.129875000.129880000","chr7.130420000.130425000",545000,10,0.0004013527,129875000,130420000,129880000,130425000,"chr7",316843,0,0,3,3,"chr7",1,0.00351617440225035
"10305","chr7.105690000.105695000","chr7.105805000.105810000",115000,25,3.198589e-09,105690000,105805000,105695000,105810000,"chr7",316910,2,0,0,2,"chr7",1,0.00586029067041725
"10306","chr7.77755000.77760000","chr7.77905000.77910000",150000,14,0.002691352,77755000,77905000,77760000,77910000,"chr7",316948,4,8,19,31,"chr7",1,0.0508673230192218
"10307","chr7.111690000.111695000","chr7.111760000.111765000",70000,20,0.0010221,111690000,111760000,111695000,111765000,"chr7",317053,3,6,5,14,"chr7",1,0.0328176277543366
"10308","chr7.98655000.98660000","chr7.98750000.98755000",95000,24,2.004984e-07,98655000,98750000,98660000,98755000,"chr7",317080,2,11,4,17,"chr7",1,0.0478199718706048
"10309","chr7.21505000.21510000","chr7.21915000.21920000",410000,9,0.007900409,21505000,21915000,21510000,21920000,"chr7",317085,3,5,4,12,"chr7",1,0.0126582278481013
"10310","chr7.5570000.5575000","chr7.5675000.5680000",105000,15,0.006911981,5570000,5675000,5575000,5680000,"chr7",317125,2,8,3,13,"chr7",1,0.0228551336146273
"10311","chr7.5230000.5235000","chr7.5470000.5475000",240000,13,0.0004566544,5230000,5470000,5235000,5475000,"chr7",317134,3,8,6,17,"chr7",1,0.0259024847632443
"10312","chr7.48085000.48090000","chr7.48115000.48120000",30000,35,5.18901e-05,48085000,48115000,48090000,48120000,"chr7",317202,1,11,4,16,"chr7",1,0.0656352555086732
"10313","chr7.43905000.43910000","chr7.43940000.43945000",35000,31,0.0001140788,43905000,43940000,43910000,43945000,"chr7",317238,5,8,5,18,"chr7",1,0.0654008438818565
"10314","chr7.105320000.105325000","chr7.105760000.105765000",440000,9,0.005891115,105320000,105760000,105325000,105765000,"chr7",317296,0,4,2,6,"chr7",1,0.00632911392405063
"10315","chr7.128040000.128045000","chr7.128100000.128105000",60000,20,0.004497771,128040000,128100000,128045000,128105000,"chr7",317315,3,2,2,7,"chr7",1,0.0164088138771683
"10316","chr7.5530000.5535000","chr7.5565000.5570000",35000,32,4.471954e-05,5530000,5565000,5535000,5570000,"chr7",317326,4,3,2,9,"chr7",1,0.0337552742616034
"10317","chr7.29145000.29150000","chr7.29405000.29410000",260000,11,0.004209802,29145000,29405000,29150000,29410000,"chr7",317360,0,1,0,1,"chr7",1,0.0012892639474918
"10318","chr7.5560000.5565000","chr7.5590000.5595000",30000,46,4.096609e-10,5560000,5590000,5565000,5595000,"chr7",317518,2,5,15,22,"chr7",1,0.118612283169245
"10319","chr7.105400000.105405000","chr7.105645000.105650000",245000,16,3.463435e-06,105400000,105645000,105405000,105650000,"chr7",317578,5,24,20,49,"chr7",1,0.0918893577121425
"10320","chr7.102930000.102935000","chr7.102990000.102995000",60000,25,2.766458e-05,102930000,102990000,102935000,102995000,"chr7",317631,2,0,0,2,"chr7",1,0.00586029067041725
"10321","chr7.65955000.65960000","chr7.66200000.66205000",245000,13,0.0003919399,65955000,66200000,65960000,66205000,"chr7",317655,0,9,2,11,"chr7",1,0.0167604313173933
"10322","chr7.78135000.78140000","chr7.78785000.78790000",650000,9,0.0007806216,78135000,78785000,78140000,78790000,"chr7",317699,0,0,2,2,"chr7",1,0.00210970464135021
"10323","chr7.73735000.73740000","chr7.73790000.73795000",55000,21,0.004210319,73735000,73790000,73740000,73795000,"chr7",317714,3,10,16,29,"chr7",1,0.0713783403656821
"10324","chr7.815000.820000","chr7.910000.915000",95000,31,1.963949e-12,815000,910000,820000,915000,"chr7",317732,5,24,21,50,"chr7",1,0.181669010782935
"10325","chr7.134590000.134595000","chr7.134615000.134620000",25000,41,1.236245e-05,134590000,134615000,134595000,134620000,"chr7",317794,1,2,4,7,"chr7",1,0.033638068448195
"10326","chr7.123670000.123675000","chr7.124365000.124370000",695000,8,0.00301312,123670000,124365000,123675000,124370000,"chr7",317795,0,3,2,5,"chr7",1,0.0046882325363338
"10327","chr7.36510000.36515000","chr7.37235000.37240000",725000,11,7.827047e-06,36510000,37235000,36515000,37240000,"chr7",317849,1,1,2,4,"chr7",1,0.00515705578996718
"10328","chr7.6235000.6240000","chr7.6345000.6350000",110000,16,0.001756896,6235000,6345000,6240000,6350000,"chr7",317861,3,9,11,23,"chr7",1,0.043131739334271
"10329","chr7.5635000.5640000","chr7.5745000.5750000",110000,22,6.643433e-07,5635000,5745000,5640000,5750000,"chr7",317899,5,17,21,43,"chr7",1,0.110876699484294
"10330","chr7.104760000.104765000","chr7.105010000.105015000",250000,11,0.00523021,104760000,105010000,104765000,105015000,"chr7",317902,0,1,2,3,"chr7",1,0.00386779184247539
"10331","chr7.111635000.111640000","chr7.111740000.111745000",105000,22,1.117547e-06,111635000,111740000,111640000,111745000,"chr7",317905,3,5,8,16,"chr7",1,0.0412564463197375
"10332","chr7.73705000.73710000","chr7.73725000.73730000",20000,37,0.002176787,73705000,73725000,73710000,73730000,"chr7",317915,4,18,19,41,"chr7",1,0.177801218940459
"10333","chr7.148275000.148280000","chr7.148575000.148580000",300000,14,1.866688e-05,148275000,148575000,148280000,148580000,"chr7",317955,0,0,3,3,"chr7",1,0.00492264416315049
"10334","chr7.92250000.92255000","chr7.92690000.92695000",440000,17,2.091009e-09,92250000,92690000,92255000,92695000,"chr7",317956,2,4,2,8,"chr7",1,0.0159399906235349
"10335","chr7.105810000.105815000","chr7.106055000.106060000",245000,11,0.005861433,105810000,106055000,105815000,106060000,"chr7",318043,4,4,6,14,"chr7",1,0.0180496952648851
"10336","chr7.107815000.107820000","chr7.108075000.108080000",260000,12,0.001104282,107815000,108075000,107820000,108080000,"chr7",318155,1,7,5,13,"chr7",1,0.0182841068917018
"10337","chr7.35750000.35755000","chr7.35800000.35805000",50000,23,0.001817981,35750000,35800000,35755000,35805000,"chr7",318212,1,0,5,6,"chr7",1,0.0161744022503516
"10338","chr7.104805000.104810000","chr7.104915000.104920000",110000,20,1.167951e-05,104805000,104915000,104810000,104920000,"chr7",318220,0,2,0,2,"chr7",1,0.0046882325363338
"10339","chr7.24665000.24670000","chr7.24700000.24705000",35000,26,0.007017412,24665000,24700000,24670000,24705000,"chr7",318243,2,3,1,6,"chr7",1,0.0182841068917018
"10340","chr7.101280000.101285000","chr7.101880000.101885000",600000,9,0.001254159,101280000,101880000,101285000,101885000,"chr7",318291,4,7,5,16,"chr7",1,0.0168776371308017
"10341","chr7.73865000.73870000","chr7.74090000.74095000",225000,11,0.009286263,73865000,74090000,73870000,74095000,"chr7",318301,0,5,2,7,"chr7",1,0.00902484763244257
"10342","chr7.28470000.28475000","chr7.28645000.28650000",175000,13,0.00355792,28470000,28645000,28475000,28650000,"chr7",318327,4,5,2,11,"chr7",1,0.0167604313173933
"10343","chr7.36190000.36195000","chr7.36315000.36320000",125000,14,0.007055032,36190000,36315000,36195000,36320000,"chr7",318334,3,0,2,5,"chr7",1,0.00820440693858415
"10344","chr7.139340000.139345000","chr7.139430000.139435000",90000,28,8.813527e-10,139340000,139430000,139345000,139435000,"chr7",318363,3,10,7,20,"chr7",1,0.0656352555086732
"10345","chr7.8120000.8125000","chr7.8170000.8175000",50000,21,0.009838551,8120000,8170000,8125000,8175000,"chr7",318421,0,1,2,3,"chr7",1,0.00738396624472574
"10346","chr7.72805000.72810000","chr7.72825000.72830000",20000,37,0.002176787,72805000,72825000,72810000,72830000,"chr7",318423,4,8,6,18,"chr7",1,0.0780590717299578
"10347","chr7.75960000.75965000","chr7.76005000.76010000",45000,25,0.0008633957,75960000,76005000,75965000,76010000,"chr7",318427,7,10,18,35,"chr7",1,0.102555086732302
"10348","chr7.104805000.104810000","chr7.104900000.104905000",95000,21,1.380867e-05,104805000,104900000,104810000,104905000,"chr7",318518,0,2,0,2,"chr7",1,0.00492264416315049
"10349","chr7.139130000.139135000","chr7.139290000.139295000",160000,14,0.001832506,139130000,139290000,139135000,139295000,"chr7",318538,0,3,1,4,"chr7",1,0.00656352555086732
"10350","chr7.71505000.71510000","chr7.71545000.71550000",40000,25,0.003179814,71505000,71545000,71510000,71550000,"chr7",318599,4,8,6,18,"chr7",1,0.0527426160337553
"10351","chr7.65955000.65960000","chr7.66455000.66460000",500000,14,3.77589e-07,65955000,66455000,65960000,66460000,"chr7",318606,0,9,2,11,"chr7",1,0.0180496952648851
"10352","chr7.28470000.28475000","chr7.28515000.28520000",45000,23,0.004836897,28470000,28515000,28475000,28520000,"chr7",318611,3,1,2,6,"chr7",1,0.0161744022503516
"10353","chr7.134440000.134445000","chr7.134605000.134610000",165000,14,0.00152594,134440000,134605000,134445000,134610000,"chr7",318684,3,2,3,8,"chr7",1,0.0131270511017346
"10354","chr7.44625000.44630000","chr7.44795000.44800000",170000,16,8.870301e-05,44625000,44795000,44630000,44800000,"chr7",318712,3,10,8,21,"chr7",1,0.0393811533052039
"10355","chr7.25430000.25435000","chr7.25885000.25890000",455000,15,1.103721e-07,25430000,25885000,25435000,25890000,"chr7",318759,0,2,0,2,"chr7",1,0.00351617440225035
"10356","chr7.75960000.75965000","chr7.75990000.75995000",30000,31,0.001458307,75960000,75990000,75965000,75995000,"chr7",318771,4,10,2,16,"chr7",1,0.0581340834505391
"10357","chr7.44895000.44900000","chr7.45150000.45155000",255000,11,0.004686834,44895000,45150000,44900000,45155000,"chr7",318833,3,6,3,12,"chr7",1,0.0154711673699015
"10358","chr7.22150000.22155000","chr7.22295000.22300000",145000,41,2.176849e-25,22150000,22295000,22155000,22300000,"chr7",318856,0,3,1,4,"chr7",1,0.0192217533989686
"10359","chr7.128860000.128865000","chr7.129110000.129115000",250000,18,7.876852e-08,128860000,129110000,128865000,129115000,"chr7",318875,7,9,11,27,"chr7",1,0.0569620253164557
"10360","chr7.75530000.75535000","chr7.75620000.75625000",90000,16,0.00705063,75530000,75620000,75535000,75625000,"chr7",318904,8,24,21,53,"chr7",1,0.0993905297702766
"10361","chr7.106925000.106930000","chr7.106975000.106980000",50000,21,0.009838551,106925000,106975000,106930000,106980000,"chr7",318929,3,6,16,25,"chr7",1,0.0615330520393812
"10362","chr7.22385000.22390000","chr7.22485000.22490000",100000,20,3.013356e-05,22385000,22485000,22390000,22490000,"chr7",318979,0,3,0,3,"chr7",1,0.0070323488045007
"10363","chr7.5630000.5635000","chr7.5675000.5680000",45000,28,4.765123e-05,5630000,5675000,5635000,5680000,"chr7",319018,2,8,3,13,"chr7",1,0.0426629160806376
"10364","chr7.75960000.75965000","chr7.76020000.76025000",60000,20,0.004497771,75960000,76020000,75965000,76025000,"chr7",319034,7,10,18,35,"chr7",1,0.0820440693858415
"10365","chr7.22885000.22890000","chr7.23055000.23060000",170000,18,4.517794e-06,22885000,23055000,22890000,23060000,"chr7",319038,1,7,3,11,"chr7",1,0.0232067510548523
"10366","chr7.73620000.73625000","chr7.73705000.73710000",85000,18,0.001463786,73620000,73705000,73625000,73710000,"chr7",319077,4,18,19,41,"chr7",1,0.0864978902953586
"10367","chr7.139520000.139525000","chr7.139600000.139605000",80000,18,0.002398881,139520000,139600000,139525000,139605000,"chr7",319080,1,16,18,35,"chr7",1,0.0738396624472574
"10368","chr7.37025000.37030000","chr7.37190000.37195000",165000,14,0.00152594,37025000,37190000,37030000,37195000,"chr7",319115,1,2,4,7,"chr7",1,0.0114861697140178
"10369","chr7.66030000.66035000","chr7.66345000.66350000",315000,11,0.00152594,66030000,66345000,66035000,66350000,"chr7",319123,0,4,7,11,"chr7",1,0.0141819034224098
"10370","chr7.104805000.104810000","chr7.104880000.104885000",75000,35,2.197234e-13,104805000,104880000,104810000,104885000,"chr7",319124,0,2,0,2,"chr7",1,0.00820440693858415
"10371","chr7.75955000.75960000","chr7.76020000.76025000",65000,19,0.005289393,75955000,76020000,75960000,76025000,"chr7",319195,11,17,20,48,"chr7",1,0.106891701828411
"10372","chr7.22425000.22430000","chr7.22450000.22455000",25000,37,0.0003455231,22425000,22450000,22430000,22455000,"chr7",319219,0,4,0,4,"chr7",1,0.0173464603844351
"10373","chr7.80135000.80140000","chr7.80185000.80190000",50000,24,0.0007217265,80135000,80185000,80140000,80190000,"chr7",319257,0,1,0,1,"chr7",1,0.00281293952180028
"10374","chr7.129315000.129320000","chr7.129500000.129505000",185000,12,0.008260206,129315000,129500000,129320000,129505000,"chr7",319270,4,10,7,21,"chr7",1,0.029535864978903
"10375","chr7.51255000.51260000","chr7.51430000.51435000",175000,16,6.95567e-05,51255000,51430000,51260000,51435000,"chr7",319296,0,3,1,4,"chr7",1,0.00750117205813408
"10376","chr7.111635000.111640000","chr7.111835000.111840000",200000,21,4.286752e-09,111635000,111835000,111640000,111840000,"chr7",319322,0,2,0,2,"chr7",1,0.00492264416315049
"10377","chr7.134420000.134425000","chr7.134645000.134650000",225000,17,1.437635e-06,134420000,134645000,134425000,134650000,"chr7",319352,1,9,1,11,"chr7",1,0.0219174871073605
"10378","chr7.74480000.74485000","chr7.75055000.75060000",575000,9,0.001578051,74480000,75055000,74485000,75060000,"chr7",319381,12,19,19,50,"chr7",1,0.0527426160337553
"10379","chr7.22220000.22225000","chr7.22300000.22305000",80000,21,8.910063e-05,22220000,22300000,22225000,22305000,"chr7",319403,0,1,1,2,"chr7",1,0.00492264416315049
"10380","chr7.97925000.97930000","chr7.98430000.98435000",505000,10,0.0006314139,97925000,98430000,97930000,98435000,"chr7",319412,2,3,2,7,"chr7",1,0.00820440693858415
"10381","chr7.5405000.5410000","chr7.5450000.5455000",45000,23,0.004836897,5405000,5450000,5410000,5455000,"chr7",319422,12,34,17,63,"chr7",1,0.169831223628692
"10382","chr7.150985000.150990000","chr7.151715000.151720000",730000,8,0.002303324,150985000,151715000,150990000,151720000,"chr7",319524,1,6,1,8,"chr7",1,0.00750117205813408
"10383","chr7.75955000.75960000","chr7.75990000.75995000",35000,26,0.007017412,75955000,75990000,75960000,75995000,"chr7",319531,4,10,2,16,"chr7",1,0.0487576183778715
"10384","chr7.6170000.6175000","chr7.6400000.6405000",230000,12,0.002350543,6170000,6400000,6175000,6405000,"chr7",319545,7,17,9,33,"chr7",1,0.0464135021097046
"10385","chr7.100490000.100495000","chr7.100705000.100710000",215000,15,5.497622e-05,100490000,100705000,100495000,100710000,"chr7",319560,12,19,32,63,"chr7",1,0.110759493670886
"10386","chr7.28000000.28005000","chr7.28020000.28025000",20000,49,1.006661e-07,2.8e+07,28020000,28005000,28025000,"chr7",319590,3,4,7,14,"chr7",1,0.0804031879981247
"10387","chr7.41980000.41985000","chr7.42280000.42285000",300000,10,0.007511413,41980000,42280000,41985000,42285000,"chr7",319593,0,1,0,1,"chr7",1,0.00117205813408345
"10388","chr7.1610000.1615000","chr7.2230000.2235000",620000,9,0.001037727,1610000,2230000,1615000,2235000,"chr7",319709,4,5,9,18,"chr7",1,0.0189873417721519
"10389","chr7.101360000.101365000","chr7.101680000.101685000",320000,10,0.005683939,101360000,101680000,101365000,101685000,"chr7",319745,6,15,13,34,"chr7",1,0.0398499765588373
"10390","chr7.22150000.22155000","chr7.22300000.22305000",150000,27,2.45445e-12,22150000,22300000,22155000,22305000,"chr7",319752,0,1,5,6,"chr7",1,0.0189873417721519
"10391","chr7.75530000.75535000","chr7.75595000.75600000",65000,19,0.005289393,75530000,75595000,75535000,75600000,"chr7",319822,4,13,14,31,"chr7",1,0.0690342240975152
"10392","chr7.104845000.104850000","chr7.104900000.104905000",55000,24,0.0002524413,104845000,104900000,104850000,104905000,"chr7",319880,1,6,7,14,"chr7",1,0.0393811533052039
"10393","chr7.105300000.105305000","chr7.105690000.105695000",390000,9,0.009783085,105300000,105690000,105305000,105695000,"chr7",319943,0,6,6,12,"chr7",1,0.0126582278481013
"10394","chr7.154715000.154720000","chr7.154785000.154790000",70000,21,0.0003571728,154715000,154785000,154720000,154790000,"chr7",319955,0,3,0,3,"chr7",1,0.00738396624472574
"10395","chr7.112150000.112155000","chr7.112530000.112535000",380000,10,0.00268837,112150000,112530000,112155000,112535000,"chr7",319979,1,1,2,4,"chr7",1,0.0046882325363338
"10396","chr7.101245000.101250000","chr7.101900000.101905000",655000,8,0.004067044,101245000,101900000,101250000,101905000,"chr7",320022,9,21,15,45,"chr7",1,0.0421940928270042
"10397","chr7.75925000.75930000","chr7.75990000.75995000",65000,21,0.0007779944,75925000,75990000,75930000,75995000,"chr7",320030,4,10,2,16,"chr7",1,0.0393811533052039
"10398","chr7.154715000.154720000","chr7.154780000.154785000",65000,23,9.289351e-05,154715000,154780000,154720000,154785000,"chr7",320064,0,2,1,3,"chr7",1,0.00808720112517581
"10399","chr7.128395000.128400000","chr7.128425000.128430000",30000,32,0.0006635666,128395000,128425000,128400000,128430000,"chr7",320098,3,6,7,16,"chr7",1,0.0600093764650727
"10400","chr7.5590000.5595000","chr7.5755000.5760000",165000,14,0.00152594,5590000,5755000,5595000,5760000,"chr7",320158,2,5,5,12,"chr7",1,0.019690576652602
"10401","chr7.90675000.90680000","chr7.91230000.91235000",555000,8,0.008864356,90675000,91230000,90680000,91235000,"chr7",320189,1,0,1,2,"chr7",1,0.00187529301453352
"10402","chr7.111525000.111530000","chr7.111760000.111765000",235000,14,0.0001215023,111525000,111760000,111530000,111765000,"chr7",320192,1,0,0,1,"chr7",1,0.00164088138771683
"10403","chr7.99110000.99115000","chr7.99140000.99145000",30000,30,0.00305535,99110000,99140000,99115000,99145000,"chr7",320197,0,1,2,3,"chr7",1,0.0105485232067511
"10404","chr7.73855000.73860000","chr7.74080000.74085000",225000,12,0.002682194,73855000,74080000,73860000,74085000,"chr7",320289,5,19,11,35,"chr7",1,0.0492264416315049
"10405","chr7.101680000.101685000","chr7.101780000.101785000",100000,15,0.009373683,101680000,101780000,101685000,101785000,"chr7",320308,6,15,13,34,"chr7",1,0.059774964838256
"10406","chr7.154765000.154770000","chr7.154785000.154790000",20000,43,2.429754e-05,154765000,154785000,154770000,154790000,"chr7",320335,0,3,0,3,"chr7",1,0.0151195499296765
"10407","chr7.44640000.44645000","chr7.45070000.45075000",430000,9,0.006533851,44640000,45070000,44645000,45075000,"chr7",320336,2,5,3,10,"chr7",1,0.0105485232067511
"10408","chr7.74045000.74050000","chr7.74080000.74085000",35000,27,0.003347901,74045000,74080000,74050000,74085000,"chr7",320403,2,4,4,10,"chr7",1,0.0316455696202532
"10409","chr7.130070000.130075000","chr7.130355000.130360000",285000,10,0.009627553,130070000,130355000,130075000,130360000,"chr7",320428,1,10,7,18,"chr7",1,0.0210970464135021
"10410","chr7.6320000.6325000","chr7.6345000.6350000",25000,42,5.023057e-06,6320000,6345000,6325000,6350000,"chr7",320469,8,18,18,44,"chr7",1,0.216596343178622
"10411","chr7.129315000.129320000","chr7.129640000.129645000",325000,12,0.0002879098,129315000,129640000,129320000,129645000,"chr7",320517,4,4,7,15,"chr7",1,0.0210970464135021
"10412","chr7.129295000.129300000","chr7.129470000.129475000",175000,14,0.001038591,129295000,129470000,129300000,129475000,"chr7",320531,5,3,8,16,"chr7",1,0.0262541022034693
"10413","chr7.130865000.130870000","chr7.131090000.131095000",225000,12,0.002682194,130865000,131090000,130870000,131095000,"chr7",320546,4,4,4,12,"chr7",1,0.0168776371308017
"10414","chr7.120430000.120435000","chr7.120740000.120745000",310000,11,0.001665673,120430000,120740000,120435000,120745000,"chr7",320548,0,2,1,3,"chr7",1,0.00386779184247539
"10415","chr7.128865000.128870000","chr7.129270000.129275000",405000,13,1.395013e-05,128865000,129270000,128870000,129275000,"chr7",320558,0,2,1,3,"chr7",1,0.00457102672292546
"10416","chr7.6370000.6375000","chr7.6480000.6485000",110000,16,0.001756896,6370000,6480000,6375000,6485000,"chr7",320603,6,18,12,36,"chr7",1,0.0675105485232067
"10417","chr7.117380000.117385000","chr7.117735000.117740000",355000,11,0.0008343956,117380000,117735000,117385000,117740000,"chr7",320609,3,3,2,8,"chr7",1,0.0103141115799344
"10418","chr7.134350000.134355000","chr7.134590000.134595000",240000,11,0.006533851,134350000,134590000,134355000,134595000,"chr7",320621,1,8,11,20,"chr7",1,0.0257852789498359
"10419","chr7.95105000.95110000","chr7.95305000.95310000",200000,12,0.005344264,95105000,95305000,95110000,95310000,"chr7",320656,1,4,1,6,"chr7",1,0.00843881856540084
"10420","chr7.22190000.22195000","chr7.22290000.22295000",100000,35,3.742335e-16,22190000,22290000,22195000,22295000,"chr7",320687,0,0,2,2,"chr7",1,0.00820440693858415
"10421","chr7.78135000.78140000","chr7.78395000.78400000",260000,18,5.102921e-08,78135000,78395000,78140000,78400000,"chr7",320701,0,0,1,1,"chr7",1,0.00210970464135021
"10422","chr7.5590000.5595000","chr7.5745000.5750000",155000,27,1.516713e-12,5590000,5745000,5595000,5750000,"chr7",320749,2,5,15,22,"chr7",1,0.069620253164557
"10423","chr7.137590000.137595000","chr7.137655000.137660000",65000,25,9.002226e-06,137590000,137655000,137595000,137660000,"chr7",320798,0,3,2,5,"chr7",1,0.0146507266760431
"10424","chr7.129640000.129645000","chr7.129660000.129665000",20000,43,2.429754e-05,129640000,129660000,129645000,129665000,"chr7",320803,3,4,8,15,"chr7",1,0.0755977496483826
"10425","chr7.16640000.16645000","chr7.16960000.16965000",320000,13,6.386341e-05,16640000,16960000,16645000,16965000,"chr7",320837,1,10,9,20,"chr7",1,0.0304735114861697
"10426","chr7.100535000.100540000","chr7.100610000.100615000",75000,19,0.001517752,100535000,100610000,100540000,100615000,"chr7",320892,15,27,35,77,"chr7",1,0.171472105016409
"10427","chr7.6170000.6175000","chr7.6235000.6240000",65000,19,0.005289393,6170000,6235000,6175000,6240000,"chr7",320952,3,9,11,23,"chr7",1,0.0512189404594468
"10428","chr7.67630000.67635000","chr7.67650000.67655000",20000,43,2.429754e-05,67630000,67650000,67635000,67655000,"chr7",320956,5,11,5,21,"chr7",1,0.105836849507736
"10429","chr7.4735000.4740000","chr7.4780000.4785000",45000,28,4.765123e-05,4735000,4780000,4740000,4785000,"chr7",320991,1,5,7,13,"chr7",1,0.0426629160806376
"10430","chr7.30430000.30435000","chr7.30555000.30560000",125000,17,0.000220791,30430000,30555000,30435000,30560000,"chr7",321096,1,4,2,7,"chr7",1,0.0139474917955931
"10431","chr7.127980000.127985000","chr7.128020000.128025000",40000,25,0.003179814,127980000,128020000,127985000,128025000,"chr7",321103,0,0,1,1,"chr7",1,0.00293014533520863
"10432","chr7.65955000.65960000","chr7.66110000.66115000",155000,13,0.007017412,65955000,66110000,65960000,66115000,"chr7",321116,0,9,2,11,"chr7",1,0.0167604313173933
"10433","chr7.22295000.22300000","chr7.22485000.22490000",190000,13,0.002161851,22295000,22485000,22300000,22490000,"chr7",321149,0,4,1,5,"chr7",1,0.00761837787154243
"10434","chr7.78130000.78135000","chr7.78415000.78420000",285000,14,2.762074e-05,78130000,78415000,78135000,78420000,"chr7",321159,1,2,1,4,"chr7",1,0.00656352555086732
"10435","chr7.5470000.5475000","chr7.5525000.5530000",55000,20,0.00985274,5470000,5525000,5475000,5530000,"chr7",321200,3,12,15,30,"chr7",1,0.070323488045007
"10436","chr7.67645000.67650000","chr7.67875000.67880000",230000,14,0.0001438093,67645000,67875000,67650000,67880000,"chr7",321372,2,2,5,9,"chr7",1,0.0147679324894515
"10437","chr7.131025000.131030000","chr7.131090000.131095000",65000,20,0.002113865,131025000,131090000,131030000,131095000,"chr7",321431,4,6,2,12,"chr7",1,0.0281293952180028
"10438","chr7.39620000.39625000","chr7.39765000.39770000",145000,20,9.002112e-07,39620000,39765000,39625000,39770000,"chr7",321439,1,1,2,4,"chr7",1,0.00937646507266761
"10439","chr7.104495000.104500000","chr7.104515000.104520000",20000,36,0.004179201,104495000,104515000,104500000,104520000,"chr7",321485,0,7,6,13,"chr7",1,0.0548523206751055
"10440","chr7.1610000.1615000","chr7.2450000.2455000",840000,7,0.005977381,1610000,2450000,1615000,2455000,"chr7",321544,5,15,12,32,"chr7",1,0.0262541022034693
"10441","chr7.140580000.140585000","chr7.140605000.140610000",25000,49,4.292255e-09,140580000,140605000,140585000,140610000,"chr7",321545,5,8,5,18,"chr7",1,0.10337552742616
"10442","chr7.77755000.77760000","chr7.78420000.78425000",665000,8,0.003766774,77755000,78420000,77760000,78425000,"chr7",321576,1,1,2,4,"chr7",1,0.00375058602906704
"10443","chr7.117150000.117155000","chr7.117735000.117740000",585000,8,0.007017412,117150000,117735000,117155000,117740000,"chr7",321587,0,2,1,3,"chr7",1,0.00281293952180028
"10444","chr7.51245000.51250000","chr7.51315000.51320000",70000,21,0.0003571728,51245000,51315000,51250000,51320000,"chr7",321663,0,2,3,5,"chr7",1,0.0123066104078762
"10445","chr7.130910000.130915000","chr7.131090000.131095000",180000,15,0.0002309465,130910000,131090000,130915000,131095000,"chr7",321684,4,6,4,14,"chr7",1,0.0246132208157525
"10446","chr7.140200000.140205000","chr7.140330000.140335000",130000,14,0.005856061,140200000,140330000,140205000,140335000,"chr7",321728,4,7,5,16,"chr7",1,0.0262541022034693
"10447","chr7.127390000.127395000","chr7.127650000.127655000",260000,11,0.004209802,127390000,127650000,127395000,127655000,"chr7",321743,1,3,5,9,"chr7",1,0.0116033755274262
"10448","chr7.48060000.48065000","chr7.48115000.48120000",55000,21,0.004210319,48060000,48115000,48065000,48120000,"chr7",321746,3,13,4,20,"chr7",1,0.0492264416315049
"10449","chr7.830000.835000","chr7.910000.915000",80000,19,0.0008424217,830000,910000,835000,915000,"chr7",321908,3,5,4,12,"chr7",1,0.0267229254571027
"10450","chr7.105320000.105325000","chr7.105690000.105695000",370000,10,0.003041796,105320000,105690000,105325000,105695000,"chr7",321911,3,7,6,16,"chr7",1,0.0187529301453352
"10451","chr7.56075000.56080000","chr7.56120000.56125000",45000,23,0.004836897,56075000,56120000,56080000,56125000,"chr7",321915,2,12,7,21,"chr7",1,0.0566104078762307
"10452","chr7.22860000.22865000","chr7.23055000.23060000",195000,15,0.0001215023,22860000,23055000,22865000,23060000,"chr7",321923,1,7,3,11,"chr7",1,0.0193389592123769
"10453","chr7.140175000.140180000","chr7.140395000.140400000",220000,12,0.00306361,140175000,140395000,140180000,140400000,"chr7",321944,3,9,8,20,"chr7",1,0.0281293952180028
"10454","chr7.100835000.100840000","chr7.101775000.101780000",940000,7,0.003120978,100835000,101775000,100840000,101780000,"chr7",322047,11,26,30,67,"chr7",1,0.0549695264885138
"10455","chr7.5600000.5605000","chr7.5695000.5700000",95000,20,5.091508e-05,5600000,5695000,5605000,5700000,"chr7",322081,4,6,4,14,"chr7",1,0.0328176277543366
"10456","chr7.5210000.5215000","chr7.5505000.5510000",295000,10,0.008140023,5210000,5505000,5215000,5510000,"chr7",322213,2,6,5,13,"chr7",1,0.0152367557430849
"10457","chr7.101185000.101190000","chr7.101915000.101920000",730000,13,8.69451e-08,101185000,101915000,101190000,101920000,"chr7",322364,4,8,5,17,"chr7",1,0.0259024847632443
"10458","chr7.128865000.128870000","chr7.129110000.129115000",245000,11,0.005861433,128865000,129110000,128870000,129115000,"chr7",322417,3,2,1,6,"chr7",1,0.00773558368495077
"10459","chr7.36510000.36515000","chr7.36985000.36990000",475000,9,0.004179201,36510000,36985000,36515000,36990000,"chr7",322430,1,1,2,4,"chr7",1,0.00421940928270042
"10460","chr7.44630000.44635000","chr7.44895000.44900000",265000,15,9.340192e-06,44630000,44895000,44635000,44900000,"chr7",322482,4,3,10,17,"chr7",1,0.029887482419128
"10461","chr7.105400000.105405000","chr7.105650000.105655000",250000,16,2.87347e-06,105400000,105650000,105405000,105655000,"chr7",322506,1,6,3,10,"chr7",1,0.0187529301453352
"10462","chr7.111770000.111775000","chr7.111840000.111845000",70000,23,3.745658e-05,111770000,111840000,111775000,111845000,"chr7",322534,1,4,2,7,"chr7",1,0.0188701359587436
"10463","chr7.44920000.44925000","chr7.45025000.45030000",105000,16,0.002398881,44920000,45025000,44925000,45030000,"chr7",322628,0,6,3,9,"chr7",1,0.0168776371308017
"10464","chr7.111855000.111860000","chr7.112045000.112050000",190000,12,0.007093495,111855000,112045000,111860000,112050000,"chr7",322641,2,0,5,7,"chr7",1,0.00984528832630099
"10465","chr7.65445000.65450000","chr7.65955000.65960000",510000,14,3.129452e-07,65445000,65955000,65450000,65960000,"chr7",322657,0,8,2,10,"chr7",1,0.0164088138771683
"10466","chr7.36530000.36535000","chr7.37235000.37240000",705000,8,0.00276956,36530000,37235000,36535000,37240000,"chr7",322670,0,4,2,6,"chr7",1,0.00562587904360056
"10467","chr7.56075000.56080000","chr7.56115000.56120000",40000,46,4.230723e-14,56075000,56115000,56080000,56120000,"chr7",322695,3,24,19,46,"chr7",1,0.248007501172058
"10468","chr7.30200000.30205000","chr7.30500000.30505000",300000,14,1.866688e-05,30200000,30500000,30205000,30505000,"chr7",322791,0,3,2,5,"chr7",1,0.00820440693858415
"10469","chr7.7680000.7685000","chr7.8160000.8165000",480000,10,0.0008335694,7680000,8160000,7685000,8165000,"chr7",322843,0,5,4,9,"chr7",1,0.0105485232067511
"10470","chr7.66030000.66035000","chr7.66455000.66460000",425000,10,0.001586599,66030000,66455000,66035000,66460000,"chr7",322858,3,4,11,18,"chr7",1,0.0210970464135021
"10471","chr7.5530000.5535000","chr7.5710000.5715000",180000,27,1.406202e-13,5530000,5710000,5535000,5715000,"chr7",322902,3,3,2,8,"chr7",1,0.0253164556962025
"10472","chr7.111635000.111640000","chr7.112050000.112055000",415000,9,0.007511413,111635000,112050000,111640000,112055000,"chr7",323004,1,1,6,8,"chr7",1,0.00843881856540084
"10473","chr7.111760000.111765000","chr7.111840000.111845000",80000,25,5.041684e-07,111760000,111840000,111765000,111845000,"chr7",323008,1,4,2,7,"chr7",1,0.0205110173464604
"10474","chr7.117375000.117380000","chr7.117830000.117835000",455000,11,0.0002232537,117375000,117830000,117380000,117835000,"chr7",323018,0,3,4,7,"chr7",1,0.00902484763244257
"10475","chr7.37025000.37030000","chr7.37225000.37230000",200000,12,0.005344264,37025000,37225000,37030000,37230000,"chr7",323051,0,2,2,4,"chr7",1,0.00562587904360056
"10476","chr7.35760000.35765000","chr7.35835000.35840000",75000,24,4.553127e-06,35760000,35835000,35765000,35840000,"chr7",323068,3,4,4,11,"chr7",1,0.0309423347398031
"10477","chr7.35760000.35765000","chr7.35800000.35805000",40000,26,0.001406709,35760000,35800000,35765000,35805000,"chr7",323157,1,4,5,10,"chr7",1,0.0304735114861697
"10478","chr7.154165000.154170000","chr7.154200000.154205000",35000,29,0.0006655918,154165000,154200000,154170000,154205000,"chr7",323173,0,2,2,4,"chr7",1,0.013595874355368
"10479","chr7.5395000.5400000","chr7.5470000.5475000",75000,18,0.004067044,5395000,5470000,5400000,5475000,"chr7",323176,3,13,15,31,"chr7",1,0.0654008438818565
"10480","chr8.37885000.37890000","chr8.38580000.38585000",695000,8,0.003446703,37885000,38580000,37890000,38585000,"chr8",323187,3,3,13,19,"chr8",1,0.0178152836380684
"10481","chr8.38715000.38720000","chr8.38795000.38800000",80000,26,1.238901e-07,38715000,38795000,38720000,38800000,"chr8",323242,3,6,6,15,"chr8",1,0.0457102672292546
"10482","chr8.70160000.70165000","chr8.70180000.70185000",20000,59,2.841758e-12,70160000,70180000,70165000,70185000,"chr8",323455,0,2,1,3,"chr8",1,0.0207454289732771
"10483","chr8.80620000.80625000","chr8.80655000.80660000",35000,31,0.0001409273,80620000,80655000,80625000,80660000,"chr8",323572,2,0,0,2,"chr8",1,0.00726676043131739
"10484","chr8.21780000.21785000","chr8.21810000.21815000",30000,35,6.505451e-05,21780000,21810000,21785000,21815000,"chr8",323671,2,2,1,5,"chr8",1,0.0205110173464604
"10485","chr8.124485000.124490000","chr8.124525000.124530000",40000,29,0.0001110205,124485000,124525000,124490000,124530000,"chr8",323714,0,4,3,7,"chr8",1,0.023792780121894
"10486","chr8.98005000.98010000","chr8.98030000.98035000",25000,36,0.000948401,98005000,98030000,98010000,98035000,"chr8",323717,2,5,1,8,"chr8",1,0.0337552742616034
"10487","chr8.25305000.25310000","chr8.26140000.26145000",835000,7,0.007551142,25305000,26140000,25310000,26145000,"chr8",323766,5,13,4,22,"chr8",1,0.0180496952648851
"10488","chr8.124560000.124565000","chr8.124690000.124695000",130000,17,0.000171528,124560000,124690000,124565000,124695000,"chr8",323812,2,7,1,10,"chr8",1,0.0199249882794187
"10489","chr8.124590000.124595000","chr8.124615000.124620000",25000,35,0.001946928,124590000,124615000,124595000,124620000,"chr8",323863,0,2,2,4,"chr8",1,0.0164088138771683
"10490","chr8.18740000.18745000","chr8.19680000.19685000",940000,7,0.004376887,18740000,19680000,18745000,19685000,"chr8",323882,0,2,1,3,"chr8",1,0.00246132208157525
"10491","chr8.103355000.103360000","chr8.103415000.103420000",60000,21,0.002098409,103355000,103415000,103360000,103420000,"chr8",323894,2,2,4,8,"chr8",1,0.019690576652602
"10492","chr8.42270000.42275000","chr8.42410000.42415000",140000,21,2.530948e-07,42270000,42410000,42275000,42415000,"chr8",323919,3,12,15,30,"chr8",1,0.0738396624472574
"10493","chr8.108915000.108920000","chr8.109260000.109265000",345000,10,0.004397365,108915000,109260000,108920000,109265000,"chr8",323940,1,2,2,5,"chr8",1,0.00586029067041725
"10494","chr8.13145000.13150000","chr8.13510000.13515000",365000,13,2.856749e-05,13145000,13510000,13150000,13515000,"chr8",323972,0,4,0,4,"chr8",1,0.00609470229723394
"10495","chr8.1670000.1675000","chr8.1985000.1990000",315000,10,0.006512791,1670000,1985000,1675000,1990000,"chr8",324050,6,5,9,20,"chr8",1,0.023441162681669
"10496","chr8.140420000.140425000","chr8.141385000.141390000",965000,10,8.249968e-06,140420000,141385000,140425000,141390000,"chr8",324056,3,0,2,5,"chr8",1,0.00586029067041725
"10497","chr8.80580000.80585000","chr8.81000000.81005000",420000,13,1.10998e-05,80580000,8.1e+07,80585000,81005000,"chr8",324065,0,3,1,4,"chr8",1,0.00609470229723394
"10498","chr8.124560000.124565000","chr8.124705000.124710000",145000,14,0.003548891,124560000,124705000,124565000,124710000,"chr8",324096,4,13,10,27,"chr8",1,0.0443037974683544
"10499","chr8.53655000.53660000","chr8.53850000.53855000",195000,15,0.0001336725,53655000,53850000,53660000,53855000,"chr8",324128,2,5,4,11,"chr8",1,0.0193389592123769
"10500","chr8.1670000.1675000","chr8.1990000.1995000",320000,10,0.006050586,1670000,1990000,1675000,1995000,"chr8",324244,1,1,2,4,"chr8",1,0.0046882325363338
"10501","chr8.101855000.101860000","chr8.102235000.102240000",380000,14,3.480851e-06,101855000,102235000,101860000,102240000,"chr8",324322,0,2,1,3,"chr8",1,0.00492264416315049
"10502","chr8.124795000.124800000","chr8.124815000.124820000",20000,46,2.565783e-06,124795000,124815000,124800000,124820000,"chr8",324330,0,3,5,8,"chr8",1,0.043131739334271
"10503","chr8.38135000.38140000","chr8.38570000.38575000",435000,10,0.001532803,38135000,38570000,38140000,38575000,"chr8",324379,2,4,9,15,"chr8",1,0.0175808720112518
"10504","chr8.29230000.29235000","chr8.29515000.29520000",285000,11,0.002832626,29230000,29515000,29235000,29520000,"chr8",324383,2,6,8,16,"chr8",1,0.0206282231598687
"10505","chr8.12950000.12955000","chr8.13220000.13225000",270000,13,0.0002175303,12950000,13220000,12955000,13225000,"chr8",324413,1,4,4,9,"chr8",1,0.0137130801687764
"10506","chr8.124520000.124525000","chr8.124775000.124780000",255000,12,0.001379201,124520000,124775000,124525000,124780000,"chr8",324422,2,9,9,20,"chr8",1,0.0281293952180028
"10507","chr8.27490000.27495000","chr8.27580000.27585000",90000,32,8.685985e-13,27490000,27580000,27495000,27585000,"chr8",324428,1,1,1,3,"chr8",1,0.0112517580872011
"10508","chr8.28475000.28480000","chr8.28590000.28595000",115000,45,3.380509e-27,28475000,28590000,28480000,28595000,"chr8",324452,5,2,2,9,"chr8",1,0.0474683544303797
"10509","chr8.97820000.97825000","chr8.97865000.97870000",45000,29,2.003529e-05,97820000,97865000,97825000,97870000,"chr8",324456,2,12,6,20,"chr8",1,0.0679793717768401
"10510","chr8.17550000.17555000","chr8.17575000.17580000",25000,38,0.0002053774,17550000,17575000,17555000,17580000,"chr8",324490,1,7,2,10,"chr8",1,0.0445382090951711
"10511","chr8.28465000.28470000","chr8.28605000.28610000",140000,15,0.001341749,28465000,28605000,28470000,28610000,"chr8",324502,3,12,10,25,"chr8",1,0.0439521800281294
"10512","chr8.22095000.22100000","chr8.22415000.22420000",320000,12,0.0003398084,22095000,22415000,22100000,22420000,"chr8",324558,4,9,5,18,"chr8",1,0.0253164556962025
"10513","chr8.30545000.30550000","chr8.30915000.30920000",370000,12,0.0001464336,30545000,30915000,30550000,30920000,"chr8",324564,0,1,5,6,"chr8",1,0.00843881856540084
"10514","chr8.18805000.18810000","chr8.18865000.18870000",60000,20,0.005204593,18805000,18865000,18810000,18870000,"chr8",324579,0,2,0,2,"chr8",1,0.0046882325363338
"10515","chr8.27490000.27495000","chr8.27595000.27600000",105000,33,5.808891e-15,27490000,27595000,27495000,27600000,"chr8",324607,1,2,3,6,"chr8",1,0.0232067510548523
"10516","chr8.25240000.25245000","chr8.25295000.25300000",55000,21,0.005023343,25240000,25295000,25245000,25300000,"chr8",324621,1,3,6,10,"chr8",1,0.0246132208157525
"10517","chr8.26205000.26210000","chr8.26230000.26235000",25000,34,0.003868347,26205000,26230000,26210000,26235000,"chr8",324642,3,8,7,18,"chr8",1,0.0717299578059072
"10518","chr8.1850000.1855000","chr8.1970000.1975000",120000,15,0.003256621,1850000,1970000,1855000,1975000,"chr8",324713,3,3,3,9,"chr8",1,0.0158227848101266
"10519","chr8.17600000.17605000","chr8.17615000.17620000",15000,40,0.0003708657,17600000,17615000,17605000,17620000,"chr8",324783,5,4,7,16,"chr8",1,0.0750117205813408
"10520","chr8.25250000.25255000","chr8.25295000.25300000",45000,34,5.555191e-08,25250000,25295000,25255000,25300000,"chr8",324824,4,12,13,29,"chr8",1,0.115564932020628
"10521","chr8.124485000.124490000","chr8.124770000.124775000",285000,24,4.319002e-14,124485000,124770000,124490000,124775000,"chr8",324853,0,2,3,5,"chr8",1,0.0140646976090014
"10522","chr8.17600000.17605000","chr8.17695000.17700000",95000,19,0.0001839667,17600000,17695000,17605000,17700000,"chr8",324871,0,2,1,3,"chr8",1,0.00668073136427567
"10523","chr8.124835000.124840000","chr8.125425000.125430000",590000,8,0.007313498,124835000,125425000,124840000,125430000,"chr8",324873,0,7,6,13,"chr8",1,0.0121894045944679
"10524","chr8.108915000.108920000","chr8.109595000.109600000",680000,8,0.00382848,108915000,109595000,108920000,109600000,"chr8",324889,1,0,0,1,"chr8",1,0.00093764650726676
"10525","chr8.38135000.38140000","chr8.38230000.38235000",95000,28,3.400068e-10,38135000,38230000,38140000,38235000,"chr8",325018,6,21,15,42,"chr8",1,0.137834036568214
"10526","chr8.17600000.17605000","chr8.17720000.17725000",120000,18,8.390931e-05,17600000,17720000,17605000,17725000,"chr8",325088,3,7,3,13,"chr8",1,0.0274261603375527
"10527","chr8.61340000.61345000","chr8.61420000.61425000",80000,24,2.067575e-06,61340000,61420000,61345000,61425000,"chr8",325187,0,1,2,3,"chr8",1,0.00843881856540084
"10528","chr8.29215000.29220000","chr8.29905000.29910000",690000,10,9.780943e-05,29215000,29905000,29220000,29910000,"chr8",325326,0,4,1,5,"chr8",1,0.00586029067041725
"10529","chr8.61430000.61435000","chr8.61465000.61470000",35000,27,0.004065245,61430000,61465000,61435000,61470000,"chr8",325380,0,6,1,7,"chr8",1,0.0221518987341772
"10530","chr8.28375000.28380000","chr8.28465000.28470000",90000,19,0.0003122206,28375000,28465000,28380000,28470000,"chr8",325470,11,18,23,52,"chr8",1,0.115799343647445
"10531","chr8.80400000.80405000","chr8.80420000.80425000",20000,38,0.001546564,80400000,80420000,80405000,80425000,"chr8",325471,6,16,14,36,"chr8",1,0.160337552742616
"10532","chr8.108825000.108830000","chr8.109645000.109650000",820000,8,0.001520955,108825000,109645000,108830000,109650000,"chr8",325481,2,3,5,10,"chr8",1,0.00937646507266761
"10533","chr8.10825000.10830000","chr8.10840000.10845000",15000,36,0.005560214,10825000,10840000,10830000,10845000,"chr8",325611,2,1,2,5,"chr8",1,0.0210970464135021
"10534","chr8.140700000.140705000","chr8.141400000.141405000",700000,8,0.00331722,140700000,141400000,140705000,141405000,"chr8",325673,0,3,1,4,"chr8",1,0.00375058602906704
"10535","chr8.20120000.20125000","chr8.20225000.20230000",105000,18,0.0002546712,20120000,20225000,20125000,20230000,"chr8",325781,2,5,2,9,"chr8",1,0.0189873417721519
"10536","chr8.104785000.104790000","chr8.105140000.105145000",355000,16,1.220096e-07,104785000,105140000,104790000,105145000,"chr8",325826,0,1,1,2,"chr8",1,0.00375058602906704
"10537","chr8.26185000.26190000","chr8.26205000.26210000",20000,39,0.0007725467,26185000,26205000,26190000,26210000,"chr8",325828,0,5,4,9,"chr8",1,0.0411392405063291
"10538","chr8.124520000.124525000","chr8.124690000.124695000",170000,21,3.155887e-08,124520000,124690000,124525000,124695000,"chr8",325867,2,7,1,10,"chr8",1,0.0246132208157525
"10539","chr8.26465000.26470000","chr8.26485000.26490000",20000,43,3.468506e-05,26465000,26485000,26470000,26490000,"chr8",325916,3,6,5,14,"chr8",1,0.0705578996718237
"10540","chr8.66555000.66560000","chr8.66745000.66750000",190000,13,0.002383096,66555000,66745000,66560000,66750000,"chr8",325932,13,20,29,62,"chr8",1,0.0944678856071261
"10541","chr8.124520000.124525000","chr8.124695000.124700000",175000,16,7.517903e-05,124520000,124695000,124525000,124700000,"chr8",325954,0,13,7,20,"chr8",1,0.0375058602906704
"10542","chr8.28505000.28510000","chr8.28590000.28595000",85000,24,9.042234e-07,28505000,28590000,28510000,28595000,"chr8",325956,5,2,4,11,"chr8",1,0.0309423347398031
"10543","chr8.42270000.42275000","chr8.42460000.42465000",190000,12,0.007757695,42270000,42460000,42275000,42465000,"chr8",325976,2,2,13,17,"chr8",1,0.0239099859353024
"10544","chr8.17605000.17610000","chr8.17715000.17720000",110000,16,0.001861363,17605000,17715000,17610000,17720000,"chr8",326011,2,4,6,12,"chr8",1,0.0225035161744023
"10545","chr8.19850000.19855000","chr8.19870000.19875000",20000,37,0.002977958,19850000,19870000,19855000,19875000,"chr8",326047,2,1,2,5,"chr8",1,0.0216830754805438
"10546","chr8.56940000.56945000","chr8.56970000.56975000",30000,30,0.003792046,56940000,56970000,56945000,56975000,"chr8",326074,0,0,2,2,"chr8",1,0.0070323488045007
"10547","chr8.27310000.27315000","chr8.27445000.27450000",135000,14,0.005166807,27310000,27445000,27315000,27450000,"chr8",326084,3,7,12,22,"chr8",1,0.0360993905297703
"10548","chr8.53690000.53695000","chr8.53840000.53845000",150000,14,0.002931625,53690000,53840000,53695000,53845000,"chr8",326111,0,4,1,5,"chr8",1,0.00820440693858415
"10549","chr8.124485000.124490000","chr8.124705000.124710000",220000,21,1.246525e-09,124485000,124705000,124490000,124710000,"chr8",326116,1,8,3,12,"chr8",1,0.029535864978903
"10550","chr8.124775000.124780000","chr8.125385000.125390000",610000,13,5.169379e-07,124775000,125385000,124780000,125390000,"chr8",326119,3,8,6,17,"chr8",1,0.0259024847632443
"10551","chr8.108065000.108070000","chr8.108470000.108475000",405000,9,0.008842232,108065000,108470000,108070000,108475000,"chr8",326135,0,5,3,8,"chr8",1,0.00843881856540084
"10552","chr8.70160000.70165000","chr8.70465000.70470000",305000,11,0.001959135,70160000,70465000,70165000,70470000,"chr8",326165,0,2,1,3,"chr8",1,0.00386779184247539
"10553","chr8.25035000.25040000","chr8.25195000.25200000",160000,13,0.006353932,25035000,25195000,25040000,25200000,"chr8",326266,5,23,25,53,"chr8",1,0.0807548054383497
"10554","chr8.101855000.101860000","chr8.102340000.102345000",485000,9,0.004065245,101855000,102340000,101860000,102345000,"chr8",326354,1,4,1,6,"chr8",1,0.00632911392405063
"10555","chr8.1670000.1675000","chr8.1975000.1980000",305000,13,9.338814e-05,1670000,1975000,1675000,1980000,"chr8",326397,0,4,1,5,"chr8",1,0.00761837787154243
"10556","chr8.124485000.124490000","chr8.124775000.124780000",290000,20,2.568792e-10,124485000,124775000,124490000,124780000,"chr8",326418,1,8,3,12,"chr8",1,0.0281293952180028
"10557","chr8.38720000.38725000","chr8.38755000.38760000",35000,30,0.0003488113,38720000,38755000,38725000,38760000,"chr8",326494,2,4,5,11,"chr8",1,0.0386779184247539
"10558","chr8.17575000.17580000","chr8.17755000.17760000",180000,28,1.561193e-14,17575000,17755000,17580000,17760000,"chr8",326507,1,9,7,17,"chr8",1,0.0557899671823722
"10559","chr8.10840000.10845000","chr8.10960000.10965000",120000,15,0.003256621,10840000,10960000,10845000,10965000,"chr8",326512,1,1,2,4,"chr8",1,0.0070323488045007
"10560","chr8.90885000.90890000","chr8.90940000.90945000",55000,22,0.002044662,90885000,90940000,90890000,90945000,"chr8",326578,6,3,4,13,"chr8",1,0.0335208626347867
"10561","chr8.25035000.25040000","chr8.25250000.25255000",215000,15,6.00047e-05,25035000,25250000,25040000,25255000,"chr8",326623,4,12,13,29,"chr8",1,0.0509845288326301
"10562","chr8.25060000.25065000","chr8.25300000.25305000",240000,11,0.007162658,25060000,25300000,25065000,25305000,"chr8",326762,2,0,0,2,"chr8",1,0.00257852789498359
"10563","chr8.23325000.23330000","chr8.23440000.23445000",115000,18,0.0001180431,23325000,23440000,23330000,23445000,"chr8",326806,0,4,1,5,"chr8",1,0.0105485232067511
"10564","chr8.29200000.29205000","chr8.29875000.29880000",675000,20,3.835953e-15,29200000,29875000,29205000,29880000,"chr8",326807,1,7,16,24,"chr8",1,0.0562587904360056
"10565","chr8.42270000.42275000","chr8.42500000.42505000",230000,11,0.008893114,42270000,42500000,42275000,42505000,"chr8",326920,3,1,5,9,"chr8",1,0.0116033755274262
"10566","chr8.38720000.38725000","chr8.38770000.38775000",50000,27,4.219437e-05,38720000,38770000,38725000,38775000,"chr8",326957,3,13,13,29,"chr8",1,0.0917721518987342
"10567","chr8.26230000.26235000","chr8.26510000.26515000",280000,15,6.150581e-06,26230000,26510000,26235000,26515000,"chr8",326966,2,5,1,8,"chr8",1,0.0140646976090014
"10568","chr8.13025000.13030000","chr8.13040000.13045000",15000,36,0.005560214,13025000,13040000,13030000,13045000,"chr8",326978,2,3,3,8,"chr8",1,0.0337552742616034
"10569","chr8.28465000.28470000","chr8.28590000.28595000",125000,29,6.499862e-13,28465000,28590000,28470000,28595000,"chr8",326982,8,18,23,49,"chr8",1,0.166549460853258
"10570","chr8.38715000.38720000","chr8.38805000.38810000",90000,27,4.222824e-09,38715000,38805000,38720000,38810000,"chr8",327001,3,4,4,11,"chr8",1,0.0348101265822785
"10571","chr8.18680000.18685000","chr8.18740000.18745000",60000,23,0.0002936694,18680000,18740000,18685000,18745000,"chr8",327075,2,2,1,5,"chr8",1,0.0134786685419597
"10572","chr8.20195000.20200000","chr8.20225000.20230000",30000,32,0.0008310805,20195000,20225000,20200000,20230000,"chr8",327124,0,5,2,7,"chr8",1,0.0262541022034693
"10573","chr8.102655000.102660000","chr8.103180000.103185000",525000,9,0.002767496,102655000,103180000,102660000,103185000,"chr8",327144,0,0,4,4,"chr8",1,0.00421940928270042
"10574","chr8.124520000.124525000","chr8.124770000.124775000",250000,11,0.005682952,124520000,124770000,124525000,124775000,"chr8",327177,0,2,3,5,"chr8",1,0.00644631973745898
"10575","chr8.9930000.9935000","chr8.10170000.10175000",240000,14,0.0001133584,9930000,10170000,9935000,10175000,"chr8",327181,1,9,6,16,"chr8",1,0.0262541022034693
"10576","chr8.10960000.10965000","chr8.11005000.11010000",45000,24,0.002548628,10960000,11005000,10965000,11010000,"chr8",327192,1,4,5,10,"chr8",1,0.0281293952180028
"10577","chr8.12950000.12955000","chr8.13130000.13135000",180000,19,5.169379e-07,12950000,13130000,12955000,13135000,"chr8",327268,2,2,6,10,"chr8",1,0.0222691045475856
"10578","chr8.119905000.119910000","chr8.119925000.119930000",20000,40,0.0003708657,119905000,119925000,119910000,119930000,"chr8",327298,0,12,6,18,"chr8",1,0.0843881856540084
"10579","chr8.38150000.38155000","chr8.38175000.38180000",25000,37,0.0004493397,38150000,38175000,38155000,38180000,"chr8",327310,4,8,12,24,"chr8",1,0.10407876230661
"10580","chr8.125230000.125235000","chr8.125385000.125390000",155000,14,0.002418698,125230000,125385000,125235000,125390000,"chr8",327373,1,3,3,7,"chr8",1,0.0114861697140178
"10581","chr8.80615000.80620000","chr8.81125000.81130000",510000,10,0.0006436861,80615000,81125000,80620000,81130000,"chr8",327379,0,0,3,3,"chr8",1,0.00351617440225035
"10582","chr8.22140000.22145000","chr8.22215000.22220000",75000,20,0.0005920886,22140000,22215000,22145000,22220000,"chr8",327382,0,8,4,12,"chr8",1,0.0281293952180028
"10583","chr8.81705000.81710000","chr8.82360000.82365000",655000,8,0.004520571,81705000,82360000,81710000,82365000,"chr8",327403,0,3,1,4,"chr8",1,0.00375058602906704
"10584","chr8.48120000.48125000","chr8.48915000.48920000",795000,7,0.009373252,48120000,48915000,48125000,48920000,"chr8",327439,1,3,2,6,"chr8",1,0.00492264416315049
"10585","chr8.124560000.124565000","chr8.124695000.124700000",135000,21,3.653953e-07,124560000,124695000,124565000,124700000,"chr8",327460,0,13,7,20,"chr8",1,0.0492264416315049
"10586","chr8.66745000.66750000","chr8.67025000.67030000",280000,13,0.000168585,66745000,67025000,66750000,67030000,"chr8",327470,7,14,11,32,"chr8",1,0.0487576183778715
"10587","chr8.124830000.124835000","chr8.125330000.125335000",500000,9,0.003529875,124830000,125330000,124835000,125335000,"chr8",327474,0,3,2,5,"chr8",1,0.00527426160337553
"10588","chr8.27330000.27335000","chr8.27595000.27600000",265000,13,0.0002492325,27330000,27595000,27335000,27600000,"chr8",327505,2,2,3,7,"chr8",1,0.0106657290201594
"10589","chr8.25180000.25185000","chr8.25250000.25255000",70000,23,4.155545e-05,25180000,25250000,25185000,25255000,"chr8",327601,4,12,13,29,"chr8",1,0.0781762775433661
"10590","chr8.9260000.9265000","chr8.9400000.9405000",140000,14,0.004244205,9260000,9400000,9265000,9405000,"chr8",327607,0,2,4,6,"chr8",1,0.00984528832630099
"10591","chr8.17650000.17655000","chr8.17740000.17745000",90000,16,0.007551142,17650000,17740000,17655000,17745000,"chr8",327624,3,15,25,43,"chr8",1,0.0806375996249414
"10592","chr8.8665000.8670000","chr8.8775000.8780000",110000,16,0.001861363,8665000,8775000,8670000,8780000,"chr8",327691,3,16,18,37,"chr8",1,0.0693858415377403
"10593","chr8.117825000.117830000","chr8.117845000.117850000",20000,41,0.000171528,117825000,117845000,117830000,117850000,"chr8",327722,3,7,4,14,"chr8",1,0.0672761368963901
"10594","chr8.29000000.29005000","chr8.29125000.29130000",125000,17,0.0002288739,2.9e+07,29125000,29005000,29130000,"chr8",327818,0,1,2,3,"chr8",1,0.0059774964838256
"10595","chr8.124440000.124445000","chr8.124485000.124490000",45000,25,0.001057157,124440000,124485000,124445000,124490000,"chr8",327972,1,8,3,12,"chr8",1,0.0351617440225035
"10596","chr8.17575000.17580000","chr8.17615000.17620000",40000,39,1.050923e-09,17575000,17615000,17580000,17620000,"chr8",328027,1,4,7,12,"chr8",1,0.0548523206751055
"10597","chr8.41830000.41835000","chr8.42015000.42020000",185000,17,1.030555e-05,41830000,42015000,41835000,42020000,"chr8",328059,0,4,1,5,"chr8",1,0.00996249413970933
"10598","chr8.108065000.108070000","chr8.108785000.108790000",720000,9,0.0004974059,108065000,108785000,108070000,108790000,"chr8",328205,0,1,1,2,"chr8",1,0.00210970464135021
"10599","chr8.42750000.42755000","chr8.42900000.42905000",150000,17,6.05453e-05,42750000,42900000,42755000,42905000,"chr8",328237,4,4,14,22,"chr8",1,0.0438349742147211
"10600","chr8.112460000.112465000","chr8.112800000.112805000",340000,12,0.0002390087,112460000,112800000,112465000,112805000,"chr8",328275,0,3,1,4,"chr8",1,0.00562587904360056
"10601","chr8.81000000.81005000","chr8.81125000.81130000",125000,18,6.050691e-05,8.1e+07,81125000,81005000,81130000,"chr8",328404,0,0,1,1,"chr8",1,0.00210970464135021
"10602","chr8.19755000.19760000","chr8.19870000.19875000",115000,15,0.00418209,19755000,19870000,19760000,19875000,"chr8",328422,0,1,1,2,"chr8",1,0.00351617440225035
"10603","chr8.102340000.102345000","chr8.103180000.103185000",840000,7,0.007435089,102340000,103180000,102345000,103185000,"chr8",328528,0,0,4,4,"chr8",1,0.00328176277543366
"10604","chr8.13050000.13055000","chr8.13080000.13085000",30000,34,0.0001589027,13050000,13080000,13055000,13085000,"chr8",328540,2,6,6,14,"chr8",1,0.0557899671823722
"10605","chr8.27485000.27490000","chr8.27610000.27615000",125000,20,3.487465e-06,27485000,27610000,27490000,27615000,"chr8",328541,0,3,2,5,"chr8",1,0.0117205813408345
"10606","chr8.17130000.17135000","chr8.17755000.17760000",625000,8,0.00557973,17130000,17755000,17135000,17760000,"chr8",328567,0,3,6,9,"chr8",1,0.00843881856540084
"10607","chr8.124475000.124480000","chr8.124705000.124710000",230000,23,1.119507e-11,124475000,124705000,124480000,124710000,"chr8",328580,0,14,10,24,"chr8",1,0.0646976090014065
"10608","chr8.97820000.97825000","chr8.98000000.98005000",180000,13,0.003315004,97820000,9.8e+07,97825000,98005000,"chr8",328696,2,12,8,22,"chr8",1,0.0335208626347867
"10609","chr8.29215000.29220000","chr8.29875000.29880000",660000,9,0.0008194416,29215000,29875000,29220000,29880000,"chr8",328701,1,7,8,16,"chr8",1,0.0168776371308017
"10610","chr8.29195000.29200000","chr8.29875000.29880000",680000,34,3.867663e-34,29195000,29875000,29200000,29880000,"chr8",328707,0,3,3,6,"chr8",1,0.0239099859353024
"10611","chr8.26230000.26235000","chr8.26290000.26295000",60000,24,9.923413e-05,26230000,26290000,26235000,26295000,"chr8",328720,2,2,0,4,"chr8",1,0.0112517580872011
"10612","chr8.65630000.65635000","chr8.66435000.66440000",805000,7,0.008871209,65630000,66435000,65635000,66440000,"chr8",328757,1,2,3,6,"chr8",1,0.00492264416315049
"10613","chr8.41845000.41850000","chr8.41995000.42000000",150000,42,6.477982e-27,41845000,41995000,41850000,4.2e+07,"chr8",328800,1,4,0,5,"chr8",1,0.0246132208157525
"10614","chr8.42410000.42415000","chr8.42500000.42505000",90000,18,0.0009598362,42410000,42500000,42415000,42505000,"chr8",328811,3,1,5,9,"chr8",1,0.0189873417721519
"10615","chr8.38715000.38720000","chr8.38765000.38770000",50000,31,3.987231e-07,38715000,38765000,38720000,38770000,"chr8",328834,2,0,0,2,"chr8",1,0.00726676043131739
"10616","chr8.65735000.65740000","chr8.66560000.66565000",825000,9,0.0002205031,65735000,66560000,65740000,66565000,"chr8",329036,0,4,2,6,"chr8",1,0.00632911392405063
"10617","chr8.140700000.140705000","chr8.141130000.141135000",430000,12,5.800416e-05,140700000,141130000,140705000,141135000,"chr8",329040,2,14,14,30,"chr8",1,0.0421940928270042
"10618","chr8.54770000.54775000","chr8.54880000.54885000",110000,15,0.005436739,54770000,54880000,54775000,54885000,"chr8",329054,0,3,1,4,"chr8",1,0.0070323488045007
"10619","chr8.38105000.38110000","chr8.38565000.38570000",460000,10,0.001130593,38105000,38565000,38110000,38570000,"chr8",329065,1,16,8,25,"chr8",1,0.0293014533520863
"10620","chr8.28490000.28495000","chr8.28510000.28515000",20000,47,1.000497e-06,28490000,28510000,28495000,28515000,"chr8",329201,0,10,8,18,"chr8",1,0.0991561181434599
"10621","chr8.42270000.42275000","chr8.42515000.42520000",245000,14,9.623219e-05,42270000,42515000,42275000,42520000,"chr8",329260,5,14,18,37,"chr8",1,0.0607126113455227
"10622","chr8.25240000.25245000","chr8.25300000.25305000",60000,21,0.002098409,25240000,25300000,25245000,25305000,"chr8",329368,1,3,6,10,"chr8",1,0.0246132208157525
"10623","chr8.30575000.30580000","chr8.30665000.30670000",90000,19,0.0003122206,30575000,30665000,30580000,30670000,"chr8",329400,0,3,1,4,"chr8",1,0.00890764181903422
"10624","chr8.38135000.38140000","chr8.38175000.38180000",40000,33,1.632782e-06,38135000,38175000,38140000,38180000,"chr8",329417,4,8,12,24,"chr8",1,0.0928270042194093
"10625","chr8.101575000.101580000","chr8.102285000.102290000",710000,8,0.003096666,101575000,102285000,101580000,102290000,"chr8",329450,1,2,1,4,"chr8",1,0.00375058602906704
"10626","chr8.102250000.102255000","chr8.102270000.102275000",20000,44,1.505194e-05,102250000,102270000,102255000,102275000,"chr8",329555,0,2,1,3,"chr8",1,0.0154711673699015
"10627","chr8.28380000.28385000","chr8.28410000.28415000",30000,29,0.007511147,28380000,28410000,28385000,28415000,"chr8",329611,4,10,9,23,"chr8",1,0.0781762775433661
"10628","chr8.12990000.12995000","chr8.13130000.13135000",140000,18,2.540841e-05,12990000,13130000,12995000,13135000,"chr8",329654,2,2,4,8,"chr8",1,0.0168776371308017
"10629","chr8.28360000.28365000","chr8.28425000.28430000",65000,24,3.378206e-05,28360000,28425000,28365000,28430000,"chr8",329726,2,15,10,27,"chr8",1,0.0759493670886076
"10630","chr8.42750000.42755000","chr8.42895000.42900000",145000,17,7.894059e-05,42750000,42895000,42755000,42900000,"chr8",329738,2,2,9,13,"chr8",1,0.0259024847632443
"10631","chr8.108915000.108920000","chr8.109060000.109065000",145000,14,0.003548891,108915000,109060000,108920000,109065000,"chr8",329766,1,4,1,6,"chr8",1,0.00984528832630099
"10632","chr8.9185000.9190000","chr8.9615000.9620000",430000,9,0.006945504,9185000,9615000,9190000,9620000,"chr8",329772,1,5,5,11,"chr8",1,0.0116033755274262
"10633","chr8.27245000.27250000","chr8.27270000.27275000",25000,35,0.001946928,27245000,27270000,27250000,27275000,"chr8",329792,0,2,2,4,"chr8",1,0.0164088138771683
"10634","chr8.28710000.28715000","chr8.29000000.29005000",290000,12,0.0006170445,28710000,2.9e+07,28715000,29005000,"chr8",329814,0,1,2,3,"chr8",1,0.00421940928270042
"10635","chr8.27330000.27335000","chr8.27445000.27450000",115000,20,7.679902e-06,27330000,27445000,27335000,27450000,"chr8",329881,6,8,7,21,"chr8",1,0.0492264416315049
"10636","chr8.103370000.103375000","chr8.103405000.103410000",35000,26,0.00833505,103370000,103405000,103375000,103410000,"chr8",329889,0,6,4,10,"chr8",1,0.0304735114861697
"10637","chr8.13080000.13085000","chr8.13115000.13120000",35000,29,0.0008245461,13080000,13115000,13085000,13120000,"chr8",329916,4,10,6,20,"chr8",1,0.0679793717768401
"10638","chr8.124535000.124540000","chr8.124695000.124700000",160000,17,3.63081e-05,124535000,124695000,124540000,124700000,"chr8",329947,0,0,1,1,"chr8",1,0.00199249882794187
"10639","chr8.86375000.86380000","chr8.87030000.87035000",655000,8,0.004520571,86375000,87030000,86380000,87035000,"chr8",330023,1,3,2,6,"chr8",1,0.00562587904360056
"10640","chr8.42500000.42505000","chr8.42900000.42905000",400000,9,0.009298624,42500000,42900000,42505000,42905000,"chr8",330036,3,1,5,9,"chr8",1,0.00949367088607595
"10641","chr8.38265000.38270000","chr8.38570000.38575000",305000,50,1.694911e-46,38265000,38570000,38270000,38575000,"chr8",330047,2,4,5,11,"chr8",1,0.0644631973745898
"10642","chr8.25255000.25260000","chr8.25300000.25305000",45000,23,0.005712645,25255000,25300000,25260000,25305000,"chr8",330104,4,8,1,13,"chr8",1,0.0350445382090952
"10643","chr8.38105000.38110000","chr8.38570000.38575000",465000,9,0.004949091,38105000,38570000,38110000,38575000,"chr8",330185,2,4,9,15,"chr8",1,0.0158227848101266
"10644","chr8.22095000.22100000","chr8.22235000.22240000",140000,14,0.004244205,22095000,22235000,22100000,22240000,"chr8",330189,4,9,5,18,"chr8",1,0.029535864978903
"10645","chr8.124475000.124480000","chr8.125385000.125390000",910000,8,0.0008393126,124475000,125385000,124480000,125390000,"chr8",330201,0,8,6,14,"chr8",1,0.0131270511017346
"10646","chr8.38910000.38915000","chr8.38935000.38940000",25000,38,0.0002053774,38910000,38935000,38915000,38940000,"chr8",330257,2,6,1,9,"chr8",1,0.040084388185654
"10647","chr8.42270000.42275000","chr8.42390000.42395000",120000,28,8.005662e-12,42270000,42390000,42275000,42395000,"chr8",330264,2,6,11,19,"chr8",1,0.0623534927332396
"10648","chr8.101145000.101150000","chr8.101575000.101580000",430000,9,0.006945504,101145000,101575000,101150000,101580000,"chr8",330342,1,0,0,1,"chr8",1,0.00105485232067511
"10649","chr8.41875000.41880000","chr8.42015000.42020000",140000,16,0.0003825996,41875000,42015000,41880000,42020000,"chr8",330348,0,4,1,5,"chr8",1,0.00937646507266761
"10650","chr8.22095000.22100000","chr8.22225000.22230000",130000,20,2.464653e-06,22095000,22225000,22100000,22230000,"chr8",330393,4,8,5,17,"chr8",1,0.0398499765588373
"10651","chr8.41845000.41850000","chr8.42005000.42010000",160000,39,1.995499e-24,41845000,42005000,41850000,42010000,"chr8",330406,1,8,3,12,"chr8",1,0.0548523206751055
"10652","chr8.18720000.18725000","chr8.18740000.18745000",20000,43,3.468506e-05,18720000,18740000,18725000,18745000,"chr8",330433,2,0,1,3,"chr8",1,0.0151195499296765
"10653","chr8.455000.460000","chr8.475000.480000",20000,37,0.002977958,455000,475000,460000,480000,"chr8",330459,2,3,2,7,"chr8",1,0.0303563056727614
"10654","chr8.38680000.38685000","chr8.38720000.38725000",40000,27,0.0007227759,38680000,38720000,38685000,38725000,"chr8",330554,2,4,1,7,"chr8",1,0.0221518987341772
"10655","chr8.129970000.129975000","chr8.129990000.129995000",20000,43,3.468506e-05,129970000,129990000,129975000,129995000,"chr8",330586,8,14,14,36,"chr8",1,0.181434599156118
"10656","chr8.119925000.119930000","chr8.119945000.119950000",20000,36,0.005560214,119925000,119945000,119930000,119950000,"chr8",330619,0,12,6,18,"chr8",1,0.0759493670886076
"10657","chr8.17615000.17620000","chr8.17715000.17720000",100000,22,1.94579e-06,17615000,17715000,17620000,17720000,"chr8",330626,2,4,6,12,"chr8",1,0.0309423347398031
"10658","chr8.13100000.13105000","chr8.13130000.13135000",30000,42,5.44319e-08,13100000,13130000,13105000,13135000,"chr8",330688,2,2,6,10,"chr8",1,0.0492264416315049
"10659","chr8.42100000.42105000","chr8.42195000.42200000",95000,17,0.00184477,42100000,42195000,42105000,42200000,"chr8",330805,4,16,6,26,"chr8",1,0.0518049695264885
"10660","chr8.8665000.8670000","chr8.8790000.8795000",125000,15,0.002567875,8665000,8790000,8670000,8795000,"chr8",330816,0,11,5,16,"chr8",1,0.0281293952180028
"10661","chr8.28785000.28790000","chr8.28940000.28945000",155000,13,0.007514159,28785000,28940000,28790000,28945000,"chr8",330845,1,7,0,8,"chr8",1,0.0121894045944679
"10662","chr8.124835000.124840000","chr8.125385000.125390000",550000,13,1.281388e-06,124835000,125385000,124840000,125390000,"chr8",330857,3,8,6,17,"chr8",1,0.0259024847632443
"10663","chr8.12935000.12940000","chr8.13040000.13045000",105000,18,0.0002546712,12935000,13040000,12940000,13045000,"chr8",330911,2,3,1,6,"chr8",1,0.0126582278481013
"10664","chr8.26140000.26145000","chr8.26215000.26220000",75000,20,0.0005920886,26140000,26215000,26145000,26220000,"chr8",330929,5,13,4,22,"chr8",1,0.0515705578996718
"10665","chr8.25300000.25305000","chr8.26200000.26205000",900000,7,0.005412715,25300000,26200000,25305000,26205000,"chr8",330989,4,6,4,14,"chr8",1,0.0114861697140178
"10666","chr8.13100000.13105000","chr8.13515000.13520000",415000,10,0.001904561,13100000,13515000,13105000,13520000,"chr8",331023,0,2,3,5,"chr8",1,0.00586029067041725
"10667","chr8.26380000.26385000","chr8.26400000.26405000",20000,48,3.955995e-07,26380000,26400000,26385000,26405000,"chr8",331077,2,7,5,14,"chr8",1,0.0787623066104079
"10668","chr8.28370000.28375000","chr8.28465000.28470000",95000,16,0.005201811,28370000,28465000,28375000,28470000,"chr8",331147,4,8,6,18,"chr8",1,0.0337552742616034
"10669","chr8.101275000.101280000","chr8.101575000.101580000",300000,11,0.002130042,101275000,101575000,101280000,101580000,"chr8",331163,1,2,1,4,"chr8",1,0.00515705578996718
"10670","chr8.1690000.1695000","chr8.1810000.1815000",120000,16,0.001036129,1690000,1810000,1695000,1815000,"chr8",331176,1,2,1,4,"chr8",1,0.00750117205813408
"10671","chr8.23160000.23165000","chr8.23265000.23270000",105000,16,0.002567875,23160000,23265000,23165000,23270000,"chr8",331195,2,9,9,20,"chr8",1,0.0375058602906704
"10672","chr8.97865000.97870000","chr8.98005000.98010000",140000,17,0.000102587,97865000,98005000,97870000,98010000,"chr8",331201,2,9,4,15,"chr8",1,0.029887482419128
"10673","chr8.38680000.38685000","chr8.38795000.38800000",115000,17,0.0004162553,38680000,38795000,38685000,38800000,"chr8",331262,2,4,1,7,"chr8",1,0.0139474917955931
"10674","chr8.67580000.67585000","chr8.67790000.67795000",210000,12,0.004463727,67580000,67790000,67585000,67795000,"chr8",331273,1,1,2,4,"chr8",1,0.00562587904360056
"10675","chr8.26290000.26295000","chr8.26400000.26405000",110000,15,0.005436739,26290000,26400000,26295000,26405000,"chr8",331298,2,2,0,4,"chr8",1,0.0070323488045007
"10676","chr8.27590000.27595000","chr8.27610000.27615000",20000,56,9.365005e-11,27590000,27610000,27595000,27615000,"chr8",331385,0,3,2,5,"chr8",1,0.0328176277543366
"10677","chr8.114480000.114485000","chr8.115080000.115085000",600000,9,0.001383869,114480000,115080000,114485000,115085000,"chr8",331388,0,3,2,5,"chr8",1,0.00527426160337553
"10678","chr8.9040000.9045000","chr8.9080000.9085000",40000,24,0.008185319,9040000,9080000,9045000,9085000,"chr8",331451,3,7,2,12,"chr8",1,0.0337552742616034
"10679","chr8.42270000.42275000","chr8.42540000.42545000",270000,18,3.37849e-08,42270000,42540000,42275000,42545000,"chr8",331489,2,2,5,9,"chr8",1,0.0189873417721519
"10680","chr8.22780000.22785000","chr8.22860000.22865000",80000,23,7.902748e-06,22780000,22860000,22785000,22865000,"chr8",331575,0,1,4,5,"chr8",1,0.0134786685419597
"10681","chr8.86415000.86420000","chr8.87040000.87045000",625000,8,0.00557973,86415000,87040000,86420000,87045000,"chr8",331678,0,0,1,1,"chr8",1,0.00093764650726676
"10682","chr8.1845000.1850000","chr8.1975000.1980000",130000,14,0.006151464,1845000,1975000,1850000,1980000,"chr8",331688,0,4,1,5,"chr8",1,0.00820440693858415
"10683","chr8.28380000.28385000","chr8.28425000.28430000",45000,32,6.519206e-07,28380000,28425000,28385000,28430000,"chr8",331689,4,10,9,23,"chr8",1,0.086263478668542
"10684","chr8.65630000.65635000","chr8.66455000.66460000",825000,8,0.001466996,65630000,66455000,65635000,66460000,"chr8",331694,11,16,27,54,"chr8",1,0.0506329113924051
"10685","chr8.27485000.27490000","chr8.27595000.27600000",110000,17,0.0005888128,27485000,27595000,27490000,27600000,"chr8",331781,2,2,3,7,"chr8",1,0.0139474917955931
"10686","chr8.29215000.29220000","chr8.30000000.30005000",785000,9,0.0003023606,29215000,3e+07,29220000,30005000,"chr8",331815,3,7,8,18,"chr8",1,0.0189873417721519
"10687","chr8.65530000.65535000","chr8.65560000.65565000",30000,30,0.003792046,65530000,65560000,65535000,65565000,"chr8",331821,3,3,5,11,"chr8",1,0.0386779184247539
"10688","chr8.116420000.116425000","chr8.116850000.116855000",430000,10,0.001614649,116420000,116850000,116425000,116855000,"chr8",331867,0,3,3,6,"chr8",1,0.0070323488045007
"10689","chr8.140425000.140430000","chr8.140665000.140670000",240000,11,0.007162658,140425000,140665000,140430000,140670000,"chr8",331943,0,4,2,6,"chr8",1,0.00773558368495077
"10690","chr8.102340000.102345000","chr8.103130000.103135000",790000,8,0.001818732,102340000,103130000,102345000,103135000,"chr8",331963,1,4,2,7,"chr8",1,0.00656352555086732
"10691","chr8.26445000.26450000","chr8.26485000.26490000",40000,41,7.035146e-11,26445000,26485000,26450000,26490000,"chr8",331967,0,6,5,11,"chr8",1,0.0528598218471636
"10692","chr8.22135000.22140000","chr8.22225000.22230000",90000,21,2.609991e-05,22135000,22225000,22140000,22230000,"chr8",331979,3,3,4,10,"chr8",1,0.0246132208157525
"10693","chr8.108825000.108830000","chr8.109730000.109735000",905000,9,0.0001199236,108825000,109730000,108830000,109735000,"chr8",332059,0,3,2,5,"chr8",1,0.00527426160337553
"10694","chr8.102340000.102345000","chr8.102655000.102660000",315000,11,0.001673151,102340000,102655000,102345000,102660000,"chr8",332117,1,7,17,25,"chr8",1,0.0322315986872949
"10695","chr8.29195000.29200000","chr8.29905000.29910000",710000,20,1.747121e-15,29195000,29905000,29200000,29910000,"chr8",332164,0,3,1,4,"chr8",1,0.00937646507266761
"10696","chr8.93860000.93865000","chr8.94035000.94040000",175000,14,0.001139329,93860000,94035000,93865000,94040000,"chr8",332183,0,7,5,12,"chr8",1,0.019690576652602
"10697","chr8.29215000.29220000","chr8.30020000.30025000",805000,10,3.420426e-05,29215000,30020000,29220000,30025000,"chr8",332198,3,7,8,18,"chr8",1,0.0210970464135021
"10698","chr8.28375000.28380000","chr8.28410000.28415000",35000,36,8.825881e-07,28375000,28410000,28380000,28415000,"chr8",332226,6,11,10,27,"chr8",1,0.113924050632911
"10699","chr8.27485000.27490000","chr8.27590000.27595000",105000,23,2.403921e-07,27485000,27590000,27490000,27595000,"chr8",332310,3,10,8,21,"chr8",1,0.0566104078762307
"10700","chr8.81000000.81005000","chr8.81070000.81075000",70000,18,0.007757695,8.1e+07,81070000,81005000,81075000,"chr8",332416,0,3,1,4,"chr8",1,0.00843881856540084
"10701","chr8.65560000.65565000","chr8.65590000.65595000",30000,31,0.001812399,65560000,65590000,65565000,65595000,"chr8",332423,3,4,5,12,"chr8",1,0.0436005625879044
"10702","chr8.38935000.38940000","chr8.38965000.38970000",30000,34,0.0001589027,38935000,38965000,38940000,38970000,"chr8",332426,2,6,1,9,"chr8",1,0.0358649789029536
"10703","chr8.25170000.25175000","chr8.25305000.25310000",135000,14,0.005166807,25170000,25305000,25175000,25310000,"chr8",332532,7,21,27,55,"chr8",1,0.0902484763244257
"10704","chr8.140700000.140705000","chr8.141000000.141005000",300000,11,0.002130042,140700000,1.41e+08,140705000,141005000,"chr8",332541,0,5,4,9,"chr8",1,0.0116033755274262
"10705","chr8.1690000.1695000","chr8.1930000.1935000",240000,11,0.007162658,1690000,1930000,1695000,1935000,"chr8",332554,1,2,1,4,"chr8",1,0.00515705578996718
"10706","chr8.86350000.86355000","chr8.87040000.87045000",690000,12,1.567553e-06,86350000,87040000,86355000,87045000,"chr8",332589,0,0,10,10,"chr8",1,0.0140646976090014
"10707","chr8.66685000.66690000","chr8.66925000.66930000",240000,12,0.001991274,66685000,66925000,66690000,66930000,"chr8",332859,0,8,13,21,"chr8",1,0.029535864978903
"10708","chr8.22780000.22785000","chr8.22800000.22805000",20000,41,0.000171528,22780000,22800000,22785000,22805000,"chr8",333096,1,2,3,6,"chr8",1,0.0288326300984529
"10709","chr8.141450000.141455000","chr8.141635000.141640000",185000,15,0.0002002579,141450000,141635000,141455000,141640000,"chr8",333149,0,1,0,1,"chr8",1,0.00175808720112518
"10710","chr8.28475000.28480000","chr8.28600000.28605000",125000,17,0.0002288739,28475000,28600000,28480000,28605000,"chr8",333171,5,2,2,9,"chr8",1,0.0179324894514768
"10711","chr8.28350000.28355000","chr8.28465000.28470000",115000,21,1.765992e-06,28350000,28465000,28355000,28470000,"chr8",333210,3,1,5,9,"chr8",1,0.0221518987341772
"10712","chr8.26230000.26235000","chr8.26265000.26270000",35000,26,0.00833505,26230000,26265000,26235000,26270000,"chr8",333538,3,8,7,18,"chr8",1,0.0548523206751055
"10713","chr8.29200000.29205000","chr8.29905000.29910000",705000,9,0.000564797,29200000,29905000,29205000,29910000,"chr8",333584,0,4,1,5,"chr8",1,0.00527426160337553
"10714","chr8.100415000.100420000","chr8.100860000.100865000",445000,11,0.0002673849,100415000,100860000,100420000,100865000,"chr8",333717,0,3,7,10,"chr8",1,0.012892639474918
"10715","chr8.42270000.42275000","chr8.42385000.42390000",115000,28,1.508455e-11,42270000,42385000,42275000,42390000,"chr8",333769,12,44,45,101,"chr8",1,0.3314580403188
"10716","chr8.125640000.125645000","chr8.125660000.125665000",20000,38,0.001546564,125640000,125660000,125645000,125665000,"chr8",333783,1,1,1,3,"chr8",1,0.0133614627285513
"10717","chr8.109600000.109605000","chr8.109645000.109650000",45000,26,0.0004184018,109600000,109645000,109605000,109650000,"chr8",333814,0,3,1,4,"chr8",1,0.0121894045944679
"10718","chr8.125015000.125020000","chr8.125410000.125415000",395000,12,9.923413e-05,125015000,125410000,125020000,125415000,"chr8",333885,1,1,2,4,"chr8",1,0.00562587904360056
"10719","chr8.38710000.38715000","chr8.38795000.38800000",85000,28,2.248246e-09,38710000,38795000,38715000,38800000,"chr8",333894,1,6,3,10,"chr8",1,0.0328176277543366
"10720","chr8.38385000.38390000","chr8.38570000.38575000",185000,13,0.002811643,38385000,38570000,38390000,38575000,"chr8",333919,2,4,9,15,"chr8",1,0.0228551336146273
"10721","chr8.39890000.39895000","chr8.40030000.40035000",140000,18,2.540841e-05,39890000,40030000,39895000,40035000,"chr8",333935,6,18,19,43,"chr8",1,0.0907172995780591
"10722","chr8.28730000.28735000","chr8.28800000.28805000",70000,18,0.007757695,28730000,28800000,28735000,28805000,"chr8",333984,1,7,4,12,"chr8",1,0.0253164556962025
"10723","chr8.71270000.71275000","chr8.71310000.71315000",40000,32,4.94608e-06,71270000,71310000,71275000,71315000,"chr8",334045,0,2,0,2,"chr8",1,0.00750117205813408
"10724","chr8.60700000.60705000","chr8.60905000.60910000",205000,12,0.005166807,60700000,60905000,60705000,60910000,"chr8",334066,0,3,1,4,"chr8",1,0.00562587904360056
"10725","chr8.18755000.18760000","chr8.19080000.19085000",325000,13,6.050691e-05,18755000,19080000,18760000,19085000,"chr8",334092,0,2,0,2,"chr8",1,0.00304735114861697
"10726","chr8.28340000.28345000","chr8.28425000.28430000",85000,19,0.0005361414,28340000,28425000,28345000,28430000,"chr8",334207,0,5,2,7,"chr8",1,0.0155883731833099
"10727","chr8.109260000.109265000","chr8.109455000.109460000",195000,17,6.29664e-06,109260000,109455000,109265000,109460000,"chr8",334228,1,2,1,4,"chr8",1,0.00796999531176746
"10728","chr8.94795000.94800000","chr8.94820000.94825000",25000,42,6.682419e-06,94795000,94820000,94800000,94825000,"chr8",334254,6,15,9,30,"chr8",1,0.147679324894515
"10729","chr8.26290000.26295000","chr8.27075000.27080000",785000,8,0.001869818,26290000,27075000,26295000,27080000,"chr8",334263,2,1,0,3,"chr8",1,0.00281293952180028
"10730","chr8.86235000.86240000","chr8.86355000.86360000",120000,19,2.132356e-05,86235000,86355000,86240000,86360000,"chr8",334310,2,0,2,4,"chr8",1,0.00890764181903422
"10731","chr8.86140000.86145000","chr8.87040000.87045000",900000,8,0.000899081,86140000,87040000,86145000,87045000,"chr8",334464,0,0,5,5,"chr8",1,0.0046882325363338
"10732","chr8.97350000.97355000","chr8.98170000.98175000",820000,9,0.0002289936,97350000,98170000,97355000,98175000,"chr8",334494,0,1,1,2,"chr8",1,0.00210970464135021
"10733","chr8.2195000.2200000","chr8.2645000.2650000",450000,9,0.005653269,2195000,2645000,2200000,2650000,"chr8",334540,1,2,6,9,"chr8",1,0.00949367088607595
"10734","chr8.13025000.13030000","chr8.13110000.13115000",85000,19,0.0005361414,13025000,13110000,13030000,13115000,"chr8",334666,4,7,3,14,"chr8",1,0.0311767463666198
"10735","chr8.26140000.26145000","chr8.26185000.26190000",45000,26,0.0004184018,26140000,26185000,26145000,26190000,"chr8",334728,0,5,4,9,"chr8",1,0.0274261603375527
"10736","chr8.8590000.8595000","chr8.8840000.8845000",250000,12,0.001562018,8590000,8840000,8595000,8845000,"chr8",334750,3,10,8,21,"chr8",1,0.029535864978903
"10737","chr8.56970000.56975000","chr8.57110000.57115000",140000,18,2.540841e-05,56970000,57110000,56975000,57115000,"chr8",334771,0,0,1,1,"chr8",1,0.00210970464135021
"10738","chr8.80655000.80660000","chr8.80950000.80955000",295000,12,0.0005562847,80655000,80950000,80660000,80955000,"chr8",334806,2,0,0,2,"chr8",1,0.00281293952180028
"10739","chr8.122465000.122470000","chr8.122720000.122725000",255000,11,0.005166807,122465000,122720000,122470000,122725000,"chr8",334871,0,1,1,2,"chr8",1,0.00257852789498359
"10740","chr8.140795000.140800000","chr8.141010000.141015000",215000,13,0.001061228,140795000,141010000,140800000,141015000,"chr8",334882,4,6,13,23,"chr8",1,0.0350445382090952
"10741","chr8.25250000.25255000","chr8.26200000.26205000",950000,8,0.0006477767,25250000,26200000,25255000,26205000,"chr8",334889,4,6,4,14,"chr8",1,0.0131270511017346
"10742","chr8.124830000.124835000","chr8.125385000.125390000",555000,12,9.307833e-06,124830000,125385000,124835000,125390000,"chr8",334948,0,3,2,5,"chr8",1,0.0070323488045007
"10743","chr8.29530000.29535000","chr8.29805000.29810000",275000,11,0.003446703,29530000,29805000,29535000,29810000,"chr8",335009,1,4,3,8,"chr8",1,0.0103141115799344
"10744","chr8.98005000.98010000","chr8.98060000.98065000",55000,21,0.005023343,98005000,98060000,98010000,98065000,"chr8",335025,2,9,4,15,"chr8",1,0.0369198312236287
"10745","chr8.17600000.17605000","chr8.17755000.17760000",155000,21,8.896447e-08,17600000,17755000,17605000,17760000,"chr8",335080,3,10,7,20,"chr8",1,0.0492264416315049
"10746","chr8.38770000.38775000","chr8.38795000.38800000",25000,35,0.001946928,38770000,38795000,38775000,38800000,"chr8",335239,3,6,6,15,"chr8",1,0.0615330520393812
"10747","chr8.120365000.120370000","chr8.120440000.120445000",75000,19,0.001692566,120365000,120440000,120370000,120445000,"chr8",335255,1,0,0,1,"chr8",1,0.00222691045475856
"10748","chr8.38135000.38140000","chr8.38180000.38185000",45000,26,0.0004184018,38135000,38180000,38140000,38185000,"chr8",335292,6,18,17,41,"chr8",1,0.124941397093296
"10749","chr8.124525000.124530000","chr8.124705000.124710000",180000,26,1.029298e-12,124525000,124705000,124530000,124710000,"chr8",335428,0,4,10,14,"chr8",1,0.0426629160806376
"10750","chr8.31800000.31805000","chr8.31820000.31825000",20000,37,0.002977958,31800000,31820000,31805000,31825000,"chr8",335727,0,0,3,3,"chr8",1,0.0130098452883263
"10751","chr8.17600000.17605000","chr8.17750000.17755000",150000,15,0.0008738735,17600000,17750000,17605000,17755000,"chr8",335730,1,4,2,7,"chr8",1,0.0123066104078762
"10752","chr8.12915000.12920000","chr8.13515000.13520000",600000,10,0.0002418045,12915000,13515000,12920000,13520000,"chr8",335738,0,2,3,5,"chr8",1,0.00586029067041725
"10753","chr8.94715000.94720000","chr8.94820000.94825000",105000,21,4.664355e-06,94715000,94820000,94720000,94825000,"chr8",335773,11,20,24,55,"chr8",1,0.135372714486639
"10754","chr8.29230000.29235000","chr8.29875000.29880000",645000,13,3.14463e-07,29230000,29875000,29235000,29880000,"chr8",335774,1,7,16,24,"chr8",1,0.0365682137834037
"10755","chr8.90840000.90845000","chr8.90940000.90945000",100000,17,0.001226167,90840000,90940000,90845000,90945000,"chr8",335837,0,0,2,2,"chr8",1,0.00398499765588373
"10756","chr8.124570000.124575000","chr8.124690000.124695000",120000,18,8.390931e-05,124570000,124690000,124575000,124695000,"chr8",335939,2,7,1,10,"chr8",1,0.0210970464135021
"10757","chr8.41995000.42000000","chr8.42015000.42020000",20000,37,0.002977958,41995000,42015000,4.2e+07,42020000,"chr8",335952,0,4,0,4,"chr8",1,0.0173464603844351
"10758","chr8.38265000.38270000","chr8.38565000.38570000",300000,24,1.953142e-14,38265000,38565000,38270000,38570000,"chr8",335997,1,6,5,12,"chr8",1,0.0337552742616034
"10759","chr8.17575000.17580000","chr8.17600000.17605000",25000,57,4.671002e-13,17575000,17600000,17580000,17605000,"chr8",336095,1,9,7,17,"chr8",1,0.113572433192686
"10760","chr8.29200000.29205000","chr8.30015000.30020000",815000,8,0.001562018,29200000,30015000,29205000,30020000,"chr8",336108,3,15,8,26,"chr8",1,0.0243788091889358
"10761","chr8.26185000.26190000","chr8.26230000.26235000",45000,32,6.519206e-07,26185000,26230000,26190000,26235000,"chr8",336115,0,5,4,9,"chr8",1,0.0337552742616034
"10762","chr8.25035000.25040000","chr8.25180000.25185000",145000,17,7.894059e-05,25035000,25180000,25040000,25185000,"chr8",336173,7,17,23,47,"chr8",1,0.0936474449132677
"10763","chr8.17625000.17630000","chr8.17645000.17650000",20000,47,1.000497e-06,17625000,17645000,17630000,17650000,"chr8",336226,2,5,5,12,"chr8",1,0.0661040787623066
"10764","chr8.17575000.17580000","chr8.17750000.17755000",175000,15,0.0003082435,17575000,17750000,17580000,17755000,"chr8",336237,1,4,2,7,"chr8",1,0.0123066104078762
"10765","chr8.140535000.140540000","chr8.140620000.140625000",85000,17,0.004402623,140535000,140620000,140540000,140625000,"chr8",336350,3,4,1,8,"chr8",1,0.0159399906235349
"10766","chr8.127795000.127800000","chr8.127820000.127825000",25000,46,1.379833e-07,127795000,127820000,127800000,127825000,"chr8",336366,1,5,12,18,"chr8",1,0.0970464135021097
"10767","chr8.86135000.86140000","chr8.87030000.87035000",895000,7,0.005559402,86135000,87030000,86140000,87035000,"chr8",336435,0,4,2,6,"chr8",1,0.00492264416315049
"10768","chr8.38765000.38770000","chr8.38785000.38790000",20000,40,0.0003708657,38765000,38785000,38770000,38790000,"chr8",336548,2,0,0,2,"chr8",1,0.00937646507266761
"10769","chr8.25035000.25040000","chr8.25240000.25245000",205000,20,2.02378e-08,25035000,25240000,25040000,25245000,"chr8",336550,1,3,6,10,"chr8",1,0.023441162681669
"10770","chr8.26185000.26190000","chr8.26215000.26220000",30000,47,1.539583e-10,26185000,26215000,26190000,26220000,"chr8",336572,0,5,4,9,"chr8",1,0.04957805907173
"10771","chr8.122655000.122660000","chr8.122720000.122725000",65000,28,2.0627e-07,122655000,122720000,122660000,122725000,"chr8",336618,0,1,2,3,"chr8",1,0.00984528832630099
"10772","chr8.26205000.26210000","chr8.26380000.26385000",175000,14,0.001139329,26205000,26380000,26210000,26385000,"chr8",336627,2,7,6,15,"chr8",1,0.0246132208157525
"10773","chr8.109540000.109545000","chr8.109730000.109735000",190000,12,0.007757695,109540000,109730000,109545000,109735000,"chr8",336655,0,2,0,2,"chr8",1,0.00281293952180028
"10774","chr8.17605000.17610000","chr8.17645000.17650000",40000,24,0.008185319,17605000,17645000,17610000,17650000,"chr8",336679,2,9,5,16,"chr8",1,0.0450070323488045
"10775","chr8.71210000.71215000","chr8.71270000.71275000",60000,21,0.002098409,71210000,71270000,71215000,71275000,"chr8",336750,0,2,0,2,"chr8",1,0.00492264416315049
"10776","chr8.13100000.13105000","chr8.13510000.13515000",410000,9,0.008356425,13100000,13510000,13105000,13515000,"chr8",336795,1,4,0,5,"chr8",1,0.00527426160337553
"10777","chr8.65830000.65835000","chr8.66470000.66475000",640000,13,3.387345e-07,65830000,66470000,65835000,66475000,"chr8",336838,2,6,4,12,"chr8",1,0.0182841068917018
"10778","chr8.17505000.17510000","chr8.17530000.17535000",25000,69,3.287873e-20,17505000,17530000,17510000,17535000,"chr8",336921,1,4,1,6,"chr8",1,0.0485232067510548
"10779","chr8.9135000.9140000","chr8.9615000.9620000",480000,9,0.004244205,9135000,9615000,9140000,9620000,"chr8",336957,0,3,3,6,"chr8",1,0.00632911392405063
"10780","chr8.79825000.79830000","chr8.80400000.80405000",575000,10,0.0003147302,79825000,80400000,79830000,80405000,"chr8",336968,7,7,8,22,"chr8",1,0.0257852789498359
"10781","chr8.12990000.12995000","chr8.13515000.13520000",525000,11,9.338814e-05,12990000,13515000,12995000,13520000,"chr8",337009,0,2,3,5,"chr8",1,0.00644631973745898
"10782","chr8.25180000.25185000","chr8.25295000.25300000",115000,18,0.0001180431,25180000,25295000,25185000,25300000,"chr8",337070,7,17,23,47,"chr8",1,0.0991561181434599
"10783","chr8.27545000.27550000","chr8.27590000.27595000",45000,30,6.682419e-06,27545000,27590000,27550000,27595000,"chr8",337078,2,2,6,10,"chr8",1,0.0351617440225035
"10784","chr8.38325000.38330000","chr8.38570000.38575000",245000,13,0.0004289973,38325000,38570000,38330000,38575000,"chr8",337092,2,4,6,12,"chr8",1,0.0182841068917018
"10785","chr8.42740000.42745000","chr8.42900000.42905000",160000,21,6.220975e-08,42740000,42900000,42745000,42905000,"chr8",337106,3,4,14,21,"chr8",1,0.0516877637130802
"10786","chr8.80615000.80620000","chr8.80655000.80660000",40000,24,0.008185319,80615000,80655000,80620000,80660000,"chr8",337125,2,0,0,2,"chr8",1,0.00562587904360056
"10787","chr8.86235000.86240000","chr8.87040000.87045000",805000,8,0.001668865,86235000,87040000,86240000,87045000,"chr8",337165,0,0,4,4,"chr8",1,0.00375058602906704
"10788","chr8.28655000.28660000","chr8.29135000.29140000",480000,9,0.004244205,28655000,29135000,28660000,29140000,"chr8",337166,3,16,11,30,"chr8",1,0.0316455696202532
"10789","chr8.73985000.73990000","chr8.74010000.74015000",25000,33,0.007327625,73985000,74010000,73990000,74015000,"chr8",337167,8,14,14,36,"chr8",1,0.139240506329114
"10790","chr8.110350000.110355000","chr8.110585000.110590000",235000,11,0.007910392,110350000,110585000,110355000,110590000,"chr8",337228,0,0,2,2,"chr8",1,0.00257852789498359
"10791","chr8.26230000.26235000","chr8.26380000.26385000",150000,20,6.475154e-07,26230000,26380000,26235000,26385000,"chr8",337254,2,7,6,15,"chr8",1,0.0351617440225035
"10792","chr8.42005000.42010000","chr8.42195000.42200000",190000,19,2.892503e-07,42005000,42195000,42010000,42200000,"chr8",337276,2,8,5,15,"chr8",1,0.0334036568213783
"10793","chr8.56970000.56975000","chr8.57000000.57005000",30000,30,0.003792046,56970000,5.7e+07,56975000,57005000,"chr8",337319,0,0,3,3,"chr8",1,0.0105485232067511
"10794","chr8.28710000.28715000","chr8.28940000.28945000",230000,11,0.008893114,28710000,28940000,28715000,28945000,"chr8",337403,1,6,0,7,"chr8",1,0.00902484763244257
"10795","chr8.1845000.1850000","chr8.1970000.1975000",125000,27,2.852144e-11,1845000,1970000,1850000,1975000,"chr8",337437,2,5,10,17,"chr8",1,0.0537974683544304
"10796","chr8.22135000.22140000","chr8.22235000.22240000",100000,16,0.003659284,22135000,22235000,22140000,22240000,"chr8",337479,3,3,4,10,"chr8",1,0.0187529301453352
"10797","chr8.84585000.84590000","chr8.85030000.85035000",445000,10,0.001354316,84585000,85030000,84590000,85035000,"chr8",337483,0,1,1,2,"chr8",1,0.0023441162681669
"10798","chr8.141145000.141150000","chr8.141385000.141390000",240000,13,0.000498978,141145000,141385000,141150000,141390000,"chr8",337578,1,0,2,3,"chr8",1,0.00457102672292546
"10799","chr8.13050000.13055000","chr8.13100000.13105000",50000,31,3.987231e-07,13050000,13100000,13055000,13105000,"chr8",337588,2,6,11,19,"chr8",1,0.0690342240975152
"10800","chr8.10840000.10845000","chr8.11005000.11010000",165000,13,0.005412715,10840000,11005000,10845000,11010000,"chr8",337660,2,1,2,5,"chr8",1,0.00761837787154243
"10801","chr8.101755000.101760000","chr8.102235000.102240000",480000,10,0.0008991707,101755000,102235000,101760000,102240000,"chr8",337671,0,2,5,7,"chr8",1,0.00820440693858415
"10802","chr8.124525000.124530000","chr8.124695000.124700000",170000,19,9.326791e-07,124525000,124695000,124530000,124700000,"chr8",337690,0,4,7,11,"chr8",1,0.0244960150023441
"10803","chr8.26180000.26185000","chr8.26205000.26210000",25000,37,0.0004493397,26180000,26205000,26185000,26210000,"chr8",337750,7,9,8,24,"chr8",1,0.10407876230661
"10804","chr8.38855000.38860000","chr8.38900000.38905000",45000,24,0.002548628,38855000,38900000,38860000,38905000,"chr8",337817,3,4,1,8,"chr8",1,0.0225035161744023
"10805","chr8.38175000.38180000","chr8.38265000.38270000",90000,16,0.007551142,38175000,38265000,38180000,38270000,"chr8",337852,2,6,5,13,"chr8",1,0.0243788091889358
"10806","chr8.29070000.29075000","chr8.29100000.29105000",30000,29,0.007511147,29070000,29100000,29075000,29105000,"chr8",337863,2,1,12,15,"chr8",1,0.0509845288326301
"10807","chr8.22800000.22805000","chr8.22860000.22865000",60000,20,0.005204593,22800000,22860000,22805000,22865000,"chr8",337868,0,1,3,4,"chr8",1,0.00937646507266761
"10808","chr8.18740000.18745000","chr8.18865000.18870000",125000,18,6.050691e-05,18740000,18865000,18745000,18870000,"chr8",337895,0,2,1,3,"chr8",1,0.00632911392405063
"10809","chr8.13190000.13195000","chr8.13510000.13515000",320000,10,0.006050586,13190000,13510000,13195000,13515000,"chr8",338000,0,4,0,4,"chr8",1,0.0046882325363338
"10810","chr8.97350000.97355000","chr8.98135000.98140000",785000,7,0.009947501,97350000,98135000,97355000,98140000,"chr8",338016,0,1,1,2,"chr8",1,0.00164088138771683
"10811","chr8.52360000.52365000","chr8.52420000.52425000",60000,24,9.923413e-05,52360000,52420000,52365000,52425000,"chr8",338017,0,0,2,2,"chr8",1,0.00562587904360056
"10812","chr8.124525000.124530000","chr8.124710000.124715000",185000,13,0.002811643,124525000,124710000,124530000,124715000,"chr8",338028,0,4,6,10,"chr8",1,0.0152367557430849
"10813","chr8.22100000.22105000","chr8.22235000.22240000",135000,15,0.001668762,22100000,22235000,22105000,22240000,"chr8",338054,8,15,8,31,"chr8",1,0.0545007032348805
"10814","chr8.38310000.38315000","chr8.38570000.38575000",260000,12,0.001211333,38310000,38570000,38315000,38575000,"chr8",338064,2,4,9,15,"chr8",1,0.0210970464135021
"10815","chr8.124525000.124530000","chr8.125385000.125390000",860000,8,0.001160219,124525000,125385000,124530000,125390000,"chr8",338114,0,4,6,10,"chr8",1,0.00937646507266761
"10816","chr8.25180000.25185000","chr8.25300000.25305000",120000,15,0.003256621,25180000,25300000,25185000,25305000,"chr8",338117,4,10,16,30,"chr8",1,0.0527426160337553
"10817","chr8.124625000.124630000","chr8.124690000.124695000",65000,23,0.0001067878,124625000,124690000,124630000,124695000,"chr8",338137,2,7,1,10,"chr8",1,0.0269573370839194
"10818","chr8.13220000.13225000","chr8.13515000.13520000",295000,12,0.0005562847,13220000,13515000,13225000,13520000,"chr8",338198,0,2,3,5,"chr8",1,0.0070323488045007
"10819","chr8.42335000.42340000","chr8.42385000.42390000",50000,22,0.005166807,42335000,42385000,42340000,42390000,"chr8",338206,6,9,16,31,"chr8",1,0.0799343647444913
"10820","chr8.38710000.38715000","chr8.38785000.38790000",75000,18,0.004478185,38710000,38785000,38715000,38790000,"chr8",338222,1,1,2,4,"chr8",1,0.00843881856540084
"10821","chr8.38680000.38685000","chr8.38935000.38940000",255000,12,0.001379201,38680000,38935000,38685000,38940000,"chr8",338311,2,4,1,7,"chr8",1,0.00984528832630099
"10822","chr8.1690000.1695000","chr8.1980000.1985000",290000,14,2.557293e-05,1690000,1980000,1695000,1985000,"chr8",338428,1,4,1,6,"chr8",1,0.00984528832630099
"10823","chr8.17505000.17510000","chr8.17550000.17555000",45000,38,2.792411e-10,17505000,17550000,17510000,17555000,"chr8",338445,2,7,2,11,"chr8",1,0.0489920300046882
"10824","chr8.13050000.13055000","chr8.13510000.13515000",460000,11,0.0002172732,13050000,13510000,13055000,13515000,"chr8",338589,1,4,0,5,"chr8",1,0.00644631973745898
"10825","chr8.26640000.26645000","chr8.27075000.27080000",435000,9,0.006564076,26640000,27075000,26645000,27080000,"chr8",338603,2,1,0,3,"chr8",1,0.00316455696202532
"10826","chr8.104775000.104780000","chr8.105140000.105145000",365000,16,9.566191e-08,104775000,105140000,104780000,105145000,"chr8",338621,2,1,1,4,"chr8",1,0.00750117205813408
"10827","chr8.20060000.20065000","chr8.20225000.20230000",165000,18,6.263152e-06,20060000,20225000,20065000,20230000,"chr8",338679,2,5,2,9,"chr8",1,0.0189873417721519
"10828","chr8.86355000.86360000","chr8.87030000.87035000",675000,14,2.025853e-08,86355000,87030000,86360000,87035000,"chr8",338729,2,0,2,4,"chr8",1,0.00656352555086732
"10829","chr8.27490000.27495000","chr8.27575000.27580000",85000,25,2.151824e-07,27490000,27575000,27495000,27580000,"chr8",338847,1,2,6,9,"chr8",1,0.0263713080168776
"10830","chr8.27490000.27495000","chr8.27590000.27595000",100000,40,1.077956e-20,27490000,27590000,27495000,27595000,"chr8",338997,1,3,8,12,"chr8",1,0.0562587904360056
"10831","chr8.26195000.26200000","chr8.26215000.26220000",20000,48,3.955995e-07,26195000,26215000,26200000,26220000,"chr8",339064,7,12,13,32,"chr8",1,0.180028129395218
"10832","chr8.23160000.23165000","chr8.23245000.23250000",85000,20,0.000168585,23160000,23245000,23165000,23250000,"chr8",339162,1,0,4,5,"chr8",1,0.0117205813408345
"10833","chr8.41830000.41835000","chr8.41995000.42000000",165000,27,5.355573e-13,41830000,41995000,41835000,4.2e+07,"chr8",339168,0,4,0,4,"chr8",1,0.0126582278481013
"10834","chr8.124475000.124480000","chr8.124775000.124780000",300000,13,0.0001044831,124475000,124775000,124480000,124780000,"chr8",339194,0,9,9,18,"chr8",1,0.0274261603375527
"10835","chr8.1690000.1695000","chr8.1970000.1975000",280000,11,0.003114018,1690000,1970000,1695000,1975000,"chr8",339227,1,4,1,6,"chr8",1,0.00773558368495077
"10836","chr8.17195000.17200000","chr8.17730000.17735000",535000,11,8.212658e-05,17195000,17730000,17200000,17735000,"chr8",339242,4,8,8,20,"chr8",1,0.0257852789498359
"10837","chr8.42670000.42675000","chr8.42900000.42905000",230000,11,0.008893114,42670000,42900000,42675000,42905000,"chr8",339326,4,4,14,22,"chr8",1,0.0283638068448195
"10838","chr8.124670000.124675000","chr8.124690000.124695000",20000,38,0.001546564,124670000,124690000,124675000,124695000,"chr8",339363,2,7,1,10,"chr8",1,0.0445382090951711
"10839","chr8.141450000.141455000","chr8.141625000.141630000",175000,15,0.0003082435,141450000,141625000,141455000,141630000,"chr8",339374,0,3,0,3,"chr8",1,0.00527426160337553
"10840","chr8.28940000.28945000","chr8.29135000.29140000",195000,13,0.002008015,28940000,29135000,28945000,29140000,"chr8",339412,1,7,0,8,"chr8",1,0.0121894045944679
"10841","chr8.20260000.20265000","chr8.20285000.20290000",25000,33,0.007327625,20260000,20285000,20265000,20290000,"chr8",339440,1,3,5,9,"chr8",1,0.0348101265822785
"10842","chr8.10410000.10415000","chr8.10670000.10675000",260000,15,1.170844e-05,10410000,10670000,10415000,10675000,"chr8",339446,2,2,3,7,"chr8",1,0.0123066104078762
"10843","chr8.42690000.42695000","chr8.42750000.42755000",60000,22,0.0008119563,42690000,42750000,42695000,42755000,"chr8",339497,3,4,2,9,"chr8",1,0.0232067510548523
"10844","chr8.86375000.86380000","chr8.86525000.86530000",150000,13,0.008842232,86375000,86525000,86380000,86530000,"chr8",339520,1,3,4,8,"chr8",1,0.0121894045944679
"10845","chr8.42330000.42335000","chr8.42525000.42530000",195000,13,0.002008015,42330000,42525000,42335000,42530000,"chr8",339590,4,9,12,25,"chr8",1,0.0380918893577121
"10846","chr8.20295000.20300000","chr8.21095000.21100000",800000,7,0.009125847,20295000,21095000,20300000,21100000,"chr8",339616,2,6,2,10,"chr8",1,0.00820440693858415
"10847","chr8.8225000.8230000","chr8.8490000.8495000",265000,11,0.004183632,8225000,8490000,8230000,8495000,"chr8",339619,0,4,0,4,"chr8",1,0.00515705578996718
"10848","chr8.86375000.86380000","chr8.87040000.87045000",665000,18,1.085227e-12,86375000,87040000,86380000,87045000,"chr8",339655,0,0,4,4,"chr8",1,0.00843881856540084
"10849","chr8.27320000.27325000","chr8.27465000.27470000",145000,17,7.894059e-05,27320000,27465000,27325000,27470000,"chr8",339672,0,2,1,3,"chr8",1,0.0059774964838256
"10850","chr8.17575000.17580000","chr8.17650000.17655000",75000,28,1.825907e-08,17575000,17650000,17580000,17655000,"chr8",339687,1,9,7,17,"chr8",1,0.0557899671823722
"10851","chr8.26480000.26485000","chr8.26510000.26515000",30000,36,2.607066e-05,26480000,26510000,26485000,26515000,"chr8",339690,2,3,1,6,"chr8",1,0.0253164556962025
"10852","chr8.26085000.26090000","chr8.26140000.26145000",55000,24,0.0003022495,26085000,26140000,26090000,26145000,"chr8",339725,2,13,4,19,"chr8",1,0.0534458509142053
"10853","chr8.28355000.28360000","chr8.28465000.28470000",110000,18,0.0001705869,28355000,28465000,28360000,28470000,"chr8",339837,5,9,12,26,"chr8",1,0.0548523206751055
"10854","chr8.28385000.28390000","chr8.28425000.28430000",40000,28,0.0002914178,28385000,28425000,28390000,28430000,"chr8",339884,4,10,10,24,"chr8",1,0.0787623066104079
"10855","chr8.97595000.97600000","chr8.98005000.98010000",410000,9,0.008356425,97595000,98005000,97600000,98010000,"chr8",339920,2,9,4,15,"chr8",1,0.0158227848101266
"10856","chr8.29165000.29170000","chr8.29875000.29880000",710000,9,0.0005417896,29165000,29875000,29170000,29880000,"chr8",339976,0,4,3,7,"chr8",1,0.00738396624472574
"10857","chr8.48190000.48195000","chr8.48690000.48695000",500000,10,0.0007247182,48190000,48690000,48195000,48695000,"chr8",339989,1,6,6,13,"chr8",1,0.0152367557430849
"10858","chr8.38380000.38385000","chr8.38570000.38575000",190000,14,0.0006576848,38380000,38570000,38385000,38575000,"chr8",339992,0,1,4,5,"chr8",1,0.00820440693858415
"10859","chr8.13220000.13225000","chr8.13510000.13515000",290000,17,1.098669e-07,13220000,13510000,13225000,13515000,"chr8",339995,1,4,0,5,"chr8",1,0.00996249413970933
"10860","chr8.28340000.28345000","chr8.28360000.28365000",20000,42,7.887943e-05,28340000,28360000,28345000,28365000,"chr8",340149,0,5,2,7,"chr8",1,0.0344585091420534
"10861","chr8.38265000.38270000","chr8.38380000.38385000",115000,21,1.765992e-06,38265000,38380000,38270000,38385000,"chr8",340179,0,1,4,5,"chr8",1,0.0123066104078762
"10862","chr8.17730000.17735000","chr8.17755000.17760000",25000,33,0.007327625,17730000,17755000,17735000,17760000,"chr8",340245,3,12,7,22,"chr8",1,0.0850914205344585
"10863","chr8.42015000.42020000","chr8.42195000.42200000",180000,23,4.010349e-10,42015000,42195000,42020000,42200000,"chr8",340264,0,6,1,7,"chr8",1,0.0188701359587436
"10864","chr8.17575000.17580000","chr8.17625000.17630000",50000,30,1.35378e-06,17575000,17625000,17580000,17630000,"chr8",340269,1,5,7,13,"chr8",1,0.0457102672292546
"10865","chr8.17575000.17580000","chr8.17785000.17790000",210000,12,0.004463727,17575000,17785000,17580000,17790000,"chr8",340286,1,9,7,17,"chr8",1,0.0239099859353024
"10866","chr8.25250000.25255000","chr8.25305000.25310000",55000,36,6.606817e-11,25250000,25305000,25255000,25310000,"chr8",340340,4,12,13,29,"chr8",1,0.122362869198312
"10867","chr8.65640000.65645000","chr8.66515000.66520000",875000,8,0.001055272,65640000,66515000,65645000,66520000,"chr8",340349,7,11,10,28,"chr8",1,0.0262541022034693
"10868","chr8.17600000.17605000","chr8.17645000.17650000",45000,31,2.133712e-06,17600000,17645000,17605000,17650000,"chr8",340433,2,10,5,17,"chr8",1,0.0617674636661978
"10869","chr8.29285000.29290000","chr8.29800000.29805000",515000,10,0.0006080783,29285000,29800000,29290000,29805000,"chr8",340450,1,4,1,6,"chr8",1,0.0070323488045007
"10870","chr8.12935000.12940000","chr8.13510000.13515000",575000,15,1.072631e-08,12935000,13510000,12940000,13515000,"chr8",340459,1,3,0,4,"chr8",1,0.0070323488045007
"10871","chr8.22110000.22115000","chr8.22245000.22250000",135000,19,7.93541e-06,22110000,22245000,22115000,22250000,"chr8",340496,3,7,6,16,"chr8",1,0.0356305672761369
"10872","chr8.17645000.17650000","chr8.17720000.17725000",75000,19,0.001692566,17645000,17720000,17650000,17725000,"chr8",340515,2,7,3,12,"chr8",1,0.0267229254571027
"10873","chr8.141730000.141735000","chr8.141810000.141815000",80000,24,2.067575e-06,141730000,141810000,141735000,141815000,"chr8",340630,0,0,1,1,"chr8",1,0.00281293952180028
"10874","chr8.52785000.52790000","chr8.53575000.53580000",790000,7,0.009663058,52785000,53575000,52790000,53580000,"chr8",340665,0,12,6,18,"chr8",1,0.0147679324894515
"10875","chr8.13025000.13030000","chr8.13130000.13135000",105000,18,0.0002546712,13025000,13130000,13030000,13135000,"chr8",340666,2,2,3,7,"chr8",1,0.0147679324894515
"10876","chr8.97350000.97355000","chr8.98280000.98285000",930000,10,1.15294e-05,97350000,98280000,97355000,98285000,"chr8",340705,0,1,1,2,"chr8",1,0.0023441162681669
"10877","chr8.69750000.69755000","chr8.70450000.70455000",700000,8,0.00331722,69750000,70450000,69755000,70455000,"chr8",340706,2,9,8,19,"chr8",1,0.0178152836380684
"10878","chr8.38310000.38315000","chr8.38550000.38555000",240000,11,0.007162658,38310000,38550000,38315000,38555000,"chr8",340838,2,6,3,11,"chr8",1,0.0141819034224098
"10879","chr8.116635000.116640000","chr8.117590000.117595000",955000,7,0.004021399,116635000,117590000,116640000,117595000,"chr8",340981,1,4,1,6,"chr8",1,0.00492264416315049
"10880","chr8.26445000.26450000","chr8.26510000.26515000",65000,20,0.002418698,26445000,26510000,26450000,26515000,"chr8",341008,0,5,1,6,"chr8",1,0.0140646976090014
"10881","chr8.124475000.124480000","chr8.124770000.124775000",295000,11,0.002350579,124475000,124770000,124480000,124775000,"chr8",341025,0,2,3,5,"chr8",1,0.00644631973745898
"10882","chr8.12935000.12940000","chr8.13025000.13030000",90000,20,9.338814e-05,12935000,13025000,12940000,13030000,"chr8",341026,2,3,1,6,"chr8",1,0.0140646976090014
"10883","chr8.130905000.130910000","chr8.131110000.131115000",205000,12,0.005166807,130905000,131110000,130910000,131115000,"chr8",341124,1,2,4,7,"chr8",1,0.00984528832630099
"10884","chr8.39890000.39895000","chr8.40050000.40055000",160000,42,1.287822e-27,39890000,40050000,39895000,40055000,"chr8",341172,2,4,7,13,"chr8",1,0.0639943741209564
"10885","chr8.108190000.108195000","chr8.108245000.108250000",55000,21,0.005023343,108190000,108245000,108195000,108250000,"chr8",341200,0,2,7,9,"chr8",1,0.0221518987341772
"10886","chr8.23245000.23250000","chr8.23265000.23270000",20000,36,0.005560214,23245000,23265000,23250000,23270000,"chr8",341247,1,0,4,5,"chr8",1,0.0210970464135021
"10887","chr8.39890000.39895000","chr8.40055000.40060000",165000,129,2.218173e-149,39890000,40055000,39895000,40060000,"chr8",341259,0,12,8,20,"chr8",1,0.30239099859353
"10888","chr8.25305000.25310000","chr8.26200000.26205000",895000,8,0.0009259052,25305000,26200000,25310000,26205000,"chr8",341298,6,6,4,16,"chr8",1,0.0150023441162682
"10889","chr8.38720000.38725000","chr8.38795000.38800000",75000,31,1.79416e-10,38720000,38795000,38725000,38800000,"chr8",341422,3,6,6,15,"chr8",1,0.0545007032348805
"10890","chr8.28340000.28345000","chr8.28590000.28595000",250000,14,8.212658e-05,28340000,28590000,28345000,28595000,"chr8",341426,0,5,2,7,"chr8",1,0.0114861697140178
"10891","chr8.17615000.17620000","chr8.17720000.17725000",105000,17,0.0008366683,17615000,17720000,17620000,17725000,"chr8",341440,3,4,3,10,"chr8",1,0.0199249882794187
"10892","chr8.42410000.42415000","chr8.42525000.42530000",115000,22,3.888075e-07,42410000,42525000,42415000,42530000,"chr8",341500,3,12,12,27,"chr8",1,0.069620253164557
"10893","chr8.1810000.1815000","chr8.1970000.1975000",160000,14,0.001994788,1810000,1970000,1815000,1975000,"chr8",341617,3,2,3,8,"chr8",1,0.0131270511017346
"10894","chr8.124485000.124490000","chr8.124695000.124700000",210000,26,7.905581e-14,124485000,124695000,124490000,124700000,"chr8",341622,0,8,3,11,"chr8",1,0.0335208626347867
"10895","chr8.27320000.27325000","chr8.27445000.27450000",125000,34,2.682625e-17,27320000,27445000,27325000,27450000,"chr8",341634,4,3,3,10,"chr8",1,0.0398499765588373
"10896","chr8.131040000.131045000","chr8.131110000.131115000",70000,19,0.003120744,131040000,131110000,131045000,131115000,"chr8",341645,0,2,1,3,"chr8",1,0.00668073136427567
"10897","chr8.104775000.104780000","chr8.105715000.105720000",940000,7,0.004376887,104775000,105715000,104780000,105720000,"chr8",341666,2,2,7,11,"chr8",1,0.00902484763244257
"10898","chr8.86135000.86140000","chr8.86200000.86205000",65000,22,0.0003198836,86135000,86200000,86140000,86205000,"chr8",341668,0,4,7,11,"chr8",1,0.0283638068448195
"10899","chr8.133200000.133205000","chr8.133485000.133490000",285000,11,0.002832626,133200000,133485000,133205000,133490000,"chr8",341682,0,8,10,18,"chr8",1,0.0232067510548523
"10900","chr8.1670000.1675000","chr8.1980000.1985000",310000,11,0.001812399,1670000,1980000,1675000,1985000,"chr8",341695,4,8,7,19,"chr8",1,0.0244960150023441
"10901","chr8.17575000.17580000","chr8.17720000.17725000",145000,33,1.618188e-17,17575000,17720000,17580000,17725000,"chr8",341721,1,7,3,11,"chr8",1,0.0425457102672293
"10902","chr8.86135000.86140000","chr8.86175000.86180000",40000,25,0.003868347,86135000,86175000,86140000,86180000,"chr8",341798,0,4,1,5,"chr8",1,0.0146507266760431
"10903","chr8.42760000.42765000","chr8.42895000.42900000",135000,14,0.005166807,42760000,42895000,42765000,42900000,"chr8",341806,2,2,4,8,"chr8",1,0.0131270511017346
"10904","chr8.26445000.26450000","chr8.26480000.26485000",35000,27,0.004065245,26445000,26480000,26450000,26485000,"chr8",341840,0,3,4,7,"chr8",1,0.0221518987341772
"10905","chr8.12840000.12845000","chr8.12870000.12875000",30000,30,0.003792046,12840000,12870000,12845000,12875000,"chr8",341901,0,3,1,4,"chr8",1,0.0140646976090014
"10906","chr8.38175000.38180000","chr8.38570000.38575000",395000,12,9.923413e-05,38175000,38570000,38180000,38575000,"chr8",341956,2,4,9,15,"chr8",1,0.0210970464135021
"10907","chr8.124440000.124445000","chr8.124690000.124695000",250000,15,1.639329e-05,124440000,124690000,124445000,124695000,"chr8",342027,2,7,1,10,"chr8",1,0.0175808720112518
"10908","chr8.73650000.73655000","chr8.73670000.73675000",20000,47,1.000497e-06,73650000,73670000,73655000,73675000,"chr8",342097,2,4,5,11,"chr8",1,0.0605954055321144
"10909","chr8.124450000.124455000","chr8.124770000.124775000",320000,11,0.001546564,124450000,124770000,124455000,124775000,"chr8",342139,0,2,3,5,"chr8",1,0.00644631973745898
"10910","chr8.38030000.38035000","chr8.38265000.38270000",235000,14,0.0001336725,38030000,38265000,38035000,38270000,"chr8",342238,2,2,5,9,"chr8",1,0.0147679324894515
"10911","chr8.19265000.19270000","chr8.19670000.19675000",405000,10,0.002130042,19265000,19670000,19270000,19675000,"chr8",342239,0,4,0,4,"chr8",1,0.0046882325363338
"10912","chr8.124525000.124530000","chr8.124775000.124780000",250000,19,1.195681e-08,124525000,124775000,124530000,124780000,"chr8",342300,0,4,9,13,"chr8",1,0.0289498359118612
"10913","chr8.9265000.9270000","chr8.9400000.9405000",135000,15,0.001668762,9265000,9400000,9270000,9405000,"chr8",342485,0,0,7,7,"chr8",1,0.0123066104078762
"10914","chr8.38150000.38155000","chr8.38580000.38585000",430000,10,0.001614649,38150000,38580000,38155000,38585000,"chr8",342514,4,3,13,20,"chr8",1,0.023441162681669
"10915","chr8.122465000.122470000","chr8.122655000.122660000",190000,15,0.0001640842,122465000,122655000,122470000,122660000,"chr8",342593,0,1,1,2,"chr8",1,0.00351617440225035
"10916","chr8.38105000.38110000","chr8.38180000.38185000",75000,20,0.0005920886,38105000,38180000,38110000,38185000,"chr8",342609,6,18,17,41,"chr8",1,0.0961087669948429
"10917","chr8.65560000.65565000","chr8.66505000.66510000",945000,7,0.004244205,65560000,66505000,65565000,66510000,"chr8",342680,3,3,5,11,"chr8",1,0.00902484763244257
"10918","chr8.27465000.27470000","chr8.27590000.27595000",125000,26,1.769816e-10,27465000,27590000,27470000,27595000,"chr8",342690,0,2,1,3,"chr8",1,0.00914205344585091
"10919","chr8.65530000.65535000","chr8.66455000.66460000",925000,8,0.0007725467,65530000,66455000,65535000,66460000,"chr8",342710,4,3,10,17,"chr8",1,0.0159399906235349
"10920","chr8.41875000.41880000","chr8.42195000.42200000",320000,10,0.006050586,41875000,42195000,41880000,42200000,"chr8",342791,2,4,3,9,"chr8",1,0.0105485232067511
"10921","chr8.38265000.38270000","chr8.38580000.38585000",315000,23,1.005159e-13,38265000,38580000,38270000,38585000,"chr8",342860,2,3,5,10,"chr8",1,0.0269573370839194
"10922","chr8.40055000.40060000","chr8.40835000.40840000",780000,11,5.105855e-06,40055000,40835000,40060000,40840000,"chr8",342883,0,4,8,12,"chr8",1,0.0154711673699015
"10923","chr8.19870000.19875000","chr8.19925000.19930000",55000,21,0.005023343,19870000,19925000,19875000,19930000,"chr8",342899,2,1,2,5,"chr8",1,0.0123066104078762
"10924","chr8.27240000.27245000","chr8.27315000.27320000",75000,18,0.004478185,27240000,27315000,27245000,27320000,"chr8",342956,0,5,8,13,"chr8",1,0.0274261603375527
"10925","chr8.6420000.6425000","chr8.6530000.6535000",110000,19,4.622068e-05,6420000,6530000,6425000,6535000,"chr8",342961,1,7,5,13,"chr8",1,0.0289498359118612
"10926","chr8.106145000.106150000","chr8.106700000.106705000",555000,9,0.002061786,106145000,106700000,106150000,106705000,"chr8",342983,1,3,0,4,"chr8",1,0.00421940928270042
"10927","chr8.109260000.109265000","chr8.109595000.109600000",335000,14,8.65378e-06,109260000,109595000,109265000,109600000,"chr8",342994,2,0,0,2,"chr8",1,0.00328176277543366
"10928","chr8.64515000.64520000","chr8.65275000.65280000",760000,8,0.002196563,64515000,65275000,64520000,65280000,"chr8",343032,0,0,1,1,"chr8",1,0.00093764650726676
"10929","chr8.39870000.39875000","chr8.40055000.40060000",185000,14,0.0007932724,39870000,40055000,39875000,40060000,"chr8",343070,0,0,4,4,"chr8",1,0.00656352555086732
"10930","chr8.22100000.22105000","chr8.22225000.22230000",125000,18,6.050691e-05,22100000,22225000,22105000,22230000,"chr8",343074,5,8,8,21,"chr8",1,0.0443037974683544
"10931","chr8.28350000.28355000","chr8.28475000.28480000",125000,16,0.0008024386,28350000,28475000,28355000,28480000,"chr8",343091,3,1,2,6,"chr8",1,0.0112517580872011
"10932","chr8.103100000.103105000","chr8.103120000.103125000",20000,40,0.0003708657,103100000,103120000,103105000,103125000,"chr8",343092,0,3,5,8,"chr8",1,0.0375058602906704
"10933","chr8.42015000.42020000","chr8.42170000.42175000",155000,14,0.002418698,42015000,42170000,42020000,42175000,"chr8",343127,0,6,1,7,"chr8",1,0.0114861697140178
"10934","chr8.28365000.28370000","chr8.28425000.28430000",60000,23,0.0002936694,28365000,28425000,28370000,28430000,"chr8",343150,3,8,2,13,"chr8",1,0.0350445382090952
"10935","chr8.80995000.81000000","chr8.81125000.81130000",130000,14,0.006151464,80995000,81125000,8.1e+07,81130000,"chr8",343186,0,0,2,2,"chr8",1,0.00328176277543366
"10936","chr8.38755000.38760000","chr8.38795000.38800000",40000,29,0.0001110205,38755000,38795000,38760000,38800000,"chr8",343252,2,4,5,11,"chr8",1,0.0373886544772621
"10937","chr8.124485000.124490000","chr8.124690000.124695000",205000,22,4.619251e-10,124485000,124690000,124490000,124695000,"chr8",343254,1,7,1,9,"chr8",1,0.0232067510548523
"10938","chr8.18680000.18685000","chr8.18720000.18725000",40000,30,4.072264e-05,18680000,18720000,18685000,18725000,"chr8",343257,2,0,2,4,"chr8",1,0.0140646976090014
"10939","chr8.39890000.39895000","chr8.40060000.40065000",170000,44,1.603361e-30,39890000,40060000,39895000,40065000,"chr8",343282,4,5,14,23,"chr8",1,0.118612283169245
"10940","chr8.124475000.124480000","chr8.124695000.124700000",220000,12,0.003413382,124475000,124695000,124480000,124700000,"chr8",343382,0,13,7,20,"chr8",1,0.0281293952180028
"10941","chr8.38410000.38415000","chr8.38580000.38585000",170000,13,0.004586544,38410000,38580000,38415000,38585000,"chr8",343390,0,3,3,6,"chr8",1,0.00914205344585091
"10942","chr8.124535000.124540000","chr8.124770000.124775000",235000,18,1.587891e-07,124535000,124770000,124540000,124775000,"chr8",343394,0,0,1,1,"chr8",1,0.00210970464135021
"10943","chr8.38075000.38080000","chr8.38135000.38140000",60000,21,0.002098409,38075000,38135000,38080000,38140000,"chr8",343455,2,27,32,61,"chr8",1,0.15014064697609
"10944","chr8.10440000.10445000","chr8.10670000.10675000",230000,23,1.119507e-11,10440000,10670000,10445000,10675000,"chr8",343505,2,2,1,5,"chr8",1,0.0134786685419597
"10945","chr8.127890000.127895000","chr8.128400000.128405000",510000,10,0.0006436861,127890000,128400000,127895000,128405000,"chr8",343578,0,2,1,3,"chr8",1,0.00351617440225035
"10946","chr8.38710000.38715000","chr8.38900000.38905000",190000,12,0.007757695,38710000,38900000,38715000,38905000,"chr8",343600,1,4,1,6,"chr8",1,0.00843881856540084
"10947","chr8.66670000.66675000","chr8.66745000.66750000",75000,18,0.004478185,66670000,66745000,66675000,66750000,"chr8",343755,8,18,23,49,"chr8",1,0.10337552742616
"10948","chr8.17575000.17580000","chr8.17715000.17720000",140000,28,8.685985e-13,17575000,17715000,17580000,17720000,"chr8",343760,1,4,6,11,"chr8",1,0.0360993905297703
"10949","chr8.38175000.38180000","chr8.38230000.38235000",55000,57,4.24019e-27,38175000,38230000,38180000,38235000,"chr8",343766,4,8,12,24,"chr8",1,0.160337552742616
"10950","chr8.28490000.28495000","chr8.28590000.28595000",100000,33,1.550641e-14,28490000,28590000,28495000,28595000,"chr8",343775,5,11,8,24,"chr8",1,0.0928270042194093
"10951","chr8.108870000.108875000","chr8.109730000.109735000",860000,11,2.32746e-06,108870000,109730000,108875000,109735000,"chr8",343858,0,3,2,5,"chr8",1,0.00644631973745898
"10952","chr8.26085000.26090000","chr8.26185000.26190000",100000,16,0.003659284,26085000,26185000,26090000,26190000,"chr8",343988,0,5,4,9,"chr8",1,0.0168776371308017
"10953","chr8.29215000.29220000","chr8.29885000.29890000",670000,8,0.00407617,29215000,29885000,29220000,29890000,"chr8",344025,0,3,2,5,"chr8",1,0.0046882325363338
"10954","chr8.27490000.27495000","chr8.27610000.27615000",120000,15,0.003256621,27490000,27610000,27495000,27615000,"chr8",344107,0,3,2,5,"chr8",1,0.00879043600562588
"10955","chr8.26215000.26220000","chr8.26575000.26580000",360000,10,0.003682411,26215000,26575000,26220000,26580000,"chr8",344125,1,11,6,18,"chr8",1,0.0210970464135021
"10956","chr8.93935000.93940000","chr8.94230000.94235000",295000,11,0.002350579,93935000,94230000,93940000,94235000,"chr8",344152,1,4,3,8,"chr8",1,0.0103141115799344
"10957","chr8.33330000.33335000","chr8.33420000.33425000",90000,19,0.0003122206,33330000,33420000,33335000,33425000,"chr8",344159,3,14,18,35,"chr8",1,0.0779418659165495
"10958","chr8.29200000.29205000","chr8.29850000.29855000",650000,12,2.571771e-06,29200000,29850000,29205000,29855000,"chr8",344187,1,3,11,15,"chr8",1,0.0210970464135021
"10959","chr8.61365000.61370000","chr8.61390000.61395000",25000,40,3.926218e-05,61365000,61390000,61370000,61395000,"chr8",344236,0,2,3,5,"chr8",1,0.023441162681669
"10960","chr8.28360000.28365000","chr8.28465000.28470000",105000,18,0.0002546712,28360000,28465000,28365000,28470000,"chr8",344255,2,15,10,27,"chr8",1,0.0569620253164557
"10961","chr8.26200000.26205000","chr8.26230000.26235000",30000,43,1.780765e-08,26200000,26230000,26205000,26235000,"chr8",344288,3,6,4,13,"chr8",1,0.0655180496952649
"10962","chr8.26570000.26575000","chr8.27035000.27040000",465000,9,0.004949091,26570000,27035000,26575000,27040000,"chr8",344381,1,6,4,11,"chr8",1,0.0116033755274262
"10963","chr8.42015000.42020000","chr8.42205000.42210000",190000,13,0.002383096,42015000,42205000,42020000,42210000,"chr8",344416,0,3,1,4,"chr8",1,0.00609470229723394
"10964","chr8.28340000.28345000","chr8.28465000.28470000",125000,17,0.0002288739,28340000,28465000,28345000,28470000,"chr8",344433,0,5,2,7,"chr8",1,0.0139474917955931
"10965","chr8.41845000.41850000","chr8.42015000.42020000",170000,20,1.765561e-07,41845000,42015000,41850000,42020000,"chr8",344438,0,6,1,7,"chr8",1,0.0164088138771683
"10966","chr8.25035000.25040000","chr8.25305000.25310000",270000,14,4.450101e-05,25035000,25305000,25040000,25310000,"chr8",344505,7,21,25,53,"chr8",1,0.086966713548992
"10967","chr8.86375000.86380000","chr8.86890000.86895000",515000,9,0.003038202,86375000,86890000,86380000,86895000,"chr8",344527,0,0,2,2,"chr8",1,0.00210970464135021
"10968","chr8.67980000.67985000","chr8.68385000.68390000",405000,10,0.002130042,67980000,68385000,67985000,68390000,"chr8",344535,1,2,3,6,"chr8",1,0.0070323488045007
"10969","chr8.27325000.27330000","chr8.27595000.27600000",270000,11,0.003816728,27325000,27595000,27330000,27600000,"chr8",344538,0,2,1,3,"chr8",1,0.00386779184247539
"10970","chr8.17575000.17580000","chr8.17730000.17735000",155000,28,1.885949e-13,17575000,17730000,17580000,17735000,"chr8",344574,1,9,7,17,"chr8",1,0.0557899671823722
"10971","chr8.123900000.123905000","chr8.123980000.123985000",80000,19,0.0009342178,123900000,123980000,123905000,123985000,"chr8",344580,0,1,6,7,"chr8",1,0.0155883731833099
"10972","chr8.124440000.124445000","chr8.125425000.125430000",985000,9,6.290187e-05,124440000,125425000,124445000,125430000,"chr8",344656,0,7,6,13,"chr8",1,0.0137130801687764
"10973","chr8.28465000.28470000","chr8.28655000.28660000",190000,14,0.0006576848,28465000,28655000,28470000,28660000,"chr8",344752,9,16,13,38,"chr8",1,0.0623534927332396
"10974","chr8.124520000.124525000","chr8.124710000.124715000",190000,14,0.0006576848,124520000,124710000,124525000,124715000,"chr8",344759,2,15,6,23,"chr8",1,0.0377402719174871
"10975","chr8.38105000.38110000","chr8.38580000.38585000",475000,11,0.0001762014,38105000,38580000,38110000,38585000,"chr8",344864,4,3,13,20,"chr8",1,0.0257852789498359
"10976","chr8.17600000.17605000","chr8.17715000.17720000",115000,18,0.0001180431,17600000,17715000,17605000,17720000,"chr8",344876,2,4,6,12,"chr8",1,0.0253164556962025
"10977","chr8.28940000.28945000","chr8.29070000.29075000",130000,14,0.006151464,28940000,29070000,28945000,29075000,"chr8",344908,1,1,0,2,"chr8",1,0.00328176277543366
"10978","chr8.40030000.40035000","chr8.40055000.40060000",25000,33,0.007327625,40030000,40055000,40035000,40060000,"chr8",344923,0,12,8,20,"chr8",1,0.0773558368495077
"10979","chr8.66745000.66750000","chr8.66925000.66930000",180000,14,0.0009430656,66745000,66925000,66750000,66930000,"chr8",344936,4,8,13,25,"chr8",1,0.0410220346929208
"10980","chr8.9270000.9275000","chr8.9320000.9325000",50000,22,0.005166807,9270000,9320000,9275000,9325000,"chr8",344992,1,6,3,10,"chr8",1,0.0257852789498359
"10981","chr8.9965000.9970000","chr8.10045000.10050000",80000,17,0.006976687,9965000,10045000,9970000,10050000,"chr8",345023,1,2,2,5,"chr8",1,0.00996249413970933
"10982","chr8.67580000.67585000","chr8.67980000.67985000",400000,11,0.0004849396,67580000,67980000,67585000,67985000,"chr8",345048,1,1,2,4,"chr8",1,0.00515705578996718
"10983","chr8.28370000.28375000","chr8.28425000.28430000",55000,22,0.002044662,28370000,28425000,28375000,28430000,"chr8",345059,4,8,6,18,"chr8",1,0.0464135021097046
"10984","chr8.26230000.26235000","chr8.26465000.26470000",235000,12,0.002273157,26230000,26465000,26235000,26470000,"chr8",345064,3,8,7,18,"chr8",1,0.0253164556962025
"10985","chr8.26195000.26200000","chr8.26230000.26235000",35000,27,0.004065245,26195000,26230000,26200000,26235000,"chr8",345069,3,8,7,18,"chr8",1,0.0569620253164557
"10986","chr8.13025000.13030000","chr8.13100000.13105000",75000,27,7.829456e-08,13025000,13100000,13030000,13105000,"chr8",345135,4,11,3,18,"chr8",1,0.0569620253164557
"10987","chr8.28465000.28470000","chr8.28490000.28495000",25000,37,0.0004493397,28465000,28490000,28470000,28495000,"chr8",345159,5,11,8,24,"chr8",1,0.10407876230661
"10988","chr8.103345000.103350000","chr8.103370000.103375000",25000,39,9.22665e-05,103345000,103370000,103350000,103375000,"chr8",345212,0,3,7,10,"chr8",1,0.0457102672292546
"10989","chr8.66560000.66565000","chr8.66665000.66670000",105000,18,0.0002546712,66560000,66665000,66565000,66670000,"chr8",345326,0,2,2,4,"chr8",1,0.00843881856540084
"10990","chr8.124705000.124710000","chr8.124770000.124775000",65000,26,2.875586e-06,124705000,124770000,124710000,124775000,"chr8",345329,0,2,3,5,"chr8",1,0.0152367557430849
"10991","chr8.29200000.29205000","chr8.30000000.30005000",800000,7,0.009125847,29200000,3e+07,29205000,30005000,"chr8",345399,3,15,16,34,"chr8",1,0.0278949835911861
"10992","chr8.9945000.9950000","chr8.10170000.10175000",225000,12,0.002977958,9945000,10170000,9950000,10175000,"chr8",345440,1,9,6,16,"chr8",1,0.0225035161744023
"10993","chr8.17530000.17535000","chr8.17550000.17555000",20000,43,3.468506e-05,17530000,17550000,17535000,17555000,"chr8",345458,1,4,1,6,"chr8",1,0.030239099859353
"10994","chr8.133200000.133205000","chr8.133495000.133500000",295000,12,0.0005562847,133200000,133495000,133205000,133500000,"chr8",345467,0,3,2,5,"chr8",1,0.0070323488045007
"10995","chr8.29230000.29235000","chr8.29850000.29855000",620000,10,0.0001943842,29230000,29850000,29235000,29855000,"chr8",345496,1,3,11,15,"chr8",1,0.0175808720112518
"10996","chr8.124525000.124530000","chr8.124690000.124695000",165000,18,6.263152e-06,124525000,124690000,124530000,124695000,"chr8",345499,0,4,1,5,"chr8",1,0.0105485232067511
"10997","chr8.101855000.101860000","chr8.102250000.102255000",395000,12,9.923413e-05,101855000,102250000,101860000,102255000,"chr8",345572,0,2,1,3,"chr8",1,0.00421940928270042
"10998","chr8.38180000.38185000","chr8.38230000.38235000",50000,40,1.391018e-12,38180000,38230000,38185000,38235000,"chr8",345595,6,18,15,39,"chr8",1,0.182841068917018
"10999","chr8.109260000.109265000","chr8.109610000.109615000",350000,10,0.004132753,109260000,109610000,109265000,109615000,"chr8",345621,1,2,0,3,"chr8",1,0.00351617440225035
"11000","chr8.129960000.129965000","chr8.130040000.130045000",80000,19,0.0009342178,129960000,130040000,129965000,130045000,"chr8",345685,5,11,13,29,"chr8",1,0.0645804031879981
"11001","chr8.38150000.38155000","chr8.38230000.38235000",80000,20,0.0003122206,38150000,38230000,38155000,38235000,"chr8",345703,6,14,15,35,"chr8",1,0.0820440693858415
"11002","chr8.29885000.29890000","chr8.29905000.29910000",20000,39,0.0007725467,29885000,29905000,29890000,29910000,"chr8",345725,0,3,1,4,"chr8",1,0.0182841068917018
"11003","chr8.42270000.42275000","chr8.42455000.42460000",185000,12,0.008952567,42270000,42455000,42275000,42460000,"chr8",345768,2,12,16,30,"chr8",1,0.0421940928270042
"11004","chr8.12935000.12940000","chr8.13100000.13105000",165000,13,0.005412715,12935000,13100000,12940000,13105000,"chr8",345807,2,3,1,6,"chr8",1,0.00914205344585091
"11005","chr8.22145000.22150000","chr8.22215000.22220000",70000,19,0.003120744,22145000,22215000,22150000,22220000,"chr8",345882,0,5,4,9,"chr8",1,0.020042194092827
"11006","chr8.30585000.30590000","chr8.30665000.30670000",80000,26,1.238901e-07,30585000,30665000,30590000,30670000,"chr8",345955,7,9,19,35,"chr8",1,0.106657290201594
"11007","chr8.124450000.124455000","chr8.124795000.124800000",345000,10,0.004397365,124450000,124795000,124455000,124800000,"chr8",345988,0,7,3,10,"chr8",1,0.0117205813408345
"11008","chr8.28490000.28495000","chr8.28885000.28890000",395000,11,0.0005205098,28490000,28885000,28495000,28890000,"chr8",346012,4,3,3,10,"chr8",1,0.012892639474918
"11009","chr8.38900000.38905000","chr8.38935000.38940000",35000,31,0.0001409273,38900000,38935000,38905000,38940000,"chr8",346147,2,4,1,7,"chr8",1,0.0254336615096109
"11010","chr8.30165000.30170000","chr8.30185000.30190000",20000,41,0.000171528,30165000,30185000,30170000,30190000,"chr8",346149,9,12,6,27,"chr8",1,0.129746835443038
"11011","chr8.38030000.38035000","chr8.38570000.38575000",540000,13,1.515518e-06,38030000,38570000,38035000,38575000,"chr8",346223,2,2,9,13,"chr8",1,0.0198077824660103
"11012","chr8.67645000.67650000","chr8.67680000.67685000",35000,27,0.004065245,67645000,67680000,67650000,67685000,"chr8",346243,3,6,8,17,"chr8",1,0.0537974683544304
"11013","chr8.121545000.121550000","chr8.121570000.121575000",25000,34,0.003868347,121545000,121570000,121550000,121575000,"chr8",346286,2,1,2,5,"chr8",1,0.0199249882794187
"11014","chr8.27315000.27320000","chr8.27445000.27450000",130000,15,0.002030521,27315000,27445000,27320000,27450000,"chr8",346364,0,5,8,13,"chr8",1,0.0228551336146273
"11015","chr8.141345000.141350000","chr8.141385000.141390000",40000,27,0.0007227759,141345000,141385000,141350000,141390000,"chr8",346392,1,0,2,3,"chr8",1,0.00949367088607595
"11016","chr8.124830000.124835000","chr8.125425000.125430000",595000,12,5.311024e-06,124830000,125425000,124835000,125430000,"chr8",346466,0,3,2,5,"chr8",1,0.0070323488045007
"11017","chr8.81000000.81005000","chr8.81120000.81125000",120000,15,0.003256621,8.1e+07,81120000,81005000,81125000,"chr8",346517,0,0,1,1,"chr8",1,0.00175808720112518
"11018","chr8.66515000.66520000","chr8.66535000.66540000",20000,38,0.001546564,66515000,66535000,66520000,66540000,"chr8",346545,5,11,10,26,"chr8",1,0.115799343647445
"11019","chr8.124485000.124490000","chr8.124670000.124675000",185000,12,0.008952567,124485000,124670000,124490000,124675000,"chr8",346571,1,8,3,12,"chr8",1,0.0168776371308017
"11020","chr8.28360000.28365000","chr8.28785000.28790000",425000,9,0.007309778,28360000,28785000,28365000,28790000,"chr8",346645,2,8,10,20,"chr8",1,0.0210970464135021
"11021","chr8.17195000.17200000","chr8.17360000.17365000",165000,16,0.0001187761,17195000,17360000,17200000,17365000,"chr8",346734,0,0,2,2,"chr8",1,0.00375058602906704
"11022","chr8.17615000.17620000","chr8.17650000.17655000",35000,33,2.055879e-05,17615000,17650000,17620000,17655000,"chr8",346773,5,4,7,16,"chr8",1,0.0618846694796062
"11023","chr8.17505000.17510000","chr8.17525000.17530000",20000,48,3.955995e-07,17505000,17525000,17510000,17530000,"chr8",346784,2,4,2,8,"chr8",1,0.0450070323488045
"11024","chr8.12935000.12940000","chr8.13145000.13150000",210000,13,0.001248172,12935000,13145000,12940000,13150000,"chr8",346801,0,3,1,4,"chr8",1,0.00609470229723394
"11025","chr8.124950000.124955000","chr8.125410000.125415000",460000,9,0.005166807,124950000,125410000,124955000,125415000,"chr8",346894,0,9,2,11,"chr8",1,0.0116033755274262
"11026","chr8.93835000.93840000","chr8.93860000.93865000",25000,33,0.007327625,93835000,93860000,93840000,93865000,"chr8",346984,4,8,10,22,"chr8",1,0.0850914205344585
"11027","chr8.38700000.38705000","chr8.38795000.38800000",95000,18,0.0006074909,38700000,38795000,38705000,38800000,"chr8",347018,0,4,3,7,"chr8",1,0.0147679324894515
"11028","chr8.25300000.25305000","chr8.26230000.26235000",930000,7,0.004609458,25300000,26230000,25305000,26235000,"chr8",347073,3,8,7,18,"chr8",1,0.0147679324894515
"11029","chr8.108865000.108870000","chr8.109730000.109735000",865000,8,0.001124015,108865000,109730000,108870000,109735000,"chr8",347137,0,1,1,2,"chr8",1,0.00187529301453352
"11030","chr8.13130000.13135000","chr8.13510000.13515000",380000,12,0.0001247591,13130000,13510000,13135000,13515000,"chr8",347156,1,2,0,3,"chr8",1,0.00421940928270042
"11031","chr8.12870000.12875000","chr8.13190000.13195000",320000,10,0.006050586,12870000,13190000,12875000,13195000,"chr8",347195,0,3,1,4,"chr8",1,0.0046882325363338
"11032","chr8.38680000.38685000","chr8.38785000.38790000",105000,18,0.0002546712,38680000,38785000,38685000,38790000,"chr8",347211,2,1,1,4,"chr8",1,0.00843881856540084
"11033","chr8.12990000.12995000","chr8.13510000.13515000",520000,12,1.519135e-05,12990000,13510000,12995000,13515000,"chr8",347222,1,4,0,5,"chr8",1,0.0070323488045007
"11034","chr8.42270000.42275000","chr8.42525000.42530000",255000,52,2.145239e-46,42270000,42525000,42275000,42530000,"chr8",347242,4,13,12,29,"chr8",1,0.176746366619784
"11035","chr8.42690000.42695000","chr8.42895000.42900000",205000,12,0.005166807,42690000,42895000,42695000,42900000,"chr8",347272,2,2,2,6,"chr8",1,0.00843881856540084
"11036","chr8.38030000.38035000","chr8.38580000.38585000",550000,16,1.724148e-09,38030000,38580000,38035000,38585000,"chr8",347323,4,2,10,16,"chr8",1,0.0300046882325363
"11037","chr8.28400000.28405000","chr8.28425000.28430000",25000,34,0.003868347,28400000,28425000,28405000,28430000,"chr8",347437,3,3,4,10,"chr8",1,0.0398499765588373
"11038","chr8.27465000.27470000","chr8.27580000.27585000",115000,18,0.0001180431,27465000,27580000,27470000,27585000,"chr8",347478,0,1,1,2,"chr8",1,0.00421940928270042
"11039","chr8.12915000.12920000","chr8.12935000.12940000",20000,36,0.005560214,12915000,12935000,12920000,12940000,"chr8",347493,2,3,1,6,"chr8",1,0.0253164556962025
"11040","chr8.25060000.25065000","chr8.25180000.25185000",120000,14,0.009298624,25060000,25180000,25065000,25185000,"chr8",347551,2,0,0,2,"chr8",1,0.00328176277543366
"11041","chr8.133200000.133205000","chr8.133500000.133505000",300000,14,1.959721e-05,133200000,133500000,133205000,133505000,"chr8",347562,0,3,1,4,"chr8",1,0.00656352555086732
"11042","chr8.19850000.19855000","chr8.19925000.19930000",75000,18,0.004478185,19850000,19925000,19855000,19930000,"chr8",347620,2,5,5,12,"chr8",1,0.0253164556962025
"11043","chr8.17575000.17580000","chr8.17645000.17650000",70000,26,9.207167e-07,17575000,17645000,17580000,17650000,"chr8",347645,1,9,5,15,"chr8",1,0.0457102672292546
"11044","chr8.81025000.81030000","chr8.81125000.81130000",100000,15,0.009915486,81025000,81125000,81030000,81130000,"chr8",347660,0,0,3,3,"chr8",1,0.00527426160337553
"11045","chr8.124560000.124565000","chr8.124670000.124675000",110000,16,0.001861363,124560000,124670000,124565000,124675000,"chr8",347694,6,13,12,31,"chr8",1,0.0581340834505391
"11046","chr8.101790000.101795000","chr8.102270000.102275000",480000,10,0.0008991707,101790000,102270000,101795000,102275000,"chr8",347704,0,3,0,3,"chr8",1,0.00351617440225035
"11047","chr8.25060000.25065000","chr8.25250000.25255000",190000,14,0.0006576848,25060000,25250000,25065000,25255000,"chr8",347731,2,0,0,2,"chr8",1,0.00328176277543366
"11048","chr8.28730000.28735000","chr8.28940000.28945000",210000,16,1.544929e-05,28730000,28940000,28735000,28945000,"chr8",347766,1,7,0,8,"chr8",1,0.0150023441162682
"11049","chr8.25195000.25200000","chr8.25300000.25305000",105000,16,0.002567875,25195000,25300000,25200000,25305000,"chr8",347788,4,10,16,30,"chr8",1,0.0562587904360056
"11050","chr8.28490000.28495000","chr8.28610000.28615000",120000,17,0.0003086668,28490000,28610000,28495000,28615000,"chr8",347793,5,11,8,24,"chr8",1,0.0478199718706048
"11051","chr8.26230000.26235000","chr8.26405000.26410000",175000,13,0.003883237,26230000,26405000,26235000,26410000,"chr8",347838,3,8,7,18,"chr8",1,0.0274261603375527
"11052","chr8.29195000.29200000","chr8.30015000.30020000",820000,13,3.205128e-08,29195000,30015000,29200000,30020000,"chr8",347842,0,3,3,6,"chr8",1,0.00914205344585091
"11053","chr8.29195000.29200000","chr8.30020000.30025000",825000,11,3.258213e-06,29195000,30020000,29200000,30025000,"chr8",347853,0,3,3,6,"chr8",1,0.00773558368495077
"11054","chr8.41830000.41835000","chr8.42005000.42010000",175000,17,1.696611e-05,41830000,42005000,41835000,42010000,"chr8",347863,0,4,2,6,"chr8",1,0.0119549929676512
"11055","chr8.38030000.38035000","chr8.38230000.38235000",200000,17,4.895679e-06,38030000,38230000,38035000,38235000,"chr8",348028,5,2,10,17,"chr8",1,0.0338724800750117
"11056","chr8.17615000.17620000","chr8.17645000.17650000",30000,33,0.0003708657,17615000,17645000,17620000,17650000,"chr8",348072,2,4,5,11,"chr8",1,0.0425457102672293
"11057","chr8.140495000.140500000","chr8.140530000.140535000",35000,30,0.0003488113,140495000,140530000,140500000,140535000,"chr8",348088,0,7,11,18,"chr8",1,0.0632911392405063
"11058","chr8.17575000.17580000","chr8.17605000.17610000",30000,40,4.756616e-07,17575000,17605000,17580000,17610000,"chr8",348090,1,9,7,17,"chr8",1,0.0796999531176746
"11059","chr8.29000000.29005000","chr8.29135000.29140000",135000,23,1.355337e-08,2.9e+07,29135000,29005000,29140000,"chr8",348100,0,1,2,3,"chr8",1,0.00808720112517581
"11060","chr8.42760000.42765000","chr8.42900000.42905000",140000,15,0.001341749,42760000,42900000,42765000,42905000,"chr8",348127,3,4,4,11,"chr8",1,0.0193389592123769
"11061","chr8.79765000.79770000","chr8.80560000.80565000",795000,9,0.0002806986,79765000,80560000,79770000,80565000,"chr8",348135,0,5,4,9,"chr8",1,0.00949367088607595
"11062","chr8.38710000.38715000","chr8.38830000.38835000",120000,17,0.0003086668,38710000,38830000,38715000,38835000,"chr8",348210,1,6,3,10,"chr8",1,0.0199249882794187
"11063","chr8.124525000.124530000","chr8.124770000.124775000",245000,18,9.991989e-08,124525000,124770000,124530000,124775000,"chr8",348278,0,2,3,5,"chr8",1,0.0105485232067511
"11064","chr8.104075000.104080000","chr8.104335000.104340000",260000,11,0.004638761,104075000,104335000,104080000,104340000,"chr8",348311,0,2,0,2,"chr8",1,0.00257852789498359
"11065","chr8.102790000.102795000","chr8.103370000.103375000",580000,8,0.007781891,102790000,103370000,102795000,103375000,"chr8",348536,0,6,11,17,"chr8",1,0.0159399906235349
"11066","chr8.38175000.38180000","chr8.38580000.38585000",405000,13,1.438855e-05,38175000,38580000,38180000,38585000,"chr8",348618,4,3,12,19,"chr8",1,0.0289498359118612
"11067","chr8.122195000.122200000","chr8.122720000.122725000",525000,9,0.002767496,122195000,122720000,122200000,122725000,"chr8",348691,1,4,4,9,"chr8",1,0.00949367088607595
"11068","chr8.26645000.26650000","chr8.27075000.27080000",430000,10,0.001614649,26645000,27075000,26650000,27080000,"chr8",348700,3,1,0,4,"chr8",1,0.0046882325363338
"11069","chr8.19555000.19560000","chr8.19600000.19605000",45000,23,0.005712645,19555000,19600000,19560000,19605000,"chr8",348740,0,2,1,3,"chr8",1,0.00808720112517581
"11070","chr8.38030000.38035000","chr8.38180000.38185000",150000,17,6.05453e-05,38030000,38180000,38035000,38185000,"chr8",348783,5,2,10,17,"chr8",1,0.0338724800750117
"11071","chr8.25390000.25395000","chr8.26085000.26090000",695000,8,0.003446703,25390000,26085000,25395000,26090000,"chr8",348798,2,18,14,34,"chr8",1,0.0318799812470699
"11072","chr8.29275000.29280000","chr8.29875000.29880000",600000,8,0.006783073,29275000,29875000,29280000,29880000,"chr8",348812,1,7,14,22,"chr8",1,0.0206282231598687
"11073","chr8.17505000.17510000","chr8.17575000.17580000",70000,24,1.248085e-05,17505000,17575000,17510000,17580000,"chr8",348824,1,9,7,17,"chr8",1,0.0478199718706048
"11074","chr8.27990000.27995000","chr8.28115000.28120000",125000,16,0.0008024386,27990000,28115000,27995000,28120000,"chr8",348864,0,2,0,2,"chr8",1,0.00375058602906704
"11075","chr8.102655000.102660000","chr8.103125000.103130000",470000,12,3.171642e-05,102655000,103125000,102660000,103130000,"chr8",348886,4,15,18,37,"chr8",1,0.0520393811533052
"11076","chr8.27490000.27495000","chr8.27545000.27550000",55000,24,0.0003022495,27490000,27545000,27495000,27550000,"chr8",348914,1,2,6,9,"chr8",1,0.0253164556962025
"11077","chr8.13025000.13030000","chr8.13050000.13055000",25000,46,1.379833e-07,13025000,13050000,13030000,13055000,"chr8",348933,2,6,3,11,"chr8",1,0.0593061415846226
"11078","chr8.66775000.66780000","chr8.66925000.66930000",150000,13,0.008842232,66775000,66925000,66780000,66930000,"chr8",349024,0,1,5,6,"chr8",1,0.00914205344585091
"11079","chr8.124705000.124710000","chr8.124775000.124780000",70000,40,1.570527e-16,124705000,124775000,124710000,124780000,"chr8",349079,3,9,9,21,"chr8",1,0.0984528832630098
"11080","chr8.11350000.11355000","chr8.11850000.11855000",500000,9,0.003529875,11350000,11850000,11355000,11855000,"chr8",349090,1,5,6,12,"chr8",1,0.0126582278481013
"11081","chr8.6420000.6425000","chr8.6560000.6565000",140000,20,1.242649e-06,6420000,6560000,6425000,6565000,"chr8",349163,0,2,0,2,"chr8",1,0.0046882325363338
"11082","chr8.42270000.42275000","chr8.42335000.42340000",65000,33,1.443181e-10,42270000,42335000,42275000,42340000,"chr8",349194,6,9,16,31,"chr8",1,0.119901547116737
"11083","chr8.93090000.93095000","chr8.93830000.93835000",740000,8,0.002532991,93090000,93830000,93095000,93835000,"chr8",349206,0,0,3,3,"chr8",1,0.00281293952180028
"11084","chr8.104775000.104780000","chr8.105515000.105520000",740000,8,0.002532991,104775000,105515000,104780000,105520000,"chr8",349354,3,4,3,10,"chr8",1,0.00937646507266761
"11085","chr8.42270000.42275000","chr8.42690000.42695000",420000,17,3.206026e-09,42270000,42690000,42275000,42695000,"chr8",349360,3,4,2,9,"chr8",1,0.0179324894514768
"11086","chr8.86355000.86360000","chr8.86510000.86515000",155000,13,0.007514159,86355000,86510000,86360000,86515000,"chr8",349404,2,0,2,4,"chr8",1,0.00609470229723394
"11087","chr8.13080000.13085000","chr8.13100000.13105000",20000,49,1.509079e-07,13080000,13100000,13085000,13105000,"chr8",349486,4,10,6,20,"chr8",1,0.114861697140178
"11088","chr8.27485000.27490000","chr8.27580000.27585000",95000,23,8.63749e-07,27485000,27580000,27490000,27585000,"chr8",349567,3,1,1,5,"chr8",1,0.0134786685419597
"11089","chr8.108865000.108870000","chr8.109435000.109440000",570000,8,0.008417668,108865000,109435000,108870000,109440000,"chr8",349788,0,1,1,2,"chr8",1,0.00187529301453352
"11090","chr8.42850000.42855000","chr8.42895000.42900000",45000,25,0.001057157,42850000,42895000,42855000,42900000,"chr8",349830,2,2,6,10,"chr8",1,0.0293014533520863
"11091","chr8.12950000.12955000","chr8.13305000.13310000",355000,11,0.0008991707,12950000,13305000,12955000,13310000,"chr8",349843,1,3,2,6,"chr8",1,0.00773558368495077
"11092","chr8.53880000.53885000","chr8.54770000.54775000",890000,9,0.0001348082,53880000,54770000,53885000,54775000,"chr8",349873,0,3,1,4,"chr8",1,0.00421940928270042
"11093","chr8.81000000.81005000","chr8.81050000.81055000",50000,22,0.005166807,8.1e+07,81050000,81005000,81055000,"chr8",349901,0,2,1,3,"chr8",1,0.00773558368495077
"11094","chr8.102790000.102795000","chr8.102860000.102865000",70000,19,0.003120744,102790000,102860000,102795000,102865000,"chr8",349920,2,9,11,22,"chr8",1,0.0489920300046882
"11095","chr8.25180000.25185000","chr8.25240000.25245000",60000,22,0.0008119563,25180000,25240000,25185000,25245000,"chr8",349932,1,3,6,10,"chr8",1,0.0257852789498359
"11096","chr8.93090000.93095000","chr8.93935000.93940000",845000,7,0.007277853,93090000,93935000,93095000,93940000,"chr8",350053,0,0,3,3,"chr8",1,0.00246132208157525
"11097","chr8.29000000.29005000","chr8.29100000.29105000",100000,17,0.001226167,2.9e+07,29100000,29005000,29105000,"chr8",350084,0,1,2,3,"chr8",1,0.0059774964838256
"11098","chr8.10960000.10965000","chr8.10990000.10995000",30000,34,0.0001589027,10960000,10990000,10965000,10995000,"chr8",350113,1,4,5,10,"chr8",1,0.0398499765588373
"11099","chr8.25255000.25260000","chr8.25295000.25300000",40000,32,4.94608e-06,25255000,25295000,25260000,25300000,"chr8",350163,5,8,1,14,"chr8",1,0.0525082044069386
"11100","chr8.30600000.30605000","chr8.30665000.30670000",65000,20,0.002418698,30600000,30665000,30605000,30670000,"chr8",350190,0,4,1,5,"chr8",1,0.0117205813408345
"11101","chr8.97350000.97355000","chr8.98005000.98010000",655000,9,0.0008501526,97350000,98005000,97355000,98010000,"chr8",350232,0,1,1,2,"chr8",1,0.00210970464135021
"11102","chr8.27760000.27765000","chr8.27870000.27875000",110000,15,0.005436739,27760000,27870000,27765000,27875000,"chr8",350337,2,4,2,8,"chr8",1,0.0140646976090014
"11103","chr8.102920000.102925000","chr8.102965000.102970000",45000,24,0.002548628,102920000,102965000,102925000,102970000,"chr8",350369,5,15,10,30,"chr8",1,0.0843881856540084
"11104","chr8.12935000.12940000","chr8.13130000.13135000",195000,19,2.16758e-07,12935000,13130000,12940000,13135000,"chr8",350372,2,2,1,5,"chr8",1,0.0111345522737928
"11105","chr8.86355000.86360000","chr8.87040000.87045000",685000,24,2.711056e-20,86355000,87040000,86360000,87045000,"chr8",350411,0,0,2,2,"chr8",1,0.00562587904360056
"11106","chr8.38120000.38125000","chr8.38230000.38235000",110000,18,0.0001705869,38120000,38230000,38125000,38235000,"chr8",350464,6,21,15,42,"chr8",1,0.0886075949367089
"11107","chr8.42295000.42300000","chr8.42525000.42530000",230000,14,0.0001589027,42295000,42525000,42300000,42530000,"chr8",350637,0,13,9,22,"chr8",1,0.0360993905297703
"11108","chr8.124280000.124285000","chr8.124770000.124775000",490000,10,0.0008102453,124280000,124770000,124285000,124775000,"chr8",350698,0,1,2,3,"chr8",1,0.00351617440225035
"11109","chr8.109260000.109265000","chr8.109600000.109605000",340000,10,0.004670941,109260000,109600000,109265000,109605000,"chr8",350836,0,2,1,3,"chr8",1,0.00351617440225035
"11110","chr8.80135000.80140000","chr8.80230000.80235000",95000,16,0.005201811,80135000,80230000,80140000,80235000,"chr8",350948,3,8,10,21,"chr8",1,0.0393811533052039
"11111","chr8.124535000.124540000","chr8.124705000.124710000",170000,15,0.0003740464,124535000,124705000,124540000,124710000,"chr8",350980,1,0,1,2,"chr8",1,0.00351617440225035
"11112","chr8.22025000.22030000","chr8.22095000.22100000",70000,21,0.0004055938,22025000,22095000,22030000,22100000,"chr8",350985,1,9,3,13,"chr8",1,0.0319971870604782
"11113","chr8.25005000.25010000","chr8.25300000.25305000",295000,11,0.002350579,25005000,25300000,25010000,25305000,"chr8",351130,4,10,16,30,"chr8",1,0.0386779184247539
"11114","chr8.23160000.23165000","chr8.23260000.23265000",100000,22,1.94579e-06,23160000,23260000,23165000,23265000,"chr8",351147,2,4,7,13,"chr8",1,0.0335208626347867
"11115","chr8.12950000.12955000","chr8.13510000.13515000",560000,10,0.0003708657,12950000,13510000,12955000,13515000,"chr8",351165,1,4,0,5,"chr8",1,0.00586029067041725
"11116","chr8.28465000.28470000","chr8.29125000.29130000",660000,8,0.004384745,28465000,29125000,28470000,29130000,"chr8",351373,2,1,3,6,"chr8",1,0.00562587904360056
"11117","chr8.65560000.65565000","chr8.66460000.66465000",900000,8,0.000899081,65560000,66460000,65565000,66465000,"chr8",351389,2,4,5,11,"chr8",1,0.0103141115799344
"11118","chr8.124835000.124840000","chr8.125380000.125385000",545000,13,1.390187e-06,124835000,125380000,124840000,125385000,"chr8",351403,3,15,9,27,"chr8",1,0.0411392405063291
"11119","chr8.124485000.124490000","chr8.124795000.124800000",310000,16,3.955995e-07,124485000,124795000,124490000,124800000,"chr8",351540,0,7,3,10,"chr8",1,0.0187529301453352
"11120","chr8.38075000.38080000","chr8.38175000.38180000",100000,20,3.117949e-05,38075000,38175000,38080000,38180000,"chr8",351630,2,8,12,22,"chr8",1,0.0515705578996718
"11121","chr8.102920000.102925000","chr8.103020000.103025000",100000,17,0.001226167,102920000,103020000,102925000,103025000,"chr8",351652,2,0,4,6,"chr8",1,0.0119549929676512
"11122","chr8.38030000.38035000","chr8.38175000.38180000",145000,18,1.909178e-05,38030000,38175000,38035000,38180000,"chr8",351659,4,2,10,16,"chr8",1,0.0337552742616034
"11123","chr8.124815000.124820000","chr8.125425000.125430000",610000,8,0.006247209,124815000,125425000,124820000,125430000,"chr8",351685,0,3,6,9,"chr8",1,0.00843881856540084
"11124","chr8.1690000.1695000","chr8.1985000.1990000",295000,12,0.0005562847,1690000,1985000,1695000,1990000,"chr8",351731,1,4,1,6,"chr8",1,0.00843881856540084
"11125","chr8.27315000.27320000","chr8.27465000.27470000",150000,16,0.0002417577,27315000,27465000,27320000,27470000,"chr8",351761,0,2,1,3,"chr8",1,0.00562587904360056
"11126","chr8.65560000.65565000","chr8.65830000.65835000",270000,12,0.0009500649,65560000,65830000,65565000,65835000,"chr8",351784,2,4,4,10,"chr8",1,0.0140646976090014
"11127","chr8.26230000.26235000","chr8.26370000.26375000",140000,14,0.004244205,26230000,26370000,26235000,26375000,"chr8",351790,3,4,5,12,"chr8",1,0.019690576652602
"11128","chr8.101575000.101580000","chr8.101830000.101835000",255000,13,0.000325834,101575000,101830000,101580000,101835000,"chr8",351953,1,2,1,4,"chr8",1,0.00609470229723394
"11129","chr8.118460000.118465000","chr8.119450000.119455000",990000,9,6.033298e-05,118460000,119450000,118465000,119455000,"chr8",352019,0,0,2,2,"chr8",1,0.00210970464135021
"11130","chr8.27635000.27640000","chr8.28465000.28470000",830000,7,0.007757695,27635000,28465000,27640000,28470000,"chr8",352061,5,6,18,29,"chr8",1,0.023792780121894
"11131","chr8.12990000.12995000","chr8.13100000.13105000",110000,16,0.001861363,12990000,13100000,12995000,13105000,"chr8",352070,4,11,4,19,"chr8",1,0.0356305672761369
"11132","chr8.25195000.25200000","chr8.25255000.25260000",60000,22,0.0008119563,25195000,25255000,25200000,25260000,"chr8",352223,5,8,1,14,"chr8",1,0.0360993905297703
"11133","chr8.25170000.25175000","chr8.25250000.25255000",80000,18,0.002638415,25170000,25250000,25175000,25255000,"chr8",352353,4,12,13,29,"chr8",1,0.0611814345991561
"11134","chr8.12950000.12955000","chr8.12990000.12995000",40000,27,0.0007227759,12950000,12990000,12955000,12995000,"chr8",352375,4,6,4,14,"chr8",1,0.0443037974683544
"11135","chr8.10760000.10765000","chr8.10840000.10845000",80000,20,0.0003122206,10760000,10840000,10765000,10845000,"chr8",352394,1,1,2,4,"chr8",1,0.00937646507266761
"11136","chr8.27320000.27325000","chr8.27490000.27495000",170000,17,2.178901e-05,27320000,27490000,27325000,27495000,"chr8",352395,1,3,3,7,"chr8",1,0.0139474917955931
"11137","chr8.67025000.67030000","chr8.67340000.67345000",315000,17,4.933465e-08,67025000,67340000,67030000,67345000,"chr8",352422,1,1,3,5,"chr8",1,0.00996249413970933
"11138","chr8.125160000.125165000","chr8.125385000.125390000",225000,14,0.000185959,125160000,125385000,125165000,125390000,"chr8",352440,2,5,3,10,"chr8",1,0.0164088138771683
"11139","chr8.124615000.124620000","chr8.124690000.124695000",75000,18,0.004478185,124615000,124690000,124620000,124695000,"chr8",352462,0,2,1,3,"chr8",1,0.00632911392405063
"11140","chr8.20285000.20290000","chr8.21095000.21100000",810000,10,3.287331e-05,20285000,21095000,20290000,21100000,"chr8",352483,1,3,5,9,"chr8",1,0.0105485232067511
"11141","chr8.25035000.25040000","chr8.25295000.25300000",260000,11,0.004638761,25035000,25295000,25040000,25300000,"chr8",352504,9,29,25,63,"chr8",1,0.0812236286919831
"11142","chr8.70125000.70130000","chr8.70160000.70165000",35000,29,0.0008245461,70125000,70160000,70130000,70165000,"chr8",352527,0,2,1,3,"chr8",1,0.010196905766526
"11143","chr8.13025000.13030000","chr8.13080000.13085000",55000,21,0.005023343,13025000,13080000,13030000,13085000,"chr8",352603,4,10,3,17,"chr8",1,0.0418424753867792
"11144","chr8.101150000.101155000","chr8.101575000.101580000",425000,10,0.001703929,101150000,101575000,101155000,101580000,"chr8",352614,1,2,1,4,"chr8",1,0.0046882325363338
"11145","chr8.27485000.27490000","chr8.27575000.27580000",90000,21,2.609991e-05,27485000,27575000,27490000,27580000,"chr8",352627,2,2,6,10,"chr8",1,0.0246132208157525
"11146","chr8.29000000.29005000","chr8.29170000.29175000",170000,26,2.522766e-12,2.9e+07,29170000,29005000,29175000,"chr8",352685,0,1,2,3,"chr8",1,0.00914205344585091
"11147","chr8.11275000.11280000","chr8.11410000.11415000",135000,15,0.001668762,11275000,11410000,11280000,11415000,"chr8",352791,2,4,3,9,"chr8",1,0.0158227848101266
"11148","chr8.17530000.17535000","chr8.17575000.17580000",45000,26,0.0004184018,17530000,17575000,17535000,17580000,"chr8",352826,1,4,1,6,"chr8",1,0.0182841068917018
"11149","chr8.42840000.42845000","chr8.42900000.42905000",60000,27,2.894129e-06,42840000,42900000,42845000,42905000,"chr8",352864,3,4,13,20,"chr8",1,0.0632911392405063
"11150","chr8.25035000.25040000","chr8.25255000.25260000",220000,12,0.003413382,25035000,25255000,25040000,25260000,"chr8",353004,5,8,1,14,"chr8",1,0.019690576652602
"11151","chr8.101855000.101860000","chr8.102270000.102275000",415000,10,0.001904561,101855000,102270000,101860000,102275000,"chr8",353029,1,4,1,6,"chr8",1,0.0070323488045007
"11152","chr8.19755000.19760000","chr8.19775000.19780000",20000,37,0.002977958,19755000,19775000,19760000,19780000,"chr8",353103,0,2,1,3,"chr8",1,0.0130098452883263
"11153","chr9.133345000.133350000","chr9.133555000.133560000",210000,14,0.0002975622,133345000,133555000,133350000,133560000,"chr9",353184,0,0,1,1,"chr9",1,0.00164088138771683
"11154","chr9.127695000.127700000","chr9.127895000.127900000",200000,16,2.403365e-05,127695000,127895000,127700000,127900000,"chr9",353197,1,1,1,3,"chr9",1,0.00562587904360056
"11155","chr9.80885000.80890000","chr9.80930000.80935000",45000,24,0.001811606,80885000,80930000,80890000,80935000,"chr9",353199,0,0,4,4,"chr9",1,0.0112517580872011
"11156","chr9.87370000.87375000","chr9.87390000.87395000",20000,34,0.008189353,87370000,87390000,87375000,87395000,"chr9",353222,0,5,4,9,"chr9",1,0.0358649789029536
"11157","chr9.37480000.37485000","chr9.37590000.37595000",110000,28,3.847625e-11,37480000,37590000,37485000,37595000,"chr9",353345,6,9,6,21,"chr9",1,0.0689170182841069
"11158","chr9.19050000.19055000","chr9.19460000.19465000",410000,10,0.001730514,19050000,19460000,19055000,19465000,"chr9",353346,1,4,2,7,"chr9",1,0.00820440693858415
"11159","chr9.33620000.33625000","chr9.33775000.33780000",155000,13,0.007211927,33620000,33775000,33625000,33780000,"chr9",353353,0,1,3,4,"chr9",1,0.00609470229723394
"11160","chr9.510000.515000","chr9.530000.535000",20000,40,0.0001222207,510000,530000,515000,535000,"chr9",353367,4,5,3,12,"chr9",1,0.0562587904360056
"11161","chr9.76300000.76305000","chr9.77165000.77170000",865000,13,1.404401e-08,76300000,77165000,76305000,77170000,"chr9",353382,1,6,6,13,"chr9",1,0.0198077824660103
"11162","chr9.27335000.27340000","chr9.27460000.27465000",125000,15,0.00250834,27335000,27460000,27340000,27465000,"chr9",353450,0,1,0,1,"chr9",1,0.00175808720112518
"11163","chr9.131105000.131110000","chr9.131175000.131180000",70000,25,2.857284e-06,131105000,131175000,131110000,131180000,"chr9",353453,5,4,4,13,"chr9",1,0.0380918893577121
"11164","chr9.27335000.27340000","chr9.27465000.27470000",130000,15,0.001998692,27335000,27465000,27340000,27470000,"chr9",353520,0,1,3,4,"chr9",1,0.0070323488045007
"11165","chr9.34895000.34900000","chr9.34995000.35000000",100000,22,2.01043e-06,34895000,34995000,34900000,3.5e+07,"chr9",353631,0,2,1,3,"chr9",1,0.00773558368495077
"11166","chr9.27340000.27345000","chr9.27465000.27470000",125000,15,0.00250834,27340000,27465000,27345000,27470000,"chr9",353698,1,2,3,6,"chr9",1,0.0105485232067511
"11167","chr9.19100000.19105000","chr9.19460000.19465000",360000,15,7.115819e-07,19100000,19460000,19105000,19465000,"chr9",353719,4,6,5,15,"chr9",1,0.0263713080168776
"11168","chr9.127750000.127755000","chr9.127820000.127825000",70000,22,0.0001098406,127750000,127820000,127755000,127825000,"chr9",353728,1,1,1,3,"chr9",1,0.00773558368495077
"11169","chr9.36245000.36250000","chr9.36315000.36320000",70000,41,2.334759e-17,36245000,36315000,36250000,36320000,"chr9",353759,1,15,9,25,"chr9",1,0.120135958743554
"11170","chr9.625000.630000","chr9.735000.740000",110000,20,1.232593e-05,625000,735000,630000,740000,"chr9",353788,0,4,0,4,"chr9",1,0.00937646507266761
"11171","chr9.35955000.35960000","chr9.36165000.36170000",210000,25,8.561599e-13,35955000,36165000,35960000,36170000,"chr9",353796,3,10,10,23,"chr9",1,0.0673933427097984
"11172","chr9.97550000.97555000","chr9.97710000.97715000",160000,15,0.0005590965,97550000,97710000,97555000,97715000,"chr9",353804,0,2,0,2,"chr9",1,0.00351617440225035
"11173","chr9.12775000.12780000","chr9.12815000.12820000",40000,25,0.002563108,12775000,12815000,12780000,12820000,"chr9",353810,0,0,1,1,"chr9",1,0.00293014533520863
"11174","chr9.36190000.36195000","chr9.36215000.36220000",25000,38,9.267601e-05,36190000,36215000,36195000,36220000,"chr9",353812,0,3,3,6,"chr9",1,0.0267229254571027
"11175","chr9.38660000.38665000","chr9.38685000.38690000",25000,38,9.267601e-05,38660000,38685000,38665000,38690000,"chr9",353815,0,0,7,7,"chr9",1,0.0311767463666198
"11176","chr9.34755000.34760000","chr9.35115000.35120000",360000,10,0.003192558,34755000,35115000,34760000,35120000,"chr9",353837,4,10,6,20,"chr9",1,0.023441162681669
"11177","chr9.27330000.27335000","chr9.27370000.27375000",40000,33,9.518485e-07,27330000,27370000,27335000,27375000,"chr9",353850,0,1,1,2,"chr9",1,0.00773558368495077
"11178","chr9.97535000.97540000","chr9.97800000.97805000",265000,12,0.0009836041,97535000,97800000,97540000,97805000,"chr9",353984,1,3,4,8,"chr9",1,0.0112517580872011
"11179","chr9.5630000.5635000","chr9.5750000.5755000",120000,20,5.433504e-06,5630000,5750000,5635000,5755000,"chr9",353989,1,5,4,10,"chr9",1,0.023441162681669
"11180","chr9.128315000.128320000","chr9.128405000.128410000",90000,17,0.00256988,128315000,128405000,128320000,128410000,"chr9",354027,6,14,13,33,"chr9",1,0.0657524613220816
"11181","chr9.35160000.35165000","chr9.35535000.35540000",375000,12,0.000118489,35160000,35535000,35165000,35540000,"chr9",354032,0,9,2,11,"chr9",1,0.0154711673699015
"11182","chr9.33775000.33780000","chr9.33850000.33855000",75000,29,3.768929e-09,33775000,33850000,33780000,33855000,"chr9",354057,0,4,8,12,"chr9",1,0.0407876230661041
"11183","chr9.34430000.34435000","chr9.34470000.34475000",40000,24,0.005626903,34430000,34470000,34435000,34475000,"chr9",354058,12,25,22,59,"chr9",1,0.165963431786217
"11184","chr9.20980000.20985000","chr9.21030000.21035000",50000,25,0.0002489968,20980000,21030000,20985000,21035000,"chr9",354084,0,4,2,6,"chr9",1,0.0175808720112518
"11185","chr9.99100000.99105000","chr9.99140000.99145000",40000,54,6.615694e-20,99100000,99140000,99105000,99145000,"chr9",354086,1,0,0,1,"chr9",1,0.00632911392405063
"11186","chr9.97560000.97565000","chr9.97875000.97880000",315000,14,1.250034e-05,97560000,97875000,97565000,97880000,"chr9",354093,1,7,5,13,"chr9",1,0.0213314580403188
"11187","chr9.113405000.113410000","chr9.114055000.114060000",650000,25,3.572302e-21,113405000,114055000,113410000,114060000,"chr9",354111,2,0,0,2,"chr9",1,0.00586029067041725
"11188","chr9.134025000.134030000","chr9.134215000.134220000",190000,12,0.007342334,134025000,134215000,134030000,134220000,"chr9",354116,0,0,2,2,"chr9",1,0.00281293952180028
"11189","chr9.127735000.127740000","chr9.127895000.127900000",160000,13,0.006049966,127735000,127895000,127740000,127900000,"chr9",354140,0,1,1,2,"chr9",1,0.00304735114861697
"11190","chr9.33445000.33450000","chr9.33510000.33515000",65000,23,8.55857e-05,33445000,33510000,33450000,33515000,"chr9",354154,4,2,5,11,"chr9",1,0.0296530707923113
"11191","chr9.109390000.109395000","chr9.109915000.109920000",525000,11,7.709735e-05,109390000,109915000,109395000,109920000,"chr9",354173,1,6,5,12,"chr9",1,0.0154711673699015
"11192","chr9.15275000.15280000","chr9.15485000.15490000",210000,14,0.0002975622,15275000,15485000,15280000,15490000,"chr9",354236,0,8,7,15,"chr9",1,0.0246132208157525
"11193","chr9.95425000.95430000","chr9.95525000.95530000",100000,15,0.009266319,95425000,95525000,95430000,95530000,"chr9",354301,0,4,5,9,"chr9",1,0.0158227848101266
"11194","chr9.35755000.35760000","chr9.35825000.35830000",70000,31,5.916484e-10,35755000,35825000,35760000,35830000,"chr9",354346,0,1,0,1,"chr9",1,0.0036333802156587
"11195","chr9.35160000.35165000","chr9.35950000.35955000",790000,7,0.00789003,35160000,35950000,35165000,35955000,"chr9",354382,0,3,1,4,"chr9",1,0.00328176277543366
"11196","chr9.129820000.129825000","chr9.129880000.129885000",60000,23,0.0002307877,129820000,129880000,129825000,129885000,"chr9",354395,1,9,9,19,"chr9",1,0.0512189404594468
"11197","chr9.27275000.27280000","chr9.27570000.27575000",295000,17,9.31175e-08,27275000,27570000,27280000,27575000,"chr9",354422,1,6,5,12,"chr9",1,0.0239099859353024
"11198","chr9.129735000.129740000","chr9.129960000.129965000",225000,14,0.0001782955,129735000,129960000,129740000,129965000,"chr9",354427,0,8,4,12,"chr9",1,0.019690576652602
"11199","chr9.35645000.35650000","chr9.35880000.35885000",235000,16,5.221609e-06,35645000,35880000,35650000,35885000,"chr9",354431,1,6,6,13,"chr9",1,0.0243788091889358
"11200","chr9.35785000.35790000","chr9.35880000.35885000",95000,44,1.316882e-23,35785000,35880000,35790000,35885000,"chr9",354473,4,11,11,26,"chr9",1,0.134083450539147
"11201","chr9.129735000.129740000","chr9.129880000.129885000",145000,14,0.003428833,129735000,129880000,129740000,129885000,"chr9",354521,1,8,6,15,"chr9",1,0.0246132208157525
"11202","chr9.37590000.37595000","chr9.37900000.37905000",310000,14,1.402465e-05,37590000,37900000,37595000,37905000,"chr9",354553,8,15,14,37,"chr9",1,0.0607126113455227
"11203","chr9.34125000.34130000","chr9.34325000.34330000",200000,19,1.737447e-07,34125000,34325000,34130000,34330000,"chr9",354556,5,12,16,33,"chr9",1,0.0734880450070323
"11204","chr9.130830000.130835000","chr9.130870000.130875000",40000,31,8.651292e-06,130830000,130870000,130835000,130875000,"chr9",354688,1,4,2,7,"chr9",1,0.0254336615096109
"11205","chr9.19100000.19105000","chr9.19455000.19460000",355000,18,1.952625e-09,19100000,19455000,19105000,19460000,"chr9",354722,4,8,9,21,"chr9",1,0.0443037974683544
"11206","chr9.27380000.27385000","chr9.27530000.27535000",150000,19,3.324998e-06,27380000,27530000,27385000,27535000,"chr9",354736,1,4,1,6,"chr9",1,0.0133614627285513
"11207","chr9.33775000.33780000","chr9.34080000.34085000",305000,10,0.006775515,33775000,34080000,33780000,34085000,"chr9",354737,0,4,8,12,"chr9",1,0.0140646976090014
"11208","chr9.37910000.37915000","chr9.38055000.38060000",145000,16,0.0002980543,37910000,38055000,37915000,38060000,"chr9",354743,0,1,1,2,"chr9",1,0.00375058602906704
"11209","chr9.35945000.35950000","chr9.36075000.36080000",130000,16,0.0006153273,35945000,36075000,35950000,36080000,"chr9",354747,6,5,5,16,"chr9",1,0.0300046882325363
"11210","chr9.36145000.36150000","chr9.36165000.36170000",20000,58,1.468009e-12,36145000,36165000,36150000,36170000,"chr9",354758,0,1,0,1,"chr9",1,0.00679793717768401
"11211","chr9.131960000.131965000","chr9.132240000.132245000",280000,11,0.002783355,131960000,132240000,131965000,132245000,"chr9",354775,2,2,1,5,"chr9",1,0.00644631973745898
"11212","chr9.117175000.117180000","chr9.117405000.117410000",230000,16,6.485356e-06,117175000,117405000,117180000,117410000,"chr9",354786,2,2,3,7,"chr9",1,0.0131270511017346
"11213","chr9.35115000.35120000","chr9.35160000.35165000",45000,77,1.396587e-41,35115000,35160000,35120000,35165000,"chr9",354810,0,9,2,11,"chr9",1,0.0992733239568683
"11214","chr9.128420000.128425000","chr9.129025000.129030000",605000,12,3.745615e-06,128420000,129025000,128425000,129030000,"chr9",354814,0,7,7,14,"chr9",1,0.019690576652602
"11215","chr9.3180000.3185000","chr9.3205000.3210000",25000,33,0.003975955,3180000,3205000,3185000,3210000,"chr9",354817,0,1,3,4,"chr9",1,0.0154711673699015
"11216","chr9.121610000.121615000","chr9.121630000.121635000",20000,35,0.004328284,121610000,121630000,121615000,121635000,"chr9",354830,3,10,2,15,"chr9",1,0.0615330520393812
"11217","chr9.111955000.111960000","chr9.112100000.112105000",145000,14,0.003428833,111955000,112100000,111960000,112105000,"chr9",354832,1,10,10,21,"chr9",1,0.0344585091420534
"11218","chr9.77440000.77445000","chr9.77520000.77525000",80000,17,0.006071643,77440000,77520000,77445000,77525000,"chr9",354851,1,8,5,14,"chr9",1,0.0278949835911861
"11219","chr9.19045000.19050000","chr9.19455000.19460000",410000,28,5.446476e-21,19045000,19455000,19050000,19460000,"chr9",354861,4,8,9,21,"chr9",1,0.0689170182841069
"11220","chr9.13425000.13430000","chr9.14180000.14185000",755000,8,0.00183715,13425000,14180000,13430000,14185000,"chr9",354868,1,2,6,9,"chr9",1,0.00843881856540084
"11221","chr9.131420000.131425000","chr9.131445000.131450000",25000,34,0.001998692,131420000,131445000,131425000,131450000,"chr9",354884,2,15,10,27,"chr9",1,0.107594936708861
"11222","chr9.113410000.113415000","chr9.114035000.114040000",625000,8,0.004574059,113410000,114035000,113415000,114040000,"chr9",354892,0,3,4,7,"chr9",1,0.00656352555086732
"11223","chr9.37745000.37750000","chr9.38360000.38365000",615000,10,0.0001676159,37745000,38360000,37750000,38365000,"chr9",354911,0,2,0,2,"chr9",1,0.0023441162681669
"11224","chr9.33025000.33030000","chr9.33075000.33080000",50000,37,8.983216e-11,33025000,33075000,33030000,33080000,"chr9",354924,3,7,9,19,"chr9",1,0.0823956868260666
"11225","chr9.27465000.27470000","chr9.27530000.27535000",65000,28,1.686854e-07,27465000,27530000,27470000,27535000,"chr9",354959,1,2,3,6,"chr9",1,0.019690576652602
"11226","chr9.27350000.27355000","chr9.27425000.27430000",75000,28,1.643611e-08,27350000,27425000,27355000,27430000,"chr9",354980,0,3,2,5,"chr9",1,0.0164088138771683
"11227","chr9.26945000.26950000","chr9.27545000.27550000",600000,8,0.005528498,26945000,27545000,26950000,27550000,"chr9",354989,0,1,1,2,"chr9",1,0.00187529301453352
"11228","chr9.131405000.131410000","chr9.131695000.131700000",290000,13,0.0001204897,131405000,131695000,131410000,131700000,"chr9",355030,0,2,0,2,"chr9",1,0.00304735114861697
"11229","chr9.6015000.6020000","chr9.6410000.6415000",395000,13,1.471919e-05,6015000,6410000,6020000,6415000,"chr9",355033,0,4,16,20,"chr9",1,0.0304735114861697
"11230","chr9.37910000.37915000","chr9.38080000.38085000",170000,26,3.262252e-12,37910000,38080000,37915000,38085000,"chr9",355041,4,18,7,29,"chr9",1,0.0883731833098922
"11231","chr9.37905000.37910000","chr9.38080000.38085000",175000,13,0.003720896,37905000,38080000,37910000,38085000,"chr9",355043,4,4,3,11,"chr9",1,0.0167604313173933
"11232","chr9.32580000.32585000","chr9.33000000.33005000",420000,16,2.50895e-08,32580000,3.3e+07,32585000,33005000,"chr9",355045,1,7,7,15,"chr9",1,0.0281293952180028
"11233","chr9.112705000.112710000","chr9.112850000.112855000",145000,18,1.98135e-05,112705000,112850000,112710000,112855000,"chr9",355063,2,1,3,6,"chr9",1,0.0126582278481013
"11234","chr9.27370000.27375000","chr9.27425000.27430000",55000,30,2.167552e-07,27370000,27425000,27375000,27430000,"chr9",355082,0,1,1,2,"chr9",1,0.0070323488045007
"11235","chr9.123385000.123390000","chr9.123470000.123475000",85000,56,8.270544e-34,123385000,123470000,123390000,123475000,"chr9",355094,0,2,1,3,"chr9",1,0.019690576652602
"11236","chr9.131960000.131965000","chr9.132140000.132145000",180000,12,0.009753831,131960000,132140000,131965000,132145000,"chr9",355108,0,2,1,3,"chr9",1,0.00421940928270042
"11237","chr9.109400000.109405000","chr9.109425000.109430000",25000,40,1.673511e-05,109400000,109425000,109405000,109430000,"chr9",355115,6,7,9,22,"chr9",1,0.103141115799344
"11238","chr9.690000.695000","chr9.760000.765000",70000,19,0.002563108,690000,760000,695000,765000,"chr9",355144,3,6,6,15,"chr9",1,0.0334036568213783
"11239","chr9.21315000.21320000","chr9.21785000.21790000",470000,10,0.000839495,21315000,21785000,21320000,21790000,"chr9",355163,2,1,2,5,"chr9",1,0.00586029067041725
"11240","chr9.35115000.35120000","chr9.35475000.35480000",360000,45,1.17827e-41,35115000,35475000,35120000,35480000,"chr9",355179,4,14,7,25,"chr9",1,0.131856540084388
"11241","chr9.34330000.34335000","chr9.34380000.34385000",50000,43,8.984598e-15,34330000,34380000,34335000,34385000,"chr9",355180,0,1,2,3,"chr9",1,0.0151195499296765
"11242","chr9.127740000.127745000","chr9.127780000.127785000",40000,31,8.651292e-06,127740000,127780000,127745000,127785000,"chr9",355212,0,8,10,18,"chr9",1,0.0654008438818565
"11243","chr9.35115000.35120000","chr9.35275000.35280000",160000,28,1.548192e-13,35115000,35275000,35120000,35280000,"chr9",355239,3,4,3,10,"chr9",1,0.0328176277543366
"11244","chr9.101080000.101085000","chr9.101525000.101530000",445000,10,0.001127333,101080000,101525000,101085000,101530000,"chr9",355268,0,8,3,11,"chr9",1,0.012892639474918
"11245","chr9.6350000.6355000","chr9.6575000.6580000",225000,28,3.424673e-16,6350000,6575000,6355000,6580000,"chr9",355307,8,12,14,34,"chr9",1,0.111579934364744
"11246","chr9.27330000.27335000","chr9.27480000.27485000",150000,16,0.000239298,27330000,27480000,27335000,27485000,"chr9",355311,2,3,4,9,"chr9",1,0.0168776371308017
"11247","chr9.8485000.8490000","chr9.8875000.8880000",390000,10,0.002228101,8485000,8875000,8490000,8880000,"chr9",355327,4,3,5,12,"chr9",1,0.0140646976090014
"11248","chr9.18435000.18440000","chr9.19010000.19015000",575000,9,0.001407349,18435000,19010000,18440000,19015000,"chr9",355352,0,4,5,9,"chr9",1,0.00949367088607595
"11249","chr9.560000.565000","chr9.725000.730000",165000,14,0.001608977,560000,725000,565000,730000,"chr9",355379,0,0,5,5,"chr9",1,0.00820440693858415
"11250","chr9.690000.695000","chr9.735000.740000",45000,29,1.326022e-05,690000,735000,695000,740000,"chr9",355437,2,4,6,12,"chr9",1,0.0407876230661041
"11251","chr9.87320000.87325000","chr9.87565000.87570000",245000,19,1.592817e-08,87320000,87565000,87325000,87570000,"chr9",355466,0,0,1,1,"chr9",1,0.00222691045475856
"11252","chr9.129100000.129105000","chr9.129125000.129130000",25000,32,0.007548942,129100000,129125000,129105000,129130000,"chr9",355477,0,5,5,10,"chr9",1,0.0375058602906704
"11253","chr9.35160000.35165000","chr9.35275000.35280000",115000,20,8.152305e-06,35160000,35275000,35165000,35280000,"chr9",355504,0,4,2,6,"chr9",1,0.0140646976090014
"11254","chr9.91680000.91685000","chr9.91845000.91850000",165000,13,0.00509474,91680000,91845000,91685000,91850000,"chr9",355598,1,3,1,5,"chr9",1,0.00761837787154243
"11255","chr9.107635000.107640000","chr9.107915000.107920000",280000,11,0.002783355,107635000,107915000,107640000,107920000,"chr9",355631,0,2,2,4,"chr9",1,0.00515705578996718
"11256","chr9.129725000.129730000","chr9.129885000.129890000",160000,13,0.006049966,129725000,129885000,129730000,129890000,"chr9",355675,0,1,1,2,"chr9",1,0.00304735114861697
"11257","chr9.4760000.4765000","chr9.5425000.5430000",665000,9,0.0006261349,4760000,5425000,4765000,5430000,"chr9",355685,3,2,6,11,"chr9",1,0.0116033755274262
"11258","chr9.6575000.6580000","chr9.6615000.6620000",40000,27,0.0004637667,6575000,6615000,6580000,6620000,"chr9",355694,6,12,11,29,"chr9",1,0.0917721518987342
"11259","chr9.35825000.35830000","chr9.35880000.35885000",55000,45,2.269005e-17,35825000,35880000,35830000,35885000,"chr9",355709,0,6,4,10,"chr9",1,0.0527426160337553
"11260","chr9.96155000.96160000","chr9.96175000.96180000",20000,44,4.119536e-06,96155000,96175000,96160000,96180000,"chr9",355755,1,7,7,15,"chr9",1,0.0773558368495077
"11261","chr9.133385000.133390000","chr9.133405000.133410000",20000,45,1.667871e-06,133385000,133405000,133390000,133410000,"chr9",355767,0,5,4,9,"chr9",1,0.0474683544303797
"11262","chr9.35050000.35055000","chr9.35475000.35480000",425000,10,0.00142954,35050000,35475000,35055000,35480000,"chr9",355806,4,14,7,25,"chr9",1,0.0293014533520863
"11263","chr9.35115000.35120000","chr9.35610000.35615000",495000,11,0.0001123886,35115000,35610000,35120000,35615000,"chr9",355823,3,11,8,22,"chr9",1,0.0283638068448195
"11264","chr9.19455000.19460000","chr9.19920000.19925000",465000,26,1.247912e-19,19455000,19920000,19460000,19925000,"chr9",355846,0,3,9,12,"chr9",1,0.0365682137834037
"11265","chr9.128605000.128610000","chr9.129025000.129030000",420000,9,0.006523488,128605000,129025000,128610000,129030000,"chr9",355849,1,7,5,13,"chr9",1,0.0137130801687764
"11266","chr9.19485000.19490000","chr9.19890000.19895000",405000,11,0.0003899077,19485000,19890000,19490000,19895000,"chr9",355852,5,14,23,42,"chr9",1,0.0541490857946554
"11267","chr9.89110000.89115000","chr9.89545000.89550000",435000,9,0.005547679,89110000,89545000,89115000,89550000,"chr9",355865,1,3,3,7,"chr9",1,0.00738396624472574
"11268","chr9.124305000.124310000","chr9.124750000.124755000",445000,33,5.651558e-28,124305000,124750000,124310000,124755000,"chr9",355877,0,3,0,3,"chr9",1,0.0116033755274262
"11269","chr9.131610000.131615000","chr9.131705000.131710000",95000,22,3.620408e-06,131610000,131705000,131615000,131710000,"chr9",355888,1,1,1,3,"chr9",1,0.00773558368495077
"11270","chr9.126890000.126895000","chr9.127030000.127035000",140000,14,0.004105485,126890000,127030000,126895000,127035000,"chr9",355918,1,3,6,10,"chr9",1,0.0164088138771683
"11271","chr9.19050000.19055000","chr9.19455000.19460000",405000,31,1.535979e-24,19050000,19455000,19055000,19460000,"chr9",355919,1,4,2,7,"chr9",1,0.0254336615096109
"11272","chr9.21250000.21255000","chr9.21395000.21400000",145000,15,0.001054106,21250000,21395000,21255000,21400000,"chr9",355931,1,3,2,6,"chr9",1,0.0105485232067511
"11273","chr9.127360000.127365000","chr9.127605000.127610000",245000,11,0.005803666,127360000,127605000,127365000,127610000,"chr9",355935,4,15,15,34,"chr9",1,0.0438349742147211
"11274","chr9.35160000.35165000","chr9.35515000.35520000",355000,14,5.104089e-06,35160000,35515000,35165000,35520000,"chr9",355941,0,3,2,5,"chr9",1,0.00820440693858415
"11275","chr9.117615000.117620000","chr9.117765000.117770000",150000,14,0.002786698,117615000,117765000,117620000,117770000,"chr9",355942,0,1,3,4,"chr9",1,0.00656352555086732
"11276","chr9.80045000.80050000","chr9.80370000.80375000",325000,14,9.960651e-06,80045000,80370000,80050000,80375000,"chr9",355970,1,4,3,8,"chr9",1,0.0131270511017346
"11277","chr9.131880000.131885000","chr9.132340000.132345000",460000,14,6.519928e-07,131880000,132340000,131885000,132345000,"chr9",355984,3,11,6,20,"chr9",1,0.0328176277543366
"11278","chr9.21325000.21330000","chr9.21395000.21400000",70000,34,4.985061e-12,21325000,21395000,21330000,21400000,"chr9",355998,3,2,7,12,"chr9",1,0.0478199718706048
"11279","chr9.19050000.19055000","chr9.19170000.19175000",120000,25,2.17468e-09,19050000,19170000,19055000,19175000,"chr9",356012,1,4,2,7,"chr9",1,0.0205110173464604
"11280","chr9.37900000.37905000","chr9.38020000.38025000",120000,18,8.576855e-05,37900000,38020000,37905000,38025000,"chr9",356040,0,7,1,8,"chr9",1,0.0168776371308017
"11281","chr9.32580000.32585000","chr9.32965000.32970000",385000,34,8.038929e-28,32580000,32965000,32585000,32970000,"chr9",356073,4,7,3,14,"chr9",1,0.0557899671823722
"11282","chr9.127545000.127550000","chr9.127575000.127580000",30000,28,0.009189652,127545000,127575000,127550000,127580000,"chr9",356141,0,8,1,9,"chr9",1,0.029535864978903
"11283","chr9.113410000.113415000","chr9.114385000.114390000",975000,8,0.0003634454,113410000,114385000,113415000,114390000,"chr9",356177,2,0,5,7,"chr9",1,0.00656352555086732
"11284","chr9.127525000.127530000","chr9.127605000.127610000",80000,17,0.006071643,127525000,127605000,127530000,127610000,"chr9",356184,0,3,4,7,"chr9",1,0.0139474917955931
"11285","chr9.97550000.97555000","chr9.97875000.97880000",325000,13,5.510568e-05,97550000,97875000,97555000,97880000,"chr9",356186,0,2,0,2,"chr9",1,0.00304735114861697
"11286","chr9.35095000.35100000","chr9.35550000.35555000",455000,16,1.131773e-08,35095000,35550000,35100000,35555000,"chr9",356188,1,9,3,13,"chr9",1,0.0243788091889358
"11287","chr9.625000.630000","chr9.755000.760000",130000,24,4.535764e-09,625000,755000,630000,760000,"chr9",356236,0,4,0,4,"chr9",1,0.0112517580872011
"11288","chr9.15100000.15105000","chr9.15135000.15140000",35000,29,0.0004939142,15100000,15135000,15105000,15140000,"chr9",356241,0,6,10,16,"chr9",1,0.0543834974214721
"11289","chr9.33045000.33050000","chr9.33075000.33080000",30000,45,7.616053e-10,33045000,33075000,33050000,33080000,"chr9",356249,2,11,10,23,"chr9",1,0.121308016877637
"11290","chr9.112330000.112335000","chr9.112555000.112560000",225000,11,0.009242184,112330000,112555000,112335000,112560000,"chr9",356272,1,0,0,1,"chr9",1,0.0012892639474918
"11291","chr9.35115000.35120000","chr9.35655000.35660000",540000,9,0.001963798,35115000,35655000,35120000,35660000,"chr9",356317,8,23,17,48,"chr9",1,0.0506329113924051
"11292","chr9.97550000.97555000","chr9.97675000.97680000",125000,17,0.0002314129,97550000,97675000,97555000,97680000,"chr9",356327,0,2,0,2,"chr9",1,0.00398499765588373
"11293","chr9.35660000.35665000","chr9.35730000.35735000",70000,20,0.0009601914,35660000,35730000,35665000,35735000,"chr9",356416,2,5,4,11,"chr9",1,0.0257852789498359
"11294","chr9.6585000.6590000","chr9.6615000.6620000",30000,29,0.004574059,6585000,6615000,6590000,6620000,"chr9",356423,5,6,4,15,"chr9",1,0.0509845288326301
"11295","chr9.37910000.37915000","chr9.37995000.38000000",85000,27,1.094393e-08,37910000,37995000,37915000,3.8e+07,"chr9",356427,2,2,4,8,"chr9",1,0.0253164556962025
"11296","chr9.695000.700000","chr9.745000.750000",50000,23,0.001642557,695000,745000,7e+05,750000,"chr9",356446,3,4,13,20,"chr9",1,0.0539146741678387
"11297","chr9.19055000.19060000","chr9.19380000.19385000",325000,11,0.001244522,19055000,19380000,19060000,19385000,"chr9",356457,1,1,0,2,"chr9",1,0.00257852789498359
"11298","chr9.33075000.33080000","chr9.33285000.33290000",210000,12,0.004121745,33075000,33285000,33080000,33290000,"chr9",356467,7,22,11,40,"chr9",1,0.0562587904360056
"11299","chr9.133685000.133690000","chr9.133915000.133920000",230000,16,6.485356e-06,133685000,133915000,133690000,133920000,"chr9",356480,0,1,0,1,"chr9",1,0.00187529301453352
"11300","chr9.19100000.19105000","chr9.19180000.19185000",80000,20,0.0002715766,19100000,19180000,19105000,19185000,"chr9",356505,8,24,29,61,"chr9",1,0.142991092358181
"11301","chr9.113410000.113415000","chr9.113645000.113650000",235000,11,0.007342334,113410000,113645000,113415000,113650000,"chr9",356536,2,0,2,4,"chr9",1,0.00515705578996718
"11302","chr9.128360000.128365000","chr9.128415000.128420000",55000,22,0.001629879,128360000,128415000,128365000,128420000,"chr9",356541,0,4,4,8,"chr9",1,0.0206282231598687
"11303","chr9.34645000.34650000","chr9.34985000.34990000",340000,10,0.004121745,34645000,34985000,34650000,34990000,"chr9",356543,0,4,1,5,"chr9",1,0.00586029067041725
"11304","chr9.36030000.36035000","chr9.36160000.36165000",130000,15,0.001998692,36030000,36160000,36035000,36165000,"chr9",356545,6,6,7,19,"chr9",1,0.0334036568213783
"11305","chr9.37905000.37910000","chr9.38045000.38050000",140000,16,0.0003833608,37905000,38045000,37910000,38050000,"chr9",356563,4,4,3,11,"chr9",1,0.0206282231598687
"11306","chr9.121925000.121930000","chr9.121950000.121955000",25000,36,0.0004653973,121925000,121950000,121930000,121955000,"chr9",356599,1,4,2,7,"chr9",1,0.029535864978903
"11307","chr9.27480000.27485000","chr9.27530000.27535000",50000,23,0.001642557,27480000,27530000,27485000,27535000,"chr9",356618,1,4,3,8,"chr9",1,0.0215658696671355
"11308","chr9.117275000.117280000","chr9.117340000.117345000",65000,21,0.0007267268,117275000,117340000,117280000,117345000,"chr9",356633,0,2,1,3,"chr9",1,0.00738396624472574
"11309","chr9.35160000.35165000","chr9.35335000.35340000",175000,21,2.537606e-08,35160000,35335000,35165000,35340000,"chr9",356667,0,8,2,10,"chr9",1,0.0246132208157525
"11310","chr9.27425000.27430000","chr9.27530000.27535000",105000,28,8.008298e-11,27425000,27530000,27430000,27535000,"chr9",356696,0,3,2,5,"chr9",1,0.0164088138771683
"11311","chr9.129995000.130000000","chr9.130180000.130185000",185000,12,0.008521915,129995000,130180000,1.3e+08,130185000,"chr9",356697,3,13,15,31,"chr9",1,0.0436005625879044
"11312","chr9.127695000.127700000","chr9.127965000.127970000",270000,11,0.003446136,127695000,127965000,127700000,127970000,"chr9",356770,9,22,18,49,"chr9",1,0.063173933427098
"11313","chr9.128170000.128175000","chr9.128990000.128995000",820000,9,0.0001793294,128170000,128990000,128175000,128995000,"chr9",356771,7,21,18,46,"chr9",1,0.0485232067510548
"11314","chr9.8650000.8655000","chr9.8845000.8850000",195000,13,0.001906131,8650000,8845000,8655000,8850000,"chr9",356786,6,7,3,16,"chr9",1,0.0243788091889358
"11315","chr9.505000.510000","chr9.530000.535000",25000,48,6.033839e-09,505000,530000,510000,535000,"chr9",356806,4,7,5,16,"chr9",1,0.090014064697609
"11316","chr9.20355000.20360000","chr9.20590000.20595000",235000,12,0.002100608,20355000,20590000,20360000,20595000,"chr9",356846,1,1,0,2,"chr9",1,0.00281293952180028
"11317","chr9.97650000.97655000","chr9.97875000.97880000",225000,12,0.002718392,97650000,97875000,97655000,97880000,"chr9",356853,1,7,2,10,"chr9",1,0.0140646976090014
"11318","chr9.27380000.27385000","chr9.27545000.27550000",165000,17,2.83942e-05,27380000,27545000,27385000,27550000,"chr9",356855,0,3,1,4,"chr9",1,0.00796999531176746
"11319","chr9.107915000.107920000","chr9.108140000.108145000",225000,11,0.009242184,107915000,108140000,107920000,108145000,"chr9",356878,0,5,2,7,"chr9",1,0.00902484763244257
"11320","chr9.38025000.38030000","chr9.38055000.38060000",30000,30,0.002262232,38025000,38055000,38030000,38060000,"chr9",356903,0,1,1,2,"chr9",1,0.0070323488045007
"11321","chr9.131960000.131965000","chr9.132250000.132255000",290000,10,0.008599966,131960000,132250000,131965000,132255000,"chr9",356970,2,2,1,5,"chr9",1,0.00586029067041725
"11322","chr9.8610000.8615000","chr9.8650000.8655000",40000,25,0.002563108,8610000,8650000,8615000,8655000,"chr9",356983,1,2,1,4,"chr9",1,0.0117205813408345
"11323","chr9.6585000.6590000","chr9.6680000.6685000",95000,23,8.881692e-07,6585000,6680000,6590000,6685000,"chr9",356998,4,6,4,14,"chr9",1,0.0377402719174871
"11324","chr9.131405000.131410000","chr9.131735000.131740000",330000,13,4.95671e-05,131405000,131735000,131410000,131740000,"chr9",357009,2,2,2,6,"chr9",1,0.00914205344585091
"11325","chr9.15430000.15435000","chr9.15550000.15555000",120000,16,0.001026552,15430000,15550000,15435000,15555000,"chr9",357041,1,1,7,9,"chr9",1,0.0168776371308017
"11326","chr9.35110000.35115000","chr9.35550000.35555000",440000,11,0.000239298,35110000,35550000,35115000,35555000,"chr9",357061,0,2,3,5,"chr9",1,0.00644631973745898
"11327","chr9.19050000.19055000","chr9.19920000.19925000",870000,7,0.004921063,19050000,19920000,19055000,19925000,"chr9",357067,0,3,2,5,"chr9",1,0.00410220346929208
"11328","chr9.127800000.127805000","chr9.127820000.127825000",20000,47,2.496136e-07,127800000,127820000,127805000,127825000,"chr9",357165,6,36,26,68,"chr9",1,0.374589779653071
"11329","chr9.127695000.127700000","chr9.127920000.127925000",225000,14,0.0001782955,127695000,127920000,127700000,127925000,"chr9",357166,2,20,12,34,"chr9",1,0.0557899671823722
"11330","chr9.35080000.35085000","chr9.35515000.35520000",435000,11,0.0002550679,35080000,35515000,35085000,35520000,"chr9",357200,0,3,3,6,"chr9",1,0.00773558368495077
"11331","chr9.27030000.27035000","chr9.27530000.27535000",500000,9,0.002885576,27030000,27530000,27035000,27535000,"chr9",357302,1,4,3,8,"chr9",1,0.00843881856540084
"11332","chr9.113150000.113155000","chr9.113360000.113365000",210000,14,0.0002975622,113150000,113360000,113155000,113365000,"chr9",357308,2,3,4,9,"chr9",1,0.0147679324894515
"11333","chr9.715000.720000","chr9.755000.760000",40000,30,2.513173e-05,715000,755000,720000,760000,"chr9",357321,4,13,16,33,"chr9",1,0.116033755274262
"11334","chr9.122040000.122045000","chr9.122120000.122125000",80000,18,0.00231679,122040000,122120000,122045000,122125000,"chr9",357359,0,3,1,4,"chr9",1,0.00843881856540084
"11335","chr9.27380000.27385000","chr9.27480000.27485000",100000,17,0.001157782,27380000,27480000,27385000,27485000,"chr9",357367,1,4,1,6,"chr9",1,0.0119549929676512
"11336","chr9.725000.730000","chr9.745000.750000",20000,54,1.596824e-10,725000,745000,730000,750000,"chr9",357391,5,18,13,36,"chr9",1,0.227848101265823
"11337","chr9.36190000.36195000","chr9.36325000.36330000",135000,16,0.0004840376,36190000,36325000,36195000,36330000,"chr9",357449,0,3,3,6,"chr9",1,0.0112517580872011
"11338","chr9.33000000.33005000","chr9.33080000.33085000",80000,17,0.006071643,3.3e+07,33080000,33005000,33085000,"chr9",357496,1,12,6,19,"chr9",1,0.0378574777308955
"11339","chr9.890000.895000","chr9.1040000.1045000",150000,14,0.002786698,890000,1040000,895000,1045000,"chr9",357499,2,1,2,5,"chr9",1,0.00820440693858415
"11340","chr9.127585000.127590000","chr9.128115000.128120000",530000,8,0.009647978,127585000,128115000,127590000,128120000,"chr9",357533,12,27,35,74,"chr9",1,0.0693858415377403
"11341","chr9.15275000.15280000","chr9.15420000.15425000",145000,17,8.103501e-05,15275000,15420000,15280000,15425000,"chr9",357545,0,8,7,15,"chr9",1,0.029887482419128
"11342","chr9.95005000.95010000","chr9.95025000.95030000",20000,34,0.008189353,95005000,95025000,95010000,95030000,"chr9",357580,0,2,1,3,"chr9",1,0.0119549929676512
"11343","chr9.27390000.27395000","chr9.27495000.27500000",105000,15,0.00697384,27390000,27495000,27395000,27500000,"chr9",357583,2,1,1,4,"chr9",1,0.0070323488045007
"11344","chr9.36400000.36405000","chr9.36460000.36465000",60000,26,7.839288e-06,36400000,36460000,36405000,36465000,"chr9",357599,2,5,3,10,"chr9",1,0.0304735114861697
"11345","chr9.97590000.97595000","chr9.97710000.97715000",120000,22,2.738512e-07,97590000,97710000,97595000,97715000,"chr9",357601,0,2,3,5,"chr9",1,0.012892639474918
"11346","chr9.131360000.131365000","chr9.131405000.131410000",45000,22,0.00922735,131360000,131405000,131365000,131410000,"chr9",357611,2,8,2,12,"chr9",1,0.0309423347398031
"11347","chr9.6700000.6705000","chr9.6765000.6770000",65000,20,0.001953927,6700000,6765000,6705000,6770000,"chr9",357673,2,12,15,29,"chr9",1,0.0679793717768401
"11348","chr9.35645000.35650000","chr9.35725000.35730000",80000,38,2.235719e-16,35645000,35725000,35650000,35730000,"chr9",357679,0,0,3,3,"chr9",1,0.0133614627285513
"11349","chr9.15430000.15435000","chr9.15485000.15490000",55000,23,0.0006229368,15430000,15485000,15435000,15490000,"chr9",357708,1,7,7,15,"chr9",1,0.040436005625879
"11350","chr9.37575000.37580000","chr9.37590000.37595000",15000,40,0.0001222207,37575000,37590000,37580000,37595000,"chr9",357722,6,29,19,54,"chr9",1,0.253164556962025
"11351","chr9.87565000.87570000","chr9.87870000.87875000",305000,22,1.781448e-12,87565000,87870000,87570000,87875000,"chr9",357725,0,0,1,1,"chr9",1,0.00257852789498359
"11352","chr9.17810000.17815000","chr9.18210000.18215000",400000,21,5.515612e-13,17810000,18210000,17815000,18215000,"chr9",357732,0,3,2,5,"chr9",1,0.0123066104078762
"11353","chr9.18255000.18260000","chr9.19010000.19015000",755000,11,5.19334e-06,18255000,19010000,18260000,19015000,"chr9",357778,1,3,3,7,"chr9",1,0.00902484763244257
"11354","chr9.35275000.35280000","chr9.35525000.35530000",250000,11,0.005191162,35275000,35525000,35280000,35530000,"chr9",357786,3,4,3,10,"chr9",1,0.012892639474918
"11355","chr9.131210000.131215000","chr9.131610000.131615000",400000,9,0.008111966,131210000,131610000,131215000,131615000,"chr9",357824,1,1,1,3,"chr9",1,0.00316455696202532
"11356","chr9.4760000.4765000","chr9.4985000.4990000",225000,23,1.8012e-11,4760000,4985000,4765000,4990000,"chr9",357858,0,2,1,3,"chr9",1,0.00808720112517581
"11357","chr9.625000.630000","chr9.760000.765000",135000,21,4.075315e-07,625000,760000,630000,765000,"chr9",357886,0,4,0,4,"chr9",1,0.00984528832630099
"11358","chr9.87600000.87605000","chr9.87870000.87875000",270000,18,3.489901e-08,87600000,87870000,87605000,87875000,"chr9",357920,0,3,2,5,"chr9",1,0.0105485232067511
"11359","chr9.27410000.27415000","chr9.27495000.27500000",85000,22,1.284245e-05,27410000,27495000,27415000,27500000,"chr9",357937,0,1,1,2,"chr9",1,0.00515705578996718
"11360","chr9.1085000.1090000","chr9.1450000.1455000",365000,11,0.0006825907,1085000,1450000,1090000,1455000,"chr9",357955,2,1,1,4,"chr9",1,0.00515705578996718
"11361","chr9.34985000.34990000","chr9.35095000.35100000",110000,21,3.012379e-06,34985000,35095000,34990000,35100000,"chr9",357982,1,4,2,7,"chr9",1,0.0172292545710267
"11362","chr9.35080000.35085000","chr9.35475000.35480000",395000,12,8.576855e-05,35080000,35475000,35085000,35480000,"chr9",358001,4,14,7,25,"chr9",1,0.0351617440225035
"11363","chr9.128320000.128325000","chr9.129215000.129220000",895000,8,0.0006921442,128320000,129215000,128325000,129220000,"chr9",358012,3,15,9,27,"chr9",1,0.0253164556962025
"11364","chr9.114875000.114880000","chr9.115060000.115065000",185000,15,0.0001963322,114875000,115060000,114880000,115065000,"chr9",358057,2,5,2,9,"chr9",1,0.0158227848101266
"11365","chr9.77380000.77385000","chr9.77560000.77565000",180000,14,0.0009019254,77380000,77560000,77385000,77565000,"chr9",358058,1,5,10,16,"chr9",1,0.0262541022034693
"11366","chr9.34430000.34435000","chr9.34600000.34605000",170000,28,5.655996e-14,34430000,34600000,34435000,34605000,"chr9",358121,0,4,3,7,"chr9",1,0.0229723394280356
"11367","chr9.35115000.35120000","chr9.35255000.35260000",140000,52,8.949189e-37,35115000,35255000,35120000,35260000,"chr9",358138,3,16,16,35,"chr9",1,0.213314580403188
"11368","chr9.113410000.113415000","chr9.113590000.113595000",180000,13,0.003121495,113410000,113590000,113415000,113595000,"chr9",358140,0,2,1,3,"chr9",1,0.00457102672292546
"11369","chr9.128525000.128530000","chr9.129035000.129040000",510000,11,9.201414e-05,128525000,129035000,128530000,129040000,"chr9",358194,5,23,19,47,"chr9",1,0.0605954055321144
"11370","chr9.33810000.33815000","chr9.34070000.34075000",260000,12,0.001107374,33810000,34070000,33815000,34075000,"chr9",358202,6,18,9,33,"chr9",1,0.0464135021097046
"11371","chr9.505000.510000","chr9.545000.550000",40000,31,8.651292e-06,505000,545000,510000,550000,"chr9",358205,3,5,2,10,"chr9",1,0.036333802156587
"11372","chr9.131940000.131945000","chr9.132180000.132185000",240000,13,0.0004664256,131940000,132180000,131945000,132185000,"chr9",358225,0,7,2,9,"chr9",1,0.0137130801687764
"11373","chr9.33850000.33855000","chr9.34080000.34085000",230000,13,0.0006229368,33850000,34080000,33855000,34085000,"chr9",358242,8,23,19,50,"chr9",1,0.0761837787154243
"11374","chr9.128420000.128425000","chr9.129225000.129230000",805000,7,0.007245133,128420000,129225000,128425000,129230000,"chr9",358244,0,7,7,14,"chr9",1,0.0114861697140178
"11375","chr9.4760000.4765000","chr9.5600000.5605000",840000,9,0.0001524874,4760000,5600000,4765000,5605000,"chr9",358264,0,7,6,13,"chr9",1,0.0137130801687764
"11376","chr9.8550000.8555000","chr9.8675000.8680000",125000,14,0.007342334,8550000,8675000,8555000,8680000,"chr9",358265,0,1,1,2,"chr9",1,0.00328176277543366
"11377","chr9.27030000.27035000","chr9.27545000.27550000",515000,11,8.616279e-05,27030000,27545000,27035000,27550000,"chr9",358291,0,3,1,4,"chr9",1,0.00515705578996718
"11378","chr9.97560000.97565000","chr9.97590000.97595000",30000,29,0.004574059,97560000,97590000,97565000,97595000,"chr9",358350,0,2,5,7,"chr9",1,0.023792780121894
"11379","chr9.109050000.109055000","chr9.109085000.109090000",35000,28,0.001147067,109050000,109085000,109055000,109090000,"chr9",358380,5,4,2,11,"chr9",1,0.0360993905297703
"11380","chr9.34985000.34990000","chr9.35075000.35080000",90000,27,4.590024e-09,34985000,35075000,34990000,35080000,"chr9",358391,1,3,0,4,"chr9",1,0.0126582278481013
"11381","chr9.715000.720000","chr9.760000.765000",45000,26,0.0002887054,715000,760000,720000,765000,"chr9",358435,3,15,12,30,"chr9",1,0.0914205344585091
"11382","chr9.27340000.27345000","chr9.27570000.27575000",230000,13,0.0006229368,27340000,27570000,27345000,27575000,"chr9",358446,2,8,7,17,"chr9",1,0.0259024847632443
"11383","chr9.32585000.32590000","chr9.33000000.33005000",415000,11,0.0003351427,32585000,3.3e+07,32590000,33005000,"chr9",358452,0,6,4,10,"chr9",1,0.012892639474918
"11384","chr9.13570000.13575000","chr9.14250000.14255000",680000,8,0.003108272,13570000,14250000,13575000,14255000,"chr9",358487,3,2,4,9,"chr9",1,0.00843881856540084
"11385","chr9.136935000.136940000","chr9.137005000.137010000",70000,19,0.002563108,136935000,137005000,136940000,137010000,"chr9",358506,2,12,12,26,"chr9",1,0.0578996718237225
"11386","chr9.112850000.112855000","chr9.112890000.112895000",40000,35,9.255489e-08,112850000,112890000,112855000,112895000,"chr9",358558,2,1,2,5,"chr9",1,0.0205110173464604
"11387","chr9.93160000.93165000","chr9.93345000.93350000",185000,14,0.0007458087,93160000,93345000,93165000,93350000,"chr9",358573,0,9,4,13,"chr9",1,0.0213314580403188
"11388","chr9.34985000.34990000","chr9.35535000.35540000",550000,8,0.008265797,34985000,35535000,34990000,35540000,"chr9",358588,1,4,2,7,"chr9",1,0.00656352555086732
"11389","chr9.128495000.128500000","chr9.129215000.129220000",720000,8,0.00232589,128495000,129215000,128500000,129220000,"chr9",358613,3,8,9,20,"chr9",1,0.0187529301453352
"11390","chr9.19050000.19055000","chr9.19155000.19160000",105000,17,0.000816932,19050000,19155000,19055000,19160000,"chr9",358626,1,4,2,7,"chr9",1,0.0139474917955931
"11391","chr9.27325000.27330000","chr9.27545000.27550000",220000,53,6.598164e-45,27325000,27545000,27330000,27550000,"chr9",358627,0,3,1,4,"chr9",1,0.0248476324425692
"11392","chr9.87345000.87350000","chr9.87370000.87375000",25000,43,1.020352e-06,87345000,87370000,87350000,87375000,"chr9",358649,4,5,10,19,"chr9",1,0.0957571495546179
"11393","chr9.77910000.77915000","chr9.78895000.78900000",985000,8,0.0003301806,77910000,78895000,77915000,78900000,"chr9",358653,0,2,2,4,"chr9",1,0.00375058602906704
"11394","chr9.129110000.129115000","chr9.129140000.129145000",30000,33,0.0002048295,129110000,129140000,129115000,129145000,"chr9",358665,0,1,2,3,"chr9",1,0.0116033755274262
"11395","chr9.129980000.129985000","chr9.130180000.130185000",200000,13,0.001629879,129980000,130180000,129985000,130185000,"chr9",358674,3,10,11,24,"chr9",1,0.0365682137834037
"11396","chr9.675000.680000","chr9.715000.720000",40000,28,0.0001817949,675000,715000,680000,720000,"chr9",358707,1,9,3,13,"chr9",1,0.0426629160806376
"11397","chr9.124305000.124310000","chr9.124770000.124775000",465000,16,9.077897e-09,124305000,124770000,124310000,124775000,"chr9",358713,0,5,0,5,"chr9",1,0.00937646507266761
"11398","chr9.131590000.131595000","chr9.131690000.131695000",100000,21,8.169299e-06,131590000,131690000,131595000,131695000,"chr9",358748,2,1,2,5,"chr9",1,0.0123066104078762
"11399","chr9.4675000.4680000","chr9.5630000.5635000",955000,9,5.510568e-05,4675000,5630000,4680000,5635000,"chr9",358765,3,10,4,17,"chr9",1,0.0179324894514768
"11400","chr9.130185000.130190000","chr9.130205000.130210000",20000,50,1.213639e-08,130185000,130205000,130190000,130210000,"chr9",358797,0,11,7,18,"chr9",1,0.105485232067511
"11401","chr9.460000.465000","chr9.755000.760000",295000,12,0.0004975477,460000,755000,465000,760000,"chr9",358814,4,6,5,15,"chr9",1,0.0210970464135021
"11402","chr9.113400000.113405000","chr9.114035000.114040000",635000,17,2.286733e-11,113400000,114035000,113405000,114040000,"chr9",358815,0,3,4,7,"chr9",1,0.0139474917955931
"11403","chr9.129995000.130000000","chr9.130050000.130055000",55000,22,0.001629879,129995000,130050000,1.3e+08,130055000,"chr9",358840,9,25,27,61,"chr9",1,0.157290201593999
"11404","chr9.36420000.36425000","chr9.36555000.36560000",135000,18,3.432231e-05,36420000,36555000,36425000,36560000,"chr9",358856,5,8,8,21,"chr9",1,0.0443037974683544
"11405","chr9.27425000.27430000","chr9.27545000.27550000",120000,25,2.17468e-09,27425000,27545000,27430000,27550000,"chr9",358913,0,3,1,4,"chr9",1,0.0117205813408345
"11406","chr9.131370000.131375000","chr9.131390000.131395000",20000,34,0.008189353,131370000,131390000,131375000,131395000,"chr9",358940,1,11,12,24,"chr9",1,0.0956399437412096
"11407","chr9.37910000.37915000","chr9.38400000.38405000",490000,16,5.232243e-09,37910000,38400000,37915000,38405000,"chr9",359001,4,16,7,27,"chr9",1,0.0506329113924051
"11408","chr9.27330000.27335000","chr9.27570000.27575000",240000,37,1.598648e-26,27330000,27570000,27335000,27575000,"chr9",359009,2,3,4,9,"chr9",1,0.0390295358649789
"11409","chr9.34125000.34130000","chr9.34335000.34340000",210000,14,0.0002975622,34125000,34335000,34130000,34340000,"chr9",359050,5,23,22,50,"chr9",1,0.0820440693858415
"11410","chr9.27350000.27355000","chr9.27545000.27550000",195000,38,3.051392e-25,27350000,27545000,27355000,27550000,"chr9",359061,0,3,1,4,"chr9",1,0.0178152836380684
"11411","chr9.5185000.5190000","chr9.5590000.5595000",405000,15,2.668567e-07,5185000,5590000,5190000,5595000,"chr9",359129,0,5,2,7,"chr9",1,0.0123066104078762
"11412","chr9.705000.710000","chr9.745000.750000",40000,30,2.513173e-05,705000,745000,710000,750000,"chr9",359142,0,15,3,18,"chr9",1,0.0632911392405063
"11413","chr9.133990000.133995000","chr9.134170000.134175000",180000,15,0.0002401557,133990000,134170000,133995000,134175000,"chr9",359164,2,3,3,8,"chr9",1,0.0140646976090014
"11414","chr9.675000.680000","chr9.745000.750000",70000,18,0.006523488,675000,745000,680000,750000,"chr9",359165,1,9,3,13,"chr9",1,0.0274261603375527
"11415","chr9.27460000.27465000","chr9.27545000.27550000",85000,17,0.003975955,27460000,27545000,27465000,27550000,"chr9",359186,0,1,0,1,"chr9",1,0.00199249882794187
"11416","chr9.130700000.130705000","chr9.130835000.130840000",135000,19,8.375916e-06,130700000,130835000,130705000,130840000,"chr9",359238,1,6,2,9,"chr9",1,0.020042194092827
"11417","chr9.127545000.127550000","chr9.128115000.128120000",570000,8,0.007028661,127545000,128115000,127550000,128120000,"chr9",359264,0,8,1,9,"chr9",1,0.00843881856540084
"11418","chr9.127920000.127925000","chr9.127975000.127980000",55000,22,0.001629879,127920000,127975000,127925000,127980000,"chr9",359269,2,12,12,26,"chr9",1,0.0670417252695734
"11419","chr9.27330000.27335000","chr9.27405000.27410000",75000,18,0.003873198,27330000,27405000,27335000,27410000,"chr9",359274,1,3,4,8,"chr9",1,0.0168776371308017
"11420","chr9.535000.540000","chr9.560000.565000",25000,34,0.001998692,535000,560000,540000,565000,"chr9",359283,0,0,5,5,"chr9",1,0.0199249882794187
"11421","chr9.18235000.18240000","chr9.19030000.19035000",795000,8,0.0013975,18235000,19030000,18240000,19035000,"chr9",359290,0,6,4,10,"chr9",1,0.00937646507266761
"11422","chr9.15210000.15215000","chr9.15550000.15555000",340000,11,0.0009917293,15210000,15550000,15215000,15555000,"chr9",359328,0,1,0,1,"chr9",1,0.0012892639474918
"11423","chr9.128360000.128365000","chr9.128420000.128425000",60000,25,2.52988e-05,128360000,128420000,128365000,128425000,"chr9",359342,0,4,4,8,"chr9",1,0.023441162681669
"11424","chr9.120555000.120560000","chr9.120580000.120585000",25000,36,0.0004653973,120555000,120580000,120560000,120585000,"chr9",359345,1,10,12,23,"chr9",1,0.0970464135021097
"11425","chr9.37470000.37475000","chr9.38360000.38365000",890000,7,0.004345694,37470000,38360000,37475000,38365000,"chr9",359395,1,4,5,10,"chr9",1,0.00820440693858415
"11426","chr9.131175000.131180000","chr9.131210000.131215000",35000,29,0.0004939142,131175000,131210000,131180000,131215000,"chr9",359417,1,4,2,7,"chr9",1,0.023792780121894
"11427","chr9.97630000.97635000","chr9.97710000.97715000",80000,23,7.083992e-06,97630000,97710000,97635000,97715000,"chr9",359445,2,4,3,9,"chr9",1,0.0242616033755274
"11428","chr9.131175000.131180000","chr9.131610000.131615000",435000,9,0.005547679,131175000,131610000,131180000,131615000,"chr9",359465,1,1,1,3,"chr9",1,0.00316455696202532
"11429","chr9.19470000.19475000","chr9.19920000.19925000",450000,36,4.712919e-32,19470000,19920000,19475000,19925000,"chr9",359476,0,3,5,8,"chr9",1,0.0337552742616034
"11430","chr9.3745000.3750000","chr9.4335000.4340000",590000,11,3.330238e-05,3745000,4335000,3750000,4340000,"chr9",359531,0,0,4,4,"chr9",1,0.00515705578996718
"11431","chr9.36190000.36195000","chr9.36315000.36320000",125000,14,0.007342334,36190000,36315000,36195000,36320000,"chr9",359549,0,3,3,6,"chr9",1,0.00984528832630099
"11432","chr9.131330000.131335000","chr9.131350000.131355000",20000,42,2.413554e-05,131330000,131350000,131335000,131355000,"chr9",359552,10,27,14,51,"chr9",1,0.251054852320675
"11433","chr9.33620000.33625000","chr9.33720000.33725000",100000,68,7.147932e-50,33620000,33720000,33625000,33725000,"chr9",359566,0,1,3,4,"chr9",1,0.0318799812470699
"11434","chr9.4315000.4320000","chr9.4365000.4370000",50000,39,4.682477e-12,4315000,4365000,4320000,4370000,"chr9",359567,0,3,0,3,"chr9",1,0.0137130801687764
"11435","chr9.33075000.33080000","chr9.33165000.33170000",90000,23,1.715212e-06,33075000,33165000,33080000,33170000,"chr9",359570,0,4,5,9,"chr9",1,0.0242616033755274
"11436","chr9.36255000.36260000","chr9.36325000.36330000",70000,18,0.006523488,36255000,36325000,36260000,36330000,"chr9",359593,2,14,10,26,"chr9",1,0.0548523206751055
"11437","chr9.6475000.6480000","chr9.6565000.6570000",90000,16,0.007001976,6475000,6565000,6480000,6570000,"chr9",359684,2,5,1,8,"chr9",1,0.0150023441162682
"11438","chr9.36215000.36220000","chr9.36245000.36250000",30000,32,0.0004704961,36215000,36245000,36220000,36250000,"chr9",359710,1,8,8,17,"chr9",1,0.0637599624941397
"11439","chr9.77440000.77445000","chr9.77560000.77565000",120000,16,0.001026552,77440000,77560000,77445000,77565000,"chr9",359746,4,5,5,14,"chr9",1,0.0262541022034693
"11440","chr9.33815000.33820000","chr9.33850000.33855000",35000,66,1.849701e-26,33815000,33850000,33820000,33855000,"chr9",359752,4,9,5,18,"chr9",1,0.139240506329114
"11441","chr9.470000.475000","chr9.715000.720000",245000,11,0.005803666,470000,715000,475000,720000,"chr9",359792,1,5,10,16,"chr9",1,0.0206282231598687
"11442","chr9.33315000.33320000","chr9.34200000.34205000",885000,7,0.004511773,33315000,34200000,33320000,34205000,"chr9",359800,2,27,11,40,"chr9",1,0.0328176277543366
"11443","chr9.35115000.35120000","chr9.35515000.35520000",400000,20,5.804262e-12,35115000,35515000,35120000,35520000,"chr9",359821,0,3,3,6,"chr9",1,0.0140646976090014
"11444","chr9.36400000.36405000","chr9.36470000.36475000",70000,18,0.006523488,36400000,36470000,36405000,36475000,"chr9",359846,4,5,3,12,"chr9",1,0.0253164556962025
"11445","chr9.136885000.136890000","chr9.137005000.137010000",120000,15,0.003167997,136885000,137005000,136890000,137010000,"chr9",359885,2,12,12,26,"chr9",1,0.0457102672292546
"11446","chr9.33815000.33820000","chr9.34070000.34075000",255000,14,6.635491e-05,33815000,34070000,33820000,34075000,"chr9",359894,4,9,5,18,"chr9",1,0.029535864978903
"11447","chr9.128315000.128320000","chr9.129255000.129260000",940000,8,0.0004899673,128315000,129255000,128320000,129260000,"chr9",359906,1,2,2,5,"chr9",1,0.0046882325363338
"11448","chr9.35110000.35115000","chr9.35160000.35165000",50000,22,0.003970557,35110000,35160000,35115000,35165000,"chr9",359916,0,2,2,4,"chr9",1,0.0103141115799344
"11449","chr9.33000000.33005000","chr9.33025000.33030000",25000,44,3.862716e-07,3.3e+07,33025000,33005000,33030000,"chr9",359927,1,7,7,15,"chr9",1,0.0773558368495077
"11450","chr9.27530000.27535000","chr9.27570000.27575000",40000,32,2.910397e-06,27530000,27570000,27535000,27575000,"chr9",359947,1,4,3,8,"chr9",1,0.0300046882325363
"11451","chr9.690000.695000","chr9.725000.730000",35000,37,1.511984e-07,690000,725000,695000,730000,"chr9",359952,5,6,6,17,"chr9",1,0.073722456633849
"11452","chr9.19045000.19050000","chr9.19380000.19385000",335000,15,1.274162e-06,19045000,19380000,19050000,19385000,"chr9",359964,6,18,21,45,"chr9",1,0.0791139240506329
"11453","chr9.132670000.132675000","chr9.132800000.132805000",130000,15,0.001998692,132670000,132800000,132675000,132805000,"chr9",359967,0,0,2,2,"chr9",1,0.00351617440225035
"11454","chr9.35080000.35085000","chr9.35160000.35165000",80000,21,8.576855e-05,35080000,35160000,35085000,35165000,"chr9",359973,0,9,2,11,"chr9",1,0.0270745428973277
"11455","chr9.26955000.26960000","chr9.27570000.27575000",615000,13,3.958653e-07,26955000,27570000,26960000,27575000,"chr9",359986,0,5,7,12,"chr9",1,0.0182841068917018
"11456","chr9.3750000.3755000","chr9.4335000.4340000",585000,12,4.886561e-06,3750000,4335000,3755000,4340000,"chr9",360011,0,0,4,4,"chr9",1,0.00562587904360056
"11457","chr9.32395000.32400000","chr9.32965000.32970000",570000,11,4.268133e-05,32395000,32965000,32400000,32970000,"chr9",360072,2,6,3,11,"chr9",1,0.0141819034224098
"11458","chr9.35645000.35650000","chr9.35785000.35790000",140000,14,0.004105485,35645000,35785000,35650000,35790000,"chr9",360142,1,6,6,13,"chr9",1,0.0213314580403188
"11459","chr9.4600000.4605000","chr9.4750000.4755000",150000,13,0.008528833,4600000,4750000,4605000,4755000,"chr9",360192,4,5,5,14,"chr9",1,0.0213314580403188
"11460","chr9.127715000.127720000","chr9.127935000.127940000",220000,17,1.883402e-06,127715000,127935000,127720000,127940000,"chr9",360224,0,9,5,14,"chr9",1,0.0278949835911861
"11461","chr9.27335000.27340000","chr9.27545000.27550000",210000,44,5.120848e-33,27335000,27545000,27340000,27550000,"chr9",360232,0,1,1,2,"chr9",1,0.0103141115799344
"11462","chr9.112020000.112025000","chr9.112070000.112075000",50000,23,0.001642557,112020000,112070000,112025000,112075000,"chr9",360241,5,11,19,35,"chr9",1,0.0943506797937178
"11463","chr9.715000.720000","chr9.735000.740000",20000,51,4.321579e-09,715000,735000,720000,740000,"chr9",360291,2,4,11,17,"chr9",1,0.101617440225035
"11464","chr9.120265000.120270000","chr9.120290000.120295000",25000,33,0.003975955,120265000,120290000,120270000,120295000,"chr9",360303,0,1,1,2,"chr9",1,0.00773558368495077
"11465","chr9.32525000.32530000","chr9.32965000.32970000",440000,11,0.000239298,32525000,32965000,32530000,32970000,"chr9",360363,4,8,3,15,"chr9",1,0.0193389592123769
"11466","chr9.35600000.35605000","chr9.35655000.35660000",55000,31,5.874774e-08,35600000,35655000,35605000,35660000,"chr9",360416,11,19,12,42,"chr9",1,0.152601969057665
"11467","chr9.6575000.6580000","chr9.6700000.6705000",125000,17,0.0002314129,6575000,6700000,6580000,6705000,"chr9",360452,5,12,20,37,"chr9",1,0.073722456633849
"11468","chr9.127715000.127720000","chr9.127755000.127760000",40000,24,0.005626903,127715000,127755000,127720000,127760000,"chr9",360453,0,14,8,22,"chr9",1,0.0618846694796062
"11469","chr9.126890000.126895000","chr9.127050000.127055000",160000,14,0.00193113,126890000,127050000,126895000,127055000,"chr9",360458,3,1,3,7,"chr9",1,0.0114861697140178
"11470","chr9.13430000.13435000","chr9.13565000.13570000",135000,21,4.075315e-07,13430000,13565000,13435000,13570000,"chr9",360480,0,2,0,2,"chr9",1,0.00492264416315049
"11471","chr9.78600000.78605000","chr9.78620000.78625000",20000,38,0.0005620438,78600000,78620000,78605000,78625000,"chr9",360495,2,2,5,9,"chr9",1,0.040084388185654
"11472","chr9.117275000.117280000","chr9.117405000.117410000",130000,16,0.0006153273,117275000,117405000,117280000,117410000,"chr9",360559,0,2,1,3,"chr9",1,0.00562587904360056
"11473","chr9.124330000.124335000","chr9.124385000.124390000",55000,21,0.003975955,124330000,124385000,124335000,124390000,"chr9",360570,0,0,1,1,"chr9",1,0.00246132208157525
"11474","chr9.18255000.18260000","chr9.19030000.19035000",775000,14,4.077746e-09,18255000,19030000,18260000,19035000,"chr9",360584,0,3,3,6,"chr9",1,0.00984528832630099
"11475","chr9.35075000.35080000","chr9.35600000.35605000",525000,11,7.709735e-05,35075000,35600000,35080000,35605000,"chr9",360591,3,3,0,6,"chr9",1,0.00773558368495077
"11476","chr9.131335000.131340000","chr9.131360000.131365000",25000,44,3.862716e-07,131335000,131360000,131340000,131365000,"chr9",360626,11,38,37,86,"chr9",1,0.443506797937178
"11477","chr9.128530000.128535000","chr9.128605000.128610000",75000,18,0.003873198,128530000,128605000,128535000,128610000,"chr9",360646,3,11,5,19,"chr9",1,0.040084388185654
"11478","chr9.34645000.34650000","chr9.35160000.35165000",515000,10,0.0004951301,34645000,35160000,34650000,35165000,"chr9",360749,0,5,1,6,"chr9",1,0.0070323488045007
"11479","chr9.35475000.35480000","chr9.35535000.35540000",60000,19,0.009860903,35475000,35535000,35480000,35540000,"chr9",360778,1,10,7,18,"chr9",1,0.040084388185654
"11480","chr9.96215000.96220000","chr9.96315000.96320000",100000,17,0.001157782,96215000,96315000,96220000,96320000,"chr9",360787,0,2,1,3,"chr9",1,0.0059774964838256
"11481","chr9.27325000.27330000","chr9.27530000.27535000",205000,29,2.169305e-16,27325000,27530000,27330000,27535000,"chr9",360790,1,4,3,8,"chr9",1,0.0271917487107361
"11482","chr9.35670000.35675000","chr9.35715000.35720000",45000,26,0.0002887054,35670000,35715000,35675000,35720000,"chr9",360818,3,3,4,10,"chr9",1,0.0304735114861697
"11483","chr9.27350000.27355000","chr9.27495000.27500000",145000,22,3.910406e-08,27350000,27495000,27355000,27500000,"chr9",360822,2,1,1,4,"chr9",1,0.0103141115799344
"11484","chr9.129110000.129115000","chr9.129135000.129140000",25000,37,0.0002115928,129110000,129135000,129115000,129140000,"chr9",360826,1,3,4,8,"chr9",1,0.0346929207688701
"11485","chr9.27495000.27500000","chr9.27545000.27550000",50000,22,0.003970557,27495000,27545000,27500000,27550000,"chr9",360827,0,1,1,2,"chr9",1,0.00515705578996718
"11486","chr9.4750000.4755000","chr9.5600000.5605000",850000,12,1.92133e-07,4750000,5600000,4755000,5605000,"chr9",360936,0,7,5,12,"chr9",1,0.0168776371308017
"11487","chr9.109425000.109430000","chr9.109470000.109475000",45000,23,0.004155497,109425000,109470000,109430000,109475000,"chr9",360946,6,13,11,30,"chr9",1,0.0808720112517581
"11488","chr9.27465000.27470000","chr9.27545000.27550000",80000,21,8.576855e-05,27465000,27545000,27470000,27550000,"chr9",360960,0,2,1,3,"chr9",1,0.00738396624472574
"11489","chr9.35075000.35080000","chr9.35095000.35100000",20000,57,4.881382e-12,35075000,35095000,35080000,35100000,"chr9",360972,2,3,0,5,"chr9",1,0.0334036568213783
"11490","chr9.15430000.15435000","chr9.15475000.15480000",45000,22,0.00922735,15430000,15475000,15435000,15480000,"chr9",360980,1,0,3,4,"chr9",1,0.0103141115799344
"11491","chr9.130945000.130950000","chr9.131745000.131750000",800000,7,0.00740886,130945000,131745000,130950000,131750000,"chr9",361077,2,11,9,22,"chr9",1,0.0180496952648851
"11492","chr9.385000.390000","chr9.755000.760000",370000,17,1.051252e-08,385000,755000,390000,760000,"chr9",361117,0,6,2,8,"chr9",1,0.0159399906235349
"11493","chr9.121940000.121945000","chr9.122040000.122045000",100000,15,0.009266319,121940000,122040000,121945000,122045000,"chr9",361139,0,3,1,4,"chr9",1,0.0070323488045007
"11494","chr9.87545000.87550000","chr9.87870000.87875000",325000,13,5.510568e-05,87545000,87870000,87550000,87875000,"chr9",361181,0,3,2,5,"chr9",1,0.00761837787154243
"11495","chr9.127545000.127550000","chr9.127610000.127615000",65000,33,1.206591e-10,127545000,127610000,127550000,127615000,"chr9",361183,0,6,1,7,"chr9",1,0.0270745428973277
"11496","chr9.129885000.129890000","chr9.129945000.129950000",60000,30,4.676196e-08,129885000,129945000,129890000,129950000,"chr9",361212,0,1,1,2,"chr9",1,0.0070323488045007
"11497","chr9.134040000.134045000","chr9.134215000.134220000",175000,13,0.003720896,134040000,134215000,134045000,134220000,"chr9",361233,0,0,2,2,"chr9",1,0.00304735114861697
"11498","chr9.610000.615000","chr9.1005000.1010000",395000,10,0.002081723,610000,1005000,615000,1010000,"chr9",361266,1,2,3,6,"chr9",1,0.0070323488045007
"11499","chr9.4985000.4990000","chr9.5590000.5595000",605000,10,0.0001855536,4985000,5590000,4990000,5595000,"chr9",361277,0,2,1,3,"chr9",1,0.00351617440225035
"11500","chr9.129100000.129105000","chr9.129135000.129140000",35000,29,0.0004939142,129100000,129135000,129105000,129140000,"chr9",361279,1,3,4,8,"chr9",1,0.0271917487107361
"11501","chr9.37590000.37595000","chr9.37785000.37790000",195000,23,1.544546e-10,37590000,37785000,37595000,37790000,"chr9",361292,1,11,3,15,"chr9",1,0.040436005625879
"11502","chr9.4760000.4765000","chr9.5590000.5595000",830000,8,0.001103996,4760000,5590000,4765000,5595000,"chr9",361304,8,6,12,26,"chr9",1,0.0243788091889358
"11503","chr9.13430000.13435000","chr9.13570000.13575000",140000,17,0.0001037481,13430000,13570000,13435000,13575000,"chr9",361312,0,2,0,2,"chr9",1,0.00398499765588373
"11504","chr9.129965000.129970000","chr9.130180000.130185000",215000,14,0.0002512537,129965000,130180000,129970000,130185000,"chr9",361316,3,13,15,31,"chr9",1,0.0508673230192218
"11505","chr9.32375000.32380000","chr9.32580000.32585000",205000,19,1.31302e-07,32375000,32580000,32380000,32585000,"chr9",361326,6,7,8,21,"chr9",1,0.0467651195499297
"11506","chr9.128525000.128530000","chr9.128725000.128730000",200000,13,0.001629879,128525000,128725000,128530000,128730000,"chr9",361332,4,20,19,43,"chr9",1,0.0655180496952649
"11507","chr9.27370000.27375000","chr9.27530000.27535000",160000,21,7.095707e-08,27370000,27530000,27375000,27535000,"chr9",361356,0,1,1,2,"chr9",1,0.00492264416315049
"11508","chr9.107740000.107745000","chr9.107905000.107910000",165000,23,1.49658e-09,107740000,107905000,107745000,107910000,"chr9",361358,0,7,8,15,"chr9",1,0.040436005625879
"11509","chr9.35160000.35165000","chr9.35255000.35260000",95000,28,3.945786e-10,35160000,35255000,35165000,35260000,"chr9",361361,0,9,2,11,"chr9",1,0.0360993905297703
"11510","chr9.15275000.15280000","chr9.15600000.15605000",325000,10,0.005011886,15275000,15600000,15280000,15605000,"chr9",361370,0,3,7,10,"chr9",1,0.0117205813408345
"11511","chr9.37900000.37905000","chr9.38085000.38090000",185000,16,4.659648e-05,37900000,38085000,37905000,38090000,"chr9",361387,3,3,9,15,"chr9",1,0.0281293952180028
"11512","chr9.34125000.34130000","chr9.34200000.34205000",75000,20,0.0004975477,34125000,34200000,34130000,34205000,"chr9",361401,2,23,11,36,"chr9",1,0.0843881856540084
"11513","chr9.120570000.120575000","chr9.120915000.120920000",345000,10,0.003914793,120570000,120915000,120575000,120920000,"chr9",361439,1,2,2,5,"chr9",1,0.00586029067041725
"11514","chr9.20355000.20360000","chr9.20980000.20985000",625000,12,2.87154e-06,20355000,20980000,20360000,20985000,"chr9",361508,0,1,0,1,"chr9",1,0.00140646976090014
"11515","chr9.131880000.131885000","chr9.132405000.132410000",525000,10,0.0004499966,131880000,132405000,131885000,132410000,"chr9",361530,2,8,9,19,"chr9",1,0.0222691045475856
"11516","chr9.107740000.107745000","chr9.107915000.107920000",175000,16,7.489218e-05,107740000,107915000,107745000,107920000,"chr9",361576,0,5,2,7,"chr9",1,0.0131270511017346
"11517","chr9.122900000.122905000","chr9.122930000.122935000",30000,29,0.004574059,122900000,122930000,122905000,122935000,"chr9",361615,1,7,2,10,"chr9",1,0.0339896858884201
"11518","chr9.127750000.127755000","chr9.127920000.127925000",170000,15,0.000365877,127750000,127920000,127755000,127925000,"chr9",361618,1,1,1,3,"chr9",1,0.00527426160337553
"11519","chr9.35600000.35605000","chr9.35745000.35750000",145000,15,0.001054106,35600000,35745000,35605000,35750000,"chr9",361621,0,4,4,8,"chr9",1,0.0140646976090014
"11520","chr9.36075000.36080000","chr9.36145000.36150000",70000,21,0.0003329182,36075000,36145000,36080000,36150000,"chr9",361670,0,1,0,1,"chr9",1,0.00246132208157525
"11521","chr9.136785000.136790000","chr9.136830000.136835000",45000,23,0.004155497,136785000,136830000,136790000,136835000,"chr9",361678,0,2,2,4,"chr9",1,0.0107829348335677
"11522","chr9.33025000.33030000","chr9.33045000.33050000",20000,62,9.956252e-15,33025000,33045000,33030000,33050000,"chr9",361692,2,7,9,18,"chr9",1,0.130801687763713
"11523","chr9.109345000.109350000","chr9.110150000.110155000",805000,7,0.007245133,109345000,110150000,109350000,110155000,"chr9",361725,3,7,5,15,"chr9",1,0.0123066104078762
"11524","chr9.130290000.130295000","chr9.130835000.130840000",545000,9,0.001875702,130290000,130835000,130295000,130840000,"chr9",361836,1,3,1,5,"chr9",1,0.00527426160337553
"11525","chr9.129820000.129825000","chr9.129965000.129970000",145000,15,0.001054106,129820000,129965000,129825000,129970000,"chr9",361845,7,27,9,43,"chr9",1,0.0755977496483826
"11526","chr9.75100000.75105000","chr9.75120000.75125000",20000,37,0.001147067,75100000,75120000,75105000,75125000,"chr9",361852,1,0,2,3,"chr9",1,0.0130098452883263
"11527","chr9.6575000.6580000","chr9.6680000.6685000",105000,29,1.347917e-11,6575000,6680000,6580000,6685000,"chr9",361864,4,11,15,30,"chr9",1,0.10196905766526
"11528","chr9.127685000.127690000","chr9.127910000.127915000",225000,11,0.009242184,127685000,127910000,127690000,127915000,"chr9",361867,5,12,10,27,"chr9",1,0.0348101265822785
"11529","chr9.133405000.133410000","chr9.133525000.133530000",120000,16,0.001026552,133405000,133525000,133410000,133530000,"chr9",361877,0,5,2,7,"chr9",1,0.0131270511017346
"11530","chr9.35160000.35165000","chr9.35730000.35735000",570000,8,0.007028661,35160000,35730000,35165000,35735000,"chr9",361952,0,5,2,7,"chr9",1,0.00656352555086732
"11531","chr9.33080000.33085000","chr9.33260000.33265000",180000,17,1.319355e-05,33080000,33260000,33085000,33265000,"chr9",361954,2,11,6,19,"chr9",1,0.0378574777308955
"11532","chr9.89215000.89220000","chr9.89635000.89640000",420000,9,0.006523488,89215000,89635000,89220000,89640000,"chr9",361955,0,3,0,3,"chr9",1,0.00316455696202532
"11533","chr9.4800000.4805000","chr9.4985000.4990000",185000,15,0.0001963322,4800000,4985000,4805000,4990000,"chr9",362003,0,2,1,3,"chr9",1,0.00527426160337553
"11534","chr9.131710000.131715000","chr9.131850000.131855000",140000,14,0.004105485,131710000,131850000,131715000,131855000,"chr9",362022,6,9,20,35,"chr9",1,0.0574308485700891
"11535","chr9.36420000.36425000","chr9.36570000.36575000",150000,13,0.008528833,36420000,36570000,36425000,36575000,"chr9",362036,5,8,8,21,"chr9",1,0.0319971870604782
"11536","chr9.124075000.124080000","chr9.124130000.124135000",55000,30,2.167552e-07,124075000,124130000,124080000,124135000,"chr9",362052,2,6,3,11,"chr9",1,0.0386779184247539
"11537","chr9.133915000.133920000","chr9.134205000.134210000",290000,10,0.008599966,133915000,134205000,133920000,134210000,"chr9",362116,0,1,2,3,"chr9",1,0.00351617440225035
"11538","chr9.12720000.12725000","chr9.12970000.12975000",250000,15,1.550895e-05,12720000,12970000,12725000,12975000,"chr9",362145,0,5,0,5,"chr9",1,0.00879043600562588
"11539","chr9.35080000.35085000","chr9.35115000.35120000",35000,32,3.094058e-05,35080000,35115000,35085000,35120000,"chr9",362168,7,18,17,42,"chr9",1,0.157524613220816
"11540","chr9.695000.700000","chr9.715000.720000",20000,62,9.956252e-15,695000,715000,7e+05,720000,"chr9",362188,3,4,13,20,"chr9",1,0.145335208626348
"11541","chr9.19920000.19925000","chr9.20355000.20360000",435000,11,0.0002550679,19920000,20355000,19925000,20360000,"chr9",362199,0,1,0,1,"chr9",1,0.0012892639474918
"11542","chr9.5630000.5635000","chr9.5830000.5835000",200000,18,9.518485e-07,5630000,5830000,5635000,5835000,"chr9",362213,2,2,2,6,"chr9",1,0.0126582278481013
"11543","chr9.19380000.19385000","chr9.19405000.19410000",25000,41,6.799763e-06,19380000,19405000,19385000,19410000,"chr9",362219,2,3,6,11,"chr9",1,0.0528598218471636
"11544","chr9.87445000.87450000","chr9.87875000.87880000",430000,9,0.005856676,87445000,87875000,87450000,87880000,"chr9",362229,1,3,2,6,"chr9",1,0.00632911392405063
"11545","chr9.127755000.127760000","chr9.127790000.127795000",35000,26,0.005428187,127755000,127790000,127760000,127795000,"chr9",362235,9,29,26,64,"chr9",1,0.195030473511486
"11546","chr9.35075000.35080000","chr9.35550000.35555000",475000,12,2.471759e-05,35075000,35550000,35080000,35555000,"chr9",362252,1,3,0,4,"chr9",1,0.00562587904360056
"11547","chr9.128370000.128375000","chr9.128920000.128925000",550000,8,0.008265797,128370000,128920000,128375000,128925000,"chr9",362267,1,4,1,6,"chr9",1,0.00562587904360056
"11548","chr9.4760000.4765000","chr9.4980000.4985000",220000,15,4.752175e-05,4760000,4980000,4765000,4985000,"chr9",362285,0,1,1,2,"chr9",1,0.00351617440225035
"11549","chr9.34175000.34180000","chr9.34375000.34380000",200000,13,0.001629879,34175000,34375000,34180000,34380000,"chr9",362287,1,4,2,7,"chr9",1,0.0106657290201594
"11550","chr9.27335000.27340000","chr9.27425000.27430000",90000,16,0.007001976,27335000,27425000,27340000,27430000,"chr9",362318,0,1,2,3,"chr9",1,0.00562587904360056
"11551","chr9.19030000.19035000","chr9.19455000.19460000",425000,10,0.00142954,19030000,19455000,19035000,19460000,"chr9",362329,0,6,4,10,"chr9",1,0.0117205813408345
"11552","chr9.135920000.135925000","chr9.135980000.135985000",60000,25,2.52988e-05,135920000,135980000,135925000,135985000,"chr9",362354,0,3,3,6,"chr9",1,0.0175808720112518
"11553","chr9.126420000.126425000","chr9.126475000.126480000",55000,22,0.001629879,126420000,126475000,126425000,126480000,"chr9",362418,1,0,3,4,"chr9",1,0.0103141115799344
"11554","chr9.19480000.19485000","chr9.19780000.19785000",300000,10,0.007342334,19480000,19780000,19485000,19785000,"chr9",362425,0,4,9,13,"chr9",1,0.0152367557430849
"11555","chr9.21250000.21255000","chr9.21315000.21320000",65000,20,0.001953927,21250000,21315000,21255000,21320000,"chr9",362442,1,1,2,4,"chr9",1,0.00937646507266761
"11556","chr9.112815000.112820000","chr9.112850000.112855000",35000,32,3.094058e-05,112815000,112850000,112820000,112855000,"chr9",362503,2,1,3,6,"chr9",1,0.0225035161744023
"11557","chr9.33045000.33050000","chr9.33165000.33170000",120000,14,0.009085841,33045000,33165000,33050000,33170000,"chr9",362520,0,4,5,9,"chr9",1,0.0147679324894515
"11558","chr9.535000.540000","chr9.755000.760000",220000,16,9.912759e-06,535000,755000,540000,760000,"chr9",362534,2,3,6,11,"chr9",1,0.0206282231598687
"11559","chr9.27335000.27340000","chr9.27530000.27535000",195000,38,3.051392e-25,27335000,27530000,27340000,27535000,"chr9",362544,0,1,3,4,"chr9",1,0.0178152836380684
"11560","chr9.27330000.27335000","chr9.27530000.27535000",200000,98,7.659045e-107,27330000,27530000,27335000,27535000,"chr9",362572,1,3,3,7,"chr9",1,0.0804031879981247
"11561","chr9.129965000.129970000","chr9.130030000.130035000",65000,25,8.13431e-06,129965000,130030000,129970000,130035000,"chr9",362576,8,17,17,42,"chr9",1,0.123066104078762
"11562","chr9.34470000.34475000","chr9.34600000.34605000",130000,16,0.0006153273,34470000,34600000,34475000,34605000,"chr9",362622,0,4,3,7,"chr9",1,0.0131270511017346
"11563","chr9.131590000.131595000","chr9.131710000.131715000",120000,19,2.272794e-05,131590000,131710000,131595000,131715000,"chr9",362654,2,3,2,7,"chr9",1,0.0155883731833099
"11564","chr9.33955000.33960000","chr9.34080000.34085000",125000,17,0.0002314129,33955000,34080000,33960000,34085000,"chr9",362681,8,16,20,44,"chr9",1,0.0876699484294421
"11565","chr9.36100000.36105000","chr9.36190000.36195000",90000,22,6.751938e-06,36100000,36190000,36105000,36195000,"chr9",362697,0,3,3,6,"chr9",1,0.0154711673699015
"11566","chr9.27330000.27335000","chr9.27425000.27430000",95000,20,5.15117e-05,27330000,27425000,27335000,27430000,"chr9",362773,0,3,2,5,"chr9",1,0.0117205813408345
"11567","chr9.97560000.97565000","chr9.97695000.97700000",135000,14,0.004906037,97560000,97695000,97565000,97700000,"chr9",362782,4,7,5,16,"chr9",1,0.0262541022034693
"11568","chr9.35050000.35055000","chr9.35550000.35555000",500000,9,0.002885576,35050000,35550000,35055000,35555000,"chr9",362807,1,9,3,13,"chr9",1,0.0137130801687764
"11569","chr9.97710000.97715000","chr9.97875000.97880000",165000,17,2.83942e-05,97710000,97875000,97715000,97880000,"chr9",362821,1,4,3,8,"chr9",1,0.0159399906235349
"11570","chr9.127695000.127700000","chr9.127910000.127915000",215000,16,1.217812e-05,127695000,127910000,127700000,127915000,"chr9",362839,5,19,19,43,"chr9",1,0.0806375996249414
"11571","chr9.26955000.26960000","chr9.27545000.27550000",590000,11,3.330238e-05,26955000,27545000,26960000,27550000,"chr9",362856,0,3,1,4,"chr9",1,0.00515705578996718
"11572","chr9.71700000.71705000","chr9.71810000.71815000",110000,15,0.005223942,71700000,71810000,71705000,71815000,"chr9",362860,2,2,2,6,"chr9",1,0.0105485232067511
"11573","chr9.715000.720000","chr9.745000.750000",30000,54,5.486136e-15,715000,745000,720000,750000,"chr9",362881,7,18,13,38,"chr9",1,0.240506329113924
"11574","chr9.35725000.35730000","chr9.35880000.35885000",155000,18,1.116752e-05,35725000,35880000,35730000,35885000,"chr9",362883,0,0,3,3,"chr9",1,0.00632911392405063
"11575","chr9.6575000.6580000","chr9.6765000.6770000",190000,15,0.00015929,6575000,6765000,6580000,6770000,"chr9",362887,2,12,15,29,"chr9",1,0.0509845288326301
"11576","chr9.12780000.12785000","chr9.12815000.12820000",35000,27,0.002563108,12780000,12815000,12785000,12820000,"chr9",362924,0,2,1,3,"chr9",1,0.00949367088607595
"11577","chr9.127755000.127760000","chr9.127820000.127825000",65000,30,1.051252e-08,127755000,127820000,127760000,127825000,"chr9",362941,9,29,26,64,"chr9",1,0.225035161744022
"11578","chr9.33850000.33855000","chr9.34070000.34075000",220000,13,0.0008539421,33850000,34070000,33855000,34075000,"chr9",362987,9,23,19,51,"chr9",1,0.0777074542897328
"11579","chr9.37910000.37915000","chr9.38025000.38030000",115000,24,1.882902e-08,37910000,38025000,37915000,38030000,"chr9",362995,0,1,1,2,"chr9",1,0.00562587904360056
"11580","chr9.36405000.36410000","chr9.36450000.36455000",45000,44,2.390813e-14,36405000,36450000,36410000,36455000,"chr9",363024,1,10,7,18,"chr9",1,0.0928270042194093
"11581","chr9.35645000.35650000","chr9.35755000.35760000",110000,21,3.012379e-06,35645000,35755000,35650000,35760000,"chr9",363059,1,1,0,2,"chr9",1,0.00492264416315049
"11582","chr9.129965000.129970000","chr9.130185000.130190000",220000,17,1.883402e-06,129965000,130185000,129970000,130190000,"chr9",363076,0,11,7,18,"chr9",1,0.0358649789029536
"11583","chr9.17530000.17535000","chr9.18210000.18215000",680000,13,1.575277e-07,17530000,18210000,17535000,18215000,"chr9",363083,0,3,2,5,"chr9",1,0.00761837787154243
"11584","chr9.129725000.129730000","chr9.129945000.129950000",220000,14,0.0002112614,129725000,129945000,129730000,129950000,"chr9",363153,7,19,18,44,"chr9",1,0.0721987810595406
"11585","chr9.35725000.35730000","chr9.35745000.35750000",20000,40,0.0001222207,35725000,35745000,35730000,35750000,"chr9",363175,0,0,3,3,"chr9",1,0.0140646976090014
"11586","chr9.35475000.35480000","chr9.35515000.35520000",40000,27,0.0004637667,35475000,35515000,35480000,35520000,"chr9",363190,0,3,3,6,"chr9",1,0.0189873417721519
"11587","chr9.610000.615000","chr9.695000.700000",85000,18,0.001421168,610000,695000,615000,7e+05,"chr9",363205,1,2,4,7,"chr9",1,0.0147679324894515
"11588","chr9.98475000.98480000","chr9.98955000.98960000",480000,9,0.003577211,98475000,98955000,98480000,98960000,"chr9",363214,1,4,2,7,"chr9",1,0.00738396624472574
"11589","chr9.98055000.98060000","chr9.98995000.99000000",940000,12,6.129191e-08,98055000,98995000,98060000,9.9e+07,"chr9",363221,5,5,4,14,"chr9",1,0.019690576652602
"11590","chr9.35600000.35605000","chr9.35755000.35760000",155000,14,0.002319745,35600000,35755000,35605000,35760000,"chr9",363235,3,1,0,4,"chr9",1,0.00656352555086732
"11591","chr9.109345000.109350000","chr9.109400000.109405000",55000,20,0.009171875,109345000,109400000,109350000,109405000,"chr9",363236,7,7,9,23,"chr9",1,0.0539146741678387
"11592","chr9.96215000.96220000","chr9.96340000.96345000",125000,22,1.810114e-07,96215000,96340000,96220000,96345000,"chr9",363237,0,2,1,3,"chr9",1,0.00773558368495077
"11593","chr9.35320000.35325000","chr9.35475000.35480000",155000,13,0.007211927,35320000,35475000,35325000,35480000,"chr9",363243,4,3,7,14,"chr9",1,0.0213314580403188
"11594","chr9.112715000.112720000","chr9.113010000.113015000",295000,10,0.007954814,112715000,113010000,112720000,113015000,"chr9",363253,1,5,3,9,"chr9",1,0.0105485232067511
"11595","chr9.76715000.76720000","chr9.76740000.76745000",25000,34,0.001998692,76715000,76740000,76720000,76745000,"chr9",363266,3,1,4,8,"chr9",1,0.0318799812470699
"11596","chr9.131330000.131335000","chr9.131405000.131410000",75000,17,0.009548344,131330000,131405000,131335000,131410000,"chr9",363316,2,8,2,12,"chr9",1,0.0239099859353024
"11597","chr9.35665000.35670000","chr9.35725000.35730000",60000,30,4.676196e-08,35665000,35725000,35670000,35730000,"chr9",363319,0,0,3,3,"chr9",1,0.0105485232067511
"11598","chr9.128410000.128415000","chr9.129250000.129255000",840000,7,0.005887932,128410000,129250000,128415000,129255000,"chr9",363325,3,13,8,24,"chr9",1,0.019690576652602
"11599","chr9.5785000.5790000","chr9.6050000.6055000",265000,11,0.003851973,5785000,6050000,5790000,6055000,"chr9",363345,7,5,3,15,"chr9",1,0.0193389592123769
"11600","chr9.27350000.27355000","chr9.27405000.27410000",55000,22,0.001629879,27350000,27405000,27355000,27410000,"chr9",363352,1,3,4,8,"chr9",1,0.0206282231598687
"11601","chr9.3420000.3425000","chr9.3440000.3445000",20000,43,1.009698e-05,3420000,3440000,3425000,3445000,"chr9",363360,0,1,0,1,"chr9",1,0.00503984997655884
"11602","chr9.19155000.19160000","chr9.19455000.19460000",300000,12,0.0004584578,19155000,19455000,19160000,19460000,"chr9",363378,4,8,9,21,"chr9",1,0.029535864978903
"11603","chr9.36115000.36120000","chr9.36165000.36170000",50000,35,1.525807e-09,36115000,36165000,36120000,36170000,"chr9",363382,0,6,4,10,"chr9",1,0.0410220346929208
"11604","chr9.71810000.71815000","chr9.71830000.71835000",20000,40,0.0001222207,71810000,71830000,71815000,71835000,"chr9",363412,4,9,6,19,"chr9",1,0.0890764181903422
"11605","chr9.127755000.127760000","chr9.127780000.127785000",25000,45,1.416788e-07,127755000,127780000,127760000,127785000,"chr9",363435,0,8,10,18,"chr9",1,0.0949367088607595
"11606","chr9.34125000.34130000","chr9.34175000.34180000",50000,34,6.033839e-09,34125000,34175000,34130000,34180000,"chr9",363438,5,23,22,50,"chr9",1,0.199249882794187
"11607","chr9.27340000.27345000","chr9.27480000.27485000",140000,15,0.001299389,27340000,27480000,27345000,27485000,"chr9",363489,2,11,13,26,"chr9",1,0.0457102672292546
"11608","chr9.37910000.37915000","chr9.38020000.38025000",110000,25,6.51826e-09,37910000,38020000,37915000,38025000,"chr9",363541,0,7,1,8,"chr9",1,0.023441162681669
"11609","chr9.131690000.131695000","chr9.131745000.131750000",55000,22,0.001629879,131690000,131745000,131695000,131750000,"chr9",363597,2,1,2,5,"chr9",1,0.012892639474918
"11610","chr9.117450000.117455000","chr9.117765000.117770000",315000,16,3.297477e-07,117450000,117765000,117455000,117770000,"chr9",363607,0,5,1,6,"chr9",1,0.0112517580872011
"11611","chr9.37430000.37435000","chr9.37485000.37490000",55000,22,0.001629879,37430000,37485000,37435000,37490000,"chr9",363676,0,6,1,7,"chr9",1,0.0180496952648851
"11612","chr9.131055000.131060000","chr9.131175000.131180000",120000,25,2.17468e-09,131055000,131175000,131060000,131180000,"chr9",363762,6,4,4,14,"chr9",1,0.0410220346929208
"11613","chr9.35080000.35085000","chr9.35550000.35555000",470000,9,0.003970557,35080000,35550000,35085000,35555000,"chr9",363763,1,9,3,13,"chr9",1,0.0137130801687764
"11614","chr9.129110000.129115000","chr9.129130000.129135000",20000,47,2.496136e-07,129110000,129130000,129115000,129135000,"chr9",363812,2,11,8,21,"chr9",1,0.115682137834037
"11615","chr9.690000.695000","chr9.755000.760000",65000,21,0.0007267268,690000,755000,695000,760000,"chr9",363819,4,6,6,16,"chr9",1,0.0393811533052039
"11616","chr9.20320000.20325000","chr9.21095000.21100000",775000,7,0.008569756,20320000,21095000,20325000,21100000,"chr9",363821,1,2,2,5,"chr9",1,0.00410220346929208
"11617","chr9.97560000.97565000","chr9.97630000.97635000",70000,28,4.95467e-08,97560000,97630000,97565000,97635000,"chr9",363852,2,6,5,13,"chr9",1,0.0426629160806376
"11618","chr9.35115000.35120000","chr9.35550000.35555000",435000,25,6.326816e-18,35115000,35550000,35120000,35555000,"chr9",363862,1,9,3,13,"chr9",1,0.0380918893577121
"11619","chr9.610000.615000","chr9.755000.760000",145000,58,2.742852e-44,610000,755000,615000,760000,"chr9",363872,1,2,4,7,"chr9",1,0.0475855602437881
"11620","chr9.128065000.128070000","chr9.128095000.128100000",30000,28,0.009189652,128065000,128095000,128070000,128100000,"chr9",363878,3,13,15,31,"chr9",1,0.101734646038444
"11621","chr9.6350000.6355000","chr9.6665000.6670000",315000,13,6.879719e-05,6350000,6665000,6355000,6670000,"chr9",363881,8,18,14,40,"chr9",1,0.0609470229723394
"11622","chr9.128265000.128270000","chr9.128285000.128290000",20000,38,0.0005620438,128265000,128285000,128270000,128290000,"chr9",363890,1,0,4,5,"chr9",1,0.0222691045475856
"11623","chr9.125045000.125050000","chr9.125080000.125085000",35000,26,0.005428187,125045000,125080000,125050000,125085000,"chr9",363922,2,4,3,9,"chr9",1,0.0274261603375527
"11624","chr9.37905000.37910000","chr9.38085000.38090000",180000,15,0.0002401557,37905000,38085000,37910000,38090000,"chr9",363985,3,3,3,9,"chr9",1,0.0158227848101266
"11625","chr9.27370000.27375000","chr9.27460000.27465000",90000,20,8.732247e-05,27370000,27460000,27375000,27465000,"chr9",364001,0,1,0,1,"chr9",1,0.0023441162681669
"11626","chr9.113410000.113415000","chr9.113575000.113580000",165000,13,0.00509474,113410000,113575000,113415000,113580000,"chr9",364081,0,10,9,19,"chr9",1,0.0289498359118612
"11627","chr9.36100000.36105000","chr9.36245000.36250000",145000,13,0.009990165,36100000,36245000,36105000,36250000,"chr9",364090,1,3,6,10,"chr9",1,0.0152367557430849
"11628","chr9.35600000.35605000","chr9.35725000.35730000",125000,15,0.00250834,35600000,35725000,35605000,35730000,"chr9",364091,0,0,3,3,"chr9",1,0.00527426160337553
"11629","chr9.19560000.19565000","chr9.19605000.19610000",45000,22,0.00922735,19560000,19605000,19565000,19610000,"chr9",364094,0,2,0,2,"chr9",1,0.00515705578996718
"11630","chr9.127585000.127590000","chr9.127605000.127610000",20000,53,4.939849e-10,127585000,127605000,127590000,127610000,"chr9",364133,4,24,30,58,"chr9",1,0.360290670417253
"11631","chr9.131050000.131055000","chr9.131175000.131180000",125000,19,1.578457e-05,131050000,131175000,131055000,131180000,"chr9",364135,4,4,4,12,"chr9",1,0.0267229254571027
"11632","chr9.127690000.127695000","chr9.127895000.127900000",205000,16,1.901789e-05,127690000,127895000,127695000,127900000,"chr9",364155,1,1,1,3,"chr9",1,0.00562587904360056
"11633","chr9.72025000.72030000","chr9.72485000.72490000",460000,10,0.0009480607,72025000,72485000,72030000,72490000,"chr9",364188,1,5,5,11,"chr9",1,0.012892639474918
"11634","chr9.35080000.35085000","chr9.35490000.35495000",410000,9,0.007275772,35080000,35490000,35085000,35495000,"chr9",364231,0,15,5,20,"chr9",1,0.0210970464135021
"11635","chr9.129965000.129970000","chr9.130200000.130205000",235000,18,1.648446e-07,129965000,130200000,129970000,130205000,"chr9",364250,6,14,21,41,"chr9",1,0.0864978902953586
"11636","chr9.19050000.19055000","chr9.19380000.19385000",330000,23,5.882834e-14,19050000,19380000,19055000,19385000,"chr9",364285,1,4,2,7,"chr9",1,0.0188701359587436
"11637","chr9.37590000.37595000","chr9.37730000.37735000",140000,14,0.004105485,37590000,37730000,37595000,37735000,"chr9",364287,1,2,1,4,"chr9",1,0.00656352555086732
"11638","chr9.129995000.130000000","chr9.130205000.130210000",210000,12,0.004121745,129995000,130205000,1.3e+08,130210000,"chr9",364325,4,17,19,40,"chr9",1,0.0562587904360056
"11639","chr9.27335000.27340000","chr9.27495000.27500000",160000,18,8.450571e-06,27335000,27495000,27340000,27500000,"chr9",364329,0,1,1,2,"chr9",1,0.00421940928270042
"11640","chr9.15245000.15250000","chr9.15430000.15435000",185000,12,0.008521915,15245000,15430000,15250000,15435000,"chr9",364345,0,2,0,2,"chr9",1,0.00281293952180028
"11641","chr9.97560000.97565000","chr9.97800000.97805000",240000,17,7.672596e-07,97560000,97800000,97565000,97805000,"chr9",364359,2,7,4,13,"chr9",1,0.0259024847632443
"11642","chr9.38010000.38015000","chr9.38045000.38050000",35000,35,1.391233e-06,38010000,38045000,38015000,38050000,"chr9",364363,2,0,0,2,"chr9",1,0.00820440693858415
"11643","chr9.128530000.128535000","chr9.128995000.129000000",465000,9,0.004121745,128530000,128995000,128535000,1.29e+08,"chr9",364385,1,11,9,21,"chr9",1,0.0221518987341772
"11644","chr9.123340000.123345000","chr9.123470000.123475000",130000,14,0.005976839,123340000,123470000,123345000,123475000,"chr9",364424,0,2,1,3,"chr9",1,0.00492264416315049
"11645","chr9.610000.615000","chr9.715000.720000",105000,28,8.008298e-11,610000,715000,615000,720000,"chr9",364427,1,2,4,7,"chr9",1,0.0229723394280356
"11646","chr9.129610000.129615000","chr9.130040000.130045000",430000,9,0.005856676,129610000,130040000,129615000,130045000,"chr9",364464,5,11,4,20,"chr9",1,0.0210970464135021
"11647","chr9.131610000.131615000","chr9.131695000.131700000",85000,20,0.0001539838,131610000,131695000,131615000,131700000,"chr9",364472,0,1,0,1,"chr9",1,0.0023441162681669
"11648","chr9.6575000.6580000","chr9.6665000.6670000",90000,23,1.715212e-06,6575000,6665000,6580000,6670000,"chr9",364485,10,12,18,40,"chr9",1,0.107829348335677
"11649","chr9.34895000.34900000","chr9.35095000.35100000",200000,20,2.992106e-08,34895000,35095000,34900000,35100000,"chr9",364513,0,3,1,4,"chr9",1,0.00937646507266761
"11650","chr9.123560000.123565000","chr9.123585000.123590000",25000,41,6.799763e-06,123560000,123585000,123565000,123590000,"chr9",364516,0,3,2,5,"chr9",1,0.0240271917487107
"11651","chr9.8550000.8555000","chr9.8775000.8780000",225000,19,4.454295e-08,8550000,8775000,8555000,8780000,"chr9",364531,0,1,1,2,"chr9",1,0.00445382090951711
"11652","chr9.87320000.87325000","chr9.87345000.87350000",25000,33,0.003975955,87320000,87345000,87325000,87350000,"chr9",364542,0,4,3,7,"chr9",1,0.0270745428973277
"11653","chr9.131610000.131615000","chr9.131690000.131695000",80000,47,3.387694e-24,131610000,131690000,131615000,131695000,"chr9",364583,1,1,1,3,"chr9",1,0.0165260196905767
"11654","chr9.13425000.13430000","chr9.14425000.14430000",1000000,9,3.551348e-05,13425000,14425000,13430000,14430000,"chr9",364606,1,0,0,1,"chr9",1,0.00105485232067511
"11655","chr9.35095000.35100000","chr9.35115000.35120000",20000,38,0.0005620438,35095000,35115000,35100000,35120000,"chr9",364613,2,13,5,20,"chr9",1,0.0890764181903422
"11656","chr9.124860000.124865000","chr9.124880000.124885000",20000,55,5.038795e-11,124860000,124880000,124865000,124885000,"chr9",364623,4,29,21,54,"chr9",1,0.348101265822785
"11657","chr9.113140000.113145000","chr9.113375000.113380000",235000,14,0.0001248317,113140000,113375000,113145000,113380000,"chr9",364655,2,6,10,18,"chr9",1,0.029535864978903
"11658","chr9.36450000.36455000","chr9.36555000.36560000",105000,20,1.947644e-05,36450000,36555000,36455000,36560000,"chr9",364670,9,43,31,83,"chr9",1,0.194561650257853
"11659","chr9.124850000.124855000","chr9.125080000.125085000",230000,12,0.002385851,124850000,125080000,124855000,125085000,"chr9",364733,1,4,3,8,"chr9",1,0.0112517580872011
"11660","chr9.128320000.128325000","chr9.128525000.128530000",205000,18,7.277712e-07,128320000,128525000,128325000,128530000,"chr9",364761,5,23,19,47,"chr9",1,0.0991561181434599
"11661","chr9.127695000.127700000","chr9.127915000.127920000",220000,13,0.0008539421,127695000,127915000,127700000,127920000,"chr9",364803,2,8,3,13,"chr9",1,0.0198077824660103
"11662","chr9.71700000.71705000","chr9.71830000.71835000",130000,16,0.0006153273,71700000,71830000,71705000,71835000,"chr9",364838,2,2,2,6,"chr9",1,0.0112517580872011
"11663","chr9.33075000.33080000","chr9.33225000.33230000",150000,29,5.745318e-14,33075000,33225000,33080000,33230000,"chr9",364857,3,7,2,12,"chr9",1,0.0407876230661041
"11664","chr9.114880000.114885000","chr9.114910000.114915000",30000,36,1.326022e-05,114880000,114910000,114885000,114915000,"chr9",364962,0,3,4,7,"chr9",1,0.029535864978903
"11665","chr9.113405000.113410000","chr9.114175000.114180000",770000,7,0.008850384,113405000,114175000,113410000,114180000,"chr9",365005,0,2,0,2,"chr9",1,0.00164088138771683
"11666","chr9.87370000.87375000","chr9.87870000.87875000",500000,10,0.0005872809,87370000,87870000,87375000,87875000,"chr9",365017,0,3,2,5,"chr9",1,0.00586029067041725
"11667","chr9.560000.565000","chr9.690000.695000",130000,29,5.116526e-13,560000,690000,565000,695000,"chr9",365023,0,0,5,5,"chr9",1,0.01699484294421
"11668","chr9.91100000.91105000","chr9.91190000.91195000",90000,18,0.0008968842,91100000,91190000,91105000,91195000,"chr9",365031,1,3,1,5,"chr9",1,0.0105485232067511
"11669","chr9.128315000.128320000","chr9.129120000.129125000",805000,7,0.007245133,128315000,129120000,128320000,129125000,"chr9",365072,6,14,21,41,"chr9",1,0.033638068448195
"11670","chr9.27350000.27355000","chr9.27530000.27535000",180000,39,2.072455e-25,27350000,27530000,27355000,27535000,"chr9",365083,1,3,3,7,"chr9",1,0.0319971870604782
"11671","chr9.129725000.129730000","chr9.129965000.129970000",240000,41,3.123677e-31,129725000,129965000,129730000,129970000,"chr9",365092,7,28,21,56,"chr9",1,0.26910454758556
"11672","chr9.97535000.97540000","chr9.97905000.97910000",370000,11,0.0006325571,97535000,97905000,97540000,97910000,"chr9",365131,1,3,5,9,"chr9",1,0.0116033755274262
"11673","chr9.131815000.131820000","chr9.132135000.132140000",320000,10,0.005394398,131815000,132135000,131820000,132140000,"chr9",365164,3,7,15,25,"chr9",1,0.0293014533520863
"11674","chr9.129735000.129740000","chr9.129965000.129970000",230000,22,1.022685e-10,129735000,129965000,129740000,129970000,"chr9",365181,3,8,6,17,"chr9",1,0.0438349742147211
"11675","chr9.100465000.100470000","chr9.100675000.100680000",210000,12,0.004121745,100465000,100675000,100470000,100680000,"chr9",365250,1,0,5,6,"chr9",1,0.00843881856540084
"11676","chr9.128320000.128325000","chr9.128500000.128505000",180000,14,0.0009019254,128320000,128500000,128325000,128505000,"chr9",365252,5,21,20,46,"chr9",1,0.0754805438349742
"11677","chr9.19455000.19460000","chr9.20355000.20360000",900000,10,1.075104e-05,19455000,20355000,19460000,20360000,"chr9",365283,1,1,0,2,"chr9",1,0.0023441162681669
"11678","chr9.19460000.19465000","chr9.19920000.19925000",460000,28,5.974307e-22,19460000,19920000,19465000,19925000,"chr9",365294,0,3,5,8,"chr9",1,0.0262541022034693
"11679","chr9.35655000.35660000","chr9.35725000.35730000",70000,34,4.985061e-12,35655000,35725000,35660000,35730000,"chr9",365318,0,0,3,3,"chr9",1,0.0119549929676512
"11680","chr9.131175000.131180000","chr9.131415000.131420000",240000,15,2.270004e-05,131175000,131415000,131180000,131420000,"chr9",365348,1,4,4,9,"chr9",1,0.0158227848101266
"11681","chr9.133325000.133330000","chr9.133555000.133560000",230000,11,0.0082624,133325000,133555000,133330000,133560000,"chr9",365374,0,0,2,2,"chr9",1,0.00257852789498359
"11682","chr9.128170000.128175000","chr9.128320000.128325000",150000,13,0.008528833,128170000,128320000,128175000,128325000,"chr9",365385,14,26,39,79,"chr9",1,0.12037037037037
"11683","chr9.97560000.97565000","chr9.97595000.97600000",35000,33,1.134641e-05,97560000,97595000,97565000,97600000,"chr9",365409,1,6,3,10,"chr9",1,0.0386779184247539
"11684","chr9.87660000.87665000","chr9.87875000.87880000",215000,13,0.0009965743,87660000,87875000,87665000,87880000,"chr9",365432,0,2,1,3,"chr9",1,0.00457102672292546
"11685","chr9.128315000.128320000","chr9.128995000.129000000",680000,8,0.003108272,128315000,128995000,128320000,1.29e+08,"chr9",365489,1,11,9,21,"chr9",1,0.019690576652602
"11686","chr9.19100000.19105000","chr9.19380000.19385000",280000,27,5.72384e-17,19100000,19380000,19105000,19385000,"chr9",365492,10,18,21,49,"chr9",1,0.15506329113924
"11687","chr9.114485000.114490000","chr9.114880000.114885000",395000,9,0.008524811,114485000,114880000,114490000,114885000,"chr9",365506,1,3,4,8,"chr9",1,0.00843881856540084
"11688","chr9.27330000.27335000","chr9.27410000.27415000",80000,19,0.0008205688,27330000,27410000,27335000,27415000,"chr9",365562,0,3,1,4,"chr9",1,0.00890764181903422
"11689","chr9.72035000.72040000","chr9.72485000.72490000",450000,12,3.568221e-05,72035000,72485000,72040000,72490000,"chr9",365639,1,4,5,10,"chr9",1,0.0140646976090014
"11690","chr9.5185000.5190000","chr9.5450000.5455000",265000,14,4.825082e-05,5185000,5450000,5190000,5455000,"chr9",365640,0,5,2,7,"chr9",1,0.0114861697140178
"11691","chr9.87370000.87375000","chr9.87565000.87570000",195000,14,0.0005148465,87370000,87565000,87375000,87570000,"chr9",365673,0,0,1,1,"chr9",1,0.00164088138771683
"11692","chr9.35160000.35165000","chr9.35600000.35605000",440000,10,0.001183306,35160000,35600000,35165000,35605000,"chr9",365679,0,9,2,11,"chr9",1,0.012892639474918
"11693","chr9.113410000.113415000","chr9.113535000.113540000",125000,15,0.00250834,113410000,113535000,113415000,113540000,"chr9",365680,4,16,19,39,"chr9",1,0.0685654008438819
"11694","chr9.35785000.35790000","chr9.35825000.35830000",40000,26,0.001107374,35785000,35825000,35790000,35830000,"chr9",365701,0,6,4,10,"chr9",1,0.0304735114861697
"11695","chr9.98190000.98195000","chr9.98995000.99000000",805000,7,0.007245133,98190000,98995000,98195000,9.9e+07,"chr9",365722,1,5,4,10,"chr9",1,0.00820440693858415
"11696","chr9.129775000.129780000","chr9.129965000.129970000",190000,14,0.0006207031,129775000,129965000,129780000,129970000,"chr9",365737,2,6,10,18,"chr9",1,0.029535864978903
"11697","chr9.128310000.128315000","chr9.128605000.128610000",295000,10,0.007954814,128310000,128605000,128315000,128610000,"chr9",365744,6,11,5,22,"chr9",1,0.0257852789498359
"11698","chr9.35070000.35075000","chr9.35115000.35120000",45000,28,3.872686e-05,35070000,35115000,35075000,35120000,"chr9",365804,1,2,2,5,"chr9",1,0.0164088138771683
"11699","chr9.38010000.38015000","chr9.38360000.38365000",350000,13,3.332232e-05,38010000,38360000,38015000,38365000,"chr9",365844,1,0,0,1,"chr9",1,0.00152367557430849
"11700","chr9.109085000.109090000","chr9.109115000.109120000",30000,35,3.395722e-05,109085000,109115000,109090000,109120000,"chr9",365853,3,4,6,13,"chr9",1,0.053328645100797
"11701","chr9.122040000.122045000","chr9.122085000.122090000",45000,27,0.0001087367,122040000,122085000,122045000,122090000,"chr9",365863,0,3,1,4,"chr9",1,0.0126582278481013
"11702","chr9.133455000.133460000","chr9.133700000.133705000",245000,12,0.001629879,133455000,133700000,133460000,133705000,"chr9",365875,1,2,1,4,"chr9",1,0.00562587904360056
"11703","chr9.123385000.123390000","chr9.123545000.123550000",160000,14,0.00193113,123385000,123545000,123390000,123550000,"chr9",365877,0,4,6,10,"chr9",1,0.0164088138771683
"11704","chr9.129965000.129970000","chr9.130105000.130110000",140000,17,0.0001037481,129965000,130105000,129970000,130110000,"chr9",365910,3,25,12,40,"chr9",1,0.0796999531176746
"11705","chr9.131405000.131410000","chr9.131710000.131715000",305000,15,2.769543e-06,131405000,131710000,131410000,131715000,"chr9",365946,2,8,2,12,"chr9",1,0.0210970464135021
"11706","chr9.37590000.37595000","chr9.37750000.37755000",160000,13,0.006049966,37590000,37750000,37595000,37755000,"chr9",365957,1,4,4,9,"chr9",1,0.0137130801687764
"11707","chr9.4665000.4670000","chr9.4740000.4745000",75000,17,0.009548344,4665000,4740000,4670000,4745000,"chr9",365995,0,1,3,4,"chr9",1,0.00796999531176746
"11708","chr9.27350000.27355000","chr9.27460000.27465000",110000,18,0.0001734391,27350000,27460000,27355000,27465000,"chr9",365997,2,1,0,3,"chr9",1,0.00632911392405063
"11709","chr9.128320000.128325000","chr9.129225000.129230000",905000,8,0.0006400049,128320000,129225000,128325000,129230000,"chr9",366033,10,29,19,58,"chr9",1,0.0543834974214721
"11710","chr9.37905000.37910000","chr9.38360000.38365000",455000,15,9.367321e-08,37905000,38360000,37910000,38365000,"chr9",366045,1,4,3,8,"chr9",1,0.0140646976090014
"11711","chr9.100210000.100215000","chr9.100375000.100380000",165000,20,2.656955e-07,100210000,100375000,100215000,100380000,"chr9",366047,3,3,2,8,"chr9",1,0.0187529301453352
"11712","chr9.27340000.27345000","chr9.27460000.27465000",120000,17,0.0003035781,27340000,27460000,27345000,27465000,"chr9",366066,2,1,0,3,"chr9",1,0.0059774964838256
"11713","chr9.19045000.19050000","chr9.19100000.19105000",55000,36,5.074682e-11,19045000,19100000,19050000,19105000,"chr9",366071,6,24,29,59,"chr9",1,0.248945147679325
"11714","chr9.27405000.27410000","chr9.27460000.27465000",55000,20,0.009171875,27405000,27460000,27410000,27465000,"chr9",366083,1,1,0,2,"chr9",1,0.0046882325363338
"11715","chr9.37575000.37580000","chr9.37675000.37680000",100000,16,0.003454179,37575000,37675000,37580000,37680000,"chr9",366092,0,5,2,7,"chr9",1,0.0131270511017346
"11716","chr9.12720000.12725000","chr9.12815000.12820000",95000,20,5.15117e-05,12720000,12815000,12725000,12820000,"chr9",366121,0,2,1,3,"chr9",1,0.0070323488045007
"11717","chr9.134065000.134070000","chr9.134205000.134210000",140000,18,2.615522e-05,134065000,134205000,134070000,134210000,"chr9",366174,0,2,2,4,"chr9",1,0.00843881856540084
"11718","chr9.123410000.123415000","chr9.123470000.123475000",60000,28,6.518259e-07,123410000,123470000,123415000,123475000,"chr9",366175,0,2,1,3,"chr9",1,0.00984528832630099
"11719","chr9.114405000.114410000","chr9.114425000.114430000",20000,39,0.0002661542,114405000,114425000,114410000,114430000,"chr9",366176,0,3,2,5,"chr9",1,0.0228551336146273
"11720","chr9.5750000.5755000","chr9.5940000.5945000",190000,14,0.0006207031,5750000,5940000,5755000,5945000,"chr9",366185,1,4,4,9,"chr9",1,0.0147679324894515
"11721","chr9.128180000.128185000","chr9.128990000.128995000",810000,7,0.007016342,128180000,128990000,128185000,128995000,"chr9",366193,6,21,11,38,"chr9",1,0.0311767463666198
"11722","chr9.345000.350000","chr9.610000.615000",265000,12,0.0009836041,345000,610000,350000,615000,"chr9",366219,1,1,1,3,"chr9",1,0.00421940928270042
"11723","chr9.85815000.85820000","chr9.85940000.85945000",125000,17,0.0002314129,85815000,85940000,85820000,85945000,"chr9",366222,1,3,2,6,"chr9",1,0.0119549929676512
"11724","chr9.8715000.8720000","chr9.8775000.8780000",60000,21,0.001685516,8715000,8775000,8720000,8780000,"chr9",366228,1,2,2,5,"chr9",1,0.0123066104078762
"11725","chr9.13570000.13575000","chr9.14425000.14430000",855000,11,1.837842e-06,13570000,14425000,13575000,14430000,"chr9",366239,2,0,0,2,"chr9",1,0.00257852789498359
"11726","chr9.136960000.136965000","chr9.137420000.137425000",460000,11,0.0001817949,136960000,137420000,136965000,137425000,"chr9",366261,2,0,0,2,"chr9",1,0.00257852789498359
"11727","chr9.127910000.127915000","chr9.127930000.127935000",20000,36,0.002291956,127910000,127930000,127915000,127935000,"chr9",366270,5,19,16,40,"chr9",1,0.168776371308017
"11728","chr9.19485000.19490000","chr9.19605000.19610000",120000,16,0.001026552,19485000,19605000,19490000,19610000,"chr9",366275,0,2,0,2,"chr9",1,0.00375058602906704
"11729","chr9.35115000.35120000","chr9.35535000.35540000",420000,20,3.173521e-12,35115000,35535000,35120000,35540000,"chr9",366276,1,10,7,18,"chr9",1,0.0421940928270042
"11730","chr9.129750000.129755000","chr9.130050000.130055000",300000,11,0.00193113,129750000,130050000,129755000,130055000,"chr9",366281,3,19,9,31,"chr9",1,0.0399671823722457
"11731","chr9.32575000.32580000","chr9.32965000.32970000",390000,23,5.964395e-15,32575000,32965000,32580000,32970000,"chr9",366289,0,1,3,4,"chr9",1,0.0107829348335677
"11732","chr9.72890000.72895000","chr9.73105000.73110000",215000,17,2.386659e-06,72890000,73105000,72895000,73110000,"chr9",366298,0,6,6,12,"chr9",1,0.0239099859353024
"11733","chr9.121325000.121330000","chr9.122155000.122160000",830000,7,0.006245654,121325000,122155000,121330000,122160000,"chr9",366302,0,2,0,2,"chr9",1,0.00164088138771683
"11734","chr9.35955000.35960000","chr9.36190000.36195000",235000,13,0.0005387066,35955000,36190000,35960000,36195000,"chr9",366333,0,3,3,6,"chr9",1,0.00914205344585091
"11735","chr9.6475000.6480000","chr9.6575000.6580000",100000,15,0.009266319,6475000,6575000,6480000,6580000,"chr9",366337,2,5,1,8,"chr9",1,0.0140646976090014
"11736","chr9.131960000.131965000","chr9.132135000.132140000",175000,14,0.001090143,131960000,132135000,131965000,132140000,"chr9",366371,2,2,1,5,"chr9",1,0.00820440693858415
"11737","chr9.19485000.19490000","chr9.19920000.19925000",435000,32,1.88464e-26,19485000,19920000,19490000,19925000,"chr9",366406,0,3,10,13,"chr9",1,0.0487576183778715
"11738","chr9.131605000.131610000","chr9.131690000.131695000",85000,18,0.001421168,131605000,131690000,131610000,131695000,"chr9",366422,2,1,2,5,"chr9",1,0.0105485232067511
"11739","chr9.27425000.27430000","chr9.27465000.27470000",40000,26,0.001107374,27425000,27465000,27430000,27470000,"chr9",366441,0,2,2,4,"chr9",1,0.0121894045944679
"11740","chr9.128370000.128375000","chr9.128435000.128440000",65000,19,0.004889805,128370000,128435000,128375000,128440000,"chr9",366442,1,4,1,6,"chr9",1,0.0133614627285513
"11741","chr9.34175000.34180000","chr9.34200000.34205000",25000,39,3.989491e-05,34175000,34200000,34180000,34205000,"chr9",366445,2,27,11,40,"chr9",1,0.182841068917018
"11742","chr9.4740000.4745000","chr9.5625000.5630000",885000,9,0.0001043541,4740000,5625000,4745000,5630000,"chr9",366447,0,10,8,18,"chr9",1,0.0189873417721519
"11743","chr9.37900000.37905000","chr9.38400000.38405000",500000,10,0.0005872809,37900000,38400000,37905000,38405000,"chr9",366450,6,15,14,35,"chr9",1,0.0410220346929208
"11744","chr9.35755000.35760000","chr9.35785000.35790000",30000,28,0.009189652,35755000,35785000,35760000,35790000,"chr9",366452,3,1,0,4,"chr9",1,0.0131270511017346
"11745","chr9.127690000.127695000","chr9.127920000.127925000",230000,11,0.0082624,127690000,127920000,127695000,127925000,"chr9",366487,2,12,11,25,"chr9",1,0.0322315986872949
"11746","chr9.133685000.133690000","chr9.133725000.133730000",40000,29,6.919718e-05,133685000,133725000,133690000,133730000,"chr9",366502,2,3,0,5,"chr9",1,0.01699484294421
"11747","chr9.107745000.107750000","chr9.107905000.107910000",160000,13,0.006049966,107745000,107905000,107750000,107910000,"chr9",366514,0,3,2,5,"chr9",1,0.00761837787154243
"11748","chr9.129980000.129985000","chr9.130105000.130110000",125000,14,0.007342334,129980000,130105000,129985000,130110000,"chr9",366515,3,10,11,24,"chr9",1,0.0393811533052039
"11749","chr9.131590000.131595000","chr9.131740000.131745000",150000,14,0.002786698,131590000,131740000,131595000,131745000,"chr9",366557,2,3,2,7,"chr9",1,0.0114861697140178
"11750","chr9.34325000.34330000","chr9.34600000.34605000",275000,14,3.569064e-05,34325000,34600000,34330000,34605000,"chr9",366562,0,4,3,7,"chr9",1,0.0114861697140178
"11751","chr9.124420000.124425000","chr9.124750000.124755000",330000,10,0.004676345,124420000,124750000,124425000,124755000,"chr9",366618,0,3,3,6,"chr9",1,0.0070323488045007
"11752","chr9.128320000.128325000","chr9.129200000.129205000",880000,7,0.00465113,128320000,129200000,128325000,129205000,"chr9",366628,0,5,1,6,"chr9",1,0.00492264416315049
"11753","chr9.35255000.35260000","chr9.35490000.35495000",235000,12,0.002100608,35255000,35490000,35260000,35495000,"chr9",366636,0,15,5,20,"chr9",1,0.0281293952180028
"11754","chr9.35255000.35260000","chr9.35550000.35555000",295000,10,0.007954814,35255000,35550000,35260000,35555000,"chr9",366645,1,9,3,13,"chr9",1,0.0152367557430849
"11755","chr9.128655000.128660000","chr9.129200000.129205000",545000,9,0.001875702,128655000,129200000,128660000,129205000,"chr9",366649,0,5,1,6,"chr9",1,0.00632911392405063
"11756","chr9.27390000.27395000","chr9.27530000.27535000",140000,19,6.164147e-06,27390000,27530000,27395000,27535000,"chr9",366670,1,4,3,8,"chr9",1,0.0178152836380684
"11757","chr9.98125000.98130000","chr9.99025000.99030000",900000,7,0.004129511,98125000,99025000,98130000,99030000,"chr9",366687,0,7,4,11,"chr9",1,0.00902484763244257
"11758","chr9.131950000.131955000","chr9.132070000.132075000",120000,15,0.003167997,131950000,132070000,131955000,132075000,"chr9",366721,0,0,1,1,"chr9",1,0.00175808720112518
"11759","chr9.134170000.134175000","chr9.134205000.134210000",35000,29,0.0004939142,134170000,134205000,134175000,134210000,"chr9",366820,0,2,2,4,"chr9",1,0.013595874355368
"11760","chr9.71700000.71705000","chr9.72185000.72190000",485000,9,0.003401316,71700000,72185000,71705000,72190000,"chr9",366852,2,2,2,6,"chr9",1,0.00632911392405063
"11761","chr9.113410000.113415000","chr9.114055000.114060000",645000,21,4.350327e-16,113410000,114055000,113415000,114060000,"chr9",366880,2,0,0,2,"chr9",1,0.00492264416315049
"11762","chr9.128320000.128325000","chr9.129255000.129260000",935000,12,6.599736e-08,128320000,129255000,128325000,129260000,"chr9",366949,1,2,2,5,"chr9",1,0.0070323488045007
"11763","chr9.32575000.32580000","chr9.33000000.33005000",425000,12,5.336685e-05,32575000,3.3e+07,32580000,33005000,"chr9",367050,0,1,7,8,"chr9",1,0.0112517580872011
"11764","chr9.131690000.131695000","chr9.131740000.131745000",50000,21,0.008949849,131690000,131740000,131695000,131745000,"chr9",367053,2,1,2,5,"chr9",1,0.0123066104078762
"11765","chr9.128160000.128165000","chr9.128700000.128705000",540000,9,0.001963798,128160000,128700000,128165000,128705000,"chr9",367076,2,4,5,11,"chr9",1,0.0116033755274262
"11766","chr9.35600000.35605000","chr9.35645000.35650000",45000,28,3.872686e-05,35600000,35645000,35605000,35650000,"chr9",367080,1,6,6,13,"chr9",1,0.0426629160806376
"11767","chr9.99000000.99005000","chr9.99025000.99030000",25000,32,0.007548942,9.9e+07,99025000,99005000,99030000,"chr9",367104,0,2,4,6,"chr9",1,0.0225035161744023
"11768","chr9.35955000.35960000","chr9.36005000.36010000",50000,36,3.80465e-10,35955000,36005000,35960000,36010000,"chr9",367105,1,2,0,3,"chr9",1,0.0126582278481013
"11769","chr9.87370000.87375000","chr9.87600000.87605000",230000,11,0.0082624,87370000,87600000,87375000,87605000,"chr9",367156,4,4,8,16,"chr9",1,0.0206282231598687
"11770","chr9.36255000.36260000","chr9.36315000.36320000",60000,23,0.0002307877,36255000,36315000,36260000,36320000,"chr9",367161,10,19,14,43,"chr9",1,0.115916549460853
"11771","chr9.76685000.76690000","chr9.76740000.76745000",55000,22,0.001629879,76685000,76740000,76690000,76745000,"chr9",367189,3,1,4,8,"chr9",1,0.0206282231598687
"11772","chr9.128505000.128510000","chr9.129035000.129040000",530000,8,0.009647978,128505000,129035000,128510000,129040000,"chr9",367209,7,19,21,47,"chr9",1,0.0440693858415377
"11773","chr9.36190000.36195000","chr9.36245000.36250000",55000,36,5.074682e-11,36190000,36245000,36195000,36250000,"chr9",367245,0,3,3,6,"chr9",1,0.0253164556962025
"11774","chr9.121980000.121985000","chr9.122040000.122045000",60000,21,0.001685516,121980000,122040000,121985000,122045000,"chr9",367271,0,1,1,2,"chr9",1,0.00492264416315049
"11775","chr9.129820000.129825000","chr9.129885000.129890000",65000,26,2.314202e-06,129820000,129885000,129825000,129890000,"chr9",367280,0,1,1,2,"chr9",1,0.00609470229723394
"11776","chr9.15210000.15215000","chr9.15605000.15610000",395000,10,0.002081723,15210000,15605000,15215000,15610000,"chr9",367301,0,3,0,3,"chr9",1,0.00351617440225035
"11777","chr9.128315000.128320000","chr9.128420000.128425000",105000,18,0.0002512537,128315000,128420000,128320000,128425000,"chr9",367325,0,7,7,14,"chr9",1,0.029535864978903
"11778","chr9.114485000.114490000","chr9.114640000.114645000",155000,14,0.002319745,114485000,114640000,114490000,114645000,"chr9",367345,2,6,5,13,"chr9",1,0.0213314580403188
"11779","chr9.14780000.14785000","chr9.15100000.15105000",320000,10,0.005394398,14780000,15100000,14785000,15105000,"chr9",367404,0,4,5,9,"chr9",1,0.0105485232067511
"11780","chr9.76300000.76305000","chr9.77185000.77190000",885000,9,0.0001043541,76300000,77185000,76305000,77190000,"chr9",367418,0,7,6,13,"chr9",1,0.0137130801687764
"11781","chr9.34895000.34900000","chr9.35050000.35055000",155000,26,1.273116e-11,34895000,35050000,34900000,35055000,"chr9",367422,0,3,1,4,"chr9",1,0.0121894045944679
"11782","chr9.33080000.33085000","chr9.33190000.33195000",110000,16,0.001815139,33080000,33190000,33085000,33195000,"chr9",367472,4,12,6,22,"chr9",1,0.0412564463197375
"11783","chr9.35655000.35660000","chr9.35715000.35720000",60000,20,0.004166415,35655000,35715000,35660000,35720000,"chr9",367482,3,3,4,10,"chr9",1,0.023441162681669
"11784","chr9.127225000.127230000","chr9.127890000.127895000",665000,8,0.003454179,127225000,127890000,127230000,127895000,"chr9",367486,2,7,7,16,"chr9",1,0.0150023441162682
"11785","chr9.19045000.19050000","chr9.19170000.19175000",125000,22,1.810114e-07,19045000,19170000,19050000,19175000,"chr9",367528,6,33,29,68,"chr9",1,0.175339896858884
"11786","chr9.36405000.36410000","chr9.36475000.36480000",70000,22,0.0001098406,36405000,36475000,36410000,36480000,"chr9",367545,1,10,7,18,"chr9",1,0.0464135021097046
"11787","chr9.27030000.27035000","chr9.27325000.27330000",295000,12,0.0004975477,27030000,27325000,27035000,27330000,"chr9",367549,3,7,9,19,"chr9",1,0.0267229254571027
"11788","chr9.35075000.35080000","chr9.35160000.35165000",85000,18,0.001421168,35075000,35160000,35080000,35165000,"chr9",367584,0,3,0,3,"chr9",1,0.00632911392405063
"11789","chr9.129995000.130000000","chr9.130185000.130190000",190000,12,0.007342334,129995000,130185000,1.3e+08,130190000,"chr9",367611,0,11,7,18,"chr9",1,0.0253164556962025
"11790","chr9.20640000.20645000","chr9.20940000.20945000",300000,11,0.00193113,20640000,20940000,20645000,20945000,"chr9",367615,0,1,0,1,"chr9",1,0.0012892639474918
"11791","chr9.34675000.34680000","chr9.35050000.35055000",375000,10,0.002623147,34675000,35050000,34680000,35055000,"chr9",367619,3,13,15,31,"chr9",1,0.036333802156587
"11792","chr9.33880000.33885000","chr9.34325000.34330000",445000,9,0.005011886,33880000,34325000,33885000,34330000,"chr9",367651,6,11,13,30,"chr9",1,0.0316455696202532
"11793","chr9.127750000.127755000","chr9.127780000.127785000",30000,39,6.519928e-07,127750000,127780000,127755000,127785000,"chr9",367681,0,1,1,2,"chr9",1,0.00914205344585091
"11794","chr9.126315000.126320000","chr9.127120000.127125000",805000,7,0.007245133,126315000,127120000,126320000,127125000,"chr9",367706,0,0,3,3,"chr9",1,0.00246132208157525
"11795","chr9.128525000.128530000","chr9.129250000.129255000",725000,8,0.002272923,128525000,129250000,128530000,129255000,"chr9",367718,4,13,8,25,"chr9",1,0.023441162681669
"11796","chr9.86280000.86285000","chr9.86300000.86305000",20000,34,0.008189353,86280000,86300000,86285000,86305000,"chr9",367727,1,2,3,6,"chr9",1,0.0239099859353024
"11797","chr9.35490000.35495000","chr9.35550000.35555000",60000,76,3.146696e-47,35490000,35550000,35495000,35555000,"chr9",367738,0,9,3,12,"chr9",1,0.106891701828411
"11798","chr9.33810000.33815000","chr9.33850000.33855000",40000,61,2.904178e-25,33810000,33850000,33815000,33855000,"chr9",367819,6,18,9,33,"chr9",1,0.235935302390999
"11799","chr9.128315000.128320000","chr9.128880000.128885000",565000,8,0.007342334,128315000,128880000,128320000,128885000,"chr9",367857,0,2,9,11,"chr9",1,0.0103141115799344
"11800","chr9.3730000.3735000","chr9.4330000.4335000",600000,10,0.0001963322,3730000,4330000,3735000,4335000,"chr9",367879,1,0,0,1,"chr9",1,0.00117205813408345
"11801","chr9.131095000.131100000","chr9.131175000.131180000",80000,22,2.533391e-05,131095000,131175000,131100000,131180000,"chr9",367897,4,4,4,12,"chr9",1,0.0309423347398031
"11802","chr9.5185000.5190000","chr9.5425000.5430000",240000,16,4.263138e-06,5185000,5425000,5190000,5430000,"chr9",367899,0,2,2,4,"chr9",1,0.00750117205813408
"11803","chr9.35655000.35660000","chr9.35745000.35750000",90000,18,0.0008968842,35655000,35745000,35660000,35750000,"chr9",367909,0,4,4,8,"chr9",1,0.0168776371308017
"11804","chr9.35525000.35530000","chr9.35550000.35555000",25000,48,6.033839e-09,35525000,35550000,35530000,35555000,"chr9",367938,1,9,3,13,"chr9",1,0.0731364275668073
"11805","chr9.129965000.129970000","chr9.130140000.130145000",175000,14,0.001090143,129965000,130140000,129970000,130145000,"chr9",367983,1,5,1,7,"chr9",1,0.0114861697140178
"11806","chr9.21335000.21340000","chr9.21395000.21400000",60000,25,2.52988e-05,21335000,21395000,21340000,21400000,"chr9",367994,3,8,7,18,"chr9",1,0.0527426160337553
"11807","chr9.129725000.129730000","chr9.129820000.129825000",95000,17,0.001732132,129725000,129820000,129730000,129825000,"chr9",368062,7,27,9,43,"chr9",1,0.0856774496015002
"11808","chr9.131665000.131670000","chr9.131690000.131695000",25000,48,6.033839e-09,131665000,131690000,131670000,131695000,"chr9",368077,1,1,1,3,"chr9",1,0.0168776371308017
"11809","chr9.34175000.34180000","chr9.34325000.34330000",150000,15,0.0008539421,34175000,34325000,34180000,34330000,"chr9",368082,8,12,16,36,"chr9",1,0.0632911392405063
"11810","chr9.124305000.124310000","chr9.124865000.124870000",560000,12,7.00428e-06,124305000,124865000,124310000,124870000,"chr9",368084,0,5,0,5,"chr9",1,0.0070323488045007
"11811","chr9.33260000.33265000","chr9.33290000.33295000",30000,36,1.326022e-05,33260000,33290000,33265000,33295000,"chr9",368133,1,5,7,13,"chr9",1,0.0548523206751055
"11812","chr9.73020000.73025000","chr9.73105000.73110000",85000,19,0.0004840376,73020000,73105000,73025000,73110000,"chr9",368145,0,4,4,8,"chr9",1,0.0178152836380684
"11813","chr9.27275000.27280000","chr9.27330000.27335000",55000,21,0.003975955,27275000,27330000,27280000,27335000,"chr9",368186,1,3,4,8,"chr9",1,0.019690576652602
"11814","chr9.127605000.127610000","chr9.127895000.127900000",290000,11,0.00231679,127605000,127895000,127610000,127900000,"chr9",368200,1,1,1,3,"chr9",1,0.00386779184247539
"11815","chr9.131990000.131995000","chr9.132355000.132360000",365000,10,0.002998033,131990000,132355000,131995000,132360000,"chr9",368216,2,7,4,13,"chr9",1,0.0152367557430849
"11816","chr9.5795000.5800000","chr9.6015000.6020000",220000,13,0.0008539421,5795000,6015000,5800000,6020000,"chr9",368240,3,16,8,27,"chr9",1,0.0411392405063291
"11817","chr9.128235000.128240000","chr9.128265000.128270000",30000,31,0.001043713,128235000,128265000,128240000,128270000,"chr9",368242,1,0,4,5,"chr9",1,0.0181669010782935
"11818","chr9.108760000.108765000","chr9.109085000.109090000",325000,10,0.005011886,108760000,109085000,108765000,109090000,"chr9",368309,0,4,5,9,"chr9",1,0.0105485232067511
"11819","chr9.27480000.27485000","chr9.27545000.27550000",65000,22,0.0002550679,27480000,27545000,27485000,27550000,"chr9",368341,0,3,1,4,"chr9",1,0.0103141115799344
"11820","chr9.128165000.128170000","chr9.128995000.129000000",830000,8,0.001103996,128165000,128995000,128170000,1.29e+08,"chr9",368379,0,9,9,18,"chr9",1,0.0168776371308017
"11821","chr9.36400000.36405000","chr9.36450000.36455000",50000,28,1.015715e-05,36400000,36450000,36405000,36455000,"chr9",368405,4,5,3,12,"chr9",1,0.0393811533052039
"11822","chr9.128315000.128320000","chr9.129235000.129240000",920000,9,7.765979e-05,128315000,129235000,128320000,129240000,"chr9",368453,0,1,2,3,"chr9",1,0.00316455696202532
"11823","chr9.131530000.131535000","chr9.131690000.131695000",160000,13,0.006049966,131530000,131690000,131535000,131695000,"chr9",368472,2,1,2,5,"chr9",1,0.00761837787154243
"11824","chr9.20355000.20360000","chr9.20640000.20645000",285000,17,1.311272e-07,20355000,20640000,20360000,20645000,"chr9",368477,0,1,0,1,"chr9",1,0.00199249882794187
"11825","chr9.131610000.131615000","chr9.131755000.131760000",145000,13,0.009990165,131610000,131755000,131615000,131760000,"chr9",368487,1,1,1,3,"chr9",1,0.00457102672292546
"11826","chr9.131415000.131420000","chr9.131690000.131695000",275000,18,2.834878e-08,131415000,131690000,131420000,131695000,"chr9",368489,1,1,2,4,"chr9",1,0.00843881856540084
"11827","chr9.130040000.130045000","chr9.130070000.130075000",30000,36,1.326022e-05,130040000,130070000,130045000,130075000,"chr9",368490,5,11,4,20,"chr9",1,0.0843881856540084
"11828","chr9.121950000.121955000","chr9.121980000.121985000",30000,29,0.004574059,121950000,121980000,121955000,121985000,"chr9",368508,0,1,2,3,"chr9",1,0.010196905766526
"11829","chr9.4680000.4685000","chr9.4740000.4745000",60000,24,7.889058e-05,4680000,4740000,4685000,4745000,"chr9",368521,0,10,8,18,"chr9",1,0.0506329113924051
"11830","chr9.690000.695000","chr9.745000.750000",55000,24,0.0002314129,690000,745000,695000,750000,"chr9",368535,5,6,6,17,"chr9",1,0.0478199718706048
"11831","chr9.89095000.89100000","chr9.89545000.89550000",450000,9,0.004756049,89095000,89545000,89100000,89550000,"chr9",368592,3,9,6,18,"chr9",1,0.0189873417721519
"11832","chr9.35745000.35750000","chr9.35825000.35830000",80000,17,0.006071643,35745000,35825000,35750000,35830000,"chr9",368595,0,4,4,8,"chr9",1,0.0159399906235349
"11833","chr9.131960000.131965000","chr9.132340000.132345000",380000,10,0.002502287,131960000,132340000,131965000,132345000,"chr9",368618,2,2,1,5,"chr9",1,0.00586029067041725
"11834","chr9.3465000.3470000","chr9.4365000.4370000",900000,8,0.0006658108,3465000,4365000,3470000,4370000,"chr9",368622,0,7,4,11,"chr9",1,0.0103141115799344
"11835","chr9.128415000.128420000","chr9.129120000.129125000",705000,8,0.00256988,128415000,129120000,128420000,129125000,"chr9",368641,5,14,17,36,"chr9",1,0.0337552742616034
"11836","chr9.132665000.132670000","chr9.132875000.132880000",210000,13,0.00115245,132665000,132875000,132670000,132880000,"chr9",368661,1,0,4,5,"chr9",1,0.00761837787154243
"11837","chr9.127790000.127795000","chr9.127820000.127825000",30000,37,4.978869e-06,127790000,127820000,127795000,127825000,"chr9",368691,10,37,27,74,"chr9",1,0.320909517112049
"11838","chr9.19490000.19495000","chr9.19920000.19925000",430000,29,1.329341e-22,19490000,19920000,19495000,19925000,"chr9",368695,0,3,10,13,"chr9",1,0.0441865916549461
"11839","chr9.109050000.109055000","chr9.109400000.109405000",350000,10,0.003657266,109050000,109400000,109055000,109405000,"chr9",368768,5,7,2,14,"chr9",1,0.0164088138771683
"11840","chr9.112745000.112750000","chr9.112850000.112855000",105000,17,0.000816932,112745000,112850000,112750000,112855000,"chr9",368787,2,1,3,6,"chr9",1,0.0119549929676512
"11841","chr9.127800000.127805000","chr9.127880000.127885000",80000,19,0.0008205688,127800000,127880000,127805000,127885000,"chr9",368799,6,31,25,62,"chr9",1,0.13806844819503
"11842","chr9.128415000.128420000","chr9.128995000.129000000",580000,11,3.759188e-05,128415000,128995000,128420000,1.29e+08,"chr9",368824,1,11,9,21,"chr9",1,0.0270745428973277
"11843","chr9.19230000.19235000","chr9.19455000.19460000",225000,12,0.002718392,19230000,19455000,19235000,19460000,"chr9",368825,4,8,9,21,"chr9",1,0.029535864978903
"11844","chr9.108725000.108730000","chr9.109050000.109055000",325000,11,0.001244522,108725000,109050000,108730000,109055000,"chr9",368857,1,0,1,2,"chr9",1,0.00257852789498359
"11845","chr9.36165000.36170000","chr9.36190000.36195000",25000,34,0.001998692,36165000,36190000,36170000,36195000,"chr9",368891,0,3,3,6,"chr9",1,0.0239099859353024
"11846","chr9.2855000.2860000","chr9.3035000.3040000",180000,20,1.024364e-07,2855000,3035000,2860000,3040000,"chr9",368892,1,1,1,3,"chr9",1,0.0070323488045007
"11847","chr9.13135000.13140000","chr9.13275000.13280000",140000,14,0.004105485,13135000,13275000,13140000,13280000,"chr9",368923,0,2,0,2,"chr9",1,0.00328176277543366
"11848","chr9.133700000.133705000","chr9.133725000.133730000",25000,52,6.216438e-11,133700000,133725000,133705000,133730000,"chr9",368956,1,2,1,4,"chr9",1,0.0243788091889358
"11849","chr9.128320000.128325000","chr9.128700000.128705000",380000,10,0.002502287,128320000,128700000,128325000,128705000,"chr9",368986,6,26,22,54,"chr9",1,0.0632911392405063
"11850","chr9.36205000.36210000","chr9.36245000.36250000",40000,24,0.005626903,36205000,36245000,36210000,36250000,"chr9",368999,0,2,5,7,"chr9",1,0.019690576652602
"11851","chr9.690000.695000","chr9.715000.720000",25000,66,5.713538e-19,690000,715000,695000,720000,"chr9",369002,5,6,6,17,"chr9",1,0.131504922644163
"11852","chr9.4750000.4755000","chr9.4985000.4990000",235000,15,2.684029e-05,4750000,4985000,4755000,4990000,"chr9",369016,0,2,1,3,"chr9",1,0.00527426160337553
"11853","chr9.37590000.37595000","chr9.37910000.37915000",320000,17,4.153831e-08,37590000,37910000,37595000,37915000,"chr9",369055,4,18,7,29,"chr9",1,0.0577824660103141
"11854","chr9.127915000.127920000","chr9.127935000.127940000",20000,35,0.004328284,127915000,127935000,127920000,127940000,"chr9",369077,2,8,3,13,"chr9",1,0.053328645100797
"11855","chr9.37470000.37475000","chr9.37910000.37915000",440000,13,6.696442e-06,37470000,37910000,37475000,37915000,"chr9",369082,4,17,7,28,"chr9",1,0.0426629160806376
"11856","chr9.129980000.129985000","chr9.130210000.130215000",230000,11,0.0082624,129980000,130210000,129985000,130215000,"chr9",369100,1,5,7,13,"chr9",1,0.0167604313173933
"11857","chr9.34335000.34340000","chr9.34380000.34385000",45000,34,3.641329e-08,34335000,34380000,34340000,34385000,"chr9",369143,0,4,2,6,"chr9",1,0.0239099859353024
"11858","chr9.124890000.124895000","chr9.125125000.125130000",235000,16,5.221609e-06,124890000,125125000,124895000,125130000,"chr9",369146,9,31,42,82,"chr9",1,0.153774027191749
"11859","chr9.695000.700000","chr9.755000.760000",60000,27,2.289868e-06,695000,755000,7e+05,760000,"chr9",369149,3,4,13,20,"chr9",1,0.0632911392405063
"11860","chr9.72585000.72590000","chr9.72730000.72735000",145000,23,7.216468e-09,72585000,72730000,72590000,72735000,"chr9",369180,0,2,2,4,"chr9",1,0.0107829348335677
"11861","chr9.27350000.27355000","chr9.27370000.27375000",20000,43,1.009698e-05,27350000,27370000,27355000,27375000,"chr9",369244,0,1,1,2,"chr9",1,0.0100796999531177
"11862","chr9.120580000.120585000","chr9.121365000.121370000",785000,7,0.008137642,120580000,121365000,120585000,121370000,"chr9",369249,2,8,2,12,"chr9",1,0.00984528832630099
"11863","chr9.36135000.36140000","chr9.36165000.36170000",30000,31,0.001043713,36135000,36165000,36140000,36170000,"chr9",369269,2,8,5,15,"chr9",1,0.0545007032348805
"11864","chr9.97535000.97540000","chr9.97560000.97565000",25000,33,0.003975955,97535000,97560000,97540000,97565000,"chr9",369287,1,3,5,9,"chr9",1,0.0348101265822785
"11865","chr9.127680000.127685000","chr9.127915000.127920000",235000,13,0.0005387066,127680000,127915000,127685000,127920000,"chr9",369299,0,2,1,3,"chr9",1,0.00457102672292546
"11866","chr9.126305000.126310000","chr9.126805000.126810000",500000,11,0.0001055146,126305000,126805000,126310000,126810000,"chr9",369312,0,4,4,8,"chr9",1,0.0103141115799344
"11867","chr9.680000.685000","chr9.725000.730000",45000,22,0.00922735,680000,725000,685000,730000,"chr9",369319,2,4,7,13,"chr9",1,0.0335208626347867
"11868","chr9.37430000.37435000","chr9.37465000.37470000",35000,29,0.0004939142,37430000,37465000,37435000,37470000,"chr9",369331,0,6,5,11,"chr9",1,0.0373886544772621
"11869","chr9.33025000.33030000","chr9.33260000.33265000",235000,12,0.002100608,33025000,33260000,33030000,33265000,"chr9",369333,2,7,9,18,"chr9",1,0.0253164556962025
"11870","chr9.27030000.27035000","chr9.27655000.27660000",625000,8,0.004574059,27030000,27655000,27035000,27660000,"chr9",369349,1,2,6,9,"chr9",1,0.00843881856540084
"11871","chr9.15420000.15425000","chr9.15550000.15555000",130000,21,5.830809e-07,15420000,15550000,15425000,15555000,"chr9",369361,2,1,8,11,"chr9",1,0.0270745428973277
"11872","chr9.36215000.36220000","chr9.36325000.36330000",110000,15,0.005223942,36215000,36325000,36220000,36330000,"chr9",369371,1,8,8,17,"chr9",1,0.029887482419128
"11873","chr9.127680000.127685000","chr9.127895000.127900000",215000,13,0.0009965743,127680000,127895000,127685000,127900000,"chr9",369387,0,1,1,2,"chr9",1,0.00304735114861697
"11874","chr9.19470000.19475000","chr9.19640000.19645000",170000,19,9.879404e-07,19470000,19640000,19475000,19645000,"chr9",369399,1,12,5,18,"chr9",1,0.040084388185654
"11875","chr9.19485000.19490000","chr9.19780000.19785000",295000,16,6.04486e-07,19485000,19780000,19490000,19785000,"chr9",369410,0,4,9,13,"chr9",1,0.0243788091889358
"11876","chr9.129780000.129785000","chr9.129965000.129970000",185000,14,0.0007458087,129780000,129965000,129785000,129970000,"chr9",369412,8,29,21,58,"chr9",1,0.0951711204875762
"11877","chr9.37415000.37420000","chr9.37470000.37475000",55000,21,0.003975955,37415000,37470000,37420000,37475000,"chr9",369444,5,6,7,18,"chr9",1,0.0443037974683544
"11878","chr9.133335000.133340000","chr9.133555000.133560000",220000,23,2.534584e-11,133335000,133555000,133340000,133560000,"chr9",369460,0,0,2,2,"chr9",1,0.00539146741678387
"11879","chr9.126315000.126320000","chr9.127185000.127190000",870000,7,0.004921063,126315000,127185000,126320000,127190000,"chr9",369483,4,8,5,17,"chr9",1,0.0139474917955931
"11880","chr9.128320000.128325000","chr9.128990000.128995000",670000,17,1.139034e-11,128320000,128990000,128325000,128995000,"chr9",369487,7,21,18,46,"chr9",1,0.0916549460853258
"11881","chr9.37910000.37915000","chr9.38085000.38090000",175000,25,1.48876e-11,37910000,38085000,37915000,38090000,"chr9",369543,3,3,7,13,"chr9",1,0.0380918893577121
"11882","chr9.129140000.129145000","chr9.129255000.129260000",115000,18,0.0001202819,129140000,129255000,129145000,129260000,"chr9",369580,0,1,2,3,"chr9",1,0.00632911392405063
"11883","chr9.19465000.19470000","chr9.19920000.19925000",455000,20,1.12501e-12,19465000,19920000,19470000,19925000,"chr9",369603,0,3,2,5,"chr9",1,0.0117205813408345
"11884","chr9.33510000.33515000","chr9.34335000.34340000",825000,8,0.001141762,33510000,34335000,33515000,34340000,"chr9",369608,4,2,5,11,"chr9",1,0.0103141115799344
"11885","chr9.35275000.35280000","chr9.35475000.35480000",200000,19,1.737447e-07,35275000,35475000,35280000,35480000,"chr9",369617,3,4,3,10,"chr9",1,0.0222691045475856
"11886","chr9.32375000.32380000","chr9.32575000.32580000",200000,36,2.402696e-23,32375000,32575000,32380000,32580000,"chr9",369626,0,1,7,8,"chr9",1,0.0337552742616034
"11887","chr9.87660000.87665000","chr9.87870000.87875000",210000,18,5.653478e-07,87660000,87870000,87665000,87875000,"chr9",369653,0,2,1,3,"chr9",1,0.00632911392405063
"11888","chr9.3465000.3470000","chr9.4335000.4340000",870000,7,0.004921063,3465000,4335000,3470000,4340000,"chr9",369654,0,0,4,4,"chr9",1,0.00328176277543366
"11889","chr9.130845000.130850000","chr9.130870000.130875000",25000,33,0.003975955,130845000,130870000,130850000,130875000,"chr9",369662,1,4,2,7,"chr9",1,0.0270745428973277
"11890","chr9.131175000.131180000","chr9.131710000.131715000",535000,8,0.009262157,131175000,131710000,131180000,131715000,"chr9",369665,9,4,4,17,"chr9",1,0.0159399906235349
"11891","chr9.34400000.34405000","chr9.34600000.34605000",200000,13,0.001629879,34400000,34600000,34405000,34605000,"chr9",369666,0,4,0,4,"chr9",1,0.00609470229723394
"11892","chr9.4800000.4805000","chr9.5590000.5595000",790000,7,0.00789003,4800000,5590000,4805000,5595000,"chr9",369673,5,6,11,22,"chr9",1,0.0180496952648851
"11893","chr9.127780000.127785000","chr9.127890000.127895000",110000,15,0.005223942,127780000,127890000,127785000,127895000,"chr9",369677,0,8,10,18,"chr9",1,0.0316455696202532
"11894","chr9.460000.465000","chr9.745000.750000",285000,10,0.009262157,460000,745000,465000,750000,"chr9",369682,4,6,5,15,"chr9",1,0.0175808720112518
"11895","chr9.20355000.20360000","chr9.20940000.20945000",585000,24,4.941377e-19,20355000,20940000,20360000,20945000,"chr9",369771,1,1,0,2,"chr9",1,0.00562587904360056
"11896","chr9.675000.680000","chr9.755000.760000",80000,23,7.083992e-06,675000,755000,680000,760000,"chr9",369793,1,9,3,13,"chr9",1,0.0350445382090952
"11897","chr9.132670000.132675000","chr9.132765000.132770000",95000,16,0.004823298,132670000,132765000,132675000,132770000,"chr9",369796,0,0,2,2,"chr9",1,0.00375058602906704
"11898","chr9.124085000.124090000","chr9.124130000.124135000",45000,41,2.284072e-12,124085000,124130000,124090000,124135000,"chr9",369802,4,18,16,38,"chr9",1,0.182606657290202
"11899","chr9.126295000.126300000","chr9.126815000.126820000",520000,10,0.0004704961,126295000,126815000,126300000,126820000,"chr9",369837,2,3,2,7,"chr9",1,0.00820440693858415
"11900","chr9.113445000.113450000","chr9.114035000.114040000",590000,10,0.0002168202,113445000,114035000,113450000,114040000,"chr9",369849,0,3,4,7,"chr9",1,0.00820440693858415
"11901","chr9.127385000.127390000","chr9.127420000.127425000",35000,26,0.005428187,127385000,127420000,127390000,127425000,"chr9",369872,4,10,4,18,"chr9",1,0.0548523206751055
"11902","chr9.8550000.8555000","chr9.8610000.8615000",60000,21,0.001685516,8550000,8610000,8555000,8615000,"chr9",369887,0,1,1,2,"chr9",1,0.00492264416315049
"11903","chr9.6475000.6480000","chr9.6555000.6560000",80000,19,0.0008205688,6475000,6555000,6480000,6560000,"chr9",369904,1,5,1,7,"chr9",1,0.0155883731833099
"11904","chr9.109105000.109110000","chr9.109470000.109475000",365000,10,0.002998033,109105000,109470000,109110000,109475000,"chr9",369913,4,11,3,18,"chr9",1,0.0210970464135021
"11905","chr9.36245000.36250000","chr9.36400000.36405000",155000,15,0.0006874354,36245000,36400000,36250000,36405000,"chr9",369917,1,5,3,9,"chr9",1,0.0158227848101266
"11906","chr9.34335000.34340000","chr9.34375000.34380000",40000,87,3.889544e-48,34335000,34375000,34340000,34380000,"chr9",369986,1,4,2,7,"chr9",1,0.0713783403656821
"11907","chr9.19480000.19485000","chr9.19640000.19645000",160000,31,3.059313e-16,19480000,19640000,19485000,19645000,"chr9",370001,2,14,7,23,"chr9",1,0.08356774496015
"11908","chr9.19100000.19105000","chr9.19125000.19130000",25000,50,6.437971e-10,19100000,19125000,19105000,19130000,"chr9",370004,7,14,19,40,"chr9",1,0.23441162681669
"11909","chr9.33290000.33295000","chr9.33390000.33395000",100000,15,0.009266319,33290000,33390000,33295000,33395000,"chr9",370020,1,5,3,9,"chr9",1,0.0158227848101266
"11910","chr9.127545000.127550000","chr9.127585000.127590000",40000,31,8.651292e-06,127545000,127585000,127550000,127590000,"chr9",370066,0,8,1,9,"chr9",1,0.0327004219409283
"11911","chr9.27330000.27335000","chr9.27350000.27355000",20000,47,2.496136e-07,27330000,27350000,27335000,27355000,"chr9",370070,2,3,4,9,"chr9",1,0.04957805907173
"11912","chr9.6555000.6560000","chr9.6575000.6580000",20000,35,0.004328284,6555000,6575000,6560000,6580000,"chr9",370095,1,12,5,18,"chr9",1,0.0738396624472574
"11913","chr9.33810000.33815000","chr9.33880000.33885000",70000,21,0.0003329182,33810000,33880000,33815000,33885000,"chr9",370113,6,11,9,26,"chr9",1,0.0639943741209564
"11914","chr9.130185000.130190000","chr9.130210000.130215000",25000,83,1.32775e-30,130185000,130210000,130190000,130215000,"chr9",370130,0,5,7,12,"chr9",1,0.116736990154712
"11915","chr9.87320000.87325000","chr9.87600000.87605000",280000,12,0.0006902268,87320000,87600000,87325000,87605000,"chr9",370140,0,4,3,7,"chr9",1,0.00984528832630099
"11916","chr9.72590000.72595000","chr9.72730000.72735000",140000,16,0.0003833608,72590000,72730000,72595000,72735000,"chr9",370142,0,2,2,4,"chr9",1,0.00750117205813408
"11917","chr9.128275000.128280000","chr9.128725000.128730000",450000,10,0.001062729,128275000,128725000,128280000,128730000,"chr9",370216,2,10,5,17,"chr9",1,0.0199249882794187
"11918","chr9.19050000.19055000","chr9.19180000.19185000",130000,23,2.401729e-08,19050000,19180000,19055000,19185000,"chr9",370219,1,4,2,7,"chr9",1,0.0188701359587436
"11919","chr9.19100000.19105000","chr9.19170000.19175000",70000,21,0.0003329182,19100000,19170000,19105000,19175000,"chr9",370223,10,24,29,63,"chr9",1,0.15506329113924
"11920","chr9.19640000.19645000","chr9.19780000.19785000",140000,15,0.001299389,19640000,19780000,19645000,19785000,"chr9",370248,0,4,7,11,"chr9",1,0.0193389592123769
"11921","chr9.128995000.129000000","chr9.129110000.129115000",115000,15,0.004057358,128995000,129110000,1.29e+08,129115000,"chr9",370255,1,11,8,20,"chr9",1,0.0351617440225035
"11922","chr9.127545000.127550000","chr9.128125000.128130000",580000,9,0.001342715,127545000,128125000,127550000,128130000,"chr9",370268,0,8,1,9,"chr9",1,0.00949367088607595
"11923","chr9.94075000.94080000","chr9.94110000.94115000",35000,29,0.0004939142,94075000,94110000,94080000,94115000,"chr9",370307,0,2,2,4,"chr9",1,0.013595874355368
"11924","chr9.35475000.35480000","chr9.35550000.35555000",75000,50,4.703358e-26,35475000,35550000,35480000,35555000,"chr9",370329,1,9,3,13,"chr9",1,0.0761837787154243
"11925","chr9.86325000.86330000","chr9.86430000.86435000",105000,19,7.274837e-05,86325000,86430000,86330000,86435000,"chr9",370338,0,3,5,8,"chr9",1,0.0178152836380684
"11926","chr9.3020000.3025000","chr9.3040000.3045000",20000,35,0.004328284,3020000,3040000,3025000,3045000,"chr9",370345,1,1,2,4,"chr9",1,0.0164088138771683
"11927","chr9.33000000.33005000","chr9.33020000.33025000",20000,43,1.009698e-05,3.3e+07,33020000,33005000,33025000,"chr9",370460,1,17,7,25,"chr9",1,0.125996249413971
"11928","chr9.625000.630000","chr9.675000.680000",50000,22,0.003970557,625000,675000,630000,680000,"chr9",370508,0,4,0,4,"chr9",1,0.0103141115799344
"11929","chr9.130765000.130770000","chr9.130820000.130825000",55000,22,0.001629879,130765000,130820000,130770000,130825000,"chr9",370550,0,4,2,6,"chr9",1,0.0154711673699015
"11930","chr9.610000.615000","chr9.760000.765000",150000,41,1.534065e-25,610000,760000,615000,765000,"chr9",370564,1,2,4,7,"chr9",1,0.033638068448195
"11931","chr9.19380000.19385000","chr9.19460000.19465000",80000,17,0.006071643,19380000,19460000,19385000,19465000,"chr9",370635,4,6,5,15,"chr9",1,0.029887482419128
"11932","chr9.6585000.6590000","chr9.6765000.6770000",180000,19,5.489901e-07,6585000,6765000,6590000,6770000,"chr9",370643,2,6,4,12,"chr9",1,0.0267229254571027
"11933","chr9.72585000.72590000","chr9.73215000.73220000",630000,9,0.0008539421,72585000,73215000,72590000,73220000,"chr9",370673,0,2,9,11,"chr9",1,0.0116033755274262
"11934","chr9.109085000.109090000","chr9.109105000.109110000",20000,35,0.004328284,109085000,109105000,109090000,109110000,"chr9",370713,4,4,3,11,"chr9",1,0.0451242381622128
"11935","chr9.127225000.127230000","chr9.127280000.127285000",55000,20,0.009171875,127225000,127280000,127230000,127285000,"chr9",370717,2,7,5,14,"chr9",1,0.0328176277543366
"11936","chr9.35160000.35165000","chr9.35475000.35480000",315000,20,9.825786e-11,35160000,35475000,35165000,35480000,"chr9",370758,0,9,2,11,"chr9",1,0.0257852789498359
"11937","chr9.33000000.33005000","chr9.33075000.33080000",75000,23,1.502237e-05,3.3e+07,33075000,33005000,33080000,"chr9",370790,1,17,7,25,"chr9",1,0.0673933427097984
"11938","chr9.126965000.126970000","chr9.127020000.127025000",55000,20,0.009171875,126965000,127020000,126970000,127025000,"chr9",370809,1,13,10,24,"chr9",1,0.0562587904360056
"11939","chr9.6575000.6580000","chr9.6780000.6785000",205000,12,0.004720771,6575000,6780000,6580000,6785000,"chr9",370909,0,8,4,12,"chr9",1,0.0168776371308017
"11940","chr9.114505000.114510000","chr9.115150000.115155000",645000,8,0.003975955,114505000,115150000,114510000,115155000,"chr9",370915,1,0,1,2,"chr9",1,0.00187529301453352
"11941","chr9.127715000.127720000","chr9.127920000.127925000",205000,12,0.004720771,127715000,127920000,127720000,127925000,"chr9",370945,0,14,8,22,"chr9",1,0.0309423347398031
"11942","chr9.4750000.4755000","chr9.4980000.4985000",230000,18,2.091409e-07,4750000,4980000,4755000,4985000,"chr9",370947,0,1,1,2,"chr9",1,0.00421940928270042
"11943","chr9.129865000.129870000","chr9.129965000.129970000",100000,19,0.0001110845,129865000,129965000,129870000,129970000,"chr9",370948,2,7,9,18,"chr9",1,0.040084388185654
"11944","chr9.465000.470000","chr9.735000.740000",270000,12,0.0008712406,465000,735000,470000,740000,"chr9",371022,2,4,11,17,"chr9",1,0.0239099859353024
"11945","chr9.19640000.19645000","chr9.19920000.19925000",280000,17,1.566966e-07,19640000,19920000,19645000,19925000,"chr9",371028,0,3,7,10,"chr9",1,0.0199249882794187
"11946","chr9.36205000.36210000","chr9.36315000.36320000",110000,22,6.96865e-07,36205000,36315000,36210000,36320000,"chr9",371059,0,2,5,7,"chr9",1,0.0180496952648851
"11947","chr9.121370000.121375000","chr9.122040000.122045000",670000,8,0.003339822,121370000,122040000,121375000,122045000,"chr9",371082,0,3,1,4,"chr9",1,0.00375058602906704
"11948","chr9.34985000.34990000","chr9.35160000.35165000",175000,13,0.003720896,34985000,35160000,34990000,35165000,"chr9",371111,0,4,2,6,"chr9",1,0.00914205344585091
"11949","chr9.72035000.72040000","chr9.72280000.72285000",245000,16,3.524681e-06,72035000,72280000,72040000,72285000,"chr9",371122,2,4,7,13,"chr9",1,0.0243788091889358
"11950","chr9.675000.680000","chr9.725000.730000",50000,30,9.801492e-07,675000,725000,680000,730000,"chr9",371134,1,9,3,13,"chr9",1,0.0457102672292546
"11951","chr9.132135000.132140000","chr9.132280000.132285000",145000,14,0.003428833,132135000,132280000,132140000,132285000,"chr9",371139,2,4,3,9,"chr9",1,0.0147679324894515
"11952","chr9.35945000.35950000","chr9.36005000.36010000",60000,25,2.52988e-05,35945000,36005000,35950000,36010000,"chr9",371149,1,2,0,3,"chr9",1,0.00879043600562588
"11953","chr9.27330000.27335000","chr9.27460000.27465000",130000,25,8.036837e-10,27330000,27460000,27335000,27465000,"chr9",371181,2,1,0,3,"chr9",1,0.00879043600562588
"11954","chr9.97595000.97600000","chr9.97710000.97715000",115000,15,0.004057358,97595000,97710000,97600000,97715000,"chr9",371187,1,4,3,8,"chr9",1,0.0140646976090014
"11955","chr9.27405000.27410000","chr9.27530000.27535000",125000,20,3.758764e-06,27405000,27530000,27410000,27535000,"chr9",371211,1,3,3,7,"chr9",1,0.0164088138771683
"11956","chr9.2155000.2160000","chr9.2840000.2845000",685000,9,0.0005326867,2155000,2840000,2160000,2845000,"chr9",371245,0,3,2,5,"chr9",1,0.00527426160337553
"11957","chr9.114435000.114440000","chr9.115150000.115155000",715000,8,0.002415967,114435000,115150000,114440000,115155000,"chr9",371251,1,1,1,3,"chr9",1,0.00281293952180028
"11958","chr9.113400000.113405000","chr9.113670000.113675000",270000,13,0.0002023744,113400000,113670000,113405000,113675000,"chr9",371254,2,10,5,17,"chr9",1,0.0259024847632443
"11959","chr9.5630000.5635000","chr9.6015000.6020000",385000,12,0.0001004302,5630000,6015000,5635000,6020000,"chr9",371297,3,10,4,17,"chr9",1,0.0239099859353024
"11960","chr9.26890000.26895000","chr9.26955000.26960000",65000,23,8.55857e-05,26890000,26955000,26895000,26960000,"chr9",371322,0,5,10,15,"chr9",1,0.040436005625879
"11961","chr9.124400000.124405000","chr9.124750000.124755000",350000,13,3.332232e-05,124400000,124750000,124405000,124755000,"chr9",371324,0,3,3,6,"chr9",1,0.00914205344585091
"11962","chr9.72890000.72895000","chr9.73215000.73220000",325000,10,0.005011886,72890000,73215000,72895000,73220000,"chr9",371345,1,2,6,9,"chr9",1,0.0105485232067511
"11963","chr9.126300000.126305000","chr9.127055000.127060000",755000,7,0.009510358,126300000,127055000,126305000,127060000,"chr9",371358,3,5,3,11,"chr9",1,0.00902484763244257
"11964","chr9.19045000.19050000","chr9.19460000.19465000",415000,18,3.765646e-10,19045000,19460000,19050000,19465000,"chr9",371382,4,6,5,15,"chr9",1,0.0316455696202532
"11965","chr9.122265000.122270000","chr9.123060000.123065000",795000,7,0.007627176,122265000,123060000,122270000,123065000,"chr9",371395,3,11,9,23,"chr9",1,0.0188701359587436
"11966","chr9.5795000.5800000","chr9.6050000.6055000",255000,16,2.398538e-06,5795000,6050000,5800000,6055000,"chr9",371404,3,5,3,11,"chr9",1,0.0206282231598687
"11967","chr9.35070000.35075000","chr9.35095000.35100000",25000,36,0.0004653973,35070000,35095000,35075000,35100000,"chr9",371414,1,2,2,5,"chr9",1,0.0210970464135021
"11968","chr9.127525000.127530000","chr9.127610000.127615000",85000,21,4.582851e-05,127525000,127610000,127530000,127615000,"chr9",371422,0,3,4,7,"chr9",1,0.0172292545710267
"11969","chr9.4675000.4680000","chr9.4740000.4745000",65000,27,6.417131e-07,4675000,4740000,4680000,4745000,"chr9",371434,0,10,6,16,"chr9",1,0.0506329113924051
"11970","chr9.37675000.37680000","chr9.37730000.37735000",55000,23,0.0006229368,37675000,37730000,37680000,37735000,"chr9",371473,0,2,1,3,"chr9",1,0.00808720112517581
"11971","chr9.98075000.98080000","chr9.98640000.98645000",565000,8,0.007342334,98075000,98640000,98080000,98645000,"chr9",371486,1,6,3,10,"chr9",1,0.00937646507266761
"11972","chr9.35095000.35100000","chr9.35515000.35520000",420000,11,0.0003109252,35095000,35515000,35100000,35520000,"chr9",371502,0,3,3,6,"chr9",1,0.00773558368495077
"11973","chr9.131420000.131425000","chr9.131710000.131715000",290000,10,0.008599966,131420000,131710000,131425000,131715000,"chr9",371503,2,16,17,35,"chr9",1,0.0410220346929208
"11974","chr9.133700000.133705000","chr9.133740000.133745000",40000,31,8.651292e-06,133700000,133740000,133705000,133745000,"chr9",371514,1,2,1,4,"chr9",1,0.0145335208626348
"11975","chr9.34665000.34670000","chr9.35160000.35165000",495000,10,0.0006229368,34665000,35160000,34670000,35165000,"chr9",371517,0,5,2,7,"chr9",1,0.00820440693858415
"11976","chr9.34335000.34340000","chr9.34600000.34605000",265000,24,1.61005e-13,34335000,34600000,34340000,34605000,"chr9",371629,0,4,3,7,"chr9",1,0.019690576652602
"11977","chr9.35945000.35950000","chr9.36100000.36105000",155000,14,0.002319745,35945000,36100000,35950000,36105000,"chr9",371653,2,3,6,11,"chr9",1,0.0180496952648851
"11978","chr9.37590000.37595000","chr9.37800000.37805000",210000,14,0.0002975622,37590000,37800000,37595000,37805000,"chr9",371656,0,4,2,6,"chr9",1,0.00984528832630099
"11979","chr9.27545000.27550000","chr9.27570000.27575000",25000,45,1.416788e-07,27545000,27570000,27550000,27575000,"chr9",371673,0,3,1,4,"chr9",1,0.0210970464135021
"11980","chr9.35785000.35790000","chr9.35945000.35950000",160000,15,0.0005590965,35785000,35945000,35790000,35950000,"chr9",371684,4,5,15,24,"chr9",1,0.0421940928270042
"11981","chr9.72890000.72895000","chr9.73130000.73135000",240000,12,0.00183715,72890000,73130000,72895000,73135000,"chr9",371692,1,1,0,2,"chr9",1,0.00281293952180028
"11982","chr9.73105000.73110000","chr9.73215000.73220000",110000,16,0.001815139,73105000,73215000,73110000,73220000,"chr9",371696,0,2,9,11,"chr9",1,0.0206282231598687
"11983","chr9.129750000.129755000","chr9.129965000.129970000",215000,12,0.003635256,129750000,129965000,129755000,129970000,"chr9",371702,3,19,9,31,"chr9",1,0.0436005625879044
"11984","chr9.6025000.6030000","chr9.6555000.6560000",530000,8,0.009647978,6025000,6555000,6030000,6560000,"chr9",371751,1,10,5,16,"chr9",1,0.0150023441162682
"11985","chr9.13430000.13435000","chr9.14250000.14255000",820000,9,0.0001793294,13430000,14250000,13435000,14255000,"chr9",371830,0,2,0,2,"chr9",1,0.00210970464135021
"11986","chr9.108725000.108730000","chr9.109640000.109645000",915000,8,0.0005954141,108725000,109640000,108730000,109645000,"chr9",371914,1,0,1,2,"chr9",1,0.00187529301453352
"11987","chr9.35515000.35520000","chr9.35550000.35555000",35000,69,7.789323e-29,35515000,35550000,35520000,35555000,"chr9",371920,0,3,3,6,"chr9",1,0.0485232067510548
"11988","chr9.21250000.21255000","chr9.21325000.21330000",75000,21,0.0001662046,21250000,21325000,21255000,21330000,"chr9",371922,1,2,2,5,"chr9",1,0.0123066104078762
"11989","chr9.35645000.35650000","chr9.35690000.35695000",45000,24,0.001811606,35645000,35690000,35650000,35695000,"chr9",371934,1,6,6,13,"chr9",1,0.0365682137834037
"11990","chr9.100700000.100705000","chr9.100730000.100735000",30000,29,0.004574059,100700000,100730000,100705000,100735000,"chr9",371958,0,0,4,4,"chr9",1,0.013595874355368
"11991","chr9.120740000.120745000","chr9.120865000.120870000",125000,15,0.00250834,120740000,120865000,120745000,120870000,"chr9",372053,1,2,1,4,"chr9",1,0.0070323488045007
"11992","chr9.36245000.36250000","chr9.36555000.36560000",310000,10,0.006247162,36245000,36555000,36250000,36560000,"chr9",372105,1,15,9,25,"chr9",1,0.0293014533520863
"11993","chr9.19100000.19105000","chr9.19230000.19235000",130000,27,2.180341e-11,19100000,19230000,19105000,19235000,"chr9",372125,6,20,23,49,"chr9",1,0.15506329113924
"11994","chr9.126305000.126310000","chr9.126800000.126805000",495000,20,3.497297e-13,126305000,126800000,126310000,126805000,"chr9",372190,3,12,8,23,"chr9",1,0.0539146741678387
"11995","chr9.97630000.97635000","chr9.97675000.97680000",45000,25,0.0007402317,97630000,97675000,97635000,97680000,"chr9",372202,2,4,3,9,"chr9",1,0.0263713080168776
"11996","chr9.77440000.77445000","chr9.77585000.77590000",145000,13,0.009990165,77440000,77585000,77445000,77590000,"chr9",372245,0,1,0,1,"chr9",1,0.00152367557430849
"11997","chr9.35645000.35650000","chr9.35730000.35735000",85000,20,0.0001539838,35645000,35730000,35650000,35735000,"chr9",372303,1,5,6,12,"chr9",1,0.0281293952180028
"11998","chr9.73020000.73025000","chr9.73215000.73220000",195000,18,1.23673e-06,73020000,73215000,73025000,73220000,"chr9",372308,0,2,4,6,"chr9",1,0.0126582278481013
"11999","chr9.32550000.32555000","chr9.33000000.33005000",450000,15,1.037706e-07,32550000,3.3e+07,32555000,33005000,"chr9",372312,0,0,3,3,"chr9",1,0.00527426160337553
"12000","chr9.114250000.114255000","chr9.114280000.114285000",30000,40,2.277429e-07,114250000,114280000,114255000,114285000,"chr9",372314,0,1,1,2,"chr9",1,0.00937646507266761
"12001","chr9.101080000.101085000","chr9.101530000.101535000",450000,9,0.004756049,101080000,101530000,101085000,101535000,"chr9",372356,0,5,5,10,"chr9",1,0.0105485232067511
"12002","chr9.8485000.8490000","chr9.8715000.8720000",230000,13,0.0006229368,8485000,8715000,8490000,8720000,"chr9",372369,1,2,2,5,"chr9",1,0.00761837787154243
"12003","chr9.610000.615000","chr9.735000.740000",125000,27,3.691611e-11,610000,735000,615000,740000,"chr9",372402,1,2,4,7,"chr9",1,0.0221518987341772
"12004","chr9.32575000.32580000","chr9.32990000.32995000",415000,10,0.001629879,32575000,32990000,32580000,32995000,"chr9",372449,0,1,7,8,"chr9",1,0.00937646507266761
"12005","chr9.128420000.128425000","chr9.129170000.129175000",750000,7,0.009785511,128420000,129170000,128425000,129175000,"chr9",372460,0,5,2,7,"chr9",1,0.00574308485700891
"12006","chr9.34895000.34900000","chr9.35075000.35080000",180000,15,0.0002401557,34895000,35075000,34900000,35080000,"chr9",372479,0,3,0,3,"chr9",1,0.00527426160337553
"12007","chr9.6410000.6415000","chr9.6575000.6580000",165000,18,6.401932e-06,6410000,6575000,6415000,6580000,"chr9",372484,0,4,16,20,"chr9",1,0.0421940928270042
"12008","chr9.8550000.8555000","chr9.8715000.8720000",165000,13,0.00509474,8550000,8715000,8555000,8720000,"chr9",372495,0,1,1,2,"chr9",1,0.00304735114861697
"12009","chr9.108760000.108765000","chr9.109600000.109605000",840000,7,0.005887932,108760000,109600000,108765000,109605000,"chr9",372537,0,4,5,9,"chr9",1,0.00738396624472574
"12010","chr9.129965000.129970000","chr9.130210000.130215000",245000,14,8.99058e-05,129965000,130210000,129970000,130215000,"chr9",372540,1,5,7,13,"chr9",1,0.0213314580403188
"12011","chr9.35880000.35885000","chr9.36160000.36165000",280000,11,0.002783355,35880000,36160000,35885000,36165000,"chr9",372545,4,11,11,26,"chr9",1,0.0335208626347867
"12012","chr9.134065000.134070000","chr9.134170000.134175000",105000,17,0.000816932,134065000,134170000,134070000,134175000,"chr9",372590,0,6,3,9,"chr9",1,0.0179324894514768
"12013","chr9.35080000.35085000","chr9.35535000.35540000",455000,11,0.0001956661,35080000,35535000,35085000,35540000,"chr9",372675,1,10,7,18,"chr9",1,0.0232067510548523
"12014","chr9.131125000.131130000","chr9.131175000.131180000",50000,67,2.347998e-34,131125000,131175000,131130000,131180000,"chr9",372692,0,4,2,6,"chr9",1,0.0471167369901547
"12015","chr9.129630000.129635000","chr9.130205000.130210000",575000,8,0.006775515,129630000,130205000,129635000,130210000,"chr9",372695,4,6,11,21,"chr9",1,0.019690576652602
"12016","chr9.510000.515000","chr9.610000.615000",100000,17,0.001157782,510000,610000,515000,615000,"chr9",372706,1,2,3,6,"chr9",1,0.0119549929676512
"12017","chr9.35610000.35615000","chr9.35725000.35730000",115000,18,0.0001202819,35610000,35725000,35615000,35730000,"chr9",372732,0,0,3,3,"chr9",1,0.00632911392405063
"12018","chr9.35920000.35925000","chr9.35945000.35950000",25000,43,1.020352e-06,35920000,35945000,35925000,35950000,"chr9",372734,4,5,4,13,"chr9",1,0.0655180496952649
"12019","chr9.33000000.33005000","chr9.33045000.33050000",45000,27,0.0001087367,3.3e+07,33045000,33005000,33050000,"chr9",372850,1,11,7,19,"chr9",1,0.060126582278481
"12020","chr9.530000.535000","chr9.715000.720000",185000,15,0.0001963322,530000,715000,535000,720000,"chr9",372883,4,7,5,16,"chr9",1,0.0281293952180028
"12021","chr9.27340000.27345000","chr9.27545000.27550000",205000,28,2.027399e-15,27340000,27545000,27345000,27550000,"chr9",372934,0,3,1,4,"chr9",1,0.0131270511017346
"12022","chr9.6700000.6705000","chr9.6755000.6760000",55000,20,0.009171875,6700000,6755000,6705000,6760000,"chr9",372969,2,12,11,25,"chr9",1,0.0586029067041725
"12023","chr9.13120000.13125000","chr9.13265000.13270000",145000,13,0.009990165,13120000,13265000,13125000,13270000,"chr9",373007,0,6,1,7,"chr9",1,0.0106657290201594
"12024","chr9.33865000.33870000","chr9.34045000.34050000",180000,12,0.009753831,33865000,34045000,33870000,34050000,"chr9",373055,6,18,19,43,"chr9",1,0.060478199718706
"12025","chr9.98165000.98170000","chr9.99020000.99025000",855000,7,0.005394516,98165000,99020000,98170000,99025000,"chr9",373063,3,2,4,9,"chr9",1,0.00738396624472574
"12026","chr9.127695000.127700000","chr9.127980000.127985000",285000,17,1.311272e-07,127695000,127980000,127700000,127985000,"chr9",373090,3,19,15,37,"chr9",1,0.073722456633849
"12027","chr9.131330000.131335000","chr9.131735000.131740000",405000,9,0.007627176,131330000,131735000,131335000,131740000,"chr9",373092,3,2,11,16,"chr9",1,0.0168776371308017
"12028","chr9.36405000.36410000","chr9.36555000.36560000",150000,47,5.059756e-32,36405000,36555000,36410000,36560000,"chr9",373097,1,10,7,18,"chr9",1,0.0991561181434599
"12029","chr9.132265000.132270000","chr9.132340000.132345000",75000,20,0.0004975477,132265000,132340000,132270000,132345000,"chr9",373112,3,8,6,17,"chr9",1,0.0398499765588373
"12030","chr9.18255000.18260000","chr9.18435000.18440000",180000,24,6.956766e-11,18255000,18435000,18260000,18440000,"chr9",373116,0,3,3,6,"chr9",1,0.0168776371308017
"12031","chr9.128170000.128175000","chr9.128495000.128500000",325000,13,5.510568e-05,128170000,128495000,128175000,128500000,"chr9",373123,4,8,9,21,"chr9",1,0.0319971870604782
"12032","chr9.129965000.129970000","chr9.130040000.130045000",75000,19,0.001420924,129965000,130040000,129970000,130045000,"chr9",373195,5,11,4,20,"chr9",1,0.0445382090951711
"12033","chr9.19380000.19385000","chr9.19455000.19460000",75000,25,1.120646e-06,19380000,19455000,19385000,19460000,"chr9",373256,4,8,9,21,"chr9",1,0.0615330520393812
"12034","chr9.133660000.133665000","chr9.133700000.133705000",40000,28,0.0001817949,133660000,133700000,133665000,133705000,"chr9",373262,1,2,1,4,"chr9",1,0.0131270511017346
"12035","chr9.129780000.129785000","chr9.129880000.129885000",100000,17,0.001157782,129780000,129880000,129785000,129885000,"chr9",373293,1,9,15,25,"chr9",1,0.0498124706985466
"12036","chr9.15485000.15490000","chr9.15605000.15610000",120000,14,0.009085841,15485000,15605000,15490000,15610000,"chr9",373302,5,10,6,21,"chr9",1,0.0344585091420534
"12037","chr9.685000.690000","chr9.755000.760000",70000,19,0.002563108,685000,755000,690000,760000,"chr9",373303,1,5,2,8,"chr9",1,0.0178152836380684
"12038","chr9.114560000.114565000","chr9.115060000.115065000",500000,9,0.002885576,114560000,115060000,114565000,115065000,"chr9",373339,0,5,5,10,"chr9",1,0.0105485232067511
"12039","chr9.37900000.37905000","chr9.38360000.38365000",460000,11,0.0001817949,37900000,38360000,37905000,38365000,"chr9",373351,1,4,5,10,"chr9",1,0.012892639474918
"12040","chr9.37905000.37910000","chr9.38025000.38030000",120000,19,2.272794e-05,37905000,38025000,37910000,38030000,"chr9",373354,0,1,1,2,"chr9",1,0.00445382090951711
"12041","chr9.109470000.109475000","chr9.109600000.109605000",130000,14,0.005976839,109470000,109600000,109475000,109605000,"chr9",373467,5,5,11,21,"chr9",1,0.0344585091420534
"12042","chr9.129140000.129145000","chr9.129250000.129255000",110000,16,0.001815139,129140000,129250000,129145000,129255000,"chr9",373470,0,1,2,3,"chr9",1,0.00562587904360056
"12043","chr9.35160000.35165000","chr9.35725000.35730000",565000,8,0.007342334,35160000,35725000,35165000,35730000,"chr9",373477,0,0,2,2,"chr9",1,0.00187529301453352
"12044","chr9.530000.535000","chr9.755000.760000",225000,11,0.009242184,530000,755000,535000,760000,"chr9",373480,4,7,5,16,"chr9",1,0.0206282231598687
"12045","chr9.27330000.27335000","chr9.27545000.27550000",215000,121,3.304525e-146,27330000,27545000,27335000,27550000,"chr9",373493,0,3,1,4,"chr9",1,0.056727613689639
"12046","chr9.32395000.32400000","chr9.32575000.32580000",180000,16,5.876535e-05,32395000,32575000,32400000,32580000,"chr9",373495,0,1,7,8,"chr9",1,0.0150023441162682
"12047","chr9.35955000.35960000","chr9.36020000.36025000",65000,22,0.0002550679,35955000,36020000,35960000,36025000,"chr9",373515,3,2,8,13,"chr9",1,0.0335208626347867
"12048","chr9.35955000.35960000","chr9.36100000.36105000",145000,15,0.001054106,35955000,36100000,35960000,36105000,"chr9",373524,2,3,6,11,"chr9",1,0.0193389592123769
"12049","chr9.126955000.126960000","chr9.127020000.127025000",65000,21,0.0007267268,126955000,127020000,126960000,127025000,"chr9",373535,1,7,3,11,"chr9",1,0.0270745428973277
"12050","chr9.19055000.19060000","chr9.19455000.19460000",400000,9,0.008111966,19055000,19455000,19060000,19460000,"chr9",373588,1,1,0,2,"chr9",1,0.00210970464135021
"12051","chr9.38025000.38030000","chr9.38360000.38365000",335000,11,0.001067282,38025000,38360000,38030000,38365000,"chr9",373601,0,1,1,2,"chr9",1,0.00257852789498359
"12052","chr9.130700000.130705000","chr9.130830000.130835000",130000,14,0.005976839,130700000,130830000,130705000,130835000,"chr9",373628,1,9,5,15,"chr9",1,0.0246132208157525
"12053","chr9.33470000.33475000","chr9.33510000.33515000",40000,32,2.910397e-06,33470000,33510000,33475000,33515000,"chr9",373635,1,2,5,8,"chr9",1,0.0300046882325363
"12054","chr9.34755000.34760000","chr9.35475000.35480000",720000,9,0.000401562,34755000,35475000,34760000,35480000,"chr9",373652,4,10,6,20,"chr9",1,0.0210970464135021
"12055","chr9.130085000.130090000","chr9.130140000.130145000",55000,22,0.001629879,130085000,130140000,130090000,130145000,"chr9",373660,1,5,1,7,"chr9",1,0.0180496952648851
"12056","chr9.96215000.96220000","chr9.96345000.96350000",130000,17,0.0001774376,96215000,96345000,96220000,96350000,"chr9",373671,0,2,1,3,"chr9",1,0.0059774964838256
"12057","chr9.114485000.114490000","chr9.115160000.115165000",675000,10,9.001918e-05,114485000,115160000,114490000,115165000,"chr9",373735,2,6,5,13,"chr9",1,0.0152367557430849
"12058","chr9.129980000.129985000","chr9.130185000.130190000",205000,21,3.540834e-09,129980000,130185000,129985000,130190000,"chr9",373754,0,10,7,17,"chr9",1,0.0418424753867792
"12059","chr9.35955000.35960000","chr9.36075000.36080000",120000,15,0.003167997,35955000,36075000,35960000,36080000,"chr9",373812,3,8,5,16,"chr9",1,0.0281293952180028
"12060","chr9.35535000.35540000","chr9.35645000.35650000",110000,15,0.005223942,35535000,35645000,35540000,35650000,"chr9",373831,1,6,6,13,"chr9",1,0.0228551336146273
"12061","chr9.123450000.123455000","chr9.123470000.123475000",20000,54,1.596824e-10,123450000,123470000,123455000,123475000,"chr9",373854,0,2,1,3,"chr9",1,0.0189873417721519
"12062","chr9.36100000.36105000","chr9.36160000.36165000",60000,40,9.987022e-15,36100000,36160000,36105000,36165000,"chr9",373879,2,3,6,11,"chr9",1,0.0515705578996718
"12063","chr9.35655000.35660000","chr9.35730000.35735000",75000,24,4.177597e-06,35655000,35730000,35660000,35735000,"chr9",373883,6,5,8,19,"chr9",1,0.0534458509142053
"12064","chr9.128310000.128315000","chr9.128495000.128500000",185000,12,0.008521915,128310000,128495000,128315000,128500000,"chr9",373979,4,8,9,21,"chr9",1,0.029535864978903
"12065","chr9.134065000.134070000","chr9.134185000.134190000",120000,15,0.003167997,134065000,134185000,134070000,134190000,"chr9",374011,0,6,4,10,"chr9",1,0.0175808720112518
"12066","chr9.27275000.27280000","chr9.27545000.27550000",270000,36,1.05658e-26,27275000,27545000,27280000,27550000,"chr9",374018,0,3,1,4,"chr9",1,0.0168776371308017
"12067","chr9.36075000.36080000","chr9.36100000.36105000",25000,36,0.0004653973,36075000,36100000,36080000,36105000,"chr9",374031,2,3,5,10,"chr9",1,0.0421940928270042
"12068","chr9.113305000.113310000","chr9.113330000.113335000",25000,36,0.0004653973,113305000,113330000,113310000,113335000,"chr9",374036,3,9,10,22,"chr9",1,0.0928270042194093
"12069","chr9.6680000.6685000","chr9.6785000.6790000",105000,15,0.00697384,6680000,6785000,6685000,6790000,"chr9",374053,4,10,10,24,"chr9",1,0.0421940928270042
"12070","chr9.114440000.114445000","chr9.114485000.114490000",45000,30,4.35355e-06,114440000,114485000,114445000,114490000,"chr9",374073,0,6,3,9,"chr9",1,0.0316455696202532
"12071","chr9.131330000.131335000","chr9.131415000.131420000",85000,22,1.284245e-05,131330000,131415000,131335000,131420000,"chr9",374121,1,8,4,13,"chr9",1,0.0335208626347867
"12072","chr9.35110000.35115000","chr9.35600000.35605000",490000,16,5.232243e-09,35110000,35600000,35115000,35605000,"chr9",374123,0,2,4,6,"chr9",1,0.0112517580872011
"12073","chr9.128320000.128325000","chr9.128370000.128375000",50000,23,0.001642557,128320000,128370000,128325000,128375000,"chr9",374171,1,4,1,6,"chr9",1,0.0161744022503516
"12074","chr9.36420000.36425000","chr9.36460000.36465000",40000,24,0.005626903,36420000,36460000,36425000,36465000,"chr9",374175,2,8,8,18,"chr9",1,0.0506329113924051
"12075","chr9.123385000.123390000","chr9.123725000.123730000",340000,10,0.004121745,123385000,123725000,123390000,123730000,"chr9",374177,0,1,4,5,"chr9",1,0.00586029067041725
"12076","chr9.35780000.35785000","chr9.35880000.35885000",100000,26,4.74924e-09,35780000,35880000,35785000,35885000,"chr9",374182,4,11,11,26,"chr9",1,0.0792311298640413
"12077","chr9.128170000.128175000","chr9.129035000.129040000",865000,8,0.000862795,128170000,129035000,128175000,129040000,"chr9",374185,7,26,21,54,"chr9",1,0.0506329113924051
"12078","chr9.76300000.76305000","chr9.77175000.77180000",875000,12,1.420698e-07,76300000,77175000,76305000,77180000,"chr9",374202,4,14,6,24,"chr9",1,0.0337552742616034
"12079","chr9.34330000.34335000","chr9.34600000.34605000",270000,13,0.0002023744,34330000,34600000,34335000,34605000,"chr9",374215,0,1,3,4,"chr9",1,0.00609470229723394
"12080","chr9.610000.615000","chr9.690000.695000",80000,30,2.6602e-10,610000,690000,615000,695000,"chr9",374218,1,2,4,7,"chr9",1,0.0246132208157525
"12081","chr9.385000.390000","chr9.760000.765000",375000,12,0.000118489,385000,760000,390000,765000,"chr9",374252,0,6,2,8,"chr9",1,0.0112517580872011
"12082","chr9.19480000.19485000","chr9.19920000.19925000",440000,35,1.765164e-30,19480000,19920000,19485000,19925000,"chr9",374253,0,3,10,13,"chr9",1,0.053328645100797
"12083","chr9.117485000.117490000","chr9.117765000.117770000",280000,14,3.094058e-05,117485000,117765000,117490000,117770000,"chr9",374257,0,2,1,3,"chr9",1,0.00492264416315049
"12084","chr9.127585000.127590000","chr9.127910000.127915000",325000,12,0.0002746507,127585000,127910000,127590000,127915000,"chr9",374262,5,19,21,45,"chr9",1,0.0632911392405063
"12085","chr9.128435000.128440000","chr9.128990000.128995000",555000,10,0.0003129411,128435000,128990000,128440000,128995000,"chr9",374325,7,21,17,45,"chr9",1,0.0527426160337553
"12086","chr9.4315000.4320000","chr9.5185000.5190000",870000,7,0.004921063,4315000,5185000,4320000,5190000,"chr9",374334,0,3,0,3,"chr9",1,0.00246132208157525
"12087","chr9.128310000.128315000","chr9.129100000.129105000",790000,7,0.00789003,128310000,129100000,128315000,129105000,"chr9",374335,1,5,6,12,"chr9",1,0.00984528832630099
"12088","chr9.33075000.33080000","chr9.33290000.33295000",215000,14,0.0002512537,33075000,33290000,33080000,33295000,"chr9",374347,1,5,7,13,"chr9",1,0.0213314580403188
"12089","chr9.127755000.127760000","chr9.128115000.128120000",360000,12,0.0001516586,127755000,128115000,127760000,128120000,"chr9",374358,9,29,26,64,"chr9",1,0.090014064697609
"12090","chr9.37905000.37910000","chr9.38400000.38405000",495000,9,0.003059107,37905000,38400000,37910000,38405000,"chr9",374393,4,4,3,11,"chr9",1,0.0116033755274262
"12091","chr9.37900000.37905000","chr9.38390000.38395000",490000,9,0.003200965,37900000,38390000,37905000,38395000,"chr9",374405,3,2,5,10,"chr9",1,0.0105485232067511
"12092","chr9.19380000.19385000","chr9.19920000.19925000",540000,14,1.534524e-07,19380000,19920000,19385000,19925000,"chr9",374415,0,3,10,13,"chr9",1,0.0213314580403188
"12093","chr9.97535000.97540000","chr9.97710000.97715000",175000,14,0.001090143,97535000,97710000,97540000,97715000,"chr9",374439,1,3,3,7,"chr9",1,0.0114861697140178
"12094","chr9.131580000.131585000","chr9.131690000.131695000",110000,18,0.0001734391,131580000,131690000,131585000,131695000,"chr9",374447,2,1,2,5,"chr9",1,0.0105485232067511
"12095","chr9.128320000.128325000","chr9.129035000.129040000",715000,10,6.219144e-05,128320000,129035000,128325000,129040000,"chr9",374465,7,37,21,65,"chr9",1,0.0761837787154243
"12096","chr9.35095000.35100000","chr9.35160000.35165000",65000,21,0.0007267268,35095000,35160000,35100000,35165000,"chr9",374473,0,9,2,11,"chr9",1,0.0270745428973277
"12097","chr9.35730000.35735000","chr9.35880000.35885000",150000,13,0.008528833,35730000,35880000,35735000,35885000,"chr9",374491,4,5,8,17,"chr9",1,0.0259024847632443
"12098","chr9.34340000.34345000","chr9.34600000.34605000",260000,14,5.627777e-05,34340000,34600000,34345000,34605000,"chr9",374554,0,4,3,7,"chr9",1,0.0114861697140178
"12099","chr9.132135000.132140000","chr9.132265000.132270000",130000,20,2.66042e-06,132135000,132265000,132140000,132270000,"chr9",374583,3,8,13,24,"chr9",1,0.0562587904360056
"12100","chr9.3420000.3425000","chr9.3455000.3460000",35000,28,0.001147067,3420000,3455000,3425000,3460000,"chr9",374639,0,1,0,1,"chr9",1,0.00328176277543366
"12101","chr9.34330000.34335000","chr9.34375000.34380000",45000,70,4.07788e-35,34330000,34375000,34335000,34380000,"chr9",374646,1,1,2,4,"chr9",1,0.0328176277543366
"12102","chr9.126475000.126480000","chr9.126805000.126810000",330000,12,0.0002527094,126475000,126805000,126480000,126810000,"chr9",374668,0,0,4,4,"chr9",1,0.00562587904360056
"12103","chr9.97550000.97555000","chr9.97905000.97910000",355000,11,0.0007893115,97550000,97905000,97555000,97910000,"chr9",374670,0,2,0,2,"chr9",1,0.00257852789498359
"12104","chr9.505000.510000","chr9.715000.720000",210000,14,0.0002975622,505000,715000,510000,720000,"chr9",374701,8,18,16,42,"chr9",1,0.0689170182841069
"12105","chr9.131415000.131420000","chr9.131530000.131535000",115000,19,3.19689e-05,131415000,131530000,131420000,131535000,"chr9",374703,1,8,4,13,"chr9",1,0.0289498359118612
"12106","chr9.35600000.35605000","chr9.35730000.35735000",130000,14,0.005976839,35600000,35730000,35605000,35735000,"chr9",374723,6,5,8,19,"chr9",1,0.0311767463666198
"12107","chr9.36100000.36105000","chr9.36145000.36150000",45000,36,2.718625e-09,36100000,36145000,36105000,36150000,"chr9",374727,0,1,0,1,"chr9",1,0.00421940928270042
"12108","chr9.85815000.85820000","chr9.86355000.86360000",540000,8,0.009003138,85815000,86355000,85820000,86360000,"chr9",374765,2,3,5,10,"chr9",1,0.00937646507266761
"12109","chr9.34985000.34990000","chr9.35070000.35075000",85000,17,0.003975955,34985000,35070000,34990000,35075000,"chr9",374771,1,2,2,5,"chr9",1,0.00996249413970933
"12110","chr9.4675000.4680000","chr9.4985000.4990000",310000,16,3.836563e-07,4675000,4985000,4680000,4990000,"chr9",374774,0,2,1,3,"chr9",1,0.00562587904360056
"12111","chr9.107740000.107745000","chr9.108140000.108145000",400000,9,0.008111966,107740000,108140000,107745000,108145000,"chr9",374792,3,8,8,19,"chr9",1,0.020042194092827
"12112","chr9.34700000.34705000","chr9.34995000.35000000",295000,10,0.007954814,34700000,34995000,34705000,3.5e+07,"chr9",374798,0,2,1,3,"chr9",1,0.00351617440225035
"12113","chr9.131710000.131715000","chr9.131740000.131745000",30000,32,0.0004704961,131710000,131740000,131715000,131745000,"chr9",374808,5,15,11,31,"chr9",1,0.116268166901078
"12114","chr9.127695000.127700000","chr9.127890000.127895000",195000,12,0.006303501,127695000,127890000,127700000,127895000,"chr9",374848,6,17,18,41,"chr9",1,0.0576652601969058
"12115","chr9.15420000.15425000","chr9.15605000.15610000",185000,12,0.008521915,15420000,15605000,15425000,15610000,"chr9",374857,2,10,6,18,"chr9",1,0.0253164556962025
"12116","chr9.35095000.35100000","chr9.35535000.35540000",440000,9,0.005270755,35095000,35535000,35100000,35540000,"chr9",374918,1,10,5,16,"chr9",1,0.0168776371308017
"12117","chr9.34405000.34410000","chr9.34630000.34635000",225000,12,0.002718392,34405000,34630000,34410000,34635000,"chr9",374926,0,2,5,7,"chr9",1,0.00984528832630099
"12118","chr9.610000.615000","chr9.745000.750000",135000,27,1.301888e-11,610000,745000,615000,750000,"chr9",374934,1,2,4,7,"chr9",1,0.0221518987341772
"12119","chr9.71680000.71685000","chr9.71700000.71705000",20000,41,5.510568e-05,71680000,71700000,71685000,71705000,"chr9",374935,1,2,2,5,"chr9",1,0.0240271917487107
"12120","chr9.27340000.27345000","chr9.27425000.27430000",85000,23,3.422986e-06,27340000,27425000,27345000,27430000,"chr9",374974,0,3,2,5,"chr9",1,0.0134786685419597
"12121","chr9.510000.515000","chr9.535000.540000",25000,37,0.0002115928,510000,535000,515000,540000,"chr9",375017,2,3,3,8,"chr9",1,0.0346929207688701
"12122","chr9.37470000.37475000","chr9.37575000.37580000",105000,15,0.00697384,37470000,37575000,37475000,37580000,"chr9",375054,6,17,14,37,"chr9",1,0.0650492264416315
"12123","chr9.79855000.79860000","chr9.79935000.79940000",80000,17,0.006071643,79855000,79935000,79860000,79940000,"chr9",375092,0,1,0,1,"chr9",1,0.00199249882794187
"12124","chr9.8550000.8555000","chr9.8845000.8850000",295000,13,0.0001069693,8550000,8845000,8555000,8850000,"chr9",375125,0,1,1,2,"chr9",1,0.00304735114861697
"12125","chr9.34335000.34340000","chr9.34455000.34460000",120000,14,0.009085841,34335000,34455000,34340000,34460000,"chr9",375147,2,6,8,16,"chr9",1,0.0262541022034693
"12126","chr9.27340000.27345000","chr9.27530000.27535000",190000,47,3.686522e-35,27340000,27530000,27345000,27535000,"chr9",375185,1,4,3,8,"chr9",1,0.0440693858415377
"12127","chr9.96230000.96235000","chr9.96325000.96330000",95000,16,0.004823298,96230000,96325000,96235000,96330000,"chr9",375207,3,4,5,12,"chr9",1,0.0225035161744023
"12128","chr9.34895000.34900000","chr9.34985000.34990000",90000,33,1.714726e-13,34895000,34985000,34900000,34990000,"chr9",375225,0,3,1,4,"chr9",1,0.0154711673699015
"12129","chr9.34045000.34050000","chr9.34175000.34180000",130000,20,2.66042e-06,34045000,34175000,34050000,34180000,"chr9",375229,6,18,19,43,"chr9",1,0.100796999531177
"12130","chr9.129980000.129985000","chr9.130205000.130210000",225000,12,0.002718392,129980000,130205000,129985000,130210000,"chr9",375230,3,10,11,24,"chr9",1,0.0337552742616034
"12131","chr9.107635000.107640000","chr9.107905000.107910000",270000,13,0.0002023744,107635000,107905000,107640000,107910000,"chr9",375236,0,2,3,5,"chr9",1,0.00761837787154243
"12132","chr9.12720000.12725000","chr9.12885000.12890000",165000,22,8.960521e-09,12720000,12885000,12725000,12890000,"chr9",375260,0,0,2,2,"chr9",1,0.00515705578996718
"12133","chr9.20355000.20360000","chr9.21095000.21100000",740000,9,0.0003365915,20355000,21095000,20360000,21100000,"chr9",375279,1,1,0,2,"chr9",1,0.00210970464135021
"12134","chr9.129725000.129730000","chr9.129980000.129985000",255000,16,2.398538e-06,129725000,129980000,129730000,129985000,"chr9",375285,3,10,11,24,"chr9",1,0.0450070323488045
"12135","chr9.6050000.6055000","chr9.6305000.6310000",255000,14,6.635491e-05,6050000,6305000,6055000,6310000,"chr9",375296,4,5,3,12,"chr9",1,0.019690576652602
"12136","chr9.112360000.112365000","chr9.112555000.112560000",195000,12,0.006303501,112360000,112555000,112365000,112560000,"chr9",375304,4,9,4,17,"chr9",1,0.0239099859353024
"12137","chr9.38660000.38665000","chr9.38690000.38695000",30000,31,0.001043713,38660000,38690000,38665000,38695000,"chr9",375333,2,0,6,8,"chr9",1,0.0290670417252696
"12138","chr9.131605000.131610000","chr9.131710000.131715000",105000,19,7.274837e-05,131605000,131710000,131610000,131715000,"chr9",375341,4,5,4,13,"chr9",1,0.0289498359118612
"12139","chr9.131665000.131670000","chr9.131815000.131820000",150000,13,0.008528833,131665000,131815000,131670000,131820000,"chr9",375404,1,4,1,6,"chr9",1,0.00914205344585091
"12140","chr9.130680000.130685000","chr9.130830000.130835000",150000,13,0.008528833,130680000,130830000,130685000,130835000,"chr9",375417,1,5,2,8,"chr9",1,0.0121894045944679
"12141","chr9.131655000.131660000","chr9.131675000.131680000",20000,45,1.667871e-06,131655000,131675000,131660000,131680000,"chr9",375429,1,5,9,15,"chr9",1,0.0791139240506329
"12142","chr9.20640000.20645000","chr9.20925000.20930000",285000,12,0.000620419,20640000,20925000,20645000,20930000,"chr9",375434,0,1,0,1,"chr9",1,0.00140646976090014
"12143","chr9.3645000.3650000","chr9.4335000.4340000",690000,11,1.047488e-05,3645000,4335000,3650000,4340000,"chr9",375436,0,0,4,4,"chr9",1,0.00515705578996718
"12144","chr9.91795000.91800000","chr9.91845000.91850000",50000,29,3.219413e-06,91795000,91845000,91800000,91850000,"chr9",375492,1,0,0,1,"chr9",1,0.00339896858884201
"12145","chr9.97595000.97600000","chr9.97630000.97635000",35000,38,4.762367e-08,97595000,97630000,97600000,97635000,"chr9",375514,1,6,3,10,"chr9",1,0.0445382090951711
"12146","chr9.131690000.131695000","chr9.131710000.131715000",20000,53,4.939849e-10,131690000,131710000,131695000,131715000,"chr9",375542,2,1,2,5,"chr9",1,0.0310595405532114
"12147","chr9.34545000.34550000","chr9.34600000.34605000",55000,30,2.167552e-07,34545000,34600000,34550000,34605000,"chr9",375583,0,3,1,4,"chr9",1,0.0140646976090014
"12148","chr9.3730000.3735000","chr9.4315000.4320000",585000,14,7.125004e-08,3730000,4315000,3735000,4320000,"chr9",375603,1,0,0,1,"chr9",1,0.00164088138771683
"12149","chr9.4740000.4745000","chr9.4985000.4990000",245000,13,0.0004034797,4740000,4985000,4745000,4990000,"chr9",375703,0,2,1,3,"chr9",1,0.00457102672292546
"12150","chr9.27410000.27415000","chr9.27530000.27535000",120000,15,0.003167997,27410000,27530000,27415000,27535000,"chr9",375768,0,3,1,4,"chr9",1,0.0070323488045007
"12151","chr9.72035000.72040000","chr9.72150000.72155000",115000,17,0.0004220198,72035000,72150000,72040000,72155000,"chr9",375773,0,1,5,6,"chr9",1,0.0119549929676512
"12152","chr9.4335000.4340000","chr9.4365000.4370000",30000,35,3.395722e-05,4335000,4365000,4340000,4370000,"chr9",375791,0,0,4,4,"chr9",1,0.0164088138771683
"12153","chr9.36100000.36105000","chr9.36165000.36170000",65000,46,1.680426e-20,36100000,36165000,36105000,36170000,"chr9",375793,2,3,6,11,"chr9",1,0.0593061415846226
"12154","chr9.560000.565000","chr9.695000.700000",135000,15,0.001629879,560000,695000,565000,7e+05,"chr9",375832,0,0,5,5,"chr9",1,0.00879043600562588
"12155","chr9.72185000.72190000","chr9.72280000.72285000",95000,26,9.971216e-09,72185000,72280000,72190000,72285000,"chr9",375855,2,5,13,20,"chr9",1,0.0609470229723394
"12156","chr9.13430000.13435000","chr9.14430000.14435000",1000000,11,3.324739e-07,13430000,14430000,13435000,14435000,"chr9",375868,0,2,0,2,"chr9",1,0.00257852789498359
"12157","chr9.128320000.128325000","chr9.128435000.128440000",115000,18,0.0001202819,128320000,128435000,128325000,128440000,"chr9",375892,9,23,17,49,"chr9",1,0.10337552742616
"12158","chr9.121360000.121365000","chr9.122120000.122125000",760000,12,5.462449e-07,121360000,122120000,121365000,122125000,"chr9",375963,0,0,1,1,"chr9",1,0.00140646976090014
"12159","chr9.32375000.32380000","chr9.32550000.32555000",175000,13,0.003720896,32375000,32550000,32380000,32555000,"chr9",375966,0,0,3,3,"chr9",1,0.00457102672292546
"12160","chr9.35030000.35035000","chr9.35050000.35055000",20000,53,4.939849e-10,35030000,35050000,35035000,35055000,"chr9",375969,6,21,22,49,"chr9",1,0.304383497421472
"12161","chr9.35660000.35665000","chr9.35725000.35730000",65000,31,2.467967e-09,35660000,35725000,35665000,35730000,"chr9",375977,0,0,3,3,"chr9",1,0.0109001406469761
"12162","chr9.27350000.27355000","chr9.27570000.27575000",220000,20,9.260558e-09,27350000,27570000,27355000,27575000,"chr9",375994,2,3,5,10,"chr9",1,0.023441162681669
"12163","chr9.127395000.127400000","chr9.128115000.128120000",720000,9,0.000401562,127395000,128115000,127400000,128120000,"chr9",376010,1,2,1,4,"chr9",1,0.00421940928270042
"12164","chr9.34895000.34900000","chr9.35475000.35480000",580000,11,3.759188e-05,34895000,35475000,34900000,35480000,"chr9",376019,0,3,1,4,"chr9",1,0.00515705578996718
"12165","chr9.4665000.4670000","chr9.4980000.4985000",315000,12,0.0003329182,4665000,4980000,4670000,4985000,"chr9",376020,0,1,1,2,"chr9",1,0.00281293952180028
"12166","chr9.87475000.87480000","chr9.87870000.87875000",395000,9,0.008524811,87475000,87870000,87480000,87875000,"chr9",376029,0,3,2,5,"chr9",1,0.00527426160337553
"12167","chr9.35110000.35115000","chr9.35255000.35260000",145000,14,0.003428833,35110000,35255000,35115000,35260000,"chr9",376041,0,2,4,6,"chr9",1,0.00984528832630099
"12168","chr9.37910000.37915000","chr9.38010000.38015000",100000,21,8.169299e-06,37910000,38010000,37915000,38015000,"chr9",376048,2,0,0,2,"chr9",1,0.00492264416315049
"12169","chr9.2855000.2860000","chr9.3180000.3185000",325000,10,0.005011886,2855000,3180000,2860000,3185000,"chr9",376052,0,1,3,4,"chr9",1,0.0046882325363338
"12170","chr9.71700000.71705000","chr9.71825000.71830000",125000,14,0.007342334,71700000,71825000,71705000,71830000,"chr9",376057,2,2,2,6,"chr9",1,0.00984528832630099
"12171","chr9.131380000.131385000","chr9.131405000.131410000",25000,34,0.001998692,131380000,131405000,131385000,131410000,"chr9",376074,2,8,2,12,"chr9",1,0.0478199718706048
"12172","chr9.35490000.35495000","chr9.35535000.35540000",45000,53,6.929734e-21,35490000,35535000,35495000,35540000,"chr9",376120,0,10,5,15,"chr9",1,0.0931786216596343
"12173","chr9.87320000.87325000","chr9.87390000.87395000",70000,19,0.002563108,87320000,87390000,87325000,87395000,"chr9",376131,0,4,3,7,"chr9",1,0.0155883731833099
"12174","chr9.460000.465000","chr9.610000.615000",150000,14,0.002786698,460000,610000,465000,615000,"chr9",376240,1,2,4,7,"chr9",1,0.0114861697140178
"12175","chr9.132875000.132880000","chr9.133030000.133035000",155000,15,0.0006874354,132875000,133030000,132880000,133035000,"chr9",376251,1,0,4,5,"chr9",1,0.00879043600562588
"12176","chr9.15305000.15310000","chr9.15420000.15425000",115000,16,0.001348035,15305000,15420000,15310000,15425000,"chr9",376280,2,10,9,21,"chr9",1,0.0393811533052039
"12177","chr9.131530000.131535000","chr9.131705000.131710000",175000,15,0.0002936157,131530000,131705000,131535000,131710000,"chr9",376290,1,11,15,27,"chr9",1,0.0474683544303797
"12178","chr9.131655000.131660000","chr9.131690000.131695000",35000,48,9.362159e-14,131655000,131690000,131660000,131695000,"chr9",376321,1,1,2,4,"chr9",1,0.0225035161744023
"12179","chr9.123400000.123405000","chr9.123470000.123475000",70000,23,3.399273e-05,123400000,123470000,123405000,123475000,"chr9",376322,0,2,0,2,"chr9",1,0.00539146741678387
"12180","chr9.570000.575000","chr9.755000.760000",185000,13,0.002613081,570000,755000,575000,760000,"chr9",376351,4,8,10,22,"chr9",1,0.0335208626347867
"12181","chr9.3465000.3470000","chr9.3730000.3735000",265000,12,0.0009836041,3465000,3730000,3470000,3735000,"chr9",376410,1,0,0,1,"chr9",1,0.00140646976090014
"12182","chr9.10210000.10215000","chr9.10230000.10235000",20000,36,0.002291956,10210000,10230000,10215000,10235000,"chr9",376439,1,2,0,3,"chr9",1,0.0126582278481013
"12183","chr9.127575000.127580000","chr9.127605000.127610000",30000,33,0.0002048295,127575000,127605000,127580000,127610000,"chr9",376484,4,24,30,58,"chr9",1,0.224331926863572
"12184","chr9.2130000.2135000","chr9.2835000.2840000",705000,12,1.040274e-06,2130000,2835000,2135000,2840000,"chr9",376534,3,1,1,5,"chr9",1,0.0070323488045007
"12185","chr9.21325000.21330000","chr9.21785000.21790000",460000,12,3.086223e-05,21325000,21785000,21330000,21790000,"chr9",376539,3,2,8,13,"chr9",1,0.0182841068917018
"12186","chr9.3335000.3340000","chr9.3405000.3410000",70000,18,0.006523488,3335000,3405000,3340000,3410000,"chr9",376543,0,1,0,1,"chr9",1,0.00210970464135021
"12187","chr9.4045000.4050000","chr9.4335000.4340000",290000,10,0.008599966,4045000,4335000,4050000,4340000,"chr9",376546,0,0,1,1,"chr9",1,0.00117205813408345
"12188","chr9.38020000.38025000","chr9.38045000.38050000",25000,43,1.020352e-06,38020000,38045000,38025000,38050000,"chr9",376549,0,7,1,8,"chr9",1,0.0403187998124707
"12189","chr9.117460000.117465000","chr9.117765000.117770000",305000,12,0.0004109516,117460000,117765000,117465000,117770000,"chr9",376594,0,5,3,8,"chr9",1,0.0112517580872011
"12190","chr9.127605000.127610000","chr9.128115000.128120000",510000,12,1.434239e-05,127605000,128115000,127610000,128120000,"chr9",376614,4,24,30,58,"chr9",1,0.0815752461322082
"12191","chr9.35490000.35495000","chr9.35610000.35615000",120000,15,0.003167997,35490000,35610000,35495000,35615000,"chr9",376620,0,11,5,16,"chr9",1,0.0281293952180028
"12192","chr9.13565000.13570000","chr9.14430000.14435000",865000,11,1.656508e-06,13565000,14430000,13570000,14435000,"chr9",376660,0,3,0,3,"chr9",1,0.00386779184247539
"12193","chr9.128315000.128320000","chr9.129250000.129255000",935000,13,5.324598e-09,128315000,129250000,128320000,129255000,"chr9",376668,4,13,8,25,"chr9",1,0.0380918893577121
"12194","chr9.97560000.97565000","chr9.97710000.97715000",150000,18,1.476428e-05,97560000,97710000,97565000,97715000,"chr9",376695,2,4,3,9,"chr9",1,0.0189873417721519
"12195","chr9.33290000.33295000","chr9.33470000.33475000",180000,15,0.0002401557,33290000,33470000,33295000,33475000,"chr9",376707,1,5,5,11,"chr9",1,0.0193389592123769
"12196","chr9.71155000.71160000","chr9.71620000.71625000",465000,10,0.0008914353,71155000,71620000,71160000,71625000,"chr9",376765,0,1,0,1,"chr9",1,0.00117205813408345
"12197","chr9.129865000.129870000","chr9.129885000.129890000",20000,38,0.0005620438,129865000,129885000,129870000,129890000,"chr9",376767,0,1,1,2,"chr9",1,0.00890764181903422
"12198","chr9.34045000.34050000","chr9.34125000.34130000",80000,21,8.576855e-05,34045000,34125000,34050000,34130000,"chr9",376827,5,18,19,42,"chr9",1,0.10337552742616
"12199","chr9.27330000.27335000","chr9.27495000.27500000",165000,22,8.960521e-09,27330000,27495000,27335000,27500000,"chr9",376828,2,1,1,4,"chr9",1,0.0103141115799344
"12200","chr9.130725000.130730000","chr9.130830000.130835000",105000,23,2.656955e-07,130725000,130830000,130730000,130835000,"chr9",376850,1,9,10,20,"chr9",1,0.0539146741678387
"12201","chr9.4665000.4670000","chr9.5590000.5595000",925000,8,0.0005558501,4665000,5590000,4670000,5595000,"chr9",376881,0,1,3,4,"chr9",1,0.00375058602906704
"12202","chr9.34325000.34330000","chr9.34375000.34380000",50000,53,2.472922e-22,34325000,34375000,34330000,34380000,"chr9",376939,1,4,2,7,"chr9",1,0.043483356774496
"12203","chr9.5885000.5890000","chr9.6050000.6055000",165000,26,5.122928e-12,5885000,6050000,5890000,6055000,"chr9",376953,2,5,3,10,"chr9",1,0.0304735114861697
"12204","chr9.27340000.27345000","chr9.27495000.27500000",155000,18,1.116752e-05,27340000,27495000,27345000,27500000,"chr9",376965,2,1,1,4,"chr9",1,0.00843881856540084
"12205","chr9.35110000.35115000","chr9.35475000.35480000",365000,11,0.0006825907,35110000,35475000,35115000,35480000,"chr9",376970,0,2,4,6,"chr9",1,0.00773558368495077
"12206","chr9.72585000.72590000","chr9.73130000.73135000",545000,8,0.008599966,72585000,73130000,72590000,73135000,"chr9",377011,0,1,0,1,"chr9",1,0.00093764650726676
"12207","chr9.36400000.36405000","chr9.36555000.36560000",155000,23,3.289363e-09,36400000,36555000,36405000,36560000,"chr9",377039,4,5,3,12,"chr9",1,0.0323488045007032
"12208","chr9.108720000.108725000","chr9.109050000.109055000",330000,10,0.004676345,108720000,109050000,108725000,109055000,"chr9",377045,0,2,1,3,"chr9",1,0.00351617440225035
"12209","chr9.19050000.19055000","chr9.19405000.19410000",355000,10,0.003428833,19050000,19405000,19055000,19410000,"chr9",377061,1,3,2,6,"chr9",1,0.0070323488045007
"12210","chr9.126475000.126480000","chr9.127050000.127055000",575000,8,0.006775515,126475000,127050000,126480000,127055000,"chr9",377118,2,0,3,5,"chr9",1,0.0046882325363338
"12211","chr9.35670000.35675000","chr9.35725000.35730000",55000,38,2.411328e-12,35670000,35725000,35675000,35730000,"chr9",377139,0,0,3,3,"chr9",1,0.0133614627285513
"12212","chr9.127780000.127785000","chr9.127820000.127825000",40000,30,2.513173e-05,127780000,127820000,127785000,127825000,"chr9",377146,0,8,10,18,"chr9",1,0.0632911392405063
"12213","chr9.38080000.38085000","chr9.38360000.38365000",280000,12,0.0006902268,38080000,38360000,38085000,38365000,"chr9",377154,1,4,5,10,"chr9",1,0.0140646976090014
"12214","chr9.128320000.128325000","chr9.128495000.128500000",175000,13,0.003720896,128320000,128495000,128325000,128500000,"chr9",377215,4,8,9,21,"chr9",1,0.0319971870604782
"12215","chr9.129980000.129985000","chr9.130070000.130075000",90000,20,8.732247e-05,129980000,130070000,129985000,130075000,"chr9",377226,3,10,11,24,"chr9",1,0.0562587904360056
"12216","chr9.126455000.126460000","chr9.126475000.126480000",20000,41,5.510568e-05,126455000,126475000,126460000,126480000,"chr9",377235,2,0,5,7,"chr9",1,0.033638068448195
"12217","chr9.35550000.35555000","chr9.35600000.35605000",50000,26,8.929298e-05,35550000,35600000,35555000,35605000,"chr9",377356,1,9,3,13,"chr9",1,0.0396155649320206
"12218","chr9.101115000.101120000","chr9.101525000.101530000",410000,9,0.007275772,101115000,101525000,101120000,101530000,"chr9",377374,0,2,2,4,"chr9",1,0.00421940928270042
"12219","chr9.97550000.97555000","chr9.97630000.97635000",80000,25,4.770026e-07,97550000,97630000,97555000,97635000,"chr9",377378,0,2,0,2,"chr9",1,0.00586029067041725
"12220","chr9.131610000.131615000","chr9.131710000.131715000",100000,23,4.770026e-07,131610000,131710000,131615000,131715000,"chr9",377410,1,1,1,3,"chr9",1,0.00808720112517581
"12221","chr9.505000.510000","chr9.755000.760000",250000,11,0.005191162,505000,755000,510000,760000,"chr9",377417,4,13,23,40,"chr9",1,0.0515705578996718
"12222","chr9.6350000.6355000","chr9.6555000.6560000",205000,18,7.277712e-07,6350000,6555000,6355000,6560000,"chr9",377437,1,15,5,21,"chr9",1,0.0443037974683544
"12223","chr9.37965000.37970000","chr9.37995000.38000000",30000,29,0.004574059,37965000,37995000,37970000,3.8e+07,"chr9",377448,2,2,4,8,"chr9",1,0.0271917487107361
"12224","chr9.128605000.128610000","chr9.129035000.129040000",430000,9,0.005856676,128605000,129035000,128610000,129040000,"chr9",377465,6,11,5,22,"chr9",1,0.0232067510548523
"12225","chr9.132665000.132670000","chr9.132765000.132770000",100000,17,0.001157782,132665000,132765000,132670000,132770000,"chr9",377487,4,8,14,26,"chr9",1,0.0518049695264885
"12226","chr9.6575000.6580000","chr9.6610000.6615000",35000,29,0.0004939142,6575000,6610000,6580000,6615000,"chr9",377529,10,12,15,37,"chr9",1,0.125761837787154
"12227","chr9.33850000.33855000","chr9.34200000.34205000",350000,10,0.003657266,33850000,34200000,33855000,34205000,"chr9",377579,2,23,11,36,"chr9",1,0.0421940928270042
"12228","chr9.34405000.34410000","chr9.34600000.34605000",195000,25,2.830679e-12,34405000,34600000,34410000,34605000,"chr9",377580,0,2,3,5,"chr9",1,0.0146507266760431
"12229","chr9.37995000.38000000","chr9.38045000.38050000",50000,23,0.001642557,37995000,38045000,3.8e+07,38050000,"chr9",377584,2,2,4,8,"chr9",1,0.0215658696671355
"12230","chr9.35160000.35165000","chr9.35550000.35555000",390000,25,3.742505e-17,35160000,35550000,35165000,35555000,"chr9",377625,0,9,2,11,"chr9",1,0.0322315986872949
"12231","chr9.32585000.32590000","chr9.32965000.32970000",380000,27,3.029185e-19,32585000,32965000,32590000,32970000,"chr9",377643,0,6,3,9,"chr9",1,0.0284810126582278
"12232","chr9.13425000.13430000","chr9.13570000.13575000",145000,15,0.001054106,13425000,13570000,13430000,13575000,"chr9",377659,1,2,4,7,"chr9",1,0.0123066104078762
"12233","chr9.117175000.117180000","chr9.117275000.117280000",100000,16,0.003454179,117175000,117275000,117180000,117280000,"chr9",377674,0,2,1,3,"chr9",1,0.00562587904360056
"12234","chr9.27405000.27410000","chr9.27495000.27500000",90000,20,8.732247e-05,27405000,27495000,27410000,27500000,"chr9",377735,1,1,1,3,"chr9",1,0.0070323488045007
"12235","chr9.21315000.21320000","chr9.21395000.21400000",80000,24,1.873787e-06,21315000,21395000,21320000,21400000,"chr9",377758,2,1,2,5,"chr9",1,0.0140646976090014
"12236","chr9.98475000.98480000","chr9.99025000.99030000",550000,8,0.008265797,98475000,99025000,98480000,99030000,"chr9",377933,0,4,2,6,"chr9",1,0.00562587904360056
"12237","chr9.19230000.19235000","chr9.19380000.19385000",150000,24,8.263185e-10,19230000,19380000,19235000,19385000,"chr9",377942,6,18,21,45,"chr9",1,0.126582278481013
"12238","chr9.87460000.87465000","chr9.87480000.87485000",20000,44,4.119536e-06,87460000,87480000,87465000,87485000,"chr9",377944,2,10,13,25,"chr9",1,0.12892639474918
"12239","chr9.77725000.77730000","chr9.77750000.77755000",25000,43,1.020352e-06,77725000,77750000,77730000,77755000,"chr9",377962,0,1,4,5,"chr9",1,0.0251992498827942
"12240","chr9.35080000.35085000","chr9.35745000.35750000",665000,11,1.380658e-05,35080000,35745000,35085000,35750000,"chr9",377979,0,4,4,8,"chr9",1,0.0103141115799344
"12241","chr9.38025000.38030000","chr9.38045000.38050000",20000,54,1.596824e-10,38025000,38045000,38030000,38050000,"chr9",378001,0,1,1,2,"chr9",1,0.0126582278481013
"12242","chr9.19050000.19055000","chr9.19100000.19105000",50000,44,1.762462e-15,19050000,19100000,19055000,19105000,"chr9",378012,1,4,2,7,"chr9",1,0.0360993905297703
"12243","chr9.34405000.34410000","chr9.34430000.34435000",25000,39,3.989491e-05,34405000,34430000,34410000,34435000,"chr9",378029,0,2,5,7,"chr9",1,0.0319971870604782
"12244","chr9.12720000.12725000","chr9.12780000.12785000",60000,25,2.52988e-05,12720000,12780000,12725000,12785000,"chr9",378030,0,3,1,4,"chr9",1,0.0117205813408345
"12245","chr9.35490000.35495000","chr9.35515000.35520000",25000,44,3.862716e-07,35490000,35515000,35495000,35520000,"chr9",378044,0,3,3,6,"chr9",1,0.0309423347398031
"12246","chr9.125700000.125705000","chr9.125785000.125790000",85000,18,0.001421168,125700000,125785000,125705000,125790000,"chr9",378059,2,10,17,29,"chr9",1,0.0611814345991561
"12247","chr9.33620000.33625000","chr9.33850000.33855000",230000,11,0.0082624,33620000,33850000,33625000,33855000,"chr9",378064,0,1,3,4,"chr9",1,0.00515705578996718
"12248","chr9.36035000.36040000","chr9.36190000.36195000",155000,14,0.002319745,36035000,36190000,36040000,36195000,"chr9",378079,0,3,3,6,"chr9",1,0.00984528832630099
"12249","chr9.35655000.35660000","chr9.35755000.35760000",100000,17,0.001157782,35655000,35755000,35660000,35760000,"chr9",378184,3,1,0,4,"chr9",1,0.00796999531176746
"12250","chr9.38045000.38050000","chr9.38360000.38365000",315000,11,0.001477535,38045000,38360000,38050000,38365000,"chr9",378205,1,4,5,10,"chr9",1,0.012892639474918
"12251","chr9.6350000.6355000","chr9.6585000.6590000",235000,11,0.007342334,6350000,6585000,6355000,6590000,"chr9",378224,5,6,4,15,"chr9",1,0.0193389592123769
"12252","chr9.127605000.127610000","chr9.127965000.127970000",360000,10,0.003192558,127605000,127965000,127610000,127970000,"chr9",378248,4,23,18,45,"chr9",1,0.0527426160337553
"12253","chr9.27370000.27375000","chr9.27495000.27500000",125000,15,0.00250834,27370000,27495000,27375000,27500000,"chr9",378259,0,1,1,2,"chr9",1,0.00351617440225035
"12254","chr9.128315000.128320000","chr9.128990000.128995000",675000,13,1.686854e-07,128315000,128990000,128320000,128995000,"chr9",378266,6,21,18,45,"chr9",1,0.0685654008438819
"12255","chr9.32525000.32530000","chr9.33000000.33005000",475000,11,0.0001483239,32525000,3.3e+07,32530000,33005000,"chr9",378269,1,17,7,25,"chr9",1,0.0322315986872949
"12256","chr9.117460000.117465000","chr9.118300000.118305000",840000,8,0.001029976,117460000,118300000,117465000,118305000,"chr9",378326,0,4,4,8,"chr9",1,0.00750117205813408
"12257","chr9.72315000.72320000","chr9.72335000.72340000",20000,36,0.002291956,72315000,72335000,72320000,72340000,"chr9",378355,0,6,3,9,"chr9",1,0.0379746835443038
"12258","chr9.4680000.4685000","chr9.4985000.4990000",305000,13,8.55857e-05,4680000,4985000,4685000,4990000,"chr9",378375,0,2,1,3,"chr9",1,0.00457102672292546
"12259","chr9.73545000.73550000","chr9.73565000.73570000",20000,50,1.213639e-08,73545000,73565000,73550000,73570000,"chr9",378388,0,2,4,6,"chr9",1,0.0351617440225035
"12260","chr9.27425000.27430000","chr9.27495000.27500000",70000,19,0.002563108,27425000,27495000,27430000,27500000,"chr9",378399,0,1,1,2,"chr9",1,0.00445382090951711
"12261","chr9.3335000.3340000","chr9.3440000.3445000",105000,15,0.00697384,3335000,3440000,3340000,3445000,"chr9",378427,0,2,0,2,"chr9",1,0.00351617440225035
"12262","chr9.112735000.112740000","chr9.112850000.112855000",115000,17,0.0004220198,112735000,112850000,112740000,112855000,"chr9",378579,2,1,3,6,"chr9",1,0.0119549929676512
"12263","chr9.108720000.108725000","chr9.109455000.109460000",735000,9,0.0003527018,108720000,109455000,108725000,109460000,"chr9",378587,0,2,1,3,"chr9",1,0.00316455696202532
"12264","chr9.3025000.3030000","chr9.3205000.3210000",180000,16,5.876535e-05,3025000,3205000,3030000,3210000,"chr9",378645,3,3,1,7,"chr9",1,0.0131270511017346
"12265","chr9.77440000.77445000","chr9.77530000.77535000",90000,19,0.0002887054,77440000,77530000,77445000,77535000,"chr9",378653,1,3,2,6,"chr9",1,0.0133614627285513
"12266","chr9.128165000.128170000","chr9.128990000.128995000",825000,13,2.38357e-08,128165000,128990000,128170000,128995000,"chr9",378656,0,9,9,18,"chr9",1,0.0274261603375527
"12267","chr9.27405000.27410000","chr9.27545000.27550000",140000,23,1.074778e-08,27405000,27545000,27410000,27550000,"chr9",378666,0,3,1,4,"chr9",1,0.0107829348335677
"12268","chr9.2125000.2130000","chr9.2835000.2840000",710000,10,6.514817e-05,2125000,2835000,2130000,2840000,"chr9",378667,2,1,1,4,"chr9",1,0.0046882325363338
"12269","chr9.6680000.6685000","chr9.6700000.6705000",20000,85,2.257841e-29,6680000,6700000,6685000,6705000,"chr9",378671,4,11,15,30,"chr9",1,0.29887482419128
"12270","chr9.3750000.3755000","chr9.4315000.4320000",565000,8,0.007342334,3750000,4315000,3755000,4320000,"chr9",378683,1,3,0,4,"chr9",1,0.00375058602906704
"12271","chr9.35645000.35650000","chr9.35825000.35830000",180000,16,5.876535e-05,35645000,35825000,35650000,35830000,"chr9",378706,0,6,4,10,"chr9",1,0.0187529301453352
"12272","chr9.100375000.100380000","chr9.100675000.100680000",300000,10,0.007342334,100375000,100675000,100380000,100680000,"chr9",378724,2,0,2,4,"chr9",1,0.0046882325363338
"12273","chr9.131445000.131450000","chr9.131690000.131695000",245000,11,0.005803666,131445000,131690000,131450000,131695000,"chr9",378728,2,1,2,5,"chr9",1,0.00644631973745898
"12274","chr9.27370000.27375000","chr9.27405000.27410000",35000,41,1.250453e-09,27370000,27405000,27375000,27410000,"chr9",378729,0,1,1,2,"chr9",1,0.00961087669948429
"12275","chr9.128295000.128300000","chr9.128995000.129000000",700000,8,0.002660892,128295000,128995000,128300000,1.29e+08,"chr9",378738,1,11,9,21,"chr9",1,0.019690576652602
"12276","chr9.20295000.20300000","chr9.20720000.20725000",425000,11,0.0002911904,20295000,20720000,20300000,20725000,"chr9",378739,2,2,3,7,"chr9",1,0.00902484763244257
"12277","chr9.36245000.36250000","chr9.36405000.36410000",160000,13,0.006049966,36245000,36405000,36250000,36410000,"chr9",378752,1,10,7,18,"chr9",1,0.0274261603375527
"12278","chr9.36400000.36405000","chr9.36420000.36425000",20000,37,0.001147067,36400000,36420000,36405000,36425000,"chr9",378753,4,5,3,12,"chr9",1,0.0520393811533052
"12279","chr9.12720000.12725000","chr9.13085000.13090000",365000,13,2.537584e-05,12720000,13085000,12725000,13090000,"chr9",378779,0,5,5,10,"chr9",1,0.0152367557430849
"12280","chr9.695000.700000","chr9.735000.740000",40000,32,2.910397e-06,695000,735000,7e+05,740000,"chr9",378839,2,4,11,17,"chr9",1,0.0637599624941397
"12281","chr9.123425000.123430000","chr9.123470000.123475000",45000,27,0.0001087367,123425000,123470000,123430000,123475000,"chr9",378904,0,2,1,3,"chr9",1,0.00949367088607595
"12282","chr9.113190000.113195000","chr9.113345000.113350000",155000,14,0.002319745,113190000,113345000,113195000,113350000,"chr9",378981,2,3,3,8,"chr9",1,0.0131270511017346
"12283","chr9.128095000.128100000","chr9.128115000.128120000",20000,39,0.0002661542,128095000,128115000,128100000,128120000,"chr9",378982,9,19,19,47,"chr9",1,0.214838255977496
"12284","chr9.33000000.33005000","chr9.33290000.33295000",290000,13,0.0001204897,3.3e+07,33290000,33005000,33295000,"chr9",379000,1,5,7,13,"chr9",1,0.0198077824660103
"12285","chr9.27030000.27035000","chr9.27275000.27280000",245000,40,2.555525e-30,27030000,27275000,27035000,27280000,"chr9",379008,1,6,5,12,"chr9",1,0.0562587904360056
"12286","chr9.87320000.87325000","chr9.87570000.87575000",250000,15,1.550895e-05,87320000,87570000,87325000,87575000,"chr9",379009,0,2,2,4,"chr9",1,0.0070323488045007
"12287","chr9.131960000.131965000","chr9.132355000.132360000",395000,10,0.002081723,131960000,132355000,131965000,132360000,"chr9",379037,2,2,1,5,"chr9",1,0.00586029067041725
"12288","chr9.75070000.75075000","chr9.75235000.75240000",165000,16,0.0001181688,75070000,75235000,75075000,75240000,"chr9",379059,0,1,3,4,"chr9",1,0.00750117205813408
"12289","chr9.127370000.127375000","chr9.127500000.127505000",130000,14,0.005976839,127370000,127500000,127375000,127505000,"chr9",379077,1,10,4,15,"chr9",1,0.0246132208157525
"12290","chr9.22810000.22815000","chr9.23490000.23495000",680000,14,1.584266e-08,22810000,23490000,22815000,23495000,"chr9",379080,0,5,4,9,"chr9",1,0.0147679324894515
"12291","chr9.124305000.124310000","chr9.124400000.124405000",95000,17,0.001732132,124305000,124400000,124310000,124405000,"chr9",379092,0,5,0,5,"chr9",1,0.00996249413970933
"12292","chr9.36400000.36405000","chr9.36475000.36480000",75000,18,0.003873198,36400000,36475000,36405000,36480000,"chr9",379098,4,5,3,12,"chr9",1,0.0253164556962025
"12293","chr9.35075000.35080000","chr9.35475000.35480000",400000,11,0.0004213101,35075000,35475000,35080000,35480000,"chr9",379155,3,3,0,6,"chr9",1,0.00773558368495077
"12294","chr9.6585000.6590000","chr9.6700000.6705000",115000,23,9.341727e-08,6585000,6700000,6590000,6705000,"chr9",379178,5,6,4,15,"chr9",1,0.040436005625879
"12295","chr9.36115000.36120000","chr9.36145000.36150000",30000,28,0.009189652,36115000,36145000,36120000,36150000,"chr9",379186,0,1,0,1,"chr9",1,0.00328176277543366
"12296","chr9.36215000.36220000","chr9.36315000.36320000",100000,17,0.001157782,36215000,36315000,36220000,36320000,"chr9",379217,1,8,8,17,"chr9",1,0.0338724800750117
"12297","chr9.129780000.129785000","chr9.129885000.129890000",105000,19,7.274837e-05,129780000,129885000,129785000,129890000,"chr9",379233,0,1,1,2,"chr9",1,0.00445382090951711
"12298","chr9.123385000.123390000","chr9.123450000.123455000",65000,28,1.686854e-07,123385000,123450000,123390000,123455000,"chr9",379247,0,5,1,6,"chr9",1,0.019690576652602
"12299","chr9.610000.615000","chr9.705000.710000",95000,18,0.0005708821,610000,705000,615000,710000,"chr9",379274,0,2,3,5,"chr9",1,0.0105485232067511
"12300","chr9.111290000.111295000","chr9.111520000.111525000",230000,11,0.0082624,111290000,111520000,111295000,111525000,"chr9",379302,2,5,2,9,"chr9",1,0.0116033755274262
"12301","chr9.114175000.114180000","chr9.114280000.114285000",105000,26,2.382978e-09,114175000,114280000,114180000,114285000,"chr9",379308,0,1,0,1,"chr9",1,0.00304735114861697
"12302","chr9.123400000.123405000","chr9.123450000.123455000",50000,27,3.094058e-05,123400000,123450000,123405000,123455000,"chr9",379333,0,2,0,2,"chr9",1,0.00632911392405063
"12303","chr9.129800000.129805000","chr9.129820000.129825000",20000,34,0.008189353,129800000,129820000,129805000,129825000,"chr9",379389,5,27,9,41,"chr9",1,0.163384903891233
"12304","chr9.127750000.127755000","chr9.127800000.127805000",50000,21,0.008949849,127750000,127800000,127755000,127805000,"chr9",379416,1,1,1,3,"chr9",1,0.00738396624472574
"12305","chr9.128155000.128160000","chr9.128990000.128995000",835000,7,0.006062086,128155000,128990000,128160000,128995000,"chr9",379418,7,21,18,46,"chr9",1,0.0377402719174871
"12306","chr9.32525000.32530000","chr9.32575000.32580000",50000,22,0.003970557,32525000,32575000,32530000,32580000,"chr9",379447,0,1,7,8,"chr9",1,0.0206282231598687
"12307","chr9.127910000.127915000","chr9.127965000.127970000",55000,21,0.003975955,127910000,127965000,127915000,127970000,"chr9",379485,5,19,18,42,"chr9",1,0.10337552742616
"12308","chr9.27370000.27375000","chr9.27410000.27415000",40000,33,9.518485e-07,27370000,27410000,27375000,27415000,"chr9",379560,0,1,1,2,"chr9",1,0.00773558368495077
"12309","chr9.131950000.131955000","chr9.132065000.132070000",115000,17,0.0004220198,131950000,132065000,131955000,132070000,"chr9",379666,0,2,1,3,"chr9",1,0.0059774964838256
"12310","chr9.128320000.128325000","chr9.129250000.129255000",930000,10,7.974195e-06,128320000,129250000,128325000,129255000,"chr9",379680,4,13,8,25,"chr9",1,0.0293014533520863
"12311","chr9.38085000.38090000","chr9.38360000.38365000",275000,19,4.049857e-09,38085000,38360000,38090000,38365000,"chr9",379687,1,3,5,9,"chr9",1,0.020042194092827
"12312","chr9.36005000.36010000","chr9.36075000.36080000",70000,26,7.670657e-07,36005000,36075000,36010000,36080000,"chr9",379690,1,2,0,3,"chr9",1,0.00914205344585091
"12313","chr9.36115000.36120000","chr9.36160000.36165000",45000,25,0.0007402317,36115000,36160000,36120000,36165000,"chr9",379707,0,6,4,10,"chr9",1,0.0293014533520863
"12314","chr9.133405000.133410000","chr9.133440000.133445000",35000,27,0.002563108,133405000,133440000,133410000,133445000,"chr9",379719,4,6,5,15,"chr9",1,0.0474683544303797
"12315","chr9.35515000.35520000","chr9.35535000.35540000",20000,83,5.680932e-28,35515000,35535000,35520000,35540000,"chr9",379731,0,3,3,6,"chr9",1,0.0583684950773558
"12316","chr9.131940000.131945000","chr9.131960000.131965000",20000,43,1.009698e-05,131940000,131960000,131945000,131965000,"chr9",379734,0,2,1,3,"chr9",1,0.0151195499296765
"12317","chr9.131045000.131050000","chr9.131105000.131110000",60000,19,0.009860903,131045000,131105000,131050000,131110000,"chr9",379751,5,16,13,34,"chr9",1,0.0757149554617909
"12318","chr9.6765000.6770000","chr9.6785000.6790000",20000,34,0.008189353,6765000,6785000,6770000,6790000,"chr9",379758,2,10,10,22,"chr9",1,0.0876699484294421
"12319","chr9.35955000.35960000","chr9.36160000.36165000",205000,20,2.224587e-08,35955000,36160000,35960000,36165000,"chr9",379795,3,10,10,23,"chr9",1,0.0539146741678387
"12320","chr9.2870000.2875000","chr9.3035000.3040000",165000,16,0.0001181688,2870000,3035000,2875000,3040000,"chr9",379836,1,1,1,3,"chr9",1,0.00562587904360056
"12321","chr9.535000.540000","chr9.715000.720000",180000,15,0.0002401557,535000,715000,540000,720000,"chr9",379846,2,3,6,11,"chr9",1,0.0193389592123769
"12322","chr9.127605000.127610000","chr9.127920000.127925000",315000,12,0.0003329182,127605000,127920000,127610000,127925000,"chr9",379848,2,20,12,34,"chr9",1,0.0478199718706048
"12323","chr9.131940000.131945000","chr9.132240000.132245000",300000,11,0.00193113,131940000,132240000,131945000,132245000,"chr9",379890,0,5,2,7,"chr9",1,0.00902484763244257
"12324","chr9.36245000.36250000","chr9.36450000.36455000",205000,12,0.004720771,36245000,36450000,36250000,36455000,"chr9",379918,1,15,9,25,"chr9",1,0.0351617440225035
"12325","chr9.37910000.37915000","chr9.38390000.38395000",480000,11,0.0001373847,37910000,38390000,37915000,38395000,"chr9",379989,3,2,5,10,"chr9",1,0.012892639474918
"12326","chr9.113535000.113540000","chr9.114055000.114060000",520000,9,0.002382054,113535000,114055000,113540000,114060000,"chr9",379999,2,0,0,2,"chr9",1,0.00210970464135021
"12327","chr9.128160000.128165000","chr9.128990000.128995000",830000,7,0.006245654,128160000,128990000,128165000,128995000,"chr9",380043,2,4,5,11,"chr9",1,0.00902484763244257
"12328","chr9.5185000.5190000","chr9.5600000.5605000",415000,21,3.393559e-13,5185000,5600000,5190000,5605000,"chr9",380114,0,5,2,7,"chr9",1,0.0172292545710267
"12329","chr9.36245000.36250000","chr9.36325000.36330000",80000,68,2.291564e-45,36245000,36325000,36250000,36330000,"chr9",380117,1,14,9,24,"chr9",1,0.191279887482419
"12330","chr9.34395000.34400000","chr9.34630000.34635000",235000,11,0.007342334,34395000,34630000,34400000,34635000,"chr9",380134,1,3,4,8,"chr9",1,0.0103141115799344
"12331","chr9.32575000.32580000","chr9.33025000.33030000",450000,11,0.0002084657,32575000,33025000,32580000,33030000,"chr9",380141,0,1,7,8,"chr9",1,0.0103141115799344
"12332","chr9.37590000.37595000","chr9.37675000.37680000",85000,30,9.166509e-11,37590000,37675000,37595000,37680000,"chr9",380143,0,5,2,7,"chr9",1,0.0246132208157525
"12333","chr9.27325000.27330000","chr9.27495000.27500000",170000,15,0.000365877,27325000,27495000,27330000,27500000,"chr9",380165,2,1,1,4,"chr9",1,0.0070323488045007
"12334","chr9.32375000.32380000","chr9.32965000.32970000",590000,21,1.844864e-15,32375000,32965000,32380000,32970000,"chr9",380167,4,8,3,15,"chr9",1,0.0369198312236287
"12335","chr9.37910000.37915000","chr9.38045000.38050000",135000,30,4.085835e-14,37910000,38045000,37915000,38050000,"chr9",380182,4,18,7,29,"chr9",1,0.10196905766526
"12336","chr9.35490000.35495000","chr9.35525000.35530000",35000,33,1.134641e-05,35490000,35525000,35495000,35530000,"chr9",380236,0,15,5,20,"chr9",1,0.0773558368495077
"12337","chr9.129725000.129730000","chr9.129865000.129870000",140000,20,1.361484e-06,129725000,129865000,129730000,129870000,"chr9",380241,2,7,9,18,"chr9",1,0.0421940928270042
"12338","chr9.35160000.35165000","chr9.35745000.35750000",585000,9,0.001277651,35160000,35745000,35165000,35750000,"chr9",380248,0,4,2,6,"chr9",1,0.00632911392405063
"12339","chr9.34985000.34990000","chr9.35600000.35605000",615000,8,0.004921063,34985000,35600000,34990000,35605000,"chr9",380253,1,4,2,7,"chr9",1,0.00656352555086732
"12340","chr9.10230000.10235000","chr9.10265000.10270000",35000,35,1.391233e-06,10230000,10265000,10235000,10270000,"chr9",380268,2,2,0,4,"chr9",1,0.0164088138771683
"12341","chr9.20355000.20360000","chr9.20680000.20685000",325000,12,0.0002746507,20355000,20680000,20360000,20685000,"chr9",380297,1,1,0,2,"chr9",1,0.00281293952180028
"12342","chr9.130185000.130190000","chr9.130215000.130220000",30000,35,3.395722e-05,130185000,130215000,130190000,130220000,"chr9",380301,0,5,3,8,"chr9",1,0.0328176277543366
"12343","chr9.27370000.27375000","chr9.27545000.27550000",175000,22,4.321579e-09,27370000,27545000,27375000,27550000,"chr9",380302,0,1,1,2,"chr9",1,0.00515705578996718
"12344","chr9.19485000.19490000","chr9.19640000.19645000",155000,26,1.273116e-11,19485000,19640000,19490000,19645000,"chr9",380305,2,14,7,23,"chr9",1,0.0700890764181903
"12345","chr9.37910000.37915000","chr9.38360000.38365000",450000,40,1.515761e-37,37910000,38360000,37915000,38365000,"chr9",380310,1,4,5,10,"chr9",1,0.046882325363338
"12346","chr9.130040000.130045000","chr9.130180000.130185000",140000,14,0.004105485,130040000,130180000,130045000,130185000,"chr9",380347,3,11,4,18,"chr9",1,0.029535864978903
"12347","chr9.17530000.17535000","chr9.17810000.17815000",280000,17,1.566966e-07,17530000,17810000,17535000,17815000,"chr9",380361,0,5,3,8,"chr9",1,0.0159399906235349
"12348","chr9.127605000.127610000","chr9.127935000.127940000",330000,10,0.004676345,127605000,127935000,127610000,127940000,"chr9",380417,4,9,5,18,"chr9",1,0.0210970464135021
"12349","chr9.18385000.18390000","chr9.19025000.19030000",640000,9,0.0007831883,18385000,19025000,18390000,19030000,"chr9",380444,1,3,1,5,"chr9",1,0.00527426160337553
"12350","chr9.87570000.87575000","chr9.87870000.87875000",300000,11,0.00193113,87570000,87870000,87575000,87875000,"chr9",380455,0,2,2,4,"chr9",1,0.00515705578996718
"12351","chr9.130030000.130035000","chr9.130185000.130190000",155000,25,8.587391e-11,130030000,130185000,130035000,130190000,"chr9",380457,0,11,7,18,"chr9",1,0.0527426160337553
"12352","chr9.33815000.33820000","chr9.34175000.34180000",360000,10,0.003192558,33815000,34175000,33820000,34180000,"chr9",380480,4,9,5,18,"chr9",1,0.0210970464135021
"12353","chr9.126890000.126895000","chr9.127150000.127155000",260000,15,1.10401e-05,126890000,127150000,126895000,127155000,"chr9",380500,0,3,1,4,"chr9",1,0.0070323488045007
"12354","chr9.19025000.19030000","chr9.19455000.19460000",430000,15,1.582224e-07,19025000,19455000,19030000,19460000,"chr9",380543,1,5,1,7,"chr9",1,0.0123066104078762
"12355","chr9.34330000.34335000","chr9.34630000.34635000",300000,10,0.007342334,34330000,34630000,34335000,34635000,"chr9",380569,2,1,9,12,"chr9",1,0.0140646976090014
"12356","chr9.109185000.109190000","chr9.109240000.109245000",55000,21,0.003975955,109185000,109240000,109190000,109245000,"chr9",380603,0,2,0,2,"chr9",1,0.00492264416315049
"12357","chr9.128315000.128320000","chr9.128435000.128440000",120000,14,0.009085841,128315000,128435000,128320000,128440000,"chr9",380615,6,23,17,46,"chr9",1,0.0754805438349742
"12358","chr9.97560000.97565000","chr9.97675000.97680000",115000,17,0.0004220198,97560000,97675000,97565000,97680000,"chr9",380616,2,4,3,9,"chr9",1,0.0179324894514768
"12359","chr9.36005000.36010000","chr9.36190000.36195000",185000,12,0.008521915,36005000,36190000,36010000,36195000,"chr9",380639,0,2,0,2,"chr9",1,0.00281293952180028
"12360","chr9.113670000.113675000","chr9.114055000.114060000",385000,10,0.002334636,113670000,114055000,113675000,114060000,"chr9",380653,2,0,0,2,"chr9",1,0.0023441162681669
"12361","chr9.128165000.128170000","chr9.128315000.128320000",150000,15,0.0008539421,128165000,128315000,128170000,128320000,"chr9",380668,0,9,9,18,"chr9",1,0.0316455696202532
"12362","chr9.126315000.126320000","chr9.127150000.127155000",835000,7,0.006062086,126315000,127150000,126320000,127155000,"chr9",380670,0,3,1,4,"chr9",1,0.00328176277543366
"12363","chr9.129995000.130000000","chr9.130105000.130110000",110000,19,4.752175e-05,129995000,130105000,1.3e+08,130110000,"chr9",380682,3,25,12,40,"chr9",1,0.0890764181903422
"12364","chr9.130030000.130035000","chr9.130210000.130215000",180000,17,1.319355e-05,130030000,130210000,130035000,130215000,"chr9",380689,1,5,7,13,"chr9",1,0.0259024847632443
"12365","chr9.35490000.35495000","chr9.35645000.35650000",155000,15,0.0006874354,35490000,35645000,35495000,35650000,"chr9",380694,0,6,5,11,"chr9",1,0.0193389592123769
"12366","chr9.131710000.131715000","chr9.131745000.131750000",35000,49,2.20637e-14,131710000,131745000,131715000,131750000,"chr9",380705,9,25,20,54,"chr9",1,0.310126582278481
"12367","chr9.5630000.5635000","chr9.5825000.5830000",195000,13,0.001906131,5630000,5825000,5635000,5830000,"chr9",380747,6,10,4,20,"chr9",1,0.0304735114861697
"12368","chr9.35255000.35260000","chr9.35475000.35480000",220000,17,1.883402e-06,35255000,35475000,35260000,35480000,"chr9",380763,3,14,7,24,"chr9",1,0.0478199718706048
"12369","chr9.119480000.119485000","chr9.120015000.120020000",535000,9,0.00206756,119480000,120015000,119485000,120020000,"chr9",380868,0,2,2,4,"chr9",1,0.00421940928270042
"12370","chr9.124385000.124390000","chr9.124750000.124755000",365000,14,4.173306e-06,124385000,124750000,124390000,124755000,"chr9",380898,0,0,3,3,"chr9",1,0.00492264416315049
"12371","chr9.131530000.131535000","chr9.131580000.131585000",50000,21,0.008949849,131530000,131580000,131535000,131585000,"chr9",380975,3,11,10,24,"chr9",1,0.0590717299578059
"12372","chr9.37855000.37860000","chr9.37875000.37880000",20000,34,0.008189353,37855000,37875000,37860000,37880000,"chr9",381020,8,9,13,30,"chr9",1,0.119549929676512
"12373","chr9.34340000.34345000","chr9.34375000.34380000",35000,41,1.250453e-09,34340000,34375000,34345000,34380000,"chr9",381051,1,4,2,7,"chr9",1,0.033638068448195
"12374","chr9.131915000.131920000","chr9.132265000.132270000",350000,11,0.0008539421,131915000,132265000,131920000,132270000,"chr9",381081,2,1,1,4,"chr9",1,0.00515705578996718
"12375","chr9.37575000.37580000","chr9.37785000.37790000",210000,13,0.00115245,37575000,37785000,37580000,37790000,"chr9",381098,1,11,3,15,"chr9",1,0.0228551336146273
"12376","chr9.27460000.27465000","chr9.27495000.27500000",35000,34,4.042197e-06,27460000,27495000,27465000,27500000,"chr9",381170,2,1,0,3,"chr9",1,0.0119549929676512
"12377","chr9.6350000.6355000","chr9.6565000.6570000",215000,44,2.453696e-33,6350000,6565000,6355000,6570000,"chr9",381171,3,7,6,16,"chr9",1,0.0825128926394749
"12378","chr9.6350000.6355000","chr9.6700000.6705000",350000,12,0.0001793294,6350000,6700000,6355000,6705000,"chr9",381188,5,12,14,31,"chr9",1,0.0436005625879044
"12379","chr9.33850000.33855000","chr9.34330000.34335000",480000,9,0.003577211,33850000,34330000,33855000,34335000,"chr9",381207,2,1,13,16,"chr9",1,0.0168776371308017
"12380","chr9.20355000.20360000","chr9.20925000.20930000",570000,12,6.093884e-06,20355000,20925000,20360000,20930000,"chr9",381238,0,1,0,1,"chr9",1,0.00140646976090014
"12381","chr9.128990000.128995000","chr9.129025000.129030000",35000,27,0.002563108,128990000,129025000,128995000,129030000,"chr9",381277,1,7,8,16,"chr9",1,0.0506329113924051
"12382","chr9.26955000.26960000","chr9.27275000.27280000",320000,12,0.0002999668,26955000,27275000,26960000,27280000,"chr9",381278,0,5,5,10,"chr9",1,0.0140646976090014
"12383","chr9.131050000.131055000","chr9.131330000.131335000",280000,11,0.002783355,131050000,131330000,131055000,131335000,"chr9",381315,4,23,10,37,"chr9",1,0.0477027660571964
"12384","chr9.33075000.33080000","chr9.33260000.33265000",185000,17,1.022226e-05,33075000,33260000,33080000,33265000,"chr9",381352,2,11,9,22,"chr9",1,0.0438349742147211
"12385","chr9.35095000.35100000","chr9.35490000.35495000",395000,11,0.0004542765,35095000,35490000,35100000,35495000,"chr9",381355,0,13,5,18,"chr9",1,0.0232067510548523
"12386","chr9.129100000.129105000","chr9.129120000.129125000",20000,34,0.008189353,129100000,129120000,129105000,129125000,"chr9",381387,1,5,6,12,"chr9",1,0.0478199718706048
"12387","chr9.131610000.131615000","chr9.131745000.131750000",135000,15,0.001629879,131610000,131745000,131615000,131750000,"chr9",381391,1,1,1,3,"chr9",1,0.00527426160337553
"12388","chr9.123385000.123390000","chr9.123465000.123470000",80000,23,7.083992e-06,123385000,123465000,123390000,123470000,"chr9",381392,0,5,6,11,"chr9",1,0.0296530707923113
"12389","chr9.101115000.101120000","chr9.101445000.101450000",330000,11,0.001147067,101115000,101445000,101120000,101450000,"chr9",381425,1,2,2,5,"chr9",1,0.00644631973745898
"12390","chr9.124320000.124325000","chr9.124770000.124775000",450000,10,0.001062729,124320000,124770000,124325000,124775000,"chr9",381445,1,6,0,7,"chr9",1,0.00820440693858415
"12391","chr9.129725000.129730000","chr9.130185000.130190000",460000,10,0.0009480607,129725000,130185000,129730000,130190000,"chr9",381465,0,11,7,18,"chr9",1,0.0210970464135021
"12392","chr9.127690000.127695000","chr9.127915000.127920000",225000,11,0.009242184,127690000,127915000,127695000,127920000,"chr9",381505,2,8,3,13,"chr9",1,0.0167604313173933
"12393","chr9.20720000.20725000","chr9.20925000.20930000",205000,14,0.0003594232,20720000,20925000,20725000,20930000,"chr9",381521,0,1,1,2,"chr9",1,0.00328176277543366
"12394","chr9.128170000.128175000","chr9.129110000.129115000",940000,7,0.003200965,128170000,129110000,128175000,129115000,"chr9",381575,2,11,8,21,"chr9",1,0.0172292545710267
"12395","chr9.33080000.33085000","chr9.33165000.33170000",85000,25,2.113522e-07,33080000,33165000,33085000,33170000,"chr9",381588,0,4,5,9,"chr9",1,0.0263713080168776
"12396","chr9.35275000.35280000","chr9.35550000.35555000",275000,12,0.0007765887,35275000,35550000,35280000,35555000,"chr9",381595,1,4,3,8,"chr9",1,0.0112517580872011
"12397","chr9.36035000.36040000","chr9.36160000.36165000",125000,14,0.007342334,36035000,36160000,36040000,36165000,"chr9",381606,6,7,5,18,"chr9",1,0.029535864978903
"12398","chr9.128990000.128995000","chr9.129035000.129040000",45000,23,0.004155497,128990000,129035000,128995000,129040000,"chr9",381652,7,21,18,46,"chr9",1,0.124003750586029
"12399","chr9.35115000.35120000","chr9.35600000.35605000",485000,11,0.0001278045,35115000,35600000,35120000,35605000,"chr9",381672,8,19,12,39,"chr9",1,0.05028129395218
"12400","chr9.27370000.27375000","chr9.27465000.27470000",95000,21,1.396591e-05,27370000,27465000,27375000,27470000,"chr9",381688,0,1,1,2,"chr9",1,0.00492264416315049
"12401","chr9.15275000.15280000","chr9.15575000.15580000",300000,11,0.00193113,15275000,15575000,15280000,15580000,"chr9",381712,0,8,7,15,"chr9",1,0.0193389592123769
"12402","chr9.97595000.97600000","chr9.97650000.97655000",55000,21,0.003975955,97595000,97650000,97600000,97655000,"chr9",381727,1,6,2,9,"chr9",1,0.0221518987341772
"12403","chr9.129725000.129730000","chr9.129960000.129965000",235000,18,1.648446e-07,129725000,129960000,129730000,129965000,"chr9",381761,0,12,4,16,"chr9",1,0.0337552742616034
"12404","chr9.74645000.74650000","chr9.74885000.74890000",240000,20,3.051794e-09,74645000,74885000,74650000,74890000,"chr9",381810,0,2,0,2,"chr9",1,0.0046882325363338
"12405","chr9.113400000.113405000","chr9.113590000.113595000",190000,13,0.002262232,113400000,113590000,113405000,113595000,"chr9",381823,0,2,1,3,"chr9",1,0.00457102672292546
"12406","chr9.123745000.123750000","chr9.123775000.123780000",30000,28,0.009189652,123745000,123775000,123750000,123780000,"chr9",381954,0,3,0,3,"chr9",1,0.00984528832630099
"12407","chr9.128495000.128500000","chr9.129280000.129285000",785000,9,0.0002370446,128495000,129280000,128500000,129285000,"chr9",381956,2,8,9,19,"chr9",1,0.020042194092827
"12408","chr9.127545000.127550000","chr9.127605000.127610000",60000,66,3.274457e-37,127545000,127605000,127550000,127610000,"chr9",381970,0,8,1,9,"chr9",1,0.069620253164557
"12409","chr9.128405000.128410000","chr9.128605000.128610000",200000,12,0.005431404,128405000,128605000,128410000,128610000,"chr9",381986,6,11,5,22,"chr9",1,0.0309423347398031
"12410","chr9.890000.895000","chr9.1005000.1010000",115000,24,1.882902e-08,890000,1005000,895000,1010000,"chr9",381989,1,4,3,8,"chr9",1,0.0225035161744023
"12411","chr9.95020000.95025000","chr9.95040000.95045000",20000,36,0.002291956,95020000,95040000,95025000,95045000,"chr9",382011,1,4,6,11,"chr9",1,0.0464135021097046
"12412","chr9.15210000.15215000","chr9.15600000.15605000",390000,13,1.608696e-05,15210000,15600000,15215000,15605000,"chr9",382020,0,3,0,3,"chr9",1,0.00457102672292546
"12413","chr9.18255000.18260000","chr9.19025000.19030000",770000,28,7.229207e-27,18255000,19025000,18260000,19030000,"chr9",382039,1,3,1,5,"chr9",1,0.0164088138771683
"12414","chr9.34435000.34440000","chr9.34600000.34605000",165000,15,0.0004584578,34435000,34600000,34440000,34605000,"chr9",382048,0,4,3,7,"chr9",1,0.0123066104078762
"12415","chr9.134830000.134835000","chr9.135070000.135075000",240000,13,0.0004664256,134830000,135070000,134835000,135075000,"chr9",382063,1,3,5,9,"chr9",1,0.0137130801687764
"12416","chr9.27275000.27280000","chr9.27530000.27535000",255000,20,1.405893e-09,27275000,27530000,27280000,27535000,"chr9",382065,1,4,3,8,"chr9",1,0.0187529301453352
"12417","chr9.129995000.130000000","chr9.130040000.130045000",45000,33,1.278909e-07,129995000,130040000,1.3e+08,130045000,"chr9",382210,5,11,4,20,"chr9",1,0.0773558368495077
"12418","chr9.125240000.125245000","chr9.125260000.125265000",20000,38,0.0005620438,125240000,125260000,125245000,125265000,"chr9",382216,3,10,9,22,"chr9",1,0.0979840600093765
"12419","chr9.128320000.128325000","chr9.128410000.128415000",90000,19,0.0002887054,128320000,128410000,128325000,128415000,"chr9",382236,3,19,13,35,"chr9",1,0.0779418659165495
"12420","chr9.130690000.130695000","chr9.130830000.130835000",140000,21,2.833524e-07,130690000,130830000,130695000,130835000,"chr9",382276,1,2,6,9,"chr9",1,0.0221518987341772
"12421","chr9.134040000.134045000","chr9.134205000.134210000",165000,18,6.401932e-06,134040000,134205000,134045000,134210000,"chr9",382283,0,2,2,4,"chr9",1,0.00843881856540084
"12422","chr9.113400000.113405000","chr9.114055000.114060000",655000,51,4.535401e-60,113400000,114055000,113405000,114060000,"chr9",382298,2,0,0,2,"chr9",1,0.0119549929676512
"12423","chr9.675000.680000","chr9.735000.740000",60000,21,0.001685516,675000,735000,680000,740000,"chr9",382306,1,4,3,8,"chr9",1,0.019690576652602
"12424","chr9.35665000.35670000","chr9.35715000.35720000",50000,23,0.001642557,35665000,35715000,35670000,35720000,"chr9",382338,3,3,4,10,"chr9",1,0.0269573370839194
"12425","chr9.93105000.93110000","chr9.93160000.93165000",55000,21,0.003975955,93105000,93160000,93110000,93165000,"chr9",382346,0,10,9,19,"chr9",1,0.0467651195499297
"12426","chr9.131665000.131670000","chr9.131710000.131715000",45000,33,1.278909e-07,131665000,131710000,131670000,131715000,"chr9",382349,1,4,1,6,"chr9",1,0.0232067510548523
"12427","chr9.4665000.4670000","chr9.4750000.4755000",85000,17,0.003975955,4665000,4750000,4670000,4755000,"chr9",382380,0,1,3,4,"chr9",1,0.00796999531176746
"12428","chr9.108725000.108730000","chr9.109085000.109090000",360000,12,0.0001516586,108725000,109085000,108730000,109090000,"chr9",382420,1,0,1,2,"chr9",1,0.00281293952180028
"12429","chr9.35670000.35675000","chr9.35755000.35760000",85000,19,0.0004840376,35670000,35755000,35675000,35760000,"chr9",382437,3,1,0,4,"chr9",1,0.00890764181903422
"12430","chr9.27370000.27375000","chr9.27570000.27575000",200000,13,0.001629879,27370000,27570000,27375000,27575000,"chr9",382496,0,1,1,2,"chr9",1,0.00304735114861697
"12431","chr9.77430000.77435000","chr9.77560000.77565000",130000,14,0.005976839,77430000,77560000,77435000,77565000,"chr9",382555,1,1,3,5,"chr9",1,0.00820440693858415
"12432","chr9.4025000.4030000","chr9.4045000.4050000",20000,36,0.002291956,4025000,4045000,4030000,4050000,"chr9",382564,0,3,1,4,"chr9",1,0.0168776371308017
"12433","chr9.129100000.129105000","chr9.129140000.129145000",40000,43,2.212527e-12,129100000,129140000,129105000,129145000,"chr9",382572,0,1,2,3,"chr9",1,0.0151195499296765
"12434","chr9.129110000.129115000","chr9.129250000.129255000",140000,17,0.0001037481,129110000,129250000,129115000,129255000,"chr9",382575,2,11,8,21,"chr9",1,0.0418424753867792
"12435","chr9.130070000.130075000","chr9.130185000.130190000",115000,15,0.004057358,130070000,130185000,130075000,130190000,"chr9",382592,0,11,7,18,"chr9",1,0.0316455696202532
"12436","chr9.37480000.37485000","chr9.37900000.37905000",420000,10,0.001535608,37480000,37900000,37485000,37905000,"chr9",382632,6,9,6,21,"chr9",1,0.0246132208157525
"12437","chr9.38010000.38015000","chr9.38085000.38090000",75000,21,0.0001662046,38010000,38085000,38015000,38090000,"chr9",382660,2,0,0,2,"chr9",1,0.00492264416315049
"12438","chr9.385000.390000","chr9.745000.750000",360000,12,0.0001516586,385000,745000,390000,750000,"chr9",382666,0,6,2,8,"chr9",1,0.0112517580872011
"12439","chr9.128285000.128290000","chr9.129110000.129115000",825000,7,0.006442891,128285000,129110000,128290000,129115000,"chr9",382715,2,11,8,21,"chr9",1,0.0172292545710267
"12440","chr9.705000.710000","chr9.725000.730000",20000,39,0.0002661542,705000,725000,710000,730000,"chr9",382724,0,15,3,18,"chr9",1,0.0822784810126582
"12441","chr9.610000.615000","chr9.725000.730000",115000,20,8.152305e-06,610000,725000,615000,730000,"chr9",382740,1,2,4,7,"chr9",1,0.0164088138771683
"12442","chr9.129980000.129985000","chr9.130050000.130055000",70000,23,3.399273e-05,129980000,130050000,129985000,130055000,"chr9",382806,3,10,11,24,"chr9",1,0.0646976090014065
"12443","chr9.36405000.36410000","chr9.36570000.36575000",165000,19,1.346592e-06,36405000,36570000,36410000,36575000,"chr9",382840,1,10,7,18,"chr9",1,0.040084388185654
"12444","chr9.27335000.27340000","chr9.27480000.27485000",145000,13,0.009990165,27335000,27480000,27340000,27485000,"chr9",382893,0,1,4,5,"chr9",1,0.00761837787154243
"12445","chr9.37995000.38000000","chr9.38020000.38025000",25000,45,1.416788e-07,37995000,38020000,3.8e+07,38025000,"chr9",382908,0,2,1,3,"chr9",1,0.0158227848101266
"12446","chr9.21250000.21255000","chr9.21330000.21335000",80000,17,0.006071643,21250000,21330000,21255000,21335000,"chr9",382932,1,2,2,5,"chr9",1,0.00996249413970933
"12447","chr9.5885000.5890000","chr9.6025000.6030000",140000,19,6.164147e-06,5885000,6025000,5890000,6030000,"chr9",382938,2,10,5,17,"chr9",1,0.0378574777308955
"12448","chr9.127790000.127795000","chr9.128370000.128375000",580000,8,0.006505528,127790000,128370000,127795000,128375000,"chr9",382956,1,4,1,6,"chr9",1,0.00562587904360056
"12449","chr9.2240000.2245000","chr9.2635000.2640000",395000,20,6.708269e-12,2240000,2635000,2245000,2640000,"chr9",382957,0,0,2,2,"chr9",1,0.0046882325363338
"12450","chr9.121470000.121475000","chr9.121500000.121505000",30000,32,0.0004704961,121470000,121500000,121475000,121505000,"chr9",382986,4,10,5,19,"chr9",1,0.0712611345522738
"12451","chr9.610000.615000","chr9.675000.680000",65000,22,0.0002550679,610000,675000,615000,680000,"chr9",383029,1,2,3,6,"chr9",1,0.0154711673699015
"12452","chr9.33080000.33085000","chr9.33225000.33230000",145000,53,2.203932e-38,33080000,33225000,33085000,33230000,"chr9",383039,3,7,2,12,"chr9",1,0.0745428973277075
"12453","chr9.119000000.119005000","chr9.119020000.119025000",20000,42,2.413554e-05,1.19e+08,119020000,119005000,119025000,"chr9",383060,1,0,2,3,"chr9",1,0.0147679324894515
"12454","chr9.6585000.6590000","chr9.6665000.6670000",80000,28,6.058709e-09,6585000,6665000,6590000,6670000,"chr9",383142,5,6,4,15,"chr9",1,0.0492264416315049
"12455","chr9.13570000.13575000","chr9.14430000.14435000",860000,13,1.505567e-08,13570000,14430000,13575000,14435000,"chr9",383162,0,2,0,2,"chr9",1,0.00304735114861697
"12456","chr9.113660000.113665000","chr9.114035000.114040000",375000,11,0.0005901662,113660000,114035000,113665000,114040000,"chr9",383163,0,3,1,4,"chr9",1,0.00515705578996718
"12457","chr9.128315000.128320000","chr9.128495000.128500000",180000,15,0.0002401557,128315000,128495000,128320000,128500000,"chr9",383174,4,8,9,21,"chr9",1,0.0369198312236287
"12458","chr9.113340000.113345000","chr9.114055000.114060000",715000,10,6.219144e-05,113340000,114055000,113345000,114060000,"chr9",383235,2,0,0,2,"chr9",1,0.0023441162681669
"12459","chr9.37465000.37470000","chr9.37590000.37595000",125000,23,3.672404e-08,37465000,37590000,37470000,37595000,"chr9",383238,2,17,16,35,"chr9",1,0.0943506797937178
"12460","chr9.97590000.97595000","chr9.97630000.97635000",40000,37,7.770343e-09,97590000,97630000,97595000,97635000,"chr9",383289,0,2,5,7,"chr9",1,0.0303563056727614
"12461","chr9.625000.630000","chr9.690000.695000",65000,19,0.004889805,625000,690000,630000,695000,"chr9",383293,0,4,0,4,"chr9",1,0.00890764181903422
"12462","chr9.114395000.114400000","chr9.114425000.114430000",30000,32,0.0004704961,114395000,114425000,114400000,114430000,"chr9",383355,1,4,3,8,"chr9",1,0.0300046882325363
"12463","chr9.4740000.4745000","chr9.5590000.5595000",850000,9,0.0001393997,4740000,5590000,4745000,5595000,"chr9",383359,0,6,8,14,"chr9",1,0.0147679324894515
"12464","chr9.13120000.13125000","chr9.13275000.13280000",155000,17,4.75328e-05,13120000,13275000,13125000,13280000,"chr9",383367,0,2,1,3,"chr9",1,0.0059774964838256
"12465","chr9.115150000.115155000","chr9.115540000.115545000",390000,11,0.0004809476,115150000,115540000,115155000,115545000,"chr9",383378,1,1,1,3,"chr9",1,0.00386779184247539
"12466","chr9.113360000.113365000","chr9.113575000.113580000",215000,12,0.003635256,113360000,113575000,113365000,113580000,"chr9",383399,0,5,4,9,"chr9",1,0.0126582278481013
"12467","chr9.131610000.131615000","chr9.131800000.131805000",190000,15,0.00015929,131610000,131800000,131615000,131805000,"chr9",383415,1,1,1,3,"chr9",1,0.00527426160337553
"12468","chr9.129980000.129985000","chr9.130040000.130045000",60000,20,0.004166415,129980000,130040000,129985000,130045000,"chr9",383508,3,10,4,17,"chr9",1,0.0398499765588373
"12469","chr9.35160000.35165000","chr9.35490000.35495000",330000,18,4.080429e-09,35160000,35490000,35165000,35495000,"chr9",383526,0,9,2,11,"chr9",1,0.0232067510548523
"12470","chr9.128780000.128785000","chr9.128850000.128855000",70000,18,0.006523488,128780000,128850000,128785000,128855000,"chr9",383567,1,6,0,7,"chr9",1,0.0147679324894515
"12471","chr9.127695000.127700000","chr9.127935000.127940000",240000,12,0.00183715,127695000,127935000,127700000,127940000,"chr9",383590,5,9,5,19,"chr9",1,0.0267229254571027
"12472","chr9.35160000.35165000","chr9.35525000.35530000",365000,11,0.0006825907,35160000,35525000,35165000,35530000,"chr9",383597,0,9,2,11,"chr9",1,0.0141819034224098
"12473","chr9.121325000.121330000","chr9.122085000.122090000",760000,7,0.009260505,121325000,122085000,121330000,122090000,"chr9",383609,0,3,0,3,"chr9",1,0.00246132208157525
"12474","chr9.94715000.94720000","chr9.94740000.94745000",25000,35,0.0009812015,94715000,94740000,94720000,94745000,"chr9",383636,1,5,7,13,"chr9",1,0.053328645100797
"12475","chr9.126890000.126895000","chr9.127055000.127060000",165000,26,5.122928e-12,126890000,127055000,126895000,127060000,"chr9",383657,4,9,16,29,"chr9",1,0.0883731833098922
"12476","chr9.32550000.32555000","chr9.33025000.33030000",475000,12,2.471759e-05,32550000,33025000,32555000,33030000,"chr9",383663,0,0,3,3,"chr9",1,0.00421940928270042
"12477","chr9.92270000.92275000","chr9.92765000.92770000",495000,10,0.0006229368,92270000,92765000,92275000,92770000,"chr9",383671,0,4,3,7,"chr9",1,0.00820440693858415
"12478","chr9.124400000.124405000","chr9.124850000.124855000",450000,9,0.004756049,124400000,124850000,124405000,124855000,"chr9",383716,1,7,8,16,"chr9",1,0.0168776371308017
"12479","chr9.12720000.12725000","chr9.12775000.12780000",55000,25,8.142348e-05,12720000,12775000,12725000,12780000,"chr9",383760,0,0,3,3,"chr9",1,0.00879043600562588
"12480","chr9.129835000.129840000","chr9.129880000.129885000",45000,22,0.00922735,129835000,129880000,129840000,129885000,"chr9",383772,0,2,0,2,"chr9",1,0.00515705578996718
"12481","chr9.36450000.36455000","chr9.36565000.36570000",115000,20,8.152305e-06,36450000,36565000,36455000,36570000,"chr9",383776,9,36,29,74,"chr9",1,0.173464603844351
"12482","chr9.32525000.32530000","chr9.32550000.32555000",25000,42,2.672708e-06,32525000,32550000,32530000,32555000,"chr9",383800,0,0,3,3,"chr9",1,0.0147679324894515
"12483","chr9.120265000.120270000","chr9.120285000.120290000",20000,47,2.496136e-07,120265000,120285000,120270000,120290000,"chr9",383820,0,1,1,2,"chr9",1,0.0110173464603844
"12484","chr9.27330000.27335000","chr9.27465000.27470000",135000,19,8.375916e-06,27330000,27465000,27335000,27470000,"chr9",383845,1,2,3,6,"chr9",1,0.0133614627285513
"12485","chr9.121610000.121615000","chr9.121635000.121640000",25000,33,0.003975955,121610000,121635000,121615000,121640000,"chr9",383863,0,2,0,2,"chr9",1,0.00773558368495077
"12486","chr9.33850000.33855000","chr9.34175000.34180000",325000,10,0.005011886,33850000,34175000,33855000,34180000,"chr9",383896,9,23,19,51,"chr9",1,0.059774964838256
"12487","chr9.126305000.126310000","chr9.126455000.126460000",150000,13,0.008528833,126305000,126455000,126310000,126460000,"chr9",383912,3,6,8,17,"chr9",1,0.0259024847632443
"12488","chr9.131420000.131425000","chr9.131740000.131745000",320000,10,0.005394398,131420000,131740000,131425000,131745000,"chr9",383928,2,15,11,28,"chr9",1,0.0328176277543366
"12489","chr9.8550000.8555000","chr9.8875000.8880000",325000,13,5.510568e-05,8550000,8875000,8555000,8880000,"chr9",383931,0,1,1,2,"chr9",1,0.00304735114861697
"12490","chr9.680000.685000","chr9.735000.740000",55000,20,0.009171875,680000,735000,685000,740000,"chr9",383963,2,4,7,13,"chr9",1,0.0304735114861697
"12491","chr9.118960000.118965000","chr9.118990000.118995000",30000,28,0.009189652,118960000,118990000,118965000,118995000,"chr9",383988,2,9,6,17,"chr9",1,0.0557899671823722
"12492","chr9.131125000.131130000","chr9.131210000.131215000",85000,19,0.0004840376,131125000,131210000,131130000,131215000,"chr9",384019,0,10,2,12,"chr9",1,0.0267229254571027
"12493","chr9.19490000.19495000","chr9.19640000.19645000",150000,15,0.0008539421,19490000,19640000,19495000,19645000,"chr9",384067,2,14,7,23,"chr9",1,0.040436005625879
"12494","chr9.113400000.113405000","chr9.113645000.113650000",245000,13,0.0004034797,113400000,113645000,113405000,113650000,"chr9",384075,2,0,2,4,"chr9",1,0.00609470229723394
"12495","chr9.85815000.85820000","chr9.86185000.86190000",370000,13,2.359394e-05,85815000,86185000,85820000,86190000,"chr9",384097,0,3,5,8,"chr9",1,0.0121894045944679
"12496","chr9.27380000.27385000","chr9.27460000.27465000",80000,25,4.770026e-07,27380000,27460000,27385000,27465000,"chr9",384102,1,1,0,2,"chr9",1,0.00586029067041725
"12497","chr9.35115000.35120000","chr9.35725000.35730000",610000,10,0.0001774376,35115000,35725000,35120000,35730000,"chr9",384109,0,0,3,3,"chr9",1,0.00351617440225035
"12498","chr9.27425000.27430000","chr9.27480000.27485000",55000,21,0.003975955,27425000,27480000,27430000,27485000,"chr9",384124,0,3,2,5,"chr9",1,0.0123066104078762
"12499","chr9.131610000.131615000","chr9.131700000.131705000",90000,16,0.007001976,131610000,131700000,131615000,131705000,"chr9",384167,1,1,1,3,"chr9",1,0.00562587904360056
"12500","chr9.2240000.2245000","chr9.2840000.2845000",600000,11,2.965253e-05,2240000,2840000,2245000,2845000,"chr9",384172,0,3,2,5,"chr9",1,0.00644631973745898
"12501","chr9.36420000.36425000","chr9.36450000.36455000",30000,42,2.537606e-08,36420000,36450000,36425000,36455000,"chr9",384188,5,8,8,21,"chr9",1,0.10337552742616
"12502","chr9.87390000.87395000","chr9.87600000.87605000",210000,13,0.00115245,87390000,87600000,87395000,87605000,"chr9",384193,0,4,4,8,"chr9",1,0.0121894045944679
"12503","chr9.128320000.128325000","chr9.128415000.128420000",95000,18,0.0005708821,128320000,128415000,128325000,128420000,"chr9",384238,5,25,17,47,"chr9",1,0.0991561181434599
"12504","chr9.127185000.127190000","chr9.127280000.127285000",95000,17,0.001732132,127185000,127280000,127190000,127285000,"chr9",384260,4,11,5,20,"chr9",1,0.0398499765588373
"12505","chr9.97535000.97540000","chr9.97875000.97880000",340000,16,1.68544e-07,97535000,97875000,97540000,97880000,"chr9",384266,1,3,5,9,"chr9",1,0.0168776371308017
"12506","chr9.133740000.133745000","chr9.133915000.133920000",175000,13,0.003720896,133740000,133915000,133745000,133920000,"chr9",384277,0,1,2,3,"chr9",1,0.00457102672292546
"12507","chr9.131525000.131530000","chr9.131710000.131715000",185000,12,0.008521915,131525000,131710000,131530000,131715000,"chr9",384314,7,10,6,23,"chr9",1,0.0323488045007032
"12508","chr9.6585000.6590000","chr9.6640000.6645000",55000,21,0.003975955,6585000,6640000,6590000,6645000,"chr9",384331,1,6,4,11,"chr9",1,0.0270745428973277
"12509","chr9.35095000.35100000","chr9.35475000.35480000",380000,14,3.10113e-06,35095000,35475000,35100000,35480000,"chr9",384333,2,13,5,20,"chr9",1,0.0328176277543366
"12510","chr9.35645000.35650000","chr9.35745000.35750000",100000,27,9.294739e-10,35645000,35745000,35650000,35750000,"chr9",384368,0,4,4,8,"chr9",1,0.0253164556962025
"12511","chr9.35070000.35075000","chr9.35160000.35165000",90000,16,0.007001976,35070000,35160000,35075000,35165000,"chr9",384382,0,2,2,4,"chr9",1,0.00750117205813408
"12512","chr9.130040000.130045000","chr9.130185000.130190000",145000,23,7.216468e-09,130040000,130185000,130045000,130190000,"chr9",384389,0,11,4,15,"chr9",1,0.040436005625879
"12513","chr9.35160000.35165000","chr9.35320000.35325000",160000,13,0.006049966,35160000,35320000,35165000,35325000,"chr9",384404,0,3,2,5,"chr9",1,0.00761837787154243
"12514","chr9.97675000.97680000","chr9.97710000.97715000",35000,32,3.094058e-05,97675000,97710000,97680000,97715000,"chr9",384405,2,4,3,9,"chr9",1,0.0337552742616034
"12515","chr9.21330000.21335000","chr9.21395000.21400000",65000,23,8.55857e-05,21330000,21395000,21335000,21400000,"chr9",384423,1,2,2,5,"chr9",1,0.0134786685419597
"12516","chr9.131175000.131180000","chr9.131420000.131425000",245000,12,0.001629879,131175000,131420000,131180000,131425000,"chr9",384431,2,4,4,10,"chr9",1,0.0140646976090014
"12517","chr9.124940000.124945000","chr9.125045000.125050000",105000,15,0.00697384,124940000,125045000,124945000,125050000,"chr9",384482,4,19,16,39,"chr9",1,0.0685654008438819
"12518","chr9.20355000.20360000","chr9.20930000.20935000",575000,11,3.989491e-05,20355000,20930000,20360000,20935000,"chr9",384499,1,1,0,2,"chr9",1,0.00257852789498359
"12519","chr9.8540000.8545000","chr9.8775000.8780000",235000,11,0.007342334,8540000,8775000,8545000,8780000,"chr9",384526,5,4,5,14,"chr9",1,0.0180496952648851
"12520","chr9.27460000.27465000","chr9.27530000.27535000",70000,23,3.399273e-05,27460000,27530000,27465000,27535000,"chr9",384571,1,1,0,2,"chr9",1,0.00539146741678387
"12521","chr9.36405000.36410000","chr9.36460000.36465000",55000,26,2.684029e-05,36405000,36460000,36410000,36465000,"chr9",384583,1,8,7,16,"chr9",1,0.0487576183778715
"12522","chr9.97535000.97540000","chr9.97630000.97635000",95000,19,0.0001787899,97535000,97630000,97540000,97635000,"chr9",384626,1,3,5,9,"chr9",1,0.020042194092827
"12523","chr9.27495000.27500000","chr9.27530000.27535000",35000,36,4.646999e-07,27495000,27530000,27500000,27535000,"chr9",384661,1,1,1,3,"chr9",1,0.0126582278481013
"12524","chr9.8540000.8545000","chr9.8845000.8850000",305000,10,0.006775515,8540000,8845000,8545000,8850000,"chr9",384675,5,7,4,16,"chr9",1,0.0187529301453352
"12525","chr9.129580000.129585000","chr9.129620000.129625000",40000,25,0.002563108,129580000,129620000,129585000,129625000,"chr9",384715,1,3,2,6,"chr9",1,0.0175808720112518
"12526","chr9.124040000.124045000","chr9.124130000.124135000",90000,36,6.562108e-16,124040000,124130000,124045000,124135000,"chr9",384727,4,9,5,18,"chr9",1,0.0759493670886076
"12527","chr9.131530000.131535000","chr9.131710000.131715000",180000,13,0.003121495,131530000,131710000,131535000,131715000,"chr9",384768,3,25,20,48,"chr9",1,0.0731364275668073
"12528","chr9.132025000.132030000","chr9.132135000.132140000",110000,15,0.005223942,132025000,132135000,132030000,132140000,"chr9",384792,0,3,1,4,"chr9",1,0.0070323488045007
"12529","chr9.32375000.32380000","chr9.32525000.32530000",150000,31,9.648393e-16,32375000,32525000,32380000,32530000,"chr9",384846,10,13,8,31,"chr9",1,0.11263478668542
"12530","chr9.35115000.35120000","chr9.35490000.35495000",375000,23,1.020352e-14,35115000,35490000,35120000,35495000,"chr9",384883,0,15,5,20,"chr9",1,0.0539146741678387
"12531","chr9.129565000.129570000","chr9.129620000.129625000",55000,37,1.11568e-11,129565000,129620000,129570000,129625000,"chr9",384888,0,9,14,23,"chr9",1,0.0997421472105016
"12532","chr9.505000.510000","chr9.535000.540000",30000,59,3.574955e-18,505000,535000,510000,540000,"chr9",384908,2,3,6,11,"chr9",1,0.0760665729020159
"12533","chr9.96215000.96220000","chr9.96325000.96330000",110000,51,1.528639e-32,96215000,96325000,96220000,96330000,"chr9",384912,0,2,1,3,"chr9",1,0.0179324894514768
"12534","chr9.127780000.127785000","chr9.127800000.127805000",20000,57,4.881382e-12,127780000,127800000,127785000,127805000,"chr9",385015,0,8,10,18,"chr9",1,0.120253164556962
"12535","chr9.97630000.97635000","chr9.97650000.97655000",20000,37,0.001147067,97630000,97650000,97635000,97655000,"chr9",385030,2,6,2,10,"chr9",1,0.0433661509610877
"12536","chr9.6680000.6685000","chr9.6760000.6765000",80000,18,0.00231679,6680000,6760000,6685000,6765000,"chr9",385038,4,11,15,30,"chr9",1,0.0632911392405063
"12537","chr9.135480000.135485000","chr9.135705000.135710000",225000,12,0.002718392,135480000,135705000,135485000,135710000,"chr9",385045,0,9,8,17,"chr9",1,0.0239099859353024
"12538","chr9.4790000.4795000","chr9.4985000.4990000",195000,15,0.0001278045,4790000,4985000,4795000,4990000,"chr9",385046,0,1,1,2,"chr9",1,0.00351617440225035
"12539","chr9.76905000.76910000","chr9.77440000.77445000",535000,8,0.009262157,76905000,77440000,76910000,77445000,"chr9",385077,1,2,1,4,"chr9",1,0.00375058602906704
"12540","chr9.101980000.101985000","chr9.102580000.102585000",600000,9,0.001115085,101980000,102580000,101985000,102585000,"chr9",385078,1,6,2,9,"chr9",1,0.00949367088607595
"12541","chr9.96775000.96780000","chr9.96990000.96995000",215000,13,0.0009965743,96775000,96990000,96780000,96995000,"chr9",385083,0,4,7,11,"chr9",1,0.0167604313173933
"12542","chr9.27370000.27375000","chr9.27390000.27395000",20000,45,1.667871e-06,27370000,27390000,27375000,27395000,"chr9",385095,0,1,1,2,"chr9",1,0.0105485232067511
"12543","chr9.127685000.127690000","chr9.127935000.127940000",250000,11,0.005191162,127685000,127935000,127690000,127940000,"chr9",385114,5,9,5,19,"chr9",1,0.0244960150023441
"12544","chr9.34895000.34900000","chr9.35550000.35555000",655000,12,1.93735e-06,34895000,35550000,34900000,35555000,"chr9",385156,0,3,1,4,"chr9",1,0.00562587904360056
"12545","chr10.15140000.15145000","chr10.15385000.15390000",245000,11,0.006240607,15140000,15385000,15145000,15390000,"chr10",385177,10,24,30,64,"chr10",1,0.0825128926394749
"12546","chr10.31060000.31065000","chr10.31775000.31780000",715000,9,0.0003839662,31060000,31775000,31065000,31780000,"chr10",385218,0,14,5,19,"chr10",1,0.020042194092827
"12547","chr10.86020000.86025000","chr10.86265000.86270000",245000,11,0.006240607,86020000,86265000,86025000,86270000,"chr10",385275,0,2,0,2,"chr10",1,0.00257852789498359
"12548","chr10.103635000.103640000","chr10.103815000.103820000",180000,18,3.359243e-06,103635000,103815000,103640000,103820000,"chr10",385281,0,2,5,7,"chr10",1,0.0147679324894515
"12549","chr10.12330000.12335000","chr10.13085000.13090000",755000,10,3.810571e-05,12330000,13085000,12335000,13090000,"chr10",385286,2,8,3,13,"chr10",1,0.0152367557430849
"12550","chr10.63215000.63220000","chr10.63520000.63525000",305000,11,0.001838952,63215000,63520000,63220000,63525000,"chr10",385294,1,0,2,3,"chr10",1,0.00386779184247539
"12551","chr10.23010000.23015000","chr10.23045000.23050000",35000,38,1.598437e-07,23010000,23045000,23015000,23050000,"chr10",385304,0,1,0,1,"chr10",1,0.00445382090951711
"12552","chr10.12260000.12265000","chr10.12785000.12790000",525000,9,0.00224033,12260000,12785000,12265000,12790000,"chr10",385306,5,25,27,57,"chr10",1,0.060126582278481
"12553","chr10.95350000.95355000","chr10.95420000.95425000",70000,18,0.009681731,95350000,95420000,95355000,95425000,"chr10",385319,2,3,1,6,"chr10",1,0.0126582278481013
"12554","chr10.97605000.97610000","chr10.97670000.97675000",65000,19,0.007481698,97605000,97670000,97610000,97675000,"chr10",385336,7,16,17,40,"chr10",1,0.0890764181903422
"12555","chr10.75035000.75040000","chr10.75415000.75420000",380000,10,0.002558774,75035000,75415000,75040000,75420000,"chr10",385352,1,3,1,5,"chr10",1,0.00586029067041725
"12556","chr10.32145000.32150000","chr10.32190000.32195000",45000,34,9.5825e-08,32145000,32190000,32150000,32195000,"chr10",385399,1,9,6,16,"chr10",1,0.0637599624941397
"12557","chr10.103565000.103570000","chr10.103815000.103820000",250000,12,0.001511564,103565000,103815000,103570000,103820000,"chr10",385400,5,15,8,28,"chr10",1,0.0393811533052039
"12558","chr10.35540000.35545000","chr10.35610000.35615000",70000,19,0.003959344,35540000,35610000,35545000,35615000,"chr10",385470,1,3,2,6,"chr10",1,0.0133614627285513
"12559","chr10.72325000.72330000","chr10.72625000.72630000",300000,13,9.979348e-05,72325000,72625000,72330000,72630000,"chr10",385520,0,9,5,14,"chr10",1,0.0213314580403188
"12560","chr10.20085000.20090000","chr10.20765000.20770000",680000,11,1.063256e-05,20085000,20765000,20090000,20770000,"chr10",385599,2,0,8,10,"chr10",1,0.012892639474918
"12561","chr10.6050000.6055000","chr10.6125000.6130000",75000,20,0.0007869547,6050000,6125000,6055000,6130000,"chr10",385623,2,11,5,18,"chr10",1,0.0421940928270042
"12562","chr10.35540000.35545000","chr10.35880000.35885000",340000,12,0.0002180887,35540000,35880000,35545000,35885000,"chr10",385793,1,3,3,7,"chr10",1,0.00984528832630099
"12563","chr10.102750000.102755000","chr10.102775000.102780000",25000,38,0.0002635264,102750000,102775000,102755000,102780000,"chr10",385854,3,9,6,18,"chr10",1,0.080168776371308
"12564","chr10.97015000.97020000","chr10.97105000.97110000",90000,16,0.009113207,97015000,97105000,97020000,97110000,"chr10",385867,3,3,3,9,"chr10",1,0.0168776371308017
"12565","chr10.340000.345000","chr10.870000.875000",530000,8,0.009679522,340000,870000,345000,875000,"chr10",385980,0,3,0,3,"chr10",1,0.00281293952180028
"12566","chr10.60020000.60025000","chr10.60145000.60150000",125000,25,1.807022e-09,60020000,60145000,60025000,60150000,"chr10",386030,0,2,1,3,"chr10",1,0.00879043600562588
"12567","chr10.15275000.15280000","chr10.15350000.15355000",75000,20,0.0007869547,15275000,15350000,15280000,15355000,"chr10",386090,4,15,11,30,"chr10",1,0.070323488045007
"12568","chr10.97185000.97190000","chr10.97315000.97320000",130000,14,0.006930734,97185000,97315000,97190000,97320000,"chr10",386124,1,3,1,5,"chr10",1,0.00820440693858415
"12569","chr10.97170000.97175000","chr10.97355000.97360000",185000,14,0.0008425915,97170000,97355000,97175000,97360000,"chr10",386129,0,6,11,17,"chr10",1,0.0278949835911861
"12570","chr10.15275000.15280000","chr10.15385000.15390000",110000,26,1.853062e-09,15275000,15385000,15280000,15390000,"chr10",386283,4,15,11,30,"chr10",1,0.0914205344585091
"12571","chr10.71955000.71960000","chr10.72105000.72110000",150000,23,6.396895e-09,71955000,72105000,71960000,72110000,"chr10",386306,0,1,1,2,"chr10",1,0.00539146741678387
"12572","chr10.71275000.71280000","chr10.71395000.71400000",120000,28,1.628957e-11,71275000,71395000,71280000,71400000,"chr10",386311,0,2,0,2,"chr10",1,0.00656352555086732
"12573","chr10.5855000.5860000","chr10.5895000.5900000",40000,31,2.104846e-05,5855000,5895000,5860000,5900000,"chr10",386389,0,1,0,1,"chr10",1,0.0036333802156587
"12574","chr10.97180000.97185000","chr10.97275000.97280000",95000,19,0.0002424219,97180000,97275000,97185000,97280000,"chr10",386596,3,4,3,10,"chr10",1,0.0222691045475856
"12575","chr10.124880000.124885000","chr10.125285000.125290000",405000,10,0.001879365,124880000,125285000,124885000,125290000,"chr10",386613,0,2,2,4,"chr10",1,0.0046882325363338
"12576","chr10.35405000.35410000","chr10.35515000.35520000",110000,19,6.169143e-05,35405000,35515000,35410000,35520000,"chr10",386859,2,1,0,3,"chr10",1,0.00668073136427567
"12577","chr10.127715000.127720000","chr10.127990000.127995000",275000,11,0.003274878,127715000,127990000,127720000,127995000,"chr10",386899,0,5,3,8,"chr10",1,0.0103141115799344
"12578","chr10.103640000.103645000","chr10.103770000.103775000",130000,20,3.422593e-06,103640000,103770000,103645000,103775000,"chr10",386926,2,2,4,8,"chr10",1,0.0187529301453352
"12579","chr10.25020000.25025000","chr10.25060000.25065000",40000,25,0.004677356,25020000,25060000,25025000,25065000,"chr10",386981,3,1,6,10,"chr10",1,0.0293014533520863
"12580","chr10.95680000.95685000","chr10.96085000.96090000",405000,10,0.001879365,95680000,96085000,95685000,96090000,"chr10",387012,2,3,2,7,"chr10",1,0.00820440693858415
"12581","chr10.104680000.104685000","chr10.104780000.104785000",100000,17,0.001510072,104680000,104780000,104685000,104785000,"chr10",387024,0,2,0,2,"chr10",1,0.00398499765588373
"12582","chr10.24985000.24990000","chr10.25215000.25220000",230000,17,1.37777e-06,24985000,25215000,24990000,25220000,"chr10",387025,0,3,3,6,"chr10",1,0.0119549929676512
"12583","chr10.120945000.120950000","chr10.121485000.121490000",540000,8,0.008891037,120945000,121485000,120950000,121490000,"chr10",387100,0,4,3,7,"chr10",1,0.00656352555086732
"12584","chr10.14525000.14530000","chr10.14875000.14880000",350000,11,0.0008876436,14525000,14875000,14530000,14880000,"chr10",387125,0,2,7,9,"chr10",1,0.0116033755274262
"12585","chr10.68720000.68725000","chr10.69235000.69240000",515000,12,1.322063e-05,68720000,69235000,68725000,69240000,"chr10",387136,3,16,26,45,"chr10",1,0.0632911392405063
"12586","chr10.60775000.60780000","chr10.60930000.60935000",155000,22,2.433592e-08,60775000,60930000,60780000,60935000,"chr10",387149,0,4,0,4,"chr10",1,0.0103141115799344
"12587","chr10.6150000.6155000","chr10.6190000.6195000",40000,64,1.487123e-26,6150000,6190000,6155000,6195000,"chr10",387153,3,12,11,26,"chr10",1,0.195030473511486
"12588","chr10.103995000.104000000","chr10.104205000.104210000",210000,13,0.001266212,103995000,104205000,1.04e+08,104210000,"chr10",387178,0,2,0,2,"chr10",1,0.00304735114861697
"12589","chr10.73600000.73605000","chr10.73645000.73650000",45000,24,0.003089335,73600000,73645000,73605000,73650000,"chr10",387214,0,0,3,3,"chr10",1,0.00843881856540084
"12590","chr10.103995000.104000000","chr10.104120000.104125000",125000,16,0.0009414146,103995000,104120000,1.04e+08,104125000,"chr10",387272,1,2,1,4,"chr10",1,0.00750117205813408
"12591","chr10.14560000.14565000","chr10.15140000.15145000",580000,8,0.006306138,14560000,15140000,14565000,15145000,"chr10",387283,0,2,0,2,"chr10",1,0.00187529301453352
"12592","chr10.121520000.121525000","chr10.121610000.121615000",90000,18,0.001212587,121520000,121610000,121525000,121615000,"chr10",387286,0,3,4,7,"chr10",1,0.0147679324894515
"12593","chr10.7025000.7030000","chr10.7290000.7295000",265000,14,5.231568e-05,7025000,7290000,7030000,7295000,"chr10",387367,1,2,1,4,"chr10",1,0.00656352555086732
"12594","chr10.80340000.80345000","chr10.80405000.80410000",65000,22,0.0004347818,80340000,80405000,80345000,80410000,"chr10",387415,3,4,3,10,"chr10",1,0.0257852789498359
"12595","chr10.71920000.71925000","chr10.71965000.71970000",45000,25,0.001309789,71920000,71965000,71925000,71970000,"chr10",387492,0,4,2,6,"chr10",1,0.0175808720112518
"12596","chr10.101240000.101245000","chr10.101270000.101275000",30000,35,8.893188e-05,101240000,101270000,101245000,101275000,"chr10",387564,1,2,1,4,"chr10",1,0.0164088138771683
"12597","chr10.24905000.24910000","chr10.24950000.24955000",45000,23,0.006896136,24905000,24950000,24910000,24955000,"chr10",387625,1,3,2,6,"chr10",1,0.0161744022503516
"12598","chr10.104240000.104245000","chr10.104345000.104350000",105000,21,6.814435e-06,104240000,104345000,104245000,104350000,"chr10",387642,1,9,8,18,"chr10",1,0.0443037974683544
"12599","chr10.28980000.28985000","chr10.29595000.29600000",615000,11,2.31968e-05,28980000,29595000,28985000,29600000,"chr10",387644,4,9,8,21,"chr10",1,0.0270745428973277
"12600","chr10.73835000.73840000","chr10.73995000.74000000",160000,19,2.237769e-06,73835000,73995000,73840000,7.4e+07,"chr10",387681,1,4,2,7,"chr10",1,0.0155883731833099
"12601","chr10.22925000.22930000","chr10.23010000.23015000",85000,19,0.0006971125,22925000,23010000,22930000,23015000,"chr10",387706,0,1,0,1,"chr10",1,0.00222691045475856
"12602","chr10.102115000.102120000","chr10.102150000.102155000",35000,27,0.004926953,102115000,102150000,102120000,102155000,"chr10",387754,0,4,3,7,"chr10",1,0.0221518987341772
"12603","chr10.59475000.59480000","chr10.59830000.59835000",355000,11,0.000817312,59475000,59830000,59480000,59835000,"chr10",387764,1,1,4,6,"chr10",1,0.00773558368495077
"12604","chr10.12420000.12425000","chr10.12620000.12625000",200000,13,0.001776106,12420000,12620000,12425000,12625000,"chr10",387822,1,5,10,16,"chr10",1,0.0243788091889358
"12605","chr10.15290000.15295000","chr10.15310000.15315000",20000,38,0.001750436,15290000,15310000,15295000,15315000,"chr10",387858,0,3,2,5,"chr10",1,0.0222691045475856
"12606","chr10.99245000.99250000","chr10.99330000.99335000",85000,19,0.0006971125,99245000,99330000,99250000,99335000,"chr10",388039,0,5,3,8,"chr10",1,0.0178152836380684
"12607","chr10.7305000.7310000","chr10.7445000.7450000",140000,36,1.233894e-19,7305000,7445000,7310000,7450000,"chr10",388195,1,3,11,15,"chr10",1,0.0632911392405063
"12608","chr10.25725000.25730000","chr10.25965000.25970000",240000,13,0.000496787,25725000,25965000,25730000,25970000,"chr10",388199,0,0,2,2,"chr10",1,0.00304735114861697
"12609","chr10.73940000.73945000","chr10.73965000.73970000",25000,48,2.924336e-08,73940000,73965000,73945000,73970000,"chr10",388227,1,13,8,22,"chr10",1,0.123769338959212
"12610","chr10.116470000.116475000","chr10.116520000.116525000",50000,22,0.00612931,116470000,116520000,116475000,116525000,"chr10",388473,0,0,2,2,"chr10",1,0.00515705578996718
"12611","chr10.95550000.95555000","chr10.95570000.95575000",20000,47,1.412761e-06,95550000,95570000,95555000,95575000,"chr10",388485,3,7,14,24,"chr10",1,0.132208157524613
"12612","chr10.73835000.73840000","chr10.73855000.73860000",20000,41,0.0002083528,73835000,73855000,73840000,73860000,"chr10",388497,1,2,2,5,"chr10",1,0.0240271917487107
"12613","chr10.102675000.102680000","chr10.102740000.102745000",65000,23,0.0001507044,102675000,102740000,102680000,102745000,"chr10",388580,0,0,2,2,"chr10",1,0.00539146741678387
"12614","chr10.104250000.104255000","chr10.104345000.104350000",95000,24,3.32387e-07,104250000,104345000,104255000,104350000,"chr10",388586,3,2,2,7,"chr10",1,0.019690576652602
"12615","chr10.27100000.27105000","chr10.27150000.27155000",50000,22,0.00612931,27100000,27150000,27105000,27155000,"chr10",388606,5,12,14,31,"chr10",1,0.0799343647444913
"12616","chr10.91040000.91045000","chr10.91135000.91140000",95000,18,0.0007678805,91040000,91135000,91045000,91140000,"chr10",388620,1,1,4,6,"chr10",1,0.0126582278481013
"12617","chr10.31775000.31780000","chr10.31930000.31935000",155000,13,0.008179677,31775000,31930000,31780000,31935000,"chr10",388652,2,17,11,30,"chr10",1,0.0457102672292546
"12618","chr10.124800000.124805000","chr10.124885000.124890000",85000,20,0.0002260435,124800000,124885000,124805000,124890000,"chr10",388700,5,13,17,35,"chr10",1,0.0820440693858415
"12619","chr10.96980000.96985000","chr10.97025000.97030000",45000,28,7.933395e-05,96980000,97025000,96985000,97030000,"chr10",388716,0,1,1,2,"chr10",1,0.00656352555086732
"12620","chr10.14875000.14880000","chr10.15310000.15315000",435000,9,0.005721615,14875000,15310000,14880000,15315000,"chr10",388719,0,2,2,4,"chr10",1,0.00421940928270042
"12621","chr10.103650000.103655000","chr10.103685000.103690000",35000,33,2.98062e-05,103650000,103685000,103655000,103690000,"chr10",388722,2,1,5,8,"chr10",1,0.0309423347398031
"12622","chr10.7260000.7265000","chr10.7445000.7450000",185000,17,1.204641e-05,7260000,7445000,7265000,7450000,"chr10",388762,0,2,2,4,"chr10",1,0.00796999531176746
"12623","chr10.14570000.14575000","chr10.14875000.14880000",305000,14,1.717337e-05,14570000,14875000,14575000,14880000,"chr10",388860,2,2,4,8,"chr10",1,0.0131270511017346
"12624","chr10.74185000.74190000","chr10.74320000.74325000",135000,14,0.00573319,74185000,74320000,74190000,74325000,"chr10",388907,5,1,6,12,"chr10",1,0.019690576652602
"12625","chr10.124090000.124095000","chr10.124135000.124140000",45000,30,9.85819e-06,124090000,124135000,124095000,124140000,"chr10",388995,1,14,7,22,"chr10",1,0.0773558368495077
"12626","chr10.5665000.5670000","chr10.5895000.5900000",230000,12,0.002575301,5665000,5895000,5670000,5900000,"chr10",389034,0,1,0,1,"chr10",1,0.00140646976090014
"12627","chr10.103780000.103785000","chr10.103800000.103805000",20000,43,4.376355e-05,103780000,103800000,103785000,103805000,"chr10",389056,1,3,7,11,"chr10",1,0.0554383497421472
"12628","chr10.13710000.13715000","chr10.13815000.13820000",105000,22,1.66245e-06,13710000,13815000,13715000,13820000,"chr10",389057,1,10,9,20,"chr10",1,0.0515705578996718
"12629","chr10.102110000.102115000","chr10.102130000.102135000",20000,98,1.029893e-36,102110000,102130000,102115000,102135000,"chr10",389080,1,0,0,1,"chr10",1,0.0114861697140178
"12630","chr10.100285000.100290000","chr10.101005000.101010000",720000,8,0.002184611,100285000,101005000,100290000,101010000,"chr10",389200,3,6,2,11,"chr10",1,0.0103141115799344
"12631","chr10.80205000.80210000","chr10.80340000.80345000",135000,14,0.00573319,80205000,80340000,80210000,80345000,"chr10",389349,6,21,13,40,"chr10",1,0.0656352555086732
"12632","chr10.125760000.125765000","chr10.126070000.126075000",310000,29,7.258937e-20,125760000,126070000,125765000,126075000,"chr10",389366,0,1,3,4,"chr10",1,0.013595874355368
"12633","chr10.24950000.24955000","chr10.25215000.25220000",265000,15,1.020978e-05,24950000,25215000,24955000,25220000,"chr10",389374,0,3,2,5,"chr10",1,0.00879043600562588
"12634","chr10.13710000.13715000","chr10.14215000.14220000",505000,11,9.632898e-05,13710000,14215000,13715000,14220000,"chr10",389410,1,15,7,23,"chr10",1,0.0296530707923113
"12635","chr10.6125000.6130000","chr10.6325000.6330000",200000,12,0.00605453,6125000,6325000,6130000,6330000,"chr10",389487,2,11,5,18,"chr10",1,0.0253164556962025
"12636","chr10.93915000.93920000","chr10.94075000.94080000",160000,16,0.0001738592,93915000,94075000,93920000,94080000,"chr10",389509,0,2,3,5,"chr10",1,0.00937646507266761
"12637","chr10.102065000.102070000","chr10.102115000.102120000",50000,23,0.002650227,102065000,102115000,102070000,102120000,"chr10",389510,0,4,0,4,"chr10",1,0.0107829348335677
"12638","chr10.95180000.95185000","chr10.95235000.95240000",55000,22,0.002536929,95180000,95235000,95185000,95240000,"chr10",389555,2,9,6,17,"chr10",1,0.0438349742147211
"12639","chr10.124655000.124660000","chr10.124915000.124920000",260000,11,0.004527275,124655000,124915000,124660000,124920000,"chr10",389565,0,2,2,4,"chr10",1,0.00515705578996718
"12640","chr10.86065000.86070000","chr10.86255000.86260000",190000,13,0.002476911,86065000,86255000,86070000,86260000,"chr10",389616,0,0,3,3,"chr10",1,0.00457102672292546
"12641","chr10.15250000.15255000","chr10.15290000.15295000",40000,26,0.002127745,15250000,15290000,15255000,15295000,"chr10",389674,2,6,2,10,"chr10",1,0.0304735114861697
"12642","chr10.104290000.104295000","chr10.104345000.104350000",55000,22,0.002536929,104290000,104345000,104295000,104350000,"chr10",389790,4,11,22,37,"chr10",1,0.0954055321143929
"12643","chr10.78970000.78975000","chr10.79400000.79405000",430000,13,8.0954e-06,78970000,79400000,78975000,79405000,"chr10",389820,1,0,3,4,"chr10",1,0.00609470229723394
"12644","chr10.13915000.13920000","chr10.13955000.13960000",40000,34,8.438987e-07,13915000,13955000,13920000,13960000,"chr10",389830,0,11,4,15,"chr10",1,0.059774964838256
"12645","chr10.5840000.5845000","chr10.6050000.6055000",210000,12,0.004560495,5840000,6050000,5845000,6055000,"chr10",389859,3,11,9,23,"chr10",1,0.0323488045007032
"12646","chr10.24865000.24870000","chr10.25215000.25220000",350000,10,0.003759125,24865000,25215000,24870000,25220000,"chr10",389866,0,3,3,6,"chr10",1,0.0070323488045007
"12647","chr10.91010000.91015000","chr10.91135000.91140000",125000,19,2.01441e-05,91010000,91135000,91015000,91140000,"chr10",389903,1,3,1,5,"chr10",1,0.0111345522737928
"12648","chr10.91015000.91020000","chr10.91130000.91135000",115000,58,2.529708e-40,91015000,91130000,91020000,91135000,"chr10",389955,2,1,1,4,"chr10",1,0.0271917487107361
"12649","chr10.121485000.121490000","chr10.121610000.121615000",125000,19,2.01441e-05,121485000,121610000,121490000,121615000,"chr10",390028,0,6,3,9,"chr10",1,0.020042194092827
"12650","chr10.125765000.125770000","chr10.126070000.126075000",305000,16,4.847998e-07,125765000,126070000,125770000,126075000,"chr10",390060,0,1,3,4,"chr10",1,0.00750117205813408
"12651","chr10.15275000.15280000","chr10.15425000.15430000",150000,15,0.0009902157,15275000,15425000,15280000,15430000,"chr10",390117,1,2,7,10,"chr10",1,0.0175808720112518
"12652","chr10.103635000.103640000","chr10.103770000.103775000",135000,30,6.390258e-14,103635000,103770000,103640000,103775000,"chr10",390157,0,2,5,7,"chr10",1,0.0246132208157525
"12653","chr10.6150000.6155000","chr10.6245000.6250000",95000,23,1.382373e-06,6150000,6245000,6155000,6250000,"chr10",390167,1,13,5,19,"chr10",1,0.0512189404594468
"12654","chr10.104275000.104280000","chr10.104345000.104350000",70000,30,6.531923e-09,104275000,104345000,104280000,104350000,"chr10",390187,4,9,12,25,"chr10",1,0.0879043600562588
"12655","chr10.126745000.126750000","chr10.126835000.126840000",90000,19,0.000410849,126745000,126835000,126750000,126840000,"chr10",390236,0,3,1,4,"chr10",1,0.00890764181903422
"12656","chr10.340000.345000","chr10.495000.500000",155000,13,0.008179677,340000,495000,345000,5e+05,"chr10",390246,2,2,9,13,"chr10",1,0.0198077824660103
"12657","chr10.22550000.22555000","chr10.22600000.22605000",50000,26,0.0001624034,22550000,22600000,22555000,22605000,"chr10",390284,3,0,2,5,"chr10",1,0.0152367557430849
"12658","chr10.72045000.72050000","chr10.72105000.72110000",60000,24,0.000138104,72045000,72105000,72050000,72110000,"chr10",390324,2,1,2,5,"chr10",1,0.0140646976090014
"12659","chr10.30725000.30730000","chr10.30780000.30785000",55000,25,0.0001424457,30725000,30780000,30730000,30785000,"chr10",390377,5,6,8,19,"chr10",1,0.0556727613689639
"12660","chr10.60030000.60035000","chr10.60145000.60150000",115000,19,4.200104e-05,60030000,60145000,60035000,60150000,"chr10",390394,0,6,2,8,"chr10",1,0.0178152836380684
"12661","chr10.13060000.13065000","chr10.13085000.13090000",25000,34,0.004565405,13060000,13085000,13065000,13090000,"chr10",390433,2,8,3,13,"chr10",1,0.0518049695264885
"12662","chr10.93890000.93895000","chr10.93915000.93920000",25000,38,0.0002635264,93890000,93915000,93895000,93920000,"chr10",390483,0,2,3,5,"chr10",1,0.0222691045475856
"12663","chr10.74320000.74325000","chr10.74585000.74590000",265000,14,5.231568e-05,74320000,74585000,74325000,74590000,"chr10",390617,0,1,3,4,"chr10",1,0.00656352555086732
"12664","chr10.104290000.104295000","chr10.104335000.104340000",45000,25,0.001309789,104290000,104335000,104295000,104340000,"chr10",390706,7,10,6,23,"chr10",1,0.0673933427097984
"12665","chr10.72305000.72310000","chr10.72455000.72460000",150000,14,0.003222971,72305000,72455000,72310000,72460000,"chr10",390726,4,12,12,28,"chr10",1,0.0459446788560713
"12666","chr10.74165000.74170000","chr10.74320000.74325000",155000,13,0.008179677,74165000,74320000,74170000,74325000,"chr10",390747,5,1,6,12,"chr10",1,0.0182841068917018
"12667","chr10.5775000.5780000","chr10.5840000.5845000",65000,23,0.0001507044,5775000,5840000,5780000,5845000,"chr10",390772,5,11,13,29,"chr10",1,0.0781762775433661
"12668","chr10.103960000.103965000","chr10.104075000.104080000",115000,15,0.00484355,103960000,104075000,103965000,104080000,"chr10",390775,0,2,0,2,"chr10",1,0.00351617440225035
"12669","chr10.100185000.100190000","chr10.101005000.101010000",820000,8,0.001066551,100185000,101005000,100190000,101010000,"chr10",390794,3,6,2,11,"chr10",1,0.0103141115799344
"12670","chr10.121540000.121545000","chr10.121610000.121615000",70000,18,0.009681731,121540000,121610000,121545000,121615000,"chr10",390795,0,5,2,7,"chr10",1,0.0147679324894515
"12671","chr10.75015000.75020000","chr10.75475000.75480000",460000,10,0.00094762,75015000,75475000,75020000,75480000,"chr10",390816,0,4,1,5,"chr10",1,0.00586029067041725
"12672","chr10.127615000.127620000","chr10.127990000.127995000",375000,11,0.0006033208,127615000,127990000,127620000,127995000,"chr10",390835,0,5,3,8,"chr10",1,0.0103141115799344
"12673","chr10.105660000.105665000","chr10.105690000.105695000",30000,33,0.0004723945,105660000,105690000,105665000,105695000,"chr10",390839,0,1,1,2,"chr10",1,0.00773558368495077
"12674","chr10.34405000.34410000","chr10.34915000.34920000",510000,9,0.00260178,34405000,34915000,34410000,34920000,"chr10",390851,6,11,9,26,"chr10",1,0.0274261603375527
"12675","chr10.31015000.31020000","chr10.31770000.31775000",755000,9,0.0002709695,31015000,31770000,31020000,31775000,"chr10",390866,3,5,5,13,"chr10",1,0.0137130801687764
"12676","chr10.80065000.80070000","chr10.80605000.80610000",540000,9,0.001932354,80065000,80605000,80070000,80610000,"chr10",390932,0,14,17,31,"chr10",1,0.0327004219409283
"12677","chr10.103190000.103195000","chr10.103490000.103495000",300000,11,0.002025695,103190000,103490000,103195000,103495000,"chr10",390947,2,9,13,24,"chr10",1,0.0309423347398031
"12678","chr10.25065000.25070000","chr10.25290000.25295000",225000,14,0.0001943461,25065000,25290000,25070000,25295000,"chr10",390961,0,3,5,8,"chr10",1,0.0131270511017346
"12679","chr10.15290000.15295000","chr10.15425000.15430000",135000,16,0.0005644524,15290000,15425000,15295000,15430000,"chr10",390970,1,2,5,8,"chr10",1,0.0150023441162682
"12680","chr10.102675000.102680000","chr10.102775000.102780000",100000,16,0.004358971,102675000,102775000,102680000,102780000,"chr10",391009,0,0,2,2,"chr10",1,0.00375058602906704
"12681","chr10.114480000.114485000","chr10.114850000.114855000",370000,10,0.002920256,114480000,114850000,114485000,114855000,"chr10",391025,1,5,3,9,"chr10",1,0.0105485232067511
"12682","chr10.95495000.95500000","chr10.95570000.95575000",75000,18,0.005637674,95495000,95570000,95500000,95575000,"chr10",391093,3,7,5,15,"chr10",1,0.0316455696202532
"12683","chr10.35610000.35615000","chr10.35820000.35825000",210000,14,0.0003343528,35610000,35820000,35615000,35825000,"chr10",391105,1,1,1,3,"chr10",1,0.00492264416315049
"12684","chr10.97445000.97450000","chr10.97605000.97610000",160000,13,0.006863816,97445000,97605000,97450000,97610000,"chr10",391121,0,8,6,14,"chr10",1,0.0213314580403188
"12685","chr10.91085000.91090000","chr10.91130000.91135000",45000,24,0.003089335,91085000,91130000,91090000,91135000,"chr10",391123,2,1,1,4,"chr10",1,0.0112517580872011
"12686","chr10.12270000.12275000","chr10.13115000.13120000",845000,9,0.0001308889,12270000,13115000,12275000,13120000,"chr10",391133,0,3,7,10,"chr10",1,0.0105485232067511
"12687","chr10.103065000.103070000","chr10.103275000.103280000",210000,14,0.0003343528,103065000,103275000,103070000,103280000,"chr10",391166,0,3,1,4,"chr10",1,0.00656352555086732
"12688","chr10.14560000.14565000","chr10.14875000.14880000",315000,13,7.170832e-05,14560000,14875000,14565000,14880000,"chr10",391197,0,2,0,2,"chr10",1,0.00304735114861697
"12689","chr10.25680000.25685000","chr10.25725000.25730000",45000,23,0.006896136,25680000,25725000,25685000,25730000,"chr10",391226,3,5,5,13,"chr10",1,0.0350445382090952
"12690","chr10.73995000.74000000","chr10.74105000.74110000",110000,17,0.0007186392,73995000,74105000,7.4e+07,74110000,"chr10",391401,0,4,5,9,"chr10",1,0.0179324894514768
"12691","chr10.103065000.103070000","chr10.103220000.103225000",155000,13,0.008179677,103065000,103220000,103070000,103225000,"chr10",391431,3,4,1,8,"chr10",1,0.0121894045944679
"12692","chr10.22600000.22605000","chr10.22760000.22765000",160000,16,0.0001738592,22600000,22760000,22605000,22765000,"chr10",391541,6,17,16,39,"chr10",1,0.0731364275668073
"12693","chr10.6150000.6155000","chr10.6210000.6215000",60000,31,2.78098e-08,6150000,6210000,6155000,6215000,"chr10",391634,3,17,11,31,"chr10",1,0.11263478668542
"12694","chr10.121485000.121490000","chr10.121645000.121650000",160000,15,0.000638866,121485000,121645000,121490000,121650000,"chr10",391666,0,6,2,8,"chr10",1,0.0140646976090014
"12695","chr10.60875000.60880000","chr10.60930000.60935000",55000,28,5.234909e-06,60875000,60930000,60880000,60935000,"chr10",391698,0,1,0,1,"chr10",1,0.00328176277543366
"12696","chr10.75020000.75025000","chr10.75295000.75300000",275000,15,7.349294e-06,75020000,75295000,75025000,75300000,"chr10",391720,3,4,9,16,"chr10",1,0.0281293952180028
"12697","chr10.103220000.103225000","chr10.103275000.103280000",55000,21,0.006045969,103220000,103275000,103225000,103280000,"chr10",391735,0,3,4,7,"chr10",1,0.0172292545710267
"12698","chr10.22600000.22605000","chr10.23375000.23380000",775000,9,0.0002279319,22600000,23375000,22605000,23380000,"chr10",391822,4,10,10,24,"chr10",1,0.0253164556962025
"12699","chr10.15255000.15260000","chr10.15290000.15295000",35000,51,7.5339e-15,15255000,15290000,15260000,15295000,"chr10",391827,2,6,3,11,"chr10",1,0.0657524613220816
"12700","chr10.70270000.70275000","chr10.70460000.70465000",190000,12,0.008135178,70270000,70460000,70275000,70465000,"chr10",391969,2,7,3,12,"chr10",1,0.0168776371308017
"12701","chr10.114495000.114500000","chr10.114875000.114880000",380000,14,3.297886e-06,114495000,114875000,114500000,114880000,"chr10",392010,0,0,2,2,"chr10",1,0.00328176277543366
"12702","chr10.112990000.112995000","chr10.113025000.113030000",35000,27,0.004926953,112990000,113025000,112995000,113030000,"chr10",392053,5,14,13,32,"chr10",1,0.10126582278481
"12703","chr10.110275000.110280000","chr10.110425000.110430000",150000,14,0.003222971,110275000,110425000,110280000,110430000,"chr10",392064,0,5,1,6,"chr10",1,0.00984528832630099
"12704","chr10.97460000.97465000","chr10.97595000.97600000",135000,21,5.31947e-07,97460000,97595000,97465000,97600000,"chr10",392085,2,5,1,8,"chr10",1,0.019690576652602
"12705","chr10.103650000.103655000","chr10.103800000.103805000",150000,13,0.009679522,103650000,103800000,103655000,103805000,"chr10",392094,1,1,5,7,"chr10",1,0.0106657290201594
"12706","chr10.24900000.24905000","chr10.25225000.25230000",325000,11,0.001287545,24900000,25225000,24905000,25230000,"chr10",392140,3,4,9,16,"chr10",1,0.0206282231598687
"12707","chr10.95530000.95535000","chr10.95550000.95555000",20000,43,4.376355e-05,95530000,95550000,95535000,95555000,"chr10",392170,0,1,1,2,"chr10",1,0.0100796999531177
"12708","chr10.104205000.104210000","chr10.104345000.104350000",140000,15,0.001511564,104205000,104345000,104210000,104350000,"chr10",392200,0,2,0,2,"chr10",1,0.00351617440225035
"12709","chr10.62785000.62790000","chr10.62830000.62835000",45000,24,0.003089335,62785000,62830000,62790000,62835000,"chr10",392211,0,2,3,5,"chr10",1,0.0140646976090014
"12710","chr10.103060000.103065000","chr10.103190000.103195000",130000,21,7.571267e-07,103060000,103190000,103065000,103195000,"chr10",392256,2,14,11,27,"chr10",1,0.0664556962025316
"12711","chr10.97230000.97235000","chr10.97330000.97335000",100000,16,0.004358971,97230000,97330000,97235000,97335000,"chr10",392274,1,8,7,16,"chr10",1,0.0300046882325363
"12712","chr10.121440000.121445000","chr10.121665000.121670000",225000,12,0.002958583,121440000,121665000,121445000,121670000,"chr10",392302,0,1,1,2,"chr10",1,0.00281293952180028
"12713","chr10.495000.500000","chr10.1085000.1090000",590000,8,0.005887451,495000,1085000,5e+05,1090000,"chr10",392305,2,2,4,8,"chr10",1,0.00750117205813408
"12714","chr10.80155000.80160000","chr10.80405000.80410000",250000,11,0.005633679,80155000,80405000,80160000,80410000,"chr10",392400,0,4,1,5,"chr10",1,0.00644631973745898
"12715","chr10.6010000.6015000","chr10.6125000.6130000",115000,15,0.00484355,6010000,6125000,6015000,6130000,"chr10",392704,2,5,2,9,"chr10",1,0.0158227848101266
"12716","chr10.100225000.100230000","chr10.101070000.101075000",845000,8,0.0009084932,100225000,101070000,100230000,101075000,"chr10",392714,4,4,3,11,"chr10",1,0.0103141115799344
"12717","chr10.21365000.21370000","chr10.21535000.21540000",170000,13,0.004880317,21365000,21535000,21370000,21540000,"chr10",392726,8,17,29,54,"chr10",1,0.0822784810126582
"12718","chr10.74120000.74125000","chr10.74595000.74600000",475000,16,7.292807e-09,74120000,74595000,74125000,74600000,"chr10",392743,0,4,1,5,"chr10",1,0.00937646507266761
"12719","chr10.22895000.22900000","chr10.22985000.22990000",90000,25,1.641998e-07,22895000,22985000,22900000,22990000,"chr10",392784,1,2,1,4,"chr10",1,0.0117205813408345
"12720","chr10.124060000.124065000","chr10.124135000.124140000",75000,18,0.005637674,124060000,124135000,124065000,124140000,"chr10",392857,0,2,0,2,"chr10",1,0.00421940928270042
"12721","chr10.12460000.12465000","chr10.12485000.12490000",25000,33,0.008561686,12460000,12485000,12465000,12490000,"chr10",392997,3,5,10,18,"chr10",1,0.069620253164557
"12722","chr10.114765000.114770000","chr10.114850000.114855000",85000,21,7.081144e-05,114765000,114850000,114770000,114855000,"chr10",393024,0,3,1,4,"chr10",1,0.00984528832630099
"12723","chr10.70250000.70255000","chr10.70550000.70555000",300000,10,0.007688403,70250000,70550000,70255000,70555000,"chr10",393043,0,3,1,4,"chr10",1,0.0046882325363338
"12724","chr10.104275000.104280000","chr10.104335000.104340000",60000,32,7.017163e-09,104275000,104335000,104280000,104340000,"chr10",393059,4,9,6,19,"chr10",1,0.0712611345522738
"12725","chr10.31015000.31020000","chr10.31775000.31780000",760000,19,7.218182e-15,31015000,31775000,31020000,31780000,"chr10",393060,4,5,5,14,"chr10",1,0.0311767463666198
"12726","chr10.91040000.91045000","chr10.91130000.91135000",90000,23,2.757608e-06,91040000,91130000,91045000,91135000,"chr10",393097,2,1,1,4,"chr10",1,0.0107829348335677
"12727","chr10.13650000.13655000","chr10.13815000.13820000",165000,15,0.0005131903,13650000,13815000,13655000,13820000,"chr10",393138,0,8,6,14,"chr10",1,0.0246132208157525
"12728","chr10.30685000.30690000","chr10.30855000.30860000",170000,13,0.004880317,30685000,30855000,30690000,30860000,"chr10",393173,2,4,1,7,"chr10",1,0.0106657290201594
"12729","chr10.73875000.73880000","chr10.74585000.74590000",710000,8,0.002329301,73875000,74585000,73880000,74590000,"chr10",393236,0,2,3,5,"chr10",1,0.0046882325363338
"12730","chr10.31130000.31135000","chr10.31775000.31780000",645000,10,0.000113551,31130000,31775000,31135000,31780000,"chr10",393249,2,5,9,16,"chr10",1,0.0187529301453352
"12731","chr10.6955000.6960000","chr10.7115000.7120000",160000,21,8.881832e-08,6955000,7115000,6960000,7120000,"chr10",393252,1,2,6,9,"chr10",1,0.0221518987341772
"12732","chr10.15290000.15295000","chr10.15415000.15420000",125000,23,4.981954e-08,15290000,15415000,15295000,15420000,"chr10",393383,2,6,5,13,"chr10",1,0.0350445382090952
"12733","chr10.92845000.92850000","chr10.93005000.93010000",160000,30,3.811855e-15,92845000,93005000,92850000,93010000,"chr10",393404,3,8,5,16,"chr10",1,0.0562587904360056
"12734","chr10.114480000.114485000","chr10.114875000.114880000",395000,17,5.832664e-09,114480000,114875000,114485000,114880000,"chr10",393485,2,5,3,10,"chr10",1,0.0199249882794187
"12735","chr10.103590000.103595000","chr10.103770000.103775000",180000,19,6.629447e-07,103590000,103770000,103595000,103775000,"chr10",393539,2,1,2,5,"chr10",1,0.0111345522737928
"12736","chr10.114525000.114530000","chr10.114850000.114855000",325000,10,0.005278928,114525000,114850000,114530000,114855000,"chr10",393541,1,13,15,29,"chr10",1,0.0339896858884201
"12737","chr10.75020000.75025000","chr10.75475000.75480000",455000,9,0.004626069,75020000,75475000,75025000,75480000,"chr10",393579,3,4,7,14,"chr10",1,0.0147679324894515
"12738","chr10.12780000.12785000","chr10.13085000.13090000",305000,10,0.007043694,12780000,13085000,12785000,13090000,"chr10",393580,2,4,3,9,"chr10",1,0.0105485232067511
"12739","chr10.28975000.28980000","chr10.29510000.29515000",535000,9,0.002033385,28975000,29510000,28980000,29515000,"chr10",393584,0,4,1,5,"chr10",1,0.00527426160337553
"12740","chr10.124655000.124660000","chr10.124690000.124695000",35000,30,0.0004528008,124655000,124690000,124660000,124695000,"chr10",393629,0,2,0,2,"chr10",1,0.0070323488045007
"12741","chr10.100230000.100235000","chr10.100990000.100995000",760000,9,0.0002603223,100230000,100990000,100235000,100995000,"chr10",393633,4,7,4,15,"chr10",1,0.0158227848101266
"12742","chr10.125760000.125765000","chr10.126080000.126085000",320000,10,0.00569406,125760000,126080000,125765000,126085000,"chr10",393678,1,1,0,2,"chr10",1,0.0023441162681669
"12743","chr10.103555000.103560000","chr10.103780000.103785000",225000,11,0.009966611,103555000,103780000,103560000,103785000,"chr10",393684,2,4,10,16,"chr10",1,0.0206282231598687
"12744","chr10.22780000.22785000","chr10.22835000.22840000",55000,21,0.006045969,22780000,22835000,22785000,22840000,"chr10",393686,6,8,6,20,"chr10",1,0.0492264416315049
"12745","chr10.15350000.15355000","chr10.15385000.15390000",35000,36,1.419352e-06,15350000,15385000,15355000,15390000,"chr10",393698,4,25,20,49,"chr10",1,0.206751054852321
"12746","chr10.60775000.60780000","chr10.60875000.60880000",100000,21,1.158588e-05,60775000,60875000,60780000,60880000,"chr10",393701,1,1,2,4,"chr10",1,0.00984528832630099
"12747","chr10.70305000.70310000","chr10.70525000.70530000",220000,14,0.0002290788,70305000,70525000,70310000,70530000,"chr10",393704,0,1,1,2,"chr10",1,0.00328176277543366
"12748","chr10.31015000.31020000","chr10.31940000.31945000",925000,7,0.003341242,31015000,31940000,31020000,31945000,"chr10",393726,4,5,5,14,"chr10",1,0.0114861697140178
"12749","chr10.72305000.72310000","chr10.72625000.72630000",320000,10,0.00569406,72305000,72625000,72310000,72630000,"chr10",393780,4,21,20,45,"chr10",1,0.0527426160337553
"12750","chr10.32145000.32150000","chr10.32275000.32280000",130000,14,0.006930734,32145000,32275000,32150000,32280000,"chr10",393791,4,18,12,34,"chr10",1,0.0557899671823722
"12751","chr10.73810000.73815000","chr10.74100000.74105000",290000,10,0.009003412,73810000,74100000,73815000,74105000,"chr10",393885,0,8,2,10,"chr10",1,0.0117205813408345
"12752","chr10.7205000.7210000","chr10.7440000.7445000",235000,11,0.007912294,7205000,7440000,7210000,7445000,"chr10",393932,6,16,9,31,"chr10",1,0.0399671823722457
"12753","chr10.6190000.6195000","chr10.6235000.6240000",45000,33,3.271201e-07,6190000,6235000,6195000,6240000,"chr10",394080,2,11,11,24,"chr10",1,0.0928270042194093
"12754","chr10.75210000.75215000","chr10.75235000.75240000",25000,33,0.008561686,75210000,75235000,75215000,75240000,"chr10",394091,2,4,4,10,"chr10",1,0.0386779184247539
"12755","chr10.91045000.91050000","chr10.91130000.91135000",85000,18,0.002017057,91045000,91130000,91050000,91135000,"chr10",394130,0,1,1,2,"chr10",1,0.00421940928270042
"12756","chr10.75290000.75295000","chr10.75415000.75420000",125000,15,0.002953031,75290000,75415000,75295000,75420000,"chr10",394176,1,1,1,3,"chr10",1,0.00527426160337553
"12757","chr10.87770000.87775000","chr10.87815000.87820000",45000,27,0.0002106261,87770000,87815000,87775000,87820000,"chr10",394214,1,1,4,6,"chr10",1,0.0189873417721519
"12758","chr10.80405000.80410000","chr10.80945000.80950000",540000,9,0.001932354,80405000,80945000,80410000,80950000,"chr10",394221,1,2,0,3,"chr10",1,0.00316455696202532
"12759","chr10.71990000.71995000","chr10.72130000.72135000",140000,16,0.0004491092,71990000,72130000,71995000,72135000,"chr10",394268,2,9,9,20,"chr10",1,0.0375058602906704
"12760","chr10.99325000.99330000","chr10.99360000.99365000",35000,30,0.0004528008,99325000,99360000,99330000,99365000,"chr10",394322,1,2,0,3,"chr10",1,0.0105485232067511
"12761","chr10.124060000.124065000","chr10.124325000.124330000",265000,23,1.78369e-12,124060000,124325000,124065000,124330000,"chr10",394473,0,1,0,1,"chr10",1,0.00269573370839194
"12762","chr10.104270000.104275000","chr10.104290000.104295000",20000,40,0.0004347818,104270000,104290000,104275000,104295000,"chr10",394545,0,0,7,7,"chr10",1,0.0328176277543366
"12763","chr10.103640000.103645000","chr10.103760000.103765000",120000,17,0.0003806324,103640000,103760000,103645000,103765000,"chr10",394679,2,2,4,8,"chr10",1,0.0159399906235349
"12764","chr10.87595000.87600000","chr10.87790000.87795000",195000,13,0.002121806,87595000,87790000,87600000,87795000,"chr10",394706,2,8,13,23,"chr10",1,0.0350445382090952
"12765","chr10.121450000.121455000","chr10.121605000.121610000",155000,16,0.0002184597,121450000,121605000,121455000,121610000,"chr10",394722,0,4,6,10,"chr10",1,0.0187529301453352
"12766","chr10.15310000.15315000","chr10.15385000.15390000",75000,21,0.0002687144,15310000,15385000,15315000,15390000,"chr10",394750,0,3,2,5,"chr10",1,0.0123066104078762
"12767","chr10.12330000.12335000","chr10.12350000.12355000",20000,38,0.001750436,12330000,12350000,12335000,12355000,"chr10",394756,1,8,10,19,"chr10",1,0.0846225972808251
"12768","chr10.103580000.103585000","chr10.103780000.103785000",200000,12,0.00605453,103580000,103780000,103585000,103785000,"chr10",394788,1,0,1,2,"chr10",1,0.00281293952180028
"12769","chr10.104210000.104215000","chr10.104345000.104350000",135000,17,0.0001619335,104210000,104345000,104215000,104350000,"chr10",394886,3,6,11,20,"chr10",1,0.0398499765588373
"12770","chr10.116705000.116710000","chr10.116725000.116730000",20000,41,0.0002083528,116705000,116725000,116710000,116730000,"chr10",394933,0,3,6,9,"chr10",1,0.0432489451476793
"12771","chr10.79145000.79150000","chr10.79400000.79405000",255000,13,0.0003258269,79145000,79400000,79150000,79405000,"chr10",394962,1,0,0,1,"chr10",1,0.00152367557430849
"12772","chr10.126610000.126615000","chr10.126665000.126670000",55000,28,5.234909e-06,126610000,126665000,126615000,126670000,"chr10",395099,0,3,2,5,"chr10",1,0.0164088138771683
"12773","chr10.71955000.71960000","chr10.71975000.71980000",20000,48,5.654326e-07,71955000,71975000,71960000,71980000,"chr10",395116,0,2,1,3,"chr10",1,0.0168776371308017
"12774","chr10.15320000.15325000","chr10.15425000.15430000",105000,19,9.532682e-05,15320000,15425000,15325000,15430000,"chr10",395158,1,2,2,5,"chr10",1,0.0111345522737928
"12775","chr10.93030000.93035000","chr10.93680000.93685000",650000,8,0.003651755,93030000,93680000,93035000,93685000,"chr10",395194,1,5,3,9,"chr10",1,0.00843881856540084
"12776","chr10.103640000.103645000","chr10.103800000.103805000",160000,18,1.023246e-05,103640000,103800000,103645000,103805000,"chr10",395205,1,2,4,7,"chr10",1,0.0147679324894515
"12777","chr10.100225000.100230000","chr10.101005000.101010000",780000,30,5.330808e-30,100225000,101005000,100230000,101010000,"chr10",395209,3,4,2,9,"chr10",1,0.0316455696202532
"12778","chr10.73855000.73860000","chr10.73965000.73970000",110000,22,9.748871e-07,73855000,73965000,73860000,73970000,"chr10",395247,1,2,4,7,"chr10",1,0.0180496952648851
"12779","chr10.103565000.103570000","chr10.103770000.103775000",205000,13,0.001510072,103565000,103770000,103570000,103775000,"chr10",395317,6,12,6,24,"chr10",1,0.0365682137834037
"12780","chr10.121485000.121490000","chr10.121605000.121610000",120000,15,0.003759125,121485000,121605000,121490000,121610000,"chr10",395326,0,7,3,10,"chr10",1,0.0175808720112518
"12781","chr10.95375000.95380000","chr10.95400000.95405000",25000,36,0.001160029,95375000,95400000,95380000,95405000,"chr10",395343,3,2,4,9,"chr10",1,0.0379746835443038
"12782","chr10.102350000.102355000","chr10.102625000.102630000",275000,13,0.0001878855,102350000,102625000,102355000,102630000,"chr10",395461,0,2,1,3,"chr10",1,0.00457102672292546
"12783","chr10.22895000.22900000","chr10.23090000.23095000",195000,18,1.465464e-06,22895000,23090000,22900000,23095000,"chr10",395520,1,2,1,4,"chr10",1,0.00843881856540084
"12784","chr10.22835000.22840000","chr10.23065000.23070000",230000,13,0.0006792492,22835000,23065000,22840000,23070000,"chr10",395542,7,11,6,24,"chr10",1,0.0365682137834037
"12785","chr10.6955000.6960000","chr10.7475000.7480000",520000,9,0.002337378,6955000,7475000,6960000,7480000,"chr10",395613,1,2,6,9,"chr10",1,0.00949367088607595
"12786","chr10.125140000.125145000","chr10.125285000.125290000",145000,15,0.00121254,125140000,125285000,125145000,125290000,"chr10",395721,0,2,2,4,"chr10",1,0.0070323488045007
"12787","chr10.124800000.124805000","chr10.125120000.125125000",320000,11,0.001410809,124800000,125120000,124805000,125125000,"chr10",395727,1,2,2,5,"chr10",1,0.00644631973745898
"12788","chr10.103455000.103460000","chr10.103790000.103795000",335000,11,0.001098789,103455000,103790000,103460000,103795000,"chr10",395738,0,0,2,2,"chr10",1,0.00257852789498359
"12789","chr10.114480000.114485000","chr10.114870000.114875000",390000,14,2.678826e-06,114480000,114870000,114485000,114875000,"chr10",395752,2,5,3,10,"chr10",1,0.0164088138771683
"12790","chr10.97460000.97465000","chr10.97585000.97590000",125000,14,0.008561686,97460000,97585000,97465000,97590000,"chr10",395808,2,5,1,8,"chr10",1,0.0131270511017346
"12791","chr10.15255000.15260000","chr10.15275000.15280000",20000,58,1.704796e-11,15255000,15275000,15260000,15280000,"chr10",395851,3,7,3,13,"chr10",1,0.0883731833098922
"12792","chr10.102105000.102110000","chr10.102130000.102135000",25000,57,1.063901e-12,102105000,102130000,102110000,102135000,"chr10",395854,2,3,3,8,"chr10",1,0.0534458509142053
"12793","chr10.72350000.72355000","chr10.72420000.72425000",70000,24,1.937909e-05,72350000,72420000,72355000,72425000,"chr10",395933,2,0,1,3,"chr10",1,0.00843881856540084
"12794","chr10.118595000.118600000","chr10.118870000.118875000",275000,11,0.003274878,118595000,118870000,118600000,118875000,"chr10",395960,5,9,9,23,"chr10",1,0.0296530707923113
"12795","chr10.97185000.97190000","chr10.97325000.97330000",140000,15,0.001511564,97185000,97325000,97190000,97330000,"chr10",395990,1,3,1,5,"chr10",1,0.00879043600562588
"12796","chr10.69435000.69440000","chr10.69455000.69460000",20000,41,0.0002083528,69435000,69455000,69440000,69460000,"chr10",396027,2,3,1,6,"chr10",1,0.0288326300984529
"12797","chr10.103605000.103610000","chr10.103770000.103775000",165000,22,1.133791e-08,103605000,103770000,103610000,103775000,"chr10",396053,6,12,6,24,"chr10",1,0.0618846694796062
"12798","chr10.20315000.20320000","chr10.21060000.21065000",745000,7,0.009579491,20315000,21060000,20320000,21065000,"chr10",396097,2,4,3,9,"chr10",1,0.00738396624472574
"12799","chr10.80350000.80355000","chr10.80660000.80665000",310000,10,0.006532077,80350000,80660000,80355000,80665000,"chr10",396101,3,1,1,5,"chr10",1,0.00586029067041725
"12800","chr10.14550000.14555000","chr10.15105000.15110000",555000,8,0.007858356,14550000,15105000,14555000,15110000,"chr10",396152,2,5,7,14,"chr10",1,0.0131270511017346
"12801","chr10.93555000.93560000","chr10.94320000.94325000",765000,7,0.008561686,93555000,94320000,93560000,94325000,"chr10",396216,2,10,10,22,"chr10",1,0.0180496952648851
"12802","chr10.22600000.22605000","chr10.22895000.22900000",295000,19,1.91084e-09,22600000,22895000,22605000,22900000,"chr10",396239,1,2,1,4,"chr10",1,0.00890764181903422
"12803","chr10.97845000.97850000","chr10.97885000.97890000",40000,73,5.651845e-34,97845000,97885000,97850000,97890000,"chr10",396249,4,12,8,24,"chr10",1,0.205344585091421
"12804","chr10.110375000.110380000","chr10.110425000.110430000",50000,26,0.0001624034,110375000,110425000,110380000,110430000,"chr10",396279,2,5,6,13,"chr10",1,0.0396155649320206
"12805","chr10.71270000.71275000","chr10.71395000.71400000",125000,20,4.864853e-06,71270000,71395000,71275000,71400000,"chr10",396305,1,5,2,8,"chr10",1,0.0187529301453352
"12806","chr10.15300000.15305000","chr10.15415000.15420000",115000,19,4.200104e-05,15300000,15415000,15305000,15420000,"chr10",396322,2,8,5,15,"chr10",1,0.0334036568213783
"12807","chr10.73835000.73840000","chr10.73940000.73945000",105000,19,9.532682e-05,73835000,73940000,73840000,73945000,"chr10",396384,1,6,2,9,"chr10",1,0.020042194092827
"12808","chr10.35540000.35545000","chr10.35825000.35830000",285000,10,0.009796166,35540000,35825000,35545000,35830000,"chr10",396388,3,3,3,9,"chr10",1,0.0105485232067511
"12809","chr10.35405000.35410000","chr10.35500000.35505000",95000,61,2.647621e-40,35405000,35500000,35410000,35505000,"chr10",396507,0,1,0,1,"chr10",1,0.00714955461790905
"12810","chr10.26695000.26700000","chr10.26765000.26770000",70000,20,0.001511564,26695000,26765000,26700000,26770000,"chr10",396526,0,6,1,7,"chr10",1,0.0164088138771683
"12811","chr10.70385000.70390000","chr10.70460000.70465000",75000,18,0.005637674,70385000,70460000,70390000,70465000,"chr10",396544,2,13,9,24,"chr10",1,0.0506329113924051
"12812","chr10.132020000.132025000","chr10.132040000.132045000",20000,36,0.006240607,132020000,132040000,132025000,132045000,"chr10",396546,5,15,17,37,"chr10",1,0.156118143459916
"12813","chr10.74025000.74030000","chr10.74080000.74085000",55000,22,0.002536929,74025000,74080000,74030000,74085000,"chr10",396601,5,20,20,45,"chr10",1,0.116033755274262
"12814","chr10.340000.345000","chr10.845000.850000",505000,9,0.002729467,340000,845000,345000,850000,"chr10",396633,0,2,0,2,"chr10",1,0.00210970464135021
"12815","chr10.104780000.104785000","chr10.105060000.105065000",280000,11,0.002957522,104780000,105060000,104785000,105065000,"chr10",396686,0,2,1,3,"chr10",1,0.00386779184247539
"12816","chr10.11550000.11555000","chr10.11795000.11800000",245000,18,1.1687e-07,11550000,11795000,11555000,11800000,"chr10",396693,0,6,4,10,"chr10",1,0.0210970464135021
"12817","chr10.104265000.104270000","chr10.104345000.104350000",80000,63,4.349459e-39,104265000,104345000,104270000,104350000,"chr10",396965,2,8,9,19,"chr10",1,0.140295358649789
"12818","chr10.12420000.12425000","chr10.12615000.12620000",195000,12,0.006930734,12420000,12615000,12425000,12620000,"chr10",397097,3,0,4,7,"chr10",1,0.00984528832630099
"12819","chr10.104260000.104265000","chr10.104335000.104340000",75000,30,1.853062e-09,104260000,104335000,104265000,104340000,"chr10",397110,0,2,0,2,"chr10",1,0.0070323488045007
"12820","chr10.23010000.23015000","chr10.23110000.23115000",100000,29,5.310661e-11,23010000,23110000,23015000,23115000,"chr10",397137,0,1,0,1,"chr10",1,0.00339896858884201
"12821","chr10.73965000.73970000","chr10.74025000.74030000",60000,24,0.000138104,73965000,74025000,73970000,74030000,"chr10",397191,1,17,8,26,"chr10",1,0.0731364275668073
"12822","chr10.25020000.25025000","chr10.25290000.25295000",270000,14,4.474241e-05,25020000,25290000,25025000,25295000,"chr10",397220,0,1,5,6,"chr10",1,0.00984528832630099
"12823","chr10.103610000.103615000","chr10.103635000.103640000",25000,36,0.001160029,103610000,103635000,103615000,103640000,"chr10",397231,0,1,0,1,"chr10",1,0.00421940928270042
"12824","chr10.20085000.20090000","chr10.21080000.21085000",995000,7,0.002111122,20085000,21080000,20090000,21085000,"chr10",397248,2,0,8,10,"chr10",1,0.00820440693858415
"12825","chr10.14615000.14620000","chr10.14665000.14670000",50000,22,0.00612931,14615000,14665000,14620000,14670000,"chr10",397264,2,5,3,10,"chr10",1,0.0257852789498359
"12826","chr10.71995000.72000000","chr10.72105000.72110000",110000,15,0.006304029,71995000,72105000,7.2e+07,72110000,"chr10",397283,2,1,2,5,"chr10",1,0.00879043600562588
"12827","chr10.70335000.70340000","chr10.70460000.70465000",125000,17,0.0002785341,70335000,70460000,70340000,70465000,"chr10",397285,0,2,2,4,"chr10",1,0.00796999531176746
"12828","chr10.106795000.106800000","chr10.106815000.106820000",20000,46,3.445934e-06,106795000,106815000,106800000,106820000,"chr10",397290,0,3,1,4,"chr10",1,0.0215658696671355
"12829","chr10.29425000.29430000","chr10.29595000.29600000",170000,14,0.001492468,29425000,29595000,29430000,29600000,"chr10",397386,3,3,6,12,"chr10",1,0.019690576652602
"12830","chr10.14520000.14525000","chr10.14665000.14670000",145000,16,0.0003592976,14520000,14665000,14525000,14670000,"chr10",397392,2,5,3,10,"chr10",1,0.0187529301453352
"12831","chr10.104265000.104270000","chr10.104680000.104685000",415000,9,0.006997883,104265000,104680000,104270000,104685000,"chr10",397418,0,2,0,2,"chr10",1,0.00210970464135021
"12832","chr10.12270000.12275000","chr10.13090000.13095000",820000,7,0.006217584,12270000,13090000,12275000,13095000,"chr10",397587,1,7,2,10,"chr10",1,0.00820440693858415
"12833","chr10.78945000.78950000","chr10.79395000.79400000",450000,11,0.0002086672,78945000,79395000,78950000,79400000,"chr10",397631,0,3,3,6,"chr10",1,0.00773558368495077
"12834","chr10.22505000.22510000","chr10.22600000.22605000",95000,19,0.0002424219,22505000,22600000,22510000,22605000,"chr10",397684,3,6,3,12,"chr10",1,0.0267229254571027
"12835","chr10.1035000.1040000","chr10.1085000.1090000",50000,23,0.002650227,1035000,1085000,1040000,1090000,"chr10",397712,0,2,0,2,"chr10",1,0.00539146741678387
"12836","chr10.114480000.114485000","chr10.114865000.114870000",385000,17,7.545292e-09,114480000,114865000,114485000,114870000,"chr10",397764,2,5,3,10,"chr10",1,0.0199249882794187
"12837","chr10.121975000.121980000","chr10.122110000.122115000",135000,14,0.00573319,121975000,122110000,121980000,122115000,"chr10",397808,0,1,2,3,"chr10",1,0.00492264416315049
"12838","chr10.35415000.35420000","chr10.35500000.35505000",85000,51,3.778697e-28,35415000,35500000,35420000,35505000,"chr10",397831,0,5,1,6,"chr10",1,0.0358649789029536
"12839","chr10.23045000.23050000","chr10.23120000.23125000",75000,18,0.005637674,23045000,23120000,23050000,23125000,"chr10",397909,1,5,4,10,"chr10",1,0.0210970464135021
"12840","chr10.73155000.73160000","chr10.73365000.73370000",210000,13,0.001266212,73155000,73365000,73160000,73370000,"chr10",397940,5,29,23,57,"chr10",1,0.0868495077355837
"12841","chr10.25110000.25115000","chr10.25215000.25220000",105000,15,0.008559542,25110000,25215000,25115000,25220000,"chr10",397965,0,3,3,6,"chr10",1,0.0105485232067511
"12842","chr10.74120000.74125000","chr10.74585000.74590000",465000,19,9.52334e-12,74120000,74585000,74125000,74590000,"chr10",398024,0,2,1,3,"chr10",1,0.00668073136427567
"12843","chr10.68875000.68880000","chr10.68895000.68900000",20000,37,0.003346303,68875000,68895000,68880000,68900000,"chr10",398027,0,3,3,6,"chr10",1,0.0260196905766526
"12844","chr10.122475000.122480000","chr10.122510000.122515000",35000,29,0.001038926,122475000,122510000,122480000,122515000,"chr10",398049,0,1,8,9,"chr10",1,0.0305907172995781
"12845","chr10.104280000.104285000","chr10.104345000.104350000",65000,23,0.0001507044,104280000,104345000,104285000,104350000,"chr10",398092,4,11,14,29,"chr10",1,0.0781762775433661
"12846","chr10.103050000.103055000","chr10.103215000.103220000",165000,13,0.005801717,103050000,103215000,103055000,103220000,"chr10",398100,2,15,12,29,"chr10",1,0.0441865916549461
"12847","chr10.125060000.125065000","chr10.125140000.125145000",80000,17,0.008561686,125060000,125140000,125065000,125145000,"chr10",398117,1,2,0,3,"chr10",1,0.0059774964838256
"12848","chr10.6150000.6155000","chr10.6300000.6305000",150000,13,0.009679522,6150000,6300000,6155000,6305000,"chr10",398188,3,17,11,31,"chr10",1,0.0472339428035631
"12849","chr10.5810000.5815000","chr10.5840000.5845000",30000,32,0.001038926,5810000,5840000,5815000,5845000,"chr10",398203,3,3,1,7,"chr10",1,0.0262541022034693
"12850","chr10.73965000.73970000","chr10.74105000.74110000",140000,14,0.004724005,73965000,74105000,73970000,74110000,"chr10",398228,0,10,8,18,"chr10",1,0.029535864978903
"12851","chr10.103050000.103055000","chr10.103190000.103195000",140000,14,0.004724005,103050000,103190000,103055000,103195000,"chr10",398309,2,14,12,28,"chr10",1,0.0459446788560713
"12852","chr10.5855000.5860000","chr10.5920000.5925000",65000,27,1.363873e-06,5855000,5920000,5860000,5925000,"chr10",398328,0,8,1,9,"chr10",1,0.0284810126582278
"12853","chr10.103255000.103260000","chr10.103275000.103280000",20000,39,0.0008876436,103255000,103275000,103260000,103280000,"chr10",398333,0,3,4,7,"chr10",1,0.0319971870604782
"12854","chr10.97185000.97190000","chr10.97355000.97360000",170000,19,1.223195e-06,97185000,97355000,97190000,97360000,"chr10",398341,0,3,1,4,"chr10",1,0.00890764181903422
"12855","chr10.59950000.59955000","chr10.60020000.60025000",70000,19,0.003959344,59950000,60020000,59955000,60025000,"chr10",398375,0,2,1,3,"chr10",1,0.00668073136427567
"12856","chr10.126595000.126600000","chr10.126745000.126750000",150000,14,0.003222971,126595000,126745000,126600000,126750000,"chr10",398395,0,4,2,6,"chr10",1,0.00984528832630099
"12857","chr10.95380000.95385000","chr10.95400000.95405000",20000,46,3.445934e-06,95380000,95400000,95385000,95405000,"chr10",398413,2,8,6,16,"chr10",1,0.086263478668542
"12858","chr10.97195000.97200000","chr10.97355000.97360000",160000,19,2.237769e-06,97195000,97355000,97200000,97360000,"chr10",398417,0,5,1,6,"chr10",1,0.0133614627285513
"12859","chr10.74265000.74270000","chr10.74585000.74590000",320000,13,6.411375e-05,74265000,74585000,74270000,74590000,"chr10",398431,0,2,3,5,"chr10",1,0.00761837787154243
"12860","chr10.97170000.97175000","chr10.97320000.97325000",150000,16,0.0002785341,97170000,97320000,97175000,97325000,"chr10",398473,5,8,13,26,"chr10",1,0.0487576183778715
"12861","chr10.12345000.12350000","chr10.13075000.13080000",730000,8,0.002031528,12345000,13075000,12350000,13080000,"chr10",398509,0,3,5,8,"chr10",1,0.00750117205813408
"12862","chr10.35410000.35415000","chr10.35500000.35505000",90000,45,2.324831e-23,35410000,35500000,35415000,35505000,"chr10",398592,0,4,1,5,"chr10",1,0.0263713080168776
"12863","chr10.91020000.91025000","chr10.91135000.91140000",115000,28,3.091113e-11,91020000,91135000,91025000,91140000,"chr10",398609,0,2,3,5,"chr10",1,0.0164088138771683
"12864","chr10.25020000.25025000","chr10.25065000.25070000",45000,46,4.636496e-15,25020000,25065000,25025000,25070000,"chr10",398700,2,1,6,9,"chr10",1,0.0485232067510548
"12865","chr10.74175000.74180000","chr10.74555000.74560000",380000,13,2.01441e-05,74175000,74555000,74180000,74560000,"chr10",398735,4,5,15,24,"chr10",1,0.0365682137834037
"12866","chr10.25465000.25470000","chr10.25495000.25500000",30000,29,0.008945346,25465000,25495000,25470000,25500000,"chr10",398769,0,0,2,2,"chr10",1,0.00679793717768401
"12867","chr10.62785000.62790000","chr10.62800000.62805000",15000,45,8.198013e-06,62785000,62800000,62790000,62805000,"chr10",398783,0,1,3,4,"chr10",1,0.0210970464135021
"12868","chr10.72310000.72315000","chr10.72625000.72630000",315000,10,0.006122986,72310000,72625000,72315000,72630000,"chr10",398825,6,23,21,50,"chr10",1,0.0586029067041725
"12869","chr10.93555000.93560000","chr10.93680000.93685000",125000,30,2.123348e-13,93555000,93680000,93560000,93685000,"chr10",398838,1,5,3,9,"chr10",1,0.0316455696202532
"12870","chr10.24900000.24905000","chr10.25020000.25025000",120000,17,0.0003806324,24900000,25020000,24905000,25025000,"chr10",398865,3,1,6,10,"chr10",1,0.0199249882794187
"12871","chr10.14670000.14675000","chr10.15105000.15110000",435000,9,0.005721615,14670000,15105000,14675000,15110000,"chr10",398913,2,10,9,21,"chr10",1,0.0221518987341772
"12872","chr10.74120000.74125000","chr10.74555000.74560000",435000,9,0.005721615,74120000,74555000,74125000,74560000,"chr10",398953,0,4,1,5,"chr10",1,0.00527426160337553
"12873","chr10.122950000.122955000","chr10.123500000.123505000",550000,8,0.008185865,122950000,123500000,122955000,123505000,"chr10",398995,5,8,2,15,"chr10",1,0.0140646976090014
"12874","chr10.12330000.12335000","chr10.12615000.12620000",285000,11,0.002657379,12330000,12615000,12335000,12620000,"chr10",399017,3,0,4,7,"chr10",1,0.00902484763244257
"12875","chr10.6645000.6650000","chr10.7445000.7450000",800000,7,0.006930734,6645000,7445000,6650000,7450000,"chr10",399137,1,1,1,3,"chr10",1,0.00246132208157525
"12876","chr10.15255000.15260000","chr10.15385000.15390000",130000,15,0.002331357,15255000,15385000,15260000,15390000,"chr10",399139,3,7,3,13,"chr10",1,0.0228551336146273
"12877","chr10.100345000.100350000","chr10.100370000.100375000",25000,39,0.0001201752,100345000,100370000,100350000,100375000,"chr10",399226,0,8,3,11,"chr10",1,0.05028129395218
"12878","chr10.103920000.103925000","chr10.104345000.104350000",425000,10,0.001459465,103920000,104345000,103925000,104350000,"chr10",399240,2,1,1,4,"chr10",1,0.0046882325363338
"12879","chr10.73855000.73860000","chr10.74055000.74060000",200000,12,0.00605453,73855000,74055000,73860000,74060000,"chr10",399276,2,2,4,8,"chr10",1,0.0112517580872011
"12880","chr10.75645000.75650000","chr10.75695000.75700000",50000,35,3.96634e-09,75645000,75695000,75650000,75700000,"chr10",399285,1,2,0,3,"chr10",1,0.0123066104078762
"12881","chr10.80075000.80080000","chr10.80405000.80410000",330000,10,0.004908412,80075000,80405000,80080000,80410000,"chr10",399288,3,4,3,10,"chr10",1,0.0117205813408345
"12882","chr10.30670000.30675000","chr10.30855000.30860000",185000,16,5.340446e-05,30670000,30855000,30675000,30860000,"chr10",399323,2,4,4,10,"chr10",1,0.0187529301453352
"12883","chr10.295000.300000","chr10.1035000.1040000",740000,7,0.009812416,295000,1035000,3e+05,1040000,"chr10",399459,0,2,0,2,"chr10",1,0.00164088138771683
"12884","chr10.7205000.7210000","chr10.7290000.7295000",85000,18,0.002017057,7205000,7290000,7210000,7295000,"chr10",399487,7,16,9,32,"chr10",1,0.0675105485232067
"12885","chr10.12345000.12350000","chr10.12665000.12670000",320000,11,0.001410809,12345000,12665000,12350000,12670000,"chr10",399514,0,4,6,10,"chr10",1,0.012892639474918
"12886","chr10.71205000.71210000","chr10.71270000.71275000",65000,21,0.001177847,71205000,71270000,71210000,71275000,"chr10",399578,0,1,1,2,"chr10",1,0.00492264416315049
"12887","chr10.103770000.103775000","chr10.103800000.103805000",30000,30,0.004565405,103770000,103800000,103775000,103805000,"chr10",399583,1,3,6,10,"chr10",1,0.0351617440225035
"12888","chr10.25015000.25020000","chr10.25080000.25085000",65000,19,0.007481698,25015000,25080000,25020000,25085000,"chr10",399600,2,3,1,6,"chr10",1,0.0133614627285513
"12889","chr10.70520000.70525000","chr10.70660000.70665000",140000,14,0.004724005,70520000,70660000,70525000,70665000,"chr10",399636,0,7,3,10,"chr10",1,0.0164088138771683
"12890","chr10.102690000.102695000","chr10.102740000.102745000",50000,30,2.128706e-06,102690000,102740000,102695000,102745000,"chr10",399644,5,5,7,17,"chr10",1,0.059774964838256
"12891","chr10.121440000.121445000","chr10.121485000.121490000",45000,29,2.861924e-05,121440000,121485000,121445000,121490000,"chr10",399650,0,7,3,10,"chr10",1,0.0339896858884201
"12892","chr10.75035000.75040000","chr10.75110000.75115000",75000,18,0.005637674,75035000,75110000,75040000,75115000,"chr10",399656,3,16,10,29,"chr10",1,0.0611814345991561
"12893","chr10.114495000.114500000","chr10.114865000.114870000",370000,10,0.002920256,114495000,114865000,114500000,114870000,"chr10",399678,0,0,2,2,"chr10",1,0.0023441162681669
"12894","chr10.22895000.22900000","chr10.23110000.23115000",215000,13,0.001081297,22895000,23110000,22900000,23115000,"chr10",399725,0,2,1,3,"chr10",1,0.00457102672292546
"12895","chr10.91010000.91015000","chr10.91130000.91135000",120000,27,9.653747e-11,91010000,91130000,91015000,91135000,"chr10",399766,2,1,1,4,"chr10",1,0.0126582278481013
"12896","chr10.103365000.103370000","chr10.103540000.103545000",175000,18,4.401708e-06,103365000,103540000,103370000,103545000,"chr10",399858,2,4,9,15,"chr10",1,0.0316455696202532
"12897","chr10.101310000.101315000","chr10.101330000.101335000",20000,41,0.0002083528,101310000,101330000,101315000,101335000,"chr10",399859,4,13,9,26,"chr10",1,0.124941397093296
"12898","chr10.12270000.12275000","chr10.12780000.12785000",510000,9,0.00260178,12270000,12780000,12275000,12785000,"chr10",399915,3,4,4,11,"chr10",1,0.0116033755274262
"12899","chr10.24950000.24955000","chr10.24985000.24990000",35000,31,0.0001906698,24950000,24985000,24955000,24990000,"chr10",399936,1,3,2,6,"chr10",1,0.0218002812939522
"12900","chr10.6920000.6925000","chr10.7305000.7310000",385000,12,0.0001031633,6920000,7305000,6925000,7310000,"chr10",399961,0,2,5,7,"chr10",1,0.00984528832630099
"12901","chr10.118720000.118725000","chr10.118750000.118755000",30000,36,3.696555e-05,118720000,118750000,118725000,118755000,"chr10",400026,0,2,2,4,"chr10",1,0.0168776371308017
"12902","chr10.60775000.60780000","chr10.60910000.60915000",135000,14,0.00573319,60775000,60910000,60780000,60915000,"chr10",400100,0,6,6,12,"chr10",1,0.019690576652602
"12903","chr10.121465000.121470000","chr10.121610000.121615000",145000,19,5.669881e-06,121465000,121610000,121470000,121615000,"chr10",400146,0,6,3,9,"chr10",1,0.020042194092827
"12904","chr10.104205000.104210000","chr10.104265000.104270000",60000,21,0.002650227,104205000,104265000,104210000,104270000,"chr10",400176,0,2,0,2,"chr10",1,0.00492264416315049
"12905","chr10.100530000.100535000","chr10.101065000.101070000",535000,9,0.002033385,100530000,101065000,100535000,101070000,"chr10",400213,7,15,11,33,"chr10",1,0.0348101265822785
"12906","chr10.102280000.102285000","chr10.102665000.102670000",385000,9,0.009687376,102280000,102665000,102285000,102670000,"chr10",400274,0,0,3,3,"chr10",1,0.00316455696202532
"12907","chr10.118595000.118600000","chr10.118720000.118725000",125000,14,0.008561686,118595000,118720000,118600000,118725000,"chr10",400285,0,2,3,5,"chr10",1,0.00820440693858415
"12908","chr10.99245000.99250000","chr10.99360000.99365000",115000,18,0.0001507044,99245000,99360000,99250000,99365000,"chr10",400312,0,2,0,2,"chr10",1,0.00421940928270042
"12909","chr10.15320000.15325000","chr10.15385000.15390000",65000,20,0.003071821,15320000,15385000,15325000,15390000,"chr10",400329,1,7,2,10,"chr10",1,0.023441162681669
"12910","chr10.75020000.75025000","chr10.75185000.75190000",165000,14,0.001805313,75020000,75185000,75025000,75190000,"chr10",400330,3,4,6,13,"chr10",1,0.0213314580403188
"12911","chr10.73835000.73840000","chr10.73965000.73970000",130000,16,0.00072938,73835000,73965000,73840000,73970000,"chr10",400338,1,6,2,9,"chr10",1,0.0168776371308017
"12912","chr10.75020000.75025000","chr10.75485000.75490000",465000,10,0.0008916935,75020000,75485000,75025000,75490000,"chr10",400395,2,4,9,15,"chr10",1,0.0175808720112518
"12913","chr10.6125000.6130000","chr10.6190000.6195000",65000,19,0.007481698,6125000,6190000,6130000,6195000,"chr10",400428,2,11,5,18,"chr10",1,0.040084388185654
"12914","chr10.3290000.3295000","chr10.3500000.3505000",210000,14,0.0003343528,3290000,3500000,3295000,3505000,"chr10",400441,0,1,1,2,"chr10",1,0.00328176277543366
"12915","chr10.97220000.97225000","chr10.97330000.97335000",110000,19,6.169143e-05,97220000,97330000,97225000,97335000,"chr10",400510,1,3,2,6,"chr10",1,0.0133614627285513
"12916","chr10.14560000.14565000","chr10.14665000.14670000",105000,15,0.008559542,14560000,14665000,14565000,14670000,"chr10",400518,0,2,0,2,"chr10",1,0.00351617440225035
"12917","chr10.104270000.104275000","chr10.104335000.104340000",65000,32,1.427696e-09,104270000,104335000,104275000,104340000,"chr10",400573,0,0,6,6,"chr10",1,0.0225035161744023
"12918","chr10.104545000.104550000","chr10.105130000.105135000",585000,8,0.00612931,104545000,105130000,104550000,105135000,"chr10",400575,1,0,2,3,"chr10",1,0.00281293952180028
"12919","chr10.15300000.15305000","chr10.15345000.15350000",45000,25,0.001309789,15300000,15345000,15305000,15350000,"chr10",400715,2,6,3,11,"chr10",1,0.0322315986872949
"12920","chr10.103675000.103680000","chr10.103770000.103775000",95000,16,0.006240607,103675000,103770000,103680000,103775000,"chr10",400717,0,5,3,8,"chr10",1,0.0150023441162682
"12921","chr10.89410000.89415000","chr10.90315000.90320000",905000,8,0.0005831433,89410000,90315000,89415000,90320000,"chr10",400891,0,2,3,5,"chr10",1,0.0046882325363338
"12922","chr10.20085000.20090000","chr10.20285000.20290000",200000,12,0.00605453,20085000,20285000,20090000,20290000,"chr10",400902,0,0,3,3,"chr10",1,0.00421940928270042
"12923","chr10.28985000.28990000","chr10.29155000.29160000",170000,17,2.618299e-05,28985000,29155000,28990000,29160000,"chr10",400915,1,12,10,23,"chr10",1,0.0458274730426629
"12924","chr10.80340000.80345000","chr10.80505000.80510000",165000,15,0.0005131903,80340000,80505000,80345000,80510000,"chr10",400968,0,1,4,5,"chr10",1,0.00879043600562588
"12925","chr10.80205000.80210000","chr10.80465000.80470000",260000,12,0.001173308,80205000,80465000,80210000,80470000,"chr10",400986,4,2,11,17,"chr10",1,0.0239099859353024
"12926","chr10.103565000.103570000","chr10.103780000.103785000",215000,13,0.001081297,103565000,103780000,103570000,103785000,"chr10",400990,2,4,8,14,"chr10",1,0.0213314580403188
"12927","chr10.19820000.19825000","chr10.20085000.20090000",265000,11,0.00402911,19820000,20085000,19825000,20090000,"chr10",401064,1,0,8,9,"chr10",1,0.0116033755274262
"12928","chr10.62785000.62790000","chr10.62805000.62810000",20000,66,1.035688e-15,62785000,62805000,62790000,62810000,"chr10",401083,0,2,2,4,"chr10",1,0.0309423347398031
"12929","chr10.14550000.14555000","chr10.14875000.14880000",325000,11,0.001287545,14550000,14875000,14555000,14880000,"chr10",401088,2,2,7,11,"chr10",1,0.0141819034224098
"12930","chr10.455000.460000","chr10.845000.850000",390000,9,0.009190154,455000,845000,460000,850000,"chr10",401096,0,1,0,1,"chr10",1,0.00105485232067511
"12931","chr10.71985000.71990000","chr10.72105000.72110000",120000,36,2.610398e-18,71985000,72105000,71990000,72110000,"chr10",401105,2,1,2,5,"chr10",1,0.0210970464135021
"12932","chr10.126605000.126610000","chr10.126745000.126750000",140000,14,0.004724005,126605000,126745000,126610000,126750000,"chr10",401122,0,4,2,6,"chr10",1,0.00984528832630099
"12933","chr10.97185000.97190000","chr10.97330000.97335000",145000,16,0.0003592976,97185000,97330000,97190000,97335000,"chr10",401140,1,3,1,5,"chr10",1,0.00937646507266761
"12934","chr10.35405000.35410000","chr10.35465000.35470000",60000,20,0.006321056,35405000,35465000,35410000,35470000,"chr10",401263,2,1,0,3,"chr10",1,0.0070323488045007
"12935","chr10.122780000.122785000","chr10.122980000.122985000",200000,12,0.00605453,122780000,122980000,122785000,122985000,"chr10",401329,0,3,1,4,"chr10",1,0.00562587904360056
"12936","chr10.20085000.20090000","chr10.21060000.21065000",975000,8,0.0003479056,20085000,21060000,20090000,21065000,"chr10",401333,2,0,3,5,"chr10",1,0.0046882325363338
"12937","chr10.103930000.103935000","chr10.104255000.104260000",325000,14,1.047216e-05,103930000,104255000,103935000,104260000,"chr10",401336,4,0,3,7,"chr10",1,0.0114861697140178
"12938","chr10.124800000.124805000","chr10.124915000.124920000",115000,19,4.200104e-05,124800000,124915000,124805000,124920000,"chr10",401372,0,8,11,19,"chr10",1,0.0423112986404126
"12939","chr10.124655000.124660000","chr10.124705000.124710000",50000,22,0.00612931,124655000,124705000,124660000,124710000,"chr10",401400,0,2,2,4,"chr10",1,0.0103141115799344
"12940","chr10.72055000.72060000","chr10.72105000.72110000",50000,23,0.002650227,72055000,72105000,72060000,72110000,"chr10",401555,2,1,2,5,"chr10",1,0.0134786685419597
"12941","chr10.6985000.6990000","chr10.7115000.7120000",130000,14,0.006930734,6985000,7115000,6990000,7120000,"chr10",401598,6,8,15,29,"chr10",1,0.0475855602437881
"12942","chr10.95330000.95335000","chr10.95400000.95405000",70000,19,0.003959344,95330000,95400000,95335000,95405000,"chr10",401602,2,8,6,16,"chr10",1,0.0356305672761369
"12943","chr10.71965000.71970000","chr10.72105000.72110000",140000,19,7.664779e-06,71965000,72105000,71970000,72110000,"chr10",401699,2,1,2,5,"chr10",1,0.0111345522737928
"12944","chr10.63610000.63615000","chr10.63630000.63635000",20000,40,0.0004347818,63610000,63630000,63615000,63635000,"chr10",401761,6,10,19,35,"chr10",1,0.164088138771683
"12945","chr10.20310000.20315000","chr10.21075000.21080000",765000,7,0.008561686,20310000,21075000,20315000,21080000,"chr10",401782,2,2,6,10,"chr10",1,0.00820440693858415
"12946","chr10.31015000.31020000","chr10.31885000.31890000",870000,9,0.0001061234,31015000,31885000,31020000,31890000,"chr10",401788,4,5,5,14,"chr10",1,0.0147679324894515
"12947","chr10.119130000.119135000","chr10.120100000.120105000",970000,7,0.002484727,119130000,120100000,119135000,120105000,"chr10",401829,2,1,1,4,"chr10",1,0.00328176277543366
"12948","chr10.124955000.124960000","chr10.125140000.125145000",185000,15,0.0002184597,124955000,125140000,124960000,125145000,"chr10",401841,1,8,3,12,"chr10",1,0.0210970464135021
"12949","chr10.71205000.71210000","chr10.71275000.71280000",70000,20,0.001511564,71205000,71275000,71210000,71280000,"chr10",401878,0,1,0,1,"chr10",1,0.0023441162681669
"12950","chr10.72330000.72335000","chr10.72625000.72630000",295000,10,0.008355344,72330000,72625000,72335000,72630000,"chr10",402147,0,0,3,3,"chr10",1,0.00351617440225035
"12951","chr10.124800000.124805000","chr10.125060000.125065000",260000,17,3.765644e-07,124800000,125060000,124805000,125065000,"chr10",402148,3,2,0,5,"chr10",1,0.00996249413970933
"12952","chr10.104255000.104260000","chr10.104335000.104340000",80000,29,2.729668e-09,104255000,104335000,104260000,104340000,"chr10",402173,5,0,3,8,"chr10",1,0.0271917487107361
"12953","chr10.30645000.30650000","chr10.30855000.30860000",210000,12,0.004560495,30645000,30855000,30650000,30860000,"chr10",402271,2,4,4,10,"chr10",1,0.0140646976090014
"12954","chr10.6150000.6155000","chr10.6445000.6450000",295000,28,2.317529e-18,6150000,6445000,6155000,6450000,"chr10",402289,0,6,3,9,"chr10",1,0.029535864978903
"12955","chr10.25015000.25020000","chr10.25225000.25230000",210000,14,0.0003343528,25015000,25225000,25020000,25230000,"chr10",402300,2,3,1,6,"chr10",1,0.00984528832630099
"12956","chr10.20110000.20115000","chr10.20285000.20290000",175000,18,4.401708e-06,20110000,20285000,20115000,20290000,"chr10",402309,0,2,2,4,"chr10",1,0.00843881856540084
"12957","chr10.7570000.7575000","chr10.7735000.7740000",165000,13,0.005801717,7570000,7735000,7575000,7740000,"chr10",402363,7,8,8,23,"chr10",1,0.0350445382090952
"12958","chr10.100225000.100230000","chr10.101000000.101005000",775000,18,8.94251e-14,100225000,1.01e+08,100230000,101005000,"chr10",402365,1,4,3,8,"chr10",1,0.0168776371308017
"12959","chr10.22925000.22930000","chr10.23045000.23050000",120000,16,0.001213263,22925000,23045000,22930000,23050000,"chr10",402391,4,15,7,26,"chr10",1,0.0487576183778715
"12960","chr10.122285000.122290000","chr10.122465000.122470000",180000,13,0.003456488,122285000,122465000,122290000,122470000,"chr10",402416,0,0,3,3,"chr10",1,0.00457102672292546
"12961","chr10.89415000.89420000","chr10.90315000.90320000",900000,9,8.261355e-05,89415000,90315000,89420000,90320000,"chr10",402465,0,2,2,4,"chr10",1,0.00421940928270042
"12962","chr10.25225000.25230000","chr10.25965000.25970000",740000,7,0.009812416,25225000,25965000,25230000,25970000,"chr10",402501,0,0,2,2,"chr10",1,0.00164088138771683
"12963","chr10.104010000.104015000","chr10.104075000.104080000",65000,20,0.003071821,104010000,104075000,104015000,104080000,"chr10",402511,0,2,0,2,"chr10",1,0.0046882325363338
"12964","chr10.70305000.70310000","chr10.70360000.70365000",55000,24,0.0003932834,70305000,70360000,70310000,70365000,"chr10",402522,0,1,7,8,"chr10",1,0.0225035161744023
"12965","chr10.102065000.102070000","chr10.102130000.102135000",65000,20,0.003071821,102065000,102130000,102070000,102135000,"chr10",402532,0,4,0,4,"chr10",1,0.00937646507266761
"12966","chr10.6150000.6155000","chr10.6170000.6175000",20000,39,0.0008876436,6150000,6170000,6155000,6175000,"chr10",402592,3,13,9,25,"chr10",1,0.114275668073136
"12967","chr10.97180000.97185000","chr10.97330000.97335000",150000,18,1.817872e-05,97180000,97330000,97185000,97335000,"chr10",402597,1,5,7,13,"chr10",1,0.0274261603375527
"12968","chr10.12110000.12115000","chr10.12235000.12240000",125000,19,2.01441e-05,12110000,12235000,12115000,12240000,"chr10",402622,4,14,10,28,"chr10",1,0.0623534927332396
"12969","chr10.91005000.91010000","chr10.91130000.91135000",125000,21,1.118589e-06,91005000,91130000,91010000,91135000,"chr10",402660,1,1,1,3,"chr10",1,0.00738396624472574
"12970","chr10.80065000.80070000","chr10.80340000.80345000",275000,11,0.003274878,80065000,80340000,80070000,80345000,"chr10",402711,6,21,13,40,"chr10",1,0.0515705578996718
"12971","chr10.100230000.100235000","chr10.101040000.101045000",810000,8,0.001148884,100230000,101040000,100235000,101045000,"chr10",402720,4,7,4,15,"chr10",1,0.0140646976090014
"12972","chr10.12260000.12265000","chr10.13090000.13095000",830000,7,0.005880899,12260000,13090000,12265000,13095000,"chr10",402769,1,7,2,10,"chr10",1,0.00820440693858415
"12973","chr10.69625000.69630000","chr10.69855000.69860000",230000,12,0.002575301,69625000,69855000,69630000,69860000,"chr10",402848,0,2,0,2,"chr10",1,0.00281293952180028
"12974","chr10.114820000.114825000","chr10.114865000.114870000",45000,24,0.003089335,114820000,114865000,114825000,114870000,"chr10",402894,0,4,4,8,"chr10",1,0.0225035161744023
"12975","chr10.73810000.73815000","chr10.73965000.73970000",155000,18,1.364524e-05,73810000,73965000,73815000,73970000,"chr10",402906,0,8,2,10,"chr10",1,0.0210970464135021
"12976","chr10.102350000.102355000","chr10.102610000.102615000",260000,11,0.004527275,102350000,102610000,102355000,102615000,"chr10",402916,0,4,1,5,"chr10",1,0.00644631973745898
"12977","chr10.75015000.75020000","chr10.75415000.75420000",400000,13,1.400821e-05,75015000,75415000,75020000,75420000,"chr10",402927,0,3,1,4,"chr10",1,0.00609470229723394
"12978","chr10.103610000.103615000","chr10.103760000.103765000",150000,18,1.817872e-05,103610000,103760000,103615000,103765000,"chr10",403034,2,1,0,3,"chr10",1,0.00632911392405063
"12979","chr10.24665000.24670000","chr10.24865000.24870000",200000,13,0.001776106,24665000,24865000,24670000,24870000,"chr10",403049,2,1,5,8,"chr10",1,0.0121894045944679
"12980","chr10.97095000.97100000","chr10.97355000.97360000",260000,14,6.077607e-05,97095000,97355000,97100000,97360000,"chr10",403082,0,3,2,5,"chr10",1,0.00820440693858415
"12981","chr10.100230000.100235000","chr10.101015000.101020000",785000,10,2.861924e-05,100230000,101015000,100235000,101020000,"chr10",403109,4,7,4,15,"chr10",1,0.0175808720112518
"12982","chr10.25080000.25085000","chr10.25110000.25115000",30000,30,0.004565405,25080000,25110000,25085000,25115000,"chr10",403153,5,8,13,26,"chr10",1,0.0914205344585091
"12983","chr10.6190000.6195000","chr10.6245000.6250000",55000,25,0.0001424457,6190000,6245000,6195000,6250000,"chr10",403185,1,12,5,18,"chr10",1,0.0527426160337553
"12984","chr10.6985000.6990000","chr10.7445000.7450000",460000,9,0.004414296,6985000,7445000,6990000,7450000,"chr10",403194,4,3,12,19,"chr10",1,0.020042194092827
"12985","chr10.97220000.97225000","chr10.97355000.97360000",135000,15,0.001884685,97220000,97355000,97225000,97360000,"chr10",403217,0,3,2,5,"chr10",1,0.00879043600562588
"12986","chr10.73965000.73970000","chr10.73995000.74000000",30000,31,0.002227343,73965000,73995000,73970000,7.4e+07,"chr10",403273,1,4,5,10,"chr10",1,0.036333802156587
"12987","chr10.126625000.126630000","chr10.126655000.126660000",30000,29,0.008945346,126625000,126655000,126630000,126660000,"chr10",403353,2,11,11,24,"chr10",1,0.0815752461322082
"12988","chr10.71975000.71980000","chr10.72420000.72425000",445000,9,0.005131684,71975000,72420000,71980000,72425000,"chr10",403358,2,6,18,26,"chr10",1,0.0274261603375527
"12989","chr10.15345000.15350000","chr10.15385000.15390000",40000,44,2.436182e-12,15345000,15385000,15350000,15390000,"chr10",403371,4,6,3,13,"chr10",1,0.0670417252695734
"12990","chr10.75290000.75295000","chr10.75475000.75480000",185000,14,0.0008425915,75290000,75475000,75295000,75480000,"chr10",403403,1,1,2,4,"chr10",1,0.00656352555086732
"12991","chr10.15320000.15325000","chr10.15415000.15420000",95000,16,0.006240607,15320000,15415000,15325000,15420000,"chr10",403407,1,7,2,10,"chr10",1,0.0187529301453352
"12992","chr10.92840000.92845000","chr10.92880000.92885000",40000,24,0.009865195,92840000,92880000,92845000,92885000,"chr10",403429,2,5,1,8,"chr10",1,0.0225035161744023
"12993","chr10.80065000.80070000","chr10.80595000.80600000",530000,11,6.971313e-05,80065000,80595000,80070000,80600000,"chr10",403439,1,2,0,3,"chr10",1,0.00386779184247539
"12994","chr10.12260000.12265000","chr10.12740000.12745000",480000,10,0.0007413742,12260000,12740000,12265000,12745000,"chr10",403445,2,10,14,26,"chr10",1,0.0304735114861697
"12995","chr10.6140000.6145000","chr10.6445000.6450000",305000,15,2.996663e-06,6140000,6445000,6145000,6450000,"chr10",403454,0,3,3,6,"chr10",1,0.0105485232067511
"12996","chr10.70335000.70340000","chr10.70525000.70530000",190000,12,0.008135178,70335000,70525000,70340000,70530000,"chr10",403550,0,2,1,3,"chr10",1,0.00421940928270042
"12997","chr10.7310000.7315000","chr10.7440000.7445000",130000,22,1.611099e-07,7310000,7440000,7315000,7445000,"chr10",403594,6,7,8,21,"chr10",1,0.0541490857946554
"12998","chr10.73645000.73650000","chr10.73780000.73785000",135000,14,0.00573319,73645000,73780000,73650000,73785000,"chr10",403659,0,0,3,3,"chr10",1,0.00492264416315049
"12999","chr10.80340000.80345000","chr10.80370000.80375000",30000,29,0.008945346,80340000,80370000,80345000,80375000,"chr10",403671,2,8,2,12,"chr10",1,0.0407876230661041
"13000","chr10.22845000.22850000","chr10.22985000.22990000",140000,15,0.001511564,22845000,22985000,22850000,22990000,"chr10",403677,2,5,5,12,"chr10",1,0.0210970464135021
"13001","chr10.12040000.12045000","chr10.12065000.12070000",25000,33,0.008561686,12040000,12065000,12045000,12070000,"chr10",403701,0,3,5,8,"chr10",1,0.0309423347398031
"13002","chr10.101270000.101275000","chr10.101330000.101335000",60000,20,0.006321056,101270000,101330000,101275000,101335000,"chr10",403705,4,6,11,21,"chr10",1,0.0492264416315049
"13003","chr10.92845000.92850000","chr10.93030000.93035000",185000,14,0.0008425915,92845000,93030000,92850000,93035000,"chr10",403706,4,16,6,26,"chr10",1,0.0426629160806376
"13004","chr10.74380000.74385000","chr10.75020000.75025000",640000,8,0.003959344,74380000,75020000,74385000,75025000,"chr10",403709,2,4,6,12,"chr10",1,0.0112517580872011
"13005","chr10.72570000.72575000","chr10.72625000.72630000",55000,29,1.585294e-06,72570000,72625000,72575000,72630000,"chr10",403730,7,25,14,46,"chr10",1,0.156352555086732
"13006","chr10.126685000.126690000","chr10.126745000.126750000",60000,39,1.782714e-13,126685000,126745000,126690000,126750000,"chr10",403834,0,0,1,1,"chr10",1,0.00457102672292546
"13007","chr10.70270000.70275000","chr10.70725000.70730000",455000,9,0.004626069,70270000,70725000,70275000,70730000,"chr10",403885,2,4,3,9,"chr10",1,0.00949367088607595
"13008","chr10.5740000.5745000","chr10.5855000.5860000",115000,20,1.061964e-05,5740000,5855000,5745000,5860000,"chr10",403907,1,3,4,8,"chr10",1,0.0187529301453352
"13009","chr10.71275000.71280000","chr10.71390000.71395000",115000,19,4.200104e-05,71275000,71390000,71280000,71395000,"chr10",403975,0,2,0,2,"chr10",1,0.00445382090951711
"13010","chr10.75235000.75240000","chr10.75415000.75420000",180000,13,0.003456488,75235000,75415000,75240000,75420000,"chr10",404030,1,3,1,5,"chr10",1,0.00761837787154243
"13011","chr10.73590000.73595000","chr10.73645000.73650000",55000,21,0.006045969,73590000,73645000,73595000,73650000,"chr10",404045,0,0,3,3,"chr10",1,0.00738396624472574
"13012","chr10.74120000.74125000","chr10.75015000.75020000",895000,8,0.0006339813,74120000,75015000,74125000,75020000,"chr10",404064,0,4,1,5,"chr10",1,0.0046882325363338
"13013","chr10.97445000.97450000","chr10.97670000.97675000",225000,14,0.0001943461,97445000,97670000,97450000,97675000,"chr10",404126,0,8,6,14,"chr10",1,0.0229723394280356
"13014","chr10.12420000.12425000","chr10.12740000.12745000",320000,11,0.001410809,12420000,12740000,12425000,12745000,"chr10",404242,2,10,14,26,"chr10",1,0.0335208626347867
"13015","chr10.15720000.15725000","chr10.15745000.15750000",25000,37,0.0005571591,15720000,15745000,15725000,15750000,"chr10",404260,1,2,4,7,"chr10",1,0.0303563056727614
"13016","chr10.25680000.25685000","chr10.25700000.25705000",20000,41,0.0002083528,25680000,25700000,25685000,25705000,"chr10",404268,3,7,5,15,"chr10",1,0.0720815752461322
"13017","chr10.103920000.103925000","chr10.104075000.104080000",155000,13,0.008179677,103920000,104075000,103925000,104080000,"chr10",404272,0,1,0,1,"chr10",1,0.00152367557430849
"13018","chr10.24965000.24970000","chr10.25290000.25295000",325000,11,0.001287545,24965000,25290000,24970000,25295000,"chr10",404279,0,3,0,3,"chr10",1,0.00386779184247539
"13019","chr10.97125000.97130000","chr10.97355000.97360000",230000,21,8.843076e-10,97125000,97355000,97130000,97360000,"chr10",404324,0,6,11,17,"chr10",1,0.0418424753867792
"13020","chr10.121450000.121455000","chr10.121485000.121490000",35000,29,0.001038926,121450000,121485000,121455000,121490000,"chr10",404442,0,4,3,7,"chr10",1,0.023792780121894
"13021","chr10.78945000.78950000","chr10.79400000.79405000",455000,10,0.001012615,78945000,79400000,78950000,79405000,"chr10",404444,0,0,3,3,"chr10",1,0.00351617440225035
"13022","chr10.103650000.103655000","chr10.103770000.103775000",120000,20,7.139547e-06,103650000,103770000,103655000,103775000,"chr10",404451,3,1,5,9,"chr10",1,0.0210970464135021
"13023","chr10.6145000.6150000","chr10.6190000.6195000",45000,30,9.85819e-06,6145000,6190000,6150000,6195000,"chr10",404452,3,4,2,9,"chr10",1,0.0316455696202532
"13024","chr10.122980000.122985000","chr10.123130000.123135000",150000,18,1.817872e-05,122980000,123130000,122985000,123135000,"chr10",404496,2,3,3,8,"chr10",1,0.0168776371308017
"13025","chr10.28975000.28980000","chr10.29155000.29160000",180000,22,3.757934e-09,28975000,29155000,28980000,29160000,"chr10",404634,0,4,1,5,"chr10",1,0.012892639474918
"13026","chr10.470000.475000","chr10.810000.815000",340000,11,0.001026061,470000,810000,475000,815000,"chr10",404649,0,4,1,5,"chr10",1,0.00644631973745898
"13027","chr10.22515000.22520000","chr10.22600000.22605000",85000,27,2.06773e-08,22515000,22600000,22520000,22605000,"chr10",404713,6,11,16,33,"chr10",1,0.104430379746835
"13028","chr10.295000.300000","chr10.340000.345000",45000,25,0.001309789,295000,340000,3e+05,345000,"chr10",404739,5,11,14,30,"chr10",1,0.0879043600562588
"13029","chr10.7305000.7310000","chr10.7440000.7445000",135000,29,4.524341e-13,7305000,7440000,7310000,7445000,"chr10",404799,1,6,11,18,"chr10",1,0.0611814345991561
"13030","chr10.122875000.122880000","chr10.123365000.123370000",490000,10,0.0006546515,122875000,123365000,122880000,123370000,"chr10",405027,0,2,1,3,"chr10",1,0.00351617440225035
"13031","chr10.24480000.24485000","chr10.24805000.24810000",325000,10,0.005278928,24480000,24805000,24485000,24810000,"chr10",405047,6,11,10,27,"chr10",1,0.0316455696202532
"13032","chr10.103980000.103985000","chr10.104205000.104210000",225000,12,0.002958583,103980000,104205000,103985000,104210000,"chr10",405125,0,2,0,2,"chr10",1,0.00281293952180028
"13033","chr10.78945000.78950000","chr10.79475000.79480000",530000,9,0.00214094,78945000,79475000,78950000,79480000,"chr10",405177,0,3,1,4,"chr10",1,0.00421940928270042
"13034","chr10.103650000.103655000","chr10.103745000.103750000",95000,21,2.051234e-05,103650000,103745000,103655000,103750000,"chr10",405185,3,1,5,9,"chr10",1,0.0221518987341772
"13035","chr10.70360000.70365000","chr10.70430000.70435000",70000,23,6.169143e-05,70360000,70430000,70365000,70435000,"chr10",405204,7,6,8,21,"chr10",1,0.0566104078762307
"13036","chr10.495000.500000","chr10.650000.655000",155000,22,2.433592e-08,495000,650000,5e+05,655000,"chr10",405225,0,2,2,4,"chr10",1,0.0103141115799344
"13037","chr10.125740000.125745000","chr10.126080000.126085000",340000,13,4.303271e-05,125740000,126080000,125745000,126085000,"chr10",405232,1,2,0,3,"chr10",1,0.00457102672292546
"13038","chr10.121450000.121455000","chr10.121610000.121615000",160000,28,2.236876e-13,121450000,121610000,121455000,121615000,"chr10",405311,0,4,7,11,"chr10",1,0.0360993905297703
"13039","chr10.6160000.6165000","chr10.6225000.6230000",65000,20,0.003071821,6160000,6225000,6165000,6230000,"chr10",405316,0,1,2,3,"chr10",1,0.0070323488045007
"13040","chr10.31030000.31035000","chr10.31770000.31775000",740000,11,5.479119e-06,31030000,31770000,31035000,31775000,"chr10",405319,0,1,1,2,"chr10",1,0.00257852789498359
"13041","chr10.78970000.78975000","chr10.79465000.79470000",495000,13,2.600774e-06,78970000,79465000,78975000,79470000,"chr10",405331,3,5,6,14,"chr10",1,0.0213314580403188
"13042","chr10.12320000.12325000","chr10.12740000.12745000",420000,9,0.006657616,12320000,12740000,12325000,12745000,"chr10",405383,2,10,14,26,"chr10",1,0.0274261603375527
"13043","chr10.59315000.59320000","chr10.59335000.59340000",20000,36,0.006240607,59315000,59335000,59320000,59340000,"chr10",405405,1,1,1,3,"chr10",1,0.0126582278481013
"13044","chr10.13690000.13695000","chr10.14560000.14565000",870000,7,0.004657057,13690000,14560000,13695000,14565000,"chr10",405411,0,2,0,2,"chr10",1,0.00164088138771683
"13045","chr10.6920000.6925000","chr10.7310000.7315000",390000,12,9.580674e-05,6920000,7310000,6925000,7315000,"chr10",405434,0,2,5,7,"chr10",1,0.00984528832630099
"13046","chr10.103745000.103750000","chr10.103770000.103775000",25000,35,0.002331357,103745000,103770000,103750000,103775000,"chr10",405462,5,8,6,19,"chr10",1,0.0779418659165495
"13047","chr10.12260000.12265000","chr10.13075000.13080000",815000,8,0.001103634,12260000,13075000,12265000,13080000,"chr10",405472,0,3,5,8,"chr10",1,0.00750117205813408
"13048","chr10.23065000.23070000","chr10.23090000.23095000",25000,43,3.855664e-06,23065000,23090000,23070000,23095000,"chr10",405517,1,3,4,8,"chr10",1,0.0403187998124707
"13049","chr10.24965000.24970000","chr10.24985000.24990000",20000,43,4.376355e-05,24965000,24985000,24970000,24990000,"chr10",405518,0,3,0,3,"chr10",1,0.0151195499296765
"13050","chr10.22715000.22720000","chr10.22835000.22840000",120000,15,0.003759125,22715000,22835000,22720000,22840000,"chr10",405538,7,13,16,36,"chr10",1,0.0632911392405063
"13051","chr10.13045000.13050000","chr10.13085000.13090000",40000,24,0.009865195,13045000,13085000,13050000,13090000,"chr10",405663,2,8,3,13,"chr10",1,0.0365682137834037
"13052","chr10.72340000.72345000","chr10.72625000.72630000",285000,11,0.002657379,72340000,72625000,72345000,72630000,"chr10",405717,5,12,6,23,"chr10",1,0.0296530707923113
"13053","chr10.25465000.25470000","chr10.25875000.25880000",410000,9,0.007442771,25465000,25875000,25470000,25880000,"chr10",405740,0,0,2,2,"chr10",1,0.00210970464135021
"13054","chr10.114765000.114770000","chr10.114855000.114860000",90000,16,0.009113207,114765000,114855000,114770000,114860000,"chr10",405810,0,3,1,4,"chr10",1,0.00750117205813408
"13055","chr10.455000.460000","chr10.545000.550000",90000,17,0.003447325,455000,545000,460000,550000,"chr10",405900,1,1,1,3,"chr10",1,0.0059774964838256
"13056","chr10.126625000.126630000","chr10.126665000.126670000",40000,30,5.74208e-05,126625000,126665000,126630000,126670000,"chr10",405953,0,3,5,8,"chr10",1,0.0281293952180028
"13057","chr10.30670000.30675000","chr10.30840000.30845000",170000,14,0.001492468,30670000,30840000,30675000,30845000,"chr10",405971,1,3,3,7,"chr10",1,0.0114861697140178
"13058","chr10.35410000.35415000","chr10.35515000.35520000",105000,21,6.814435e-06,35410000,35515000,35415000,35520000,"chr10",405990,2,1,1,4,"chr10",1,0.00984528832630099
"13059","chr10.7260000.7265000","chr10.7305000.7310000",45000,26,0.0005367901,7260000,7305000,7265000,7310000,"chr10",406046,0,2,2,4,"chr10",1,0.0121894045944679
"13060","chr10.71955000.71960000","chr10.72045000.72050000",90000,16,0.009113207,71955000,72045000,71960000,72050000,"chr10",406072,0,2,1,3,"chr10",1,0.00562587904360056
"13061","chr10.28990000.28995000","chr10.29155000.29160000",165000,13,0.005801717,28990000,29155000,28995000,29160000,"chr10",406156,1,12,8,21,"chr10",1,0.0319971870604782
"13062","chr10.23010000.23015000","chr10.23090000.23095000",80000,19,0.001206444,23010000,23090000,23015000,23095000,"chr10",406218,0,1,0,1,"chr10",1,0.00222691045475856
"13063","chr10.97185000.97190000","chr10.97320000.97325000",135000,17,0.0001619335,97185000,97320000,97190000,97325000,"chr10",406270,1,3,1,5,"chr10",1,0.00996249413970933
"13064","chr10.108390000.108395000","chr10.108435000.108440000",45000,26,0.0005367901,108390000,108435000,108395000,108440000,"chr10",406286,0,4,5,9,"chr10",1,0.0274261603375527
"13065","chr10.71980000.71985000","chr10.72105000.72110000",125000,34,7.526312e-17,71980000,72105000,71985000,72110000,"chr10",406455,2,1,2,5,"chr10",1,0.0199249882794187
"13066","chr10.15260000.15265000","chr10.15290000.15295000",30000,29,0.008945346,15260000,15290000,15265000,15295000,"chr10",406474,2,6,5,13,"chr10",1,0.0441865916549461
"13067","chr10.104055000.104060000","chr10.104075000.104080000",20000,42,9.616299e-05,104055000,104075000,104060000,104080000,"chr10",406573,0,2,0,2,"chr10",1,0.00984528832630099
"13068","chr10.28975000.28980000","chr10.29585000.29590000",610000,8,0.004982721,28975000,29585000,28980000,29590000,"chr10",406631,0,4,1,5,"chr10",1,0.0046882325363338
"13069","chr10.6920000.6925000","chr10.7445000.7450000",525000,9,0.00224033,6920000,7445000,6925000,7450000,"chr10",406736,0,2,5,7,"chr10",1,0.00738396624472574
"13070","chr10.69615000.69620000","chr10.69855000.69860000",240000,15,2.470846e-05,69615000,69855000,69620000,69860000,"chr10",406806,0,3,0,3,"chr10",1,0.00527426160337553
"13071","chr10.126605000.126610000","chr10.126665000.126670000",60000,23,0.000392744,126605000,126665000,126610000,126670000,"chr10",406863,0,3,3,6,"chr10",1,0.0161744022503516
"13072","chr10.6145000.6150000","chr10.6245000.6250000",100000,16,0.004358971,6145000,6245000,6150000,6250000,"chr10",406917,1,4,2,7,"chr10",1,0.0131270511017346
"13073","chr10.95300000.95305000","chr10.95420000.95425000",120000,15,0.003759125,95300000,95420000,95305000,95425000,"chr10",406924,5,16,18,39,"chr10",1,0.0685654008438819
"13074","chr10.103675000.103680000","chr10.103695000.103700000",20000,38,0.001750436,103675000,103695000,103680000,103700000,"chr10",406961,0,3,3,6,"chr10",1,0.0267229254571027
"13075","chr10.70660000.70665000","chr10.70880000.70885000",220000,12,0.003386353,70660000,70880000,70665000,70885000,"chr10",407056,0,3,5,8,"chr10",1,0.0112517580872011
"13076","chr10.24955000.24960000","chr10.24985000.24990000",30000,30,0.004565405,24955000,24985000,24960000,24990000,"chr10",407080,2,4,3,9,"chr10",1,0.0316455696202532
"13077","chr10.31030000.31035000","chr10.31060000.31065000",30000,29,0.008945346,31030000,31060000,31035000,31065000,"chr10",407104,0,1,1,2,"chr10",1,0.00679793717768401
"13078","chr10.124885000.124890000","chr10.125140000.125145000",255000,17,4.654801e-07,124885000,125140000,124890000,125145000,"chr10",407120,1,8,3,12,"chr10",1,0.0239099859353024
"13079","chr10.110510000.110515000","chr10.110530000.110535000",20000,41,0.0002083528,110510000,110530000,110515000,110535000,"chr10",407144,0,3,2,5,"chr10",1,0.0240271917487107
"13080","chr10.103220000.103225000","chr10.103295000.103300000",75000,27,1.466835e-07,103220000,103295000,103225000,103300000,"chr10",407238,13,29,28,70,"chr10",1,0.221518987341772
"13081","chr10.62610000.62615000","chr10.62785000.62790000",175000,13,0.004132041,62610000,62785000,62615000,62790000,"chr10",407343,0,2,1,3,"chr10",1,0.00457102672292546
"13082","chr10.24950000.24955000","chr10.25065000.25070000",115000,16,0.001633531,24950000,25065000,24955000,25070000,"chr10",407402,1,3,2,6,"chr10",1,0.0112517580872011
"13083","chr10.14600000.14605000","chr10.14875000.14880000",275000,15,7.349294e-06,14600000,14875000,14605000,14880000,"chr10",407417,2,2,7,11,"chr10",1,0.0193389592123769
"13084","chr10.103640000.103645000","chr10.103755000.103760000",115000,18,0.0001507044,103640000,103755000,103645000,103760000,"chr10",407470,1,2,4,7,"chr10",1,0.0147679324894515
"13085","chr10.23045000.23050000","chr10.23090000.23095000",45000,34,9.5825e-08,23045000,23090000,23050000,23095000,"chr10",407479,1,3,4,8,"chr10",1,0.0318799812470699
"13086","chr10.124800000.124805000","chr10.125140000.125145000",340000,31,5.932981e-23,124800000,125140000,124805000,125145000,"chr10",407542,1,8,3,12,"chr10",1,0.0436005625879044
"13087","chr10.95510000.95515000","chr10.95570000.95575000",60000,22,0.001038926,95510000,95570000,95515000,95575000,"chr10",407555,3,7,10,20,"chr10",1,0.0515705578996718
"13088","chr10.11225000.11230000","chr10.11250000.11255000",25000,49,1.025408e-08,11225000,11250000,11230000,11255000,"chr10",407557,0,1,2,3,"chr10",1,0.0172292545710267
"13089","chr10.62270000.62275000","chr10.62370000.62375000",100000,17,0.001510072,62270000,62370000,62275000,62375000,"chr10",407644,0,2,0,2,"chr10",1,0.00398499765588373
"13090","chr10.119195000.119200000","chr10.120100000.120105000",905000,7,0.003779704,119195000,120100000,119200000,120105000,"chr10",407729,2,1,1,4,"chr10",1,0.00328176277543366
"13091","chr10.15250000.15255000","chr10.15415000.15420000",165000,20,3.345556e-07,15250000,15415000,15255000,15420000,"chr10",407732,3,8,2,13,"chr10",1,0.0304735114861697
"13092","chr10.14520000.14525000","chr10.14615000.14620000",95000,16,0.006240607,14520000,14615000,14525000,14620000,"chr10",407791,4,9,8,21,"chr10",1,0.0393811533052039
"13093","chr10.103640000.103645000","chr10.103815000.103820000",175000,15,0.000340692,103640000,103815000,103645000,103820000,"chr10",407793,2,2,4,8,"chr10",1,0.0140646976090014
"13094","chr10.73995000.74000000","chr10.74025000.74030000",30000,36,3.696555e-05,73995000,74025000,7.4e+07,74030000,"chr10",407803,3,4,5,12,"chr10",1,0.0506329113924051
"13095","chr10.126525000.126530000","chr10.126595000.126600000",70000,21,0.0005470535,126525000,126595000,126530000,126600000,"chr10",407932,0,0,6,6,"chr10",1,0.0147679324894515
"13096","chr10.25020000.25025000","chr10.25225000.25230000",205000,18,8.566775e-07,25020000,25225000,25025000,25230000,"chr10",407950,3,1,6,10,"chr10",1,0.0210970464135021
"13097","chr10.6955000.6960000","chr10.7205000.7210000",250000,11,0.005633679,6955000,7205000,6960000,7210000,"chr10",408037,1,2,6,9,"chr10",1,0.0116033755274262
"13098","chr10.24900000.24905000","chr10.25290000.25295000",390000,11,0.0004880646,24900000,25290000,24905000,25295000,"chr10",408045,0,3,5,8,"chr10",1,0.0103141115799344
"13099","chr10.28980000.28985000","chr10.29155000.29160000",175000,13,0.004132041,28980000,29155000,28985000,29160000,"chr10",408098,1,9,10,20,"chr10",1,0.0304735114861697
"13100","chr10.15275000.15280000","chr10.15415000.15420000",140000,15,0.001511564,15275000,15415000,15280000,15420000,"chr10",408112,4,8,11,23,"chr10",1,0.040436005625879
"13101","chr10.92845000.92850000","chr10.92880000.92885000",35000,35,4.050693e-06,92845000,92880000,92850000,92885000,"chr10",408230,2,5,1,8,"chr10",1,0.0328176277543366
"13102","chr10.102065000.102070000","chr10.102150000.102155000",85000,22,2.051234e-05,102065000,102150000,102070000,102155000,"chr10",408258,0,4,0,4,"chr10",1,0.0103141115799344
"13103","chr10.100225000.100230000","chr10.101010000.101015000",785000,15,2.303877e-10,100225000,101010000,100230000,101015000,"chr10",408267,0,4,3,7,"chr10",1,0.0123066104078762
"13104","chr10.12420000.12425000","chr10.12460000.12465000",40000,26,0.002127745,12420000,12460000,12425000,12465000,"chr10",408280,3,21,17,41,"chr10",1,0.124941397093296
"13105","chr10.99330000.99335000","chr10.99375000.99380000",45000,23,0.006896136,99330000,99375000,99335000,99380000,"chr10",408294,2,4,3,9,"chr10",1,0.0242616033755274
"13106","chr10.104260000.104265000","chr10.104345000.104350000",85000,65,2.025771e-42,104260000,104345000,104265000,104350000,"chr10",408360,0,2,0,2,"chr10",1,0.0152367557430849
"13107","chr10.103220000.103225000","chr10.103240000.103245000",20000,42,9.616299e-05,103220000,103240000,103225000,103245000,"chr10",408446,4,10,10,24,"chr10",1,0.118143459915612
"13108","chr10.31060000.31065000","chr10.32055000.32060000",995000,7,0.002111122,31060000,32055000,31065000,32060000,"chr10",408463,0,1,1,2,"chr10",1,0.00164088138771683
"13109","chr10.102065000.102070000","chr10.102180000.102185000",115000,21,2.600774e-06,102065000,102180000,102070000,102185000,"chr10",408466,0,4,0,4,"chr10",1,0.00984528832630099
"13110","chr10.6125000.6130000","chr10.6150000.6155000",25000,37,0.0005571591,6125000,6150000,6130000,6155000,"chr10",408522,2,11,5,18,"chr10",1,0.0780590717299578
"13111","chr10.122735000.122740000","chr10.123365000.123370000",630000,9,0.0008074568,122735000,123365000,122740000,123370000,"chr10",408523,0,2,1,3,"chr10",1,0.00316455696202532
"13112","chr10.71990000.71995000","chr10.72010000.72015000",20000,38,0.001750436,71990000,72010000,71995000,72015000,"chr10",408560,2,1,2,5,"chr10",1,0.0222691045475856
"13113","chr10.25500000.25505000","chr10.25965000.25970000",465000,12,2.863809e-05,25500000,25965000,25505000,25970000,"chr10",408580,0,0,2,2,"chr10",1,0.00281293952180028
"13114","chr10.23010000.23015000","chr10.23065000.23070000",55000,22,0.002536929,23010000,23065000,23015000,23070000,"chr10",408622,0,1,0,1,"chr10",1,0.00257852789498359
"13115","chr10.84225000.84230000","chr10.84245000.84250000",20000,42,9.616299e-05,84225000,84245000,84230000,84250000,"chr10",408625,0,3,1,4,"chr10",1,0.019690576652602
"13116","chr10.12345000.12350000","chr10.12785000.12790000",440000,13,6.814435e-06,12345000,12785000,12350000,12790000,"chr10",408630,7,30,24,61,"chr10",1,0.0929442100328176
"13117","chr10.114765000.114770000","chr10.114865000.114870000",100000,19,0.0001506426,114765000,114865000,114770000,114870000,"chr10",408644,0,3,1,4,"chr10",1,0.00890764181903422
"13118","chr10.91550000.91555000","chr10.91905000.91910000",355000,12,0.000169549,91550000,91905000,91555000,91910000,"chr10",408659,0,2,5,7,"chr10",1,0.00984528832630099
"13119","chr10.97530000.97535000","chr10.97585000.97590000",55000,23,0.001022284,97530000,97585000,97535000,97590000,"chr10",408662,6,14,15,35,"chr10",1,0.0943506797937178
"13120","chr10.35530000.35535000","chr10.35610000.35615000",80000,18,0.003328662,35530000,35610000,35535000,35615000,"chr10",408688,1,3,2,6,"chr10",1,0.0126582278481013
"13121","chr10.80155000.80160000","chr10.80945000.80950000",790000,13,3.143943e-08,80155000,80945000,80160000,80950000,"chr10",408768,0,2,0,2,"chr10",1,0.00304735114861697
"13122","chr10.73580000.73585000","chr10.73995000.74000000",415000,10,0.001652022,73580000,73995000,73585000,7.4e+07,"chr10",408840,3,4,5,12,"chr10",1,0.0140646976090014
"13123","chr10.80065000.80070000","chr10.80945000.80950000",880000,16,3.529368e-12,80065000,80945000,80070000,80950000,"chr10",408857,1,2,0,3,"chr10",1,0.00562587904360056
"13124","chr10.28975000.28980000","chr10.29535000.29540000",560000,11,4.658119e-05,28975000,29535000,28980000,29540000,"chr10",408909,0,3,1,4,"chr10",1,0.00515705578996718
"13125","chr10.24965000.24970000","chr10.25875000.25880000",910000,7,0.003661783,24965000,25875000,24970000,25880000,"chr10",409004,0,3,0,3,"chr10",1,0.00246132208157525
"13126","chr10.11250000.11255000","chr10.11270000.11275000",20000,36,0.006240607,11250000,11270000,11255000,11275000,"chr10",409023,0,2,1,3,"chr10",1,0.0126582278481013
"13127","chr10.103640000.103645000","chr10.103780000.103785000",140000,21,3.737732e-07,103640000,103780000,103645000,103785000,"chr10",409038,2,2,4,8,"chr10",1,0.019690576652602
"13128","chr10.15230000.15235000","chr10.15425000.15430000",195000,15,0.0001458754,15230000,15425000,15235000,15430000,"chr10",409056,1,2,7,10,"chr10",1,0.0175808720112518
"13129","chr10.80065000.80070000","chr10.80680000.80685000",615000,8,0.004809562,80065000,80680000,80070000,80685000,"chr10",409069,0,3,2,5,"chr10",1,0.0046882325363338
"13130","chr10.103635000.103640000","chr10.103760000.103765000",125000,17,0.0002785341,103635000,103760000,103640000,103765000,"chr10",409136,0,2,5,7,"chr10",1,0.0139474917955931
"13131","chr10.495000.500000","chr10.845000.850000",350000,16,1.389931e-07,495000,845000,5e+05,850000,"chr10",409219,0,2,0,2,"chr10",1,0.00375058602906704
"13132","chr10.124880000.124885000","chr10.125140000.125145000",260000,13,0.0002787561,124880000,125140000,124885000,125145000,"chr10",409235,1,8,3,12,"chr10",1,0.0182841068917018
"13133","chr10.14215000.14220000","chr10.14525000.14530000",310000,11,0.001684379,14215000,14525000,14220000,14530000,"chr10",409309,0,9,7,16,"chr10",1,0.0206282231598687
"13134","chr10.93825000.93830000","chr10.94075000.94080000",250000,13,0.0003791695,93825000,94075000,93830000,94080000,"chr10",409321,0,7,5,12,"chr10",1,0.0182841068917018
"13135","chr10.104270000.104275000","chr10.104345000.104350000",75000,39,5.614033e-16,104270000,104345000,104275000,104350000,"chr10",409328,0,0,7,7,"chr10",1,0.0319971870604782
"13136","chr10.125060000.125065000","chr10.125120000.125125000",60000,25,4.641293e-05,125060000,125120000,125065000,125125000,"chr10",409387,1,2,0,3,"chr10",1,0.00879043600562588
"13137","chr10.105690000.105695000","chr10.105875000.105880000",185000,15,0.0002184597,105690000,105875000,105695000,105880000,"chr10",409399,0,1,2,3,"chr10",1,0.00527426160337553
"13138","chr10.17215000.17220000","chr10.17255000.17260000",40000,27,0.0009142507,17215000,17255000,17220000,17260000,"chr10",409403,1,7,7,15,"chr10",1,0.0474683544303797
"13139","chr10.5840000.5845000","chr10.5915000.5920000",75000,18,0.005637674,5840000,5915000,5845000,5920000,"chr10",409417,0,4,1,5,"chr10",1,0.0105485232067511
"13140","chr10.28975000.28980000","chr10.29080000.29085000",105000,19,9.532682e-05,28975000,29080000,28980000,29085000,"chr10",409435,0,4,1,5,"chr10",1,0.0111345522737928
"13141","chr10.72340000.72345000","chr10.72420000.72425000",80000,18,0.003328662,72340000,72420000,72345000,72425000,"chr10",409447,5,12,6,23,"chr10",1,0.0485232067510548
"13142","chr10.60775000.60780000","chr10.60960000.60965000",185000,14,0.0008425915,60775000,60960000,60780000,60965000,"chr10",409467,0,1,1,2,"chr10",1,0.00328176277543366
"13143","chr10.28980000.28985000","chr10.29080000.29085000",100000,16,0.004358971,28980000,29080000,28985000,29085000,"chr10",409484,2,6,6,14,"chr10",1,0.0262541022034693
"13144","chr10.13345000.13350000","chr10.13610000.13615000",265000,11,0.00402911,13345000,13610000,13350000,13615000,"chr10",409582,2,9,8,19,"chr10",1,0.0244960150023441
"13145","chr10.121465000.121470000","chr10.121665000.121670000",200000,12,0.00605453,121465000,121665000,121470000,121670000,"chr10",409594,1,1,1,3,"chr10",1,0.00421940928270042
"13146","chr10.126605000.126610000","chr10.126655000.126660000",50000,27,5.8222e-05,126605000,126655000,126610000,126660000,"chr10",409747,1,6,3,10,"chr10",1,0.0316455696202532
"13147","chr10.104260000.104265000","chr10.104405000.104410000",145000,17,9.585142e-05,104260000,104405000,104265000,104410000,"chr10",409757,0,2,0,2,"chr10",1,0.00398499765588373
"13148","chr10.525000.530000","chr10.650000.655000",125000,14,0.008561686,525000,650000,530000,655000,"chr10",409767,0,2,2,4,"chr10",1,0.00656352555086732
"13149","chr10.5740000.5745000","chr10.5840000.5845000",100000,27,1.512021e-09,5740000,5840000,5745000,5845000,"chr10",409774,1,3,4,8,"chr10",1,0.0253164556962025
"13150","chr10.80605000.80610000","chr10.80945000.80950000",340000,10,0.004316179,80605000,80945000,80610000,80950000,"chr10",409786,0,2,0,2,"chr10",1,0.0023441162681669
"13151","chr10.75020000.75025000","chr10.75110000.75115000",90000,17,0.003447325,75020000,75110000,75025000,75115000,"chr10",409829,3,4,9,16,"chr10",1,0.0318799812470699
"13152","chr10.103930000.103935000","chr10.104120000.104125000",190000,12,0.008135178,103930000,104120000,103935000,104125000,"chr10",409882,1,2,1,4,"chr10",1,0.00562587904360056
"13153","chr10.104255000.104260000","chr10.104345000.104350000",90000,29,3.39838e-10,104255000,104345000,104260000,104350000,"chr10",409888,4,0,3,7,"chr10",1,0.023792780121894
"13154","chr10.92755000.92760000","chr10.93030000.93035000",275000,17,2.096373e-07,92755000,93030000,92760000,93035000,"chr10",409902,2,6,7,15,"chr10",1,0.029887482419128
"13155","chr10.14875000.14880000","chr10.15140000.15145000",265000,13,0.0002424219,14875000,15140000,14880000,15145000,"chr10",409935,2,2,7,11,"chr10",1,0.0167604313173933
"13156","chr10.14615000.14620000","chr10.14875000.14880000",260000,19,8.89278e-09,14615000,14875000,14620000,14880000,"chr10",409952,2,2,7,11,"chr10",1,0.0244960150023441
"13157","chr10.35565000.35570000","chr10.35880000.35885000",315000,11,0.001529788,35565000,35880000,35570000,35885000,"chr10",409971,0,3,3,6,"chr10",1,0.00773558368495077
"13158","chr10.6955000.6960000","chr10.7440000.7445000",485000,13,3.098814e-06,6955000,7440000,6960000,7445000,"chr10",410048,1,2,6,9,"chr10",1,0.0137130801687764
"13159","chr10.126610000.126615000","chr10.126655000.126660000",45000,25,0.001309789,126610000,126655000,126615000,126660000,"chr10",410051,1,3,2,6,"chr10",1,0.0175808720112518
"13160","chr10.31775000.31780000","chr10.31940000.31945000",165000,18,7.68889e-06,31775000,31940000,31780000,31945000,"chr10",410121,7,21,15,43,"chr10",1,0.0907172995780591
"13161","chr10.114390000.114395000","chr10.114850000.114855000",460000,10,0.00094762,114390000,114850000,114395000,114855000,"chr10",410251,1,6,5,12,"chr10",1,0.0140646976090014
"13162","chr10.97170000.97175000","chr10.97325000.97330000",155000,14,0.002650227,97170000,97325000,97175000,97330000,"chr10",410339,2,8,10,20,"chr10",1,0.0328176277543366
"13163","chr10.13650000.13655000","chr10.14520000.14525000",870000,8,0.000761464,13650000,14520000,13655000,14525000,"chr10",410391,0,8,6,14,"chr10",1,0.0131270511017346
"13164","chr10.103580000.103585000","chr10.103770000.103775000",190000,17,9.383181e-06,103580000,103770000,103585000,103775000,"chr10",410404,1,0,1,2,"chr10",1,0.00398499765588373
"13165","chr10.71965000.71970000","chr10.72155000.72160000",190000,12,0.008135178,71965000,72155000,71970000,72160000,"chr10",410407,2,4,7,13,"chr10",1,0.0182841068917018
"13166","chr10.495000.500000","chr10.685000.690000",190000,12,0.008135178,495000,685000,5e+05,690000,"chr10",410420,0,2,2,4,"chr10",1,0.00562587904360056
"13167","chr10.72325000.72330000","chr10.72420000.72425000",95000,17,0.002255301,72325000,72420000,72330000,72425000,"chr10",410458,0,9,5,14,"chr10",1,0.0278949835911861
"13168","chr10.100230000.100235000","chr10.101005000.101010000",775000,16,1.998313e-11,100230000,101005000,100235000,101010000,"chr10",410462,3,6,2,11,"chr10",1,0.0206282231598687
"13169","chr10.103050000.103055000","chr10.103220000.103225000",170000,14,0.001492468,103050000,103220000,103055000,103225000,"chr10",410499,2,19,12,33,"chr10",1,0.0541490857946554
"13170","chr10.122780000.122785000","chr10.123365000.123370000",585000,8,0.00612931,122780000,123365000,122785000,123370000,"chr10",410507,0,3,1,4,"chr10",1,0.00375058602906704
"13171","chr10.124325000.124330000","chr10.124460000.124465000",135000,21,5.31947e-07,124325000,124460000,124330000,124465000,"chr10",410536,2,1,2,5,"chr10",1,0.0123066104078762
"13172","chr10.13690000.13695000","chr10.13775000.13780000",85000,17,0.005416061,13690000,13775000,13695000,13780000,"chr10",410564,1,6,4,11,"chr10",1,0.0219174871073605
"13173","chr10.6920000.6925000","chr10.7205000.7210000",285000,10,0.009796166,6920000,7205000,6925000,7210000,"chr10",410571,0,2,5,7,"chr10",1,0.00820440693858415
"13174","chr10.103240000.103245000","chr10.103275000.103280000",35000,35,4.050693e-06,103240000,103275000,103245000,103280000,"chr10",410631,0,3,4,7,"chr10",1,0.0287154242850445
"13175","chr10.126595000.126600000","chr10.126665000.126670000",70000,26,1.582124e-06,126595000,126665000,126600000,126670000,"chr10",410654,0,3,5,8,"chr10",1,0.0243788091889358
"13176","chr10.74025000.74030000","chr10.74105000.74110000",80000,20,0.0004220823,74025000,74105000,74030000,74110000,"chr10",410709,0,10,11,21,"chr10",1,0.0492264416315049
"13177","chr10.100145000.100150000","chr10.101000000.101005000",855000,7,0.005063583,100145000,1.01e+08,100150000,101005000,"chr10",410777,1,4,4,9,"chr10",1,0.00738396624472574
"13178","chr10.5855000.5860000","chr10.5885000.5890000",30000,39,2.128706e-06,5855000,5885000,5860000,5890000,"chr10",410780,0,5,11,16,"chr10",1,0.0731364275668073
"13179","chr10.95525000.95530000","chr10.95570000.95575000",45000,27,0.0002106261,95525000,95570000,95530000,95575000,"chr10",410785,1,3,2,6,"chr10",1,0.0189873417721519
"13180","chr10.95400000.95405000","chr10.95420000.95425000",20000,43,4.376355e-05,95400000,95420000,95405000,95425000,"chr10",410938,5,11,6,22,"chr10",1,0.110876699484294
"13181","chr10.102675000.102680000","chr10.102710000.102715000",35000,27,0.004926953,102675000,102710000,102680000,102715000,"chr10",410949,0,0,2,2,"chr10",1,0.00632911392405063
"13182","chr10.75020000.75025000","chr10.75290000.75295000",270000,12,0.0009282395,75020000,75290000,75025000,75295000,"chr10",410994,1,1,2,4,"chr10",1,0.00562587904360056
"13183","chr10.46020000.46025000","chr10.46080000.46085000",60000,24,0.000138104,46020000,46080000,46025000,46085000,"chr10",411015,0,2,3,5,"chr10",1,0.0140646976090014
"13184","chr10.124915000.124920000","chr10.125285000.125290000",370000,10,0.002920256,124915000,125285000,124920000,125290000,"chr10",411099,0,2,2,4,"chr10",1,0.0046882325363338
"13185","chr10.91905000.91910000","chr10.92290000.92295000",385000,9,0.009687376,91905000,92290000,91910000,92295000,"chr10",411163,2,6,3,11,"chr10",1,0.0116033755274262
"13186","chr10.121440000.121445000","chr10.121610000.121615000",170000,26,4.505239e-12,121440000,121610000,121445000,121615000,"chr10",411183,0,6,5,11,"chr10",1,0.0335208626347867
"13187","chr10.72305000.72310000","chr10.72570000.72575000",265000,13,0.0002424219,72305000,72570000,72310000,72575000,"chr10",411208,4,21,14,39,"chr10",1,0.0594233473980309
"13188","chr10.15255000.15260000","chr10.15425000.15430000",170000,15,0.0004220823,15255000,15425000,15260000,15430000,"chr10",411231,1,2,3,6,"chr10",1,0.0105485232067511
"13189","chr10.28765000.28770000","chr10.28785000.28790000",20000,45,8.198013e-06,28765000,28785000,28770000,28790000,"chr10",411257,0,0,1,1,"chr10",1,0.00527426160337553
"13190","chr10.75020000.75025000","chr10.75305000.75310000",285000,10,0.009796166,75020000,75305000,75025000,75310000,"chr10",411351,3,3,2,8,"chr10",1,0.00937646507266761
"13191","chr10.100230000.100235000","chr10.100995000.101000000",765000,7,0.008561686,100230000,100995000,100235000,1.01e+08,"chr10",411379,0,2,0,2,"chr10",1,0.00164088138771683
"13192","chr10.122890000.122895000","chr10.122980000.122985000",90000,19,0.000410849,122890000,122980000,122895000,122985000,"chr10",411507,1,4,9,14,"chr10",1,0.0311767463666198
"13193","chr10.104485000.104490000","chr10.104595000.104600000",110000,22,9.748871e-07,104485000,104595000,104490000,104600000,"chr10",411547,0,0,2,2,"chr10",1,0.00515705578996718
"13194","chr10.31770000.31775000","chr10.32055000.32060000",285000,11,0.002657379,31770000,32055000,31775000,32060000,"chr10",411572,2,1,1,4,"chr10",1,0.00515705578996718
"13195","chr10.69615000.69620000","chr10.69645000.69650000",30000,43,3.143943e-08,69615000,69645000,69620000,69650000,"chr10",411585,1,3,3,7,"chr10",1,0.0352789498359119
"13196","chr10.3480000.3485000","chr10.3500000.3505000",20000,36,0.006240607,3480000,3500000,3485000,3505000,"chr10",411607,1,3,1,5,"chr10",1,0.0210970464135021
"13197","chr10.80355000.80360000","chr10.80405000.80410000",50000,23,0.002650227,80355000,80405000,80360000,80410000,"chr10",411668,0,1,0,1,"chr10",1,0.00269573370839194
"13198","chr10.28975000.28980000","chr10.29595000.29600000",620000,14,3.637402e-08,28975000,29595000,28980000,29600000,"chr10",411675,0,4,1,5,"chr10",1,0.00820440693858415
"13199","chr10.114480000.114485000","chr10.114885000.114890000",405000,11,0.0003991711,114480000,114885000,114485000,114890000,"chr10",411692,2,5,3,10,"chr10",1,0.012892639474918
"13200","chr10.123300000.123305000","chr10.123330000.123335000",30000,42,9.309695e-08,123300000,123330000,123305000,123335000,"chr10",411741,0,5,2,7,"chr10",1,0.0344585091420534
"13201","chr10.80340000.80345000","chr10.80415000.80420000",75000,19,0.00217959,80340000,80415000,80345000,80420000,"chr10",411809,2,6,10,18,"chr10",1,0.040084388185654
"13202","chr10.22830000.22835000","chr10.22895000.22900000",65000,19,0.007481698,22830000,22895000,22835000,22900000,"chr10",411845,1,2,1,4,"chr10",1,0.00890764181903422
"13203","chr10.71975000.71980000","chr10.72130000.72135000",155000,18,1.364524e-05,71975000,72130000,71980000,72135000,"chr10",411850,2,6,9,17,"chr10",1,0.0358649789029536
"13204","chr10.98130000.98135000","chr10.98305000.98310000",175000,14,0.001213263,98130000,98305000,98135000,98310000,"chr10",411858,2,3,4,9,"chr10",1,0.0147679324894515
"13205","chr10.34990000.34995000","chr10.35090000.35095000",100000,16,0.004358971,34990000,35090000,34995000,35095000,"chr10",411887,3,11,13,27,"chr10",1,0.0506329113924051
"13206","chr10.15300000.15305000","chr10.15385000.15390000",85000,27,2.06773e-08,15300000,15385000,15305000,15390000,"chr10",411964,2,18,5,25,"chr10",1,0.0791139240506329
"13207","chr10.13650000.13655000","chr10.13690000.13695000",40000,27,0.0009142507,13650000,13690000,13655000,13695000,"chr10",411965,0,8,6,14,"chr10",1,0.0443037974683544
"13208","chr10.103930000.103935000","chr10.104345000.104350000",415000,12,6.357115e-05,103930000,104345000,103935000,104350000,"chr10",411980,4,5,3,12,"chr10",1,0.0168776371308017
"13209","chr10.14535000.14540000","chr10.14875000.14880000",340000,17,2.527045e-08,14535000,14875000,14540000,14880000,"chr10",412002,2,2,5,9,"chr10",1,0.0179324894514768
"13210","chr10.103930000.103935000","chr10.103980000.103985000",50000,23,0.002650227,103930000,103980000,103935000,103985000,"chr10",412110,1,3,0,4,"chr10",1,0.0107829348335677
"13211","chr10.103065000.103070000","chr10.103190000.103195000",125000,18,7.740679e-05,103065000,103190000,103070000,103195000,"chr10",412113,2,4,1,7,"chr10",1,0.0147679324894515
"13212","chr10.22600000.22605000","chr10.22800000.22805000",200000,12,0.00605453,22600000,22800000,22605000,22805000,"chr10",412131,6,17,16,39,"chr10",1,0.0548523206751055
"13213","chr10.104305000.104310000","chr10.104345000.104350000",40000,29,0.0001507044,104305000,104345000,104310000,104350000,"chr10",412194,1,2,3,6,"chr10",1,0.020393811533052
"13214","chr10.84075000.84080000","chr10.84135000.84140000",60000,20,0.006321056,84075000,84135000,84080000,84140000,"chr10",412216,4,3,4,11,"chr10",1,0.0257852789498359
"13215","chr10.6955000.6960000","chr10.7445000.7450000",490000,19,4.800928e-12,6955000,7445000,6960000,7450000,"chr10",412227,1,2,6,9,"chr10",1,0.020042194092827
"13216","chr10.75015000.75020000","chr10.75290000.75295000",275000,13,0.0001878855,75015000,75290000,75020000,75295000,"chr10",412239,0,1,1,2,"chr10",1,0.00304735114861697
"13217","chr10.119080000.119085000","chr10.119130000.119135000",50000,25,0.0004347818,119080000,119130000,119085000,119135000,"chr10",412289,3,27,24,54,"chr10",1,0.158227848101266
"13218","chr10.23045000.23050000","chr10.23110000.23115000",65000,22,0.0004347818,23045000,23110000,23050000,23115000,"chr10",412299,0,4,3,7,"chr10",1,0.0180496952648851
"13219","chr10.122180000.122185000","chr10.122485000.122490000",305000,11,0.001838952,122180000,122485000,122185000,122490000,"chr10",412310,0,2,2,4,"chr10",1,0.00515705578996718
"13220","chr10.86020000.86025000","chr10.86110000.86115000",90000,16,0.009113207,86020000,86110000,86025000,86115000,"chr10",412356,0,2,0,2,"chr10",1,0.00375058602906704
"13221","chr10.15290000.15295000","chr10.15345000.15350000",55000,22,0.002536929,15290000,15345000,15295000,15350000,"chr10",412377,2,6,3,11,"chr10",1,0.0283638068448195
"13222","chr10.13955000.13960000","chr10.14525000.14530000",570000,9,0.001424034,13955000,14525000,13960000,14530000,"chr10",412412,0,9,7,16,"chr10",1,0.0168776371308017
"13223","chr10.103610000.103615000","chr10.103685000.103690000",75000,21,0.0002687144,103610000,103685000,103615000,103690000,"chr10",412418,2,1,0,3,"chr10",1,0.00738396624472574
"13224","chr10.103650000.103655000","chr10.103760000.103765000",110000,18,0.0002163546,103650000,103760000,103655000,103765000,"chr10",412456,3,1,5,9,"chr10",1,0.0189873417721519
"13225","chr10.73740000.73745000","chr10.73800000.73805000",60000,27,4.616826e-06,73740000,73800000,73745000,73805000,"chr10",412532,0,4,0,4,"chr10",1,0.0126582278481013
"13226","chr10.35565000.35570000","chr10.35610000.35615000",45000,24,0.003089335,35565000,35610000,35570000,35615000,"chr10",412625,0,3,2,5,"chr10",1,0.0140646976090014
"13227","chr10.22600000.22605000","chr10.22845000.22850000",245000,20,2.673278e-09,22600000,22845000,22605000,22850000,"chr10",412671,2,6,5,13,"chr10",1,0.0304735114861697
"13228","chr10.103920000.103925000","chr10.104205000.104210000",285000,10,0.009796166,103920000,104205000,103925000,104210000,"chr10",412698,0,1,0,1,"chr10",1,0.00117205813408345
"13229","chr10.5740000.5745000","chr10.5810000.5815000",70000,26,1.582124e-06,5740000,5810000,5745000,5815000,"chr10",412756,1,3,1,5,"chr10",1,0.0152367557430849
"13230","chr10.22600000.22605000","chr10.23090000.23095000",490000,9,0.003210676,22600000,23090000,22605000,23095000,"chr10",412785,1,3,4,8,"chr10",1,0.00843881856540084
"13231","chr10.22870000.22875000","chr10.22895000.22900000",25000,33,0.008561686,22870000,22895000,22875000,22900000,"chr10",412890,1,1,1,3,"chr10",1,0.0116033755274262
"13232","chr10.79000000.79005000","chr10.79400000.79405000",400000,12,8.084511e-05,7.9e+07,79400000,79005000,79405000,"chr10",412903,1,0,3,4,"chr10",1,0.00562587904360056
"13233","chr10.80465000.80470000","chr10.80595000.80600000",130000,14,0.006930734,80465000,80595000,80470000,80600000,"chr10",412940,1,2,0,3,"chr10",1,0.00492264416315049
"13234","chr10.71205000.71210000","chr10.71260000.71265000",55000,26,4.949195e-05,71205000,71260000,71210000,71265000,"chr10",413048,0,1,1,2,"chr10",1,0.00609470229723394
"13235","chr10.74265000.74270000","chr10.74290000.74295000",25000,37,0.0005571591,74265000,74290000,74270000,74295000,"chr10",413055,1,9,10,20,"chr10",1,0.0867323019221753
"13236","chr10.91015000.91020000","chr10.91085000.91090000",70000,30,6.531923e-09,91015000,91085000,91020000,91090000,"chr10",413089,3,6,11,20,"chr10",1,0.070323488045007
"13237","chr10.73875000.73880000","chr10.73965000.73970000",90000,21,3.779589e-05,73875000,73965000,73880000,73970000,"chr10",413145,1,10,8,19,"chr10",1,0.0467651195499297
"13238","chr10.6955000.6960000","chr10.7260000.7265000",305000,20,1.594149e-10,6955000,7260000,6960000,7265000,"chr10",413169,0,2,2,4,"chr10",1,0.00937646507266761
"13239","chr10.100315000.100320000","chr10.101005000.101010000",690000,8,0.002685426,100315000,101005000,100320000,101010000,"chr10",413180,2,6,2,10,"chr10",1,0.00937646507266761
"13240","chr10.20250000.20255000","chr10.21060000.21065000",810000,7,0.006532077,20250000,21060000,20255000,21065000,"chr10",413316,1,2,1,4,"chr10",1,0.00328176277543366
"13241","chr10.52190000.52195000","chr10.52310000.52315000",120000,16,0.001213263,52190000,52310000,52195000,52315000,"chr10",413327,2,0,2,4,"chr10",1,0.00750117205813408
"13242","chr10.22255000.22260000","chr10.22835000.22840000",580000,8,0.006306138,22255000,22835000,22260000,22840000,"chr10",413351,2,0,1,3,"chr10",1,0.00281293952180028
"13243","chr10.75035000.75040000","chr10.75235000.75240000",200000,14,0.0004748091,75035000,75235000,75040000,75240000,"chr10",413369,2,4,4,10,"chr10",1,0.0164088138771683
"13244","chr10.28975000.28980000","chr10.29530000.29535000",555000,13,9.434771e-07,28975000,29530000,28980000,29535000,"chr10",413396,0,4,1,5,"chr10",1,0.00761837787154243
"13245","chr10.116945000.116950000","chr10.116970000.116975000",25000,33,0.008561686,116945000,116970000,116950000,116975000,"chr10",413428,0,2,0,2,"chr10",1,0.00773558368495077
"13246","chr10.71955000.71960000","chr10.71980000.71985000",25000,35,0.002331357,71955000,71980000,71960000,71985000,"chr10",413438,0,2,1,3,"chr10",1,0.0123066104078762
"13247","chr10.96980000.96985000","chr10.97075000.97080000",95000,16,0.006240607,96980000,97075000,96985000,97080000,"chr10",413457,2,1,4,7,"chr10",1,0.0131270511017346
"13248","chr10.15260000.15265000","chr10.15385000.15390000",125000,15,0.002953031,15260000,15385000,15265000,15390000,"chr10",413557,7,14,7,28,"chr10",1,0.0492264416315049
"13249","chr10.7560000.7565000","chr10.7735000.7740000",175000,13,0.004132041,7560000,7735000,7565000,7740000,"chr10",413596,0,1,2,3,"chr10",1,0.00457102672292546
"13250","chr10.79400000.79405000","chr10.79465000.79470000",65000,20,0.003071821,79400000,79465000,79405000,79470000,"chr10",413619,1,0,3,4,"chr10",1,0.00937646507266761
"13251","chr10.5870000.5875000","chr10.5915000.5920000",45000,23,0.006896136,5870000,5915000,5875000,5920000,"chr10",413666,0,4,1,5,"chr10",1,0.0134786685419597
"13252","chr10.5665000.5670000","chr10.5685000.5690000",20000,38,0.001750436,5665000,5685000,5670000,5690000,"chr10",413739,2,10,9,21,"chr10",1,0.0935302390998594
"13253","chr10.13660000.13665000","chr10.13815000.13820000",155000,16,0.0002184597,13660000,13815000,13665000,13820000,"chr10",413836,3,10,10,23,"chr10",1,0.043131739334271
"13254","chr10.5740000.5745000","chr10.5915000.5920000",175000,19,8.937182e-07,5740000,5915000,5745000,5920000,"chr10",413919,0,3,1,4,"chr10",1,0.00890764181903422
"13255","chr10.6920000.6925000","chr10.7260000.7265000",340000,14,7.494761e-06,6920000,7260000,6925000,7265000,"chr10",414016,0,2,2,4,"chr10",1,0.00656352555086732
"13256","chr10.103605000.103610000","chr10.103640000.103645000",35000,32,7.688221e-05,103605000,103640000,103610000,103645000,"chr10",414080,2,2,4,8,"chr10",1,0.0300046882325363
"13257","chr10.86670000.86675000","chr10.87095000.87100000",425000,9,0.006304029,86670000,87095000,86675000,87100000,"chr10",414120,1,1,2,4,"chr10",1,0.00421940928270042
"13258","chr10.75645000.75650000","chr10.75785000.75790000",140000,15,0.001511564,75645000,75785000,75650000,75790000,"chr10",414164,1,2,4,7,"chr10",1,0.0123066104078762
"13259","chr10.68895000.68900000","chr10.69235000.69240000",340000,10,0.004316179,68895000,69235000,68900000,69240000,"chr10",414196,6,16,23,45,"chr10",1,0.0527426160337553
"13260","chr10.72330000.72335000","chr10.72570000.72575000",240000,11,0.006967739,72330000,72570000,72335000,72575000,"chr10",414244,0,0,3,3,"chr10",1,0.00386779184247539
"13261","chr10.14585000.14590000","chr10.14875000.14880000",290000,16,7.645232e-07,14585000,14875000,14590000,14880000,"chr10",414292,0,2,0,2,"chr10",1,0.00375058602906704
"13262","chr10.125760000.125765000","chr10.126090000.126095000",330000,11,0.001193573,125760000,126090000,125765000,126095000,"chr10",414315,2,1,2,5,"chr10",1,0.00644631973745898
"13263","chr10.102670000.102675000","chr10.102690000.102695000",20000,51,3.117625e-08,102670000,102690000,102675000,102695000,"chr10",414319,4,14,15,33,"chr10",1,0.197257383966245
"13264","chr10.22895000.22900000","chr10.22925000.22930000",30000,33,0.0004723945,22895000,22925000,22900000,22930000,"chr10",414375,1,2,1,4,"chr10",1,0.0154711673699015
"13265","chr10.63215000.63220000","chr10.63630000.63635000",415000,9,0.006997883,63215000,63630000,63220000,63635000,"chr10",414423,1,0,2,3,"chr10",1,0.00316455696202532
"13266","chr10.22895000.22900000","chr10.23010000.23015000",115000,28,3.091113e-11,22895000,23010000,22900000,23015000,"chr10",414435,0,1,0,1,"chr10",1,0.00328176277543366
"13267","chr10.80340000.80345000","chr10.80945000.80950000",605000,8,0.005215399,80340000,80945000,80345000,80950000,"chr10",414495,1,2,0,3,"chr10",1,0.00281293952180028
"13268","chr10.124090000.124095000","chr10.124325000.124330000",235000,19,3.055723e-08,124090000,124325000,124095000,124330000,"chr10",414580,1,1,2,4,"chr10",1,0.00890764181903422
"13269","chr10.70520000.70525000","chr10.70755000.70760000",235000,13,0.0005747384,70520000,70755000,70525000,70760000,"chr10",414621,1,9,3,13,"chr10",1,0.0198077824660103
"13270","chr10.13690000.13695000","chr10.13815000.13820000",125000,16,0.0009414146,13690000,13815000,13695000,13820000,"chr10",414644,3,10,10,23,"chr10",1,0.043131739334271
"13271","chr10.24900000.24905000","chr10.25110000.25115000",210000,14,0.0003343528,24900000,25110000,24905000,25115000,"chr10",414649,4,8,15,27,"chr10",1,0.0443037974683544
"13272","chr10.6400000.6405000","chr10.6415000.6420000",15000,38,0.001750436,6400000,6415000,6405000,6420000,"chr10",414655,1,12,6,19,"chr10",1,0.0846225972808251
"13273","chr10.73940000.73945000","chr10.74105000.74110000",165000,13,0.005801717,73940000,74105000,73945000,74110000,"chr10",414725,0,10,11,21,"chr10",1,0.0319971870604782
"13274","chr10.104700000.104705000","chr10.104780000.104785000",80000,18,0.003328662,104700000,104780000,104705000,104785000,"chr10",414810,0,2,1,3,"chr10",1,0.00632911392405063
"13275","chr10.25065000.25070000","chr10.25215000.25220000",150000,13,0.009679522,25065000,25215000,25070000,25220000,"chr10",414811,0,3,3,6,"chr10",1,0.00914205344585091
"13276","chr10.7310000.7315000","chr10.7445000.7450000",135000,29,4.524341e-13,7310000,7445000,7315000,7450000,"chr10",414861,4,3,8,15,"chr10",1,0.0509845288326301
"13277","chr10.24950000.24955000","chr10.25290000.25295000",340000,12,0.0002180887,24950000,25290000,24955000,25295000,"chr10",414898,0,3,2,5,"chr10",1,0.0070323488045007
"13278","chr10.125740000.125745000","chr10.126070000.126075000",330000,21,6.858011e-12,125740000,126070000,125745000,126075000,"chr10",414902,0,2,3,5,"chr10",1,0.0123066104078762
"13279","chr10.103220000.103225000","chr10.104205000.104210000",985000,8,0.0003201395,103220000,104205000,103225000,104210000,"chr10",414936,0,2,0,2,"chr10",1,0.00187529301453352
"13280","chr10.91020000.91025000","chr10.91130000.91135000",110000,56,2.097475e-37,91020000,91130000,91025000,91135000,"chr10",414988,0,1,1,2,"chr10",1,0.0131270511017346
"13281","chr10.6140000.6145000","chr10.6190000.6195000",50000,25,0.0004347818,6140000,6190000,6145000,6195000,"chr10",415019,3,3,6,12,"chr10",1,0.0351617440225035
"13282","chr10.100230000.100235000","chr10.101000000.101005000",770000,13,4.078343e-08,100230000,1.01e+08,100235000,101005000,"chr10",415038,1,4,4,9,"chr10",1,0.0137130801687764
"13283","chr10.77835000.77840000","chr10.78030000.78035000",195000,12,0.006930734,77835000,78030000,77840000,78035000,"chr10",415084,0,4,3,7,"chr10",1,0.00984528832630099
"13284","chr10.121450000.121455000","chr10.121625000.121630000",175000,24,1.346117e-10,121450000,121625000,121455000,121630000,"chr10",415123,0,4,8,12,"chr10",1,0.0337552742616034
"13285","chr10.80075000.80080000","chr10.80945000.80950000",870000,8,0.000761464,80075000,80945000,80080000,80950000,"chr10",415264,1,2,0,3,"chr10",1,0.00281293952180028
"13286","chr10.99330000.99335000","chr10.99360000.99365000",30000,33,0.0004723945,99330000,99360000,99335000,99365000,"chr10",415376,1,2,0,3,"chr10",1,0.0116033755274262
"13287","chr10.102350000.102355000","chr10.102640000.102645000",290000,10,0.009003412,102350000,102640000,102355000,102645000,"chr10",415414,0,4,1,5,"chr10",1,0.00586029067041725
"13288","chr10.6125000.6130000","chr10.6245000.6250000",120000,15,0.003759125,6125000,6245000,6130000,6250000,"chr10",415425,1,11,5,17,"chr10",1,0.029887482419128
"13289","chr10.73365000.73370000","chr10.73585000.73590000",220000,12,0.003386353,73365000,73585000,73370000,73590000,"chr10",415539,0,5,3,8,"chr10",1,0.0112517580872011
"13290","chr10.7290000.7295000","chr10.7440000.7445000",150000,13,0.009679522,7290000,7440000,7295000,7445000,"chr10",415580,6,16,13,35,"chr10",1,0.053328645100797
"13291","chr10.73885000.73890000","chr10.73965000.73970000",80000,25,8.800329e-07,73885000,73965000,73890000,73970000,"chr10",415586,1,14,8,23,"chr10",1,0.0673933427097984
"13292","chr10.75015000.75020000","chr10.75235000.75240000",220000,18,3.955592e-07,75015000,75235000,75020000,75240000,"chr10",415680,0,4,1,5,"chr10",1,0.0105485232067511
"13293","chr10.24900000.24905000","chr10.24950000.24955000",50000,30,2.128706e-06,24900000,24950000,24905000,24955000,"chr10",415715,1,3,2,6,"chr10",1,0.0210970464135021
"13294","chr10.28530000.28535000","chr10.28675000.28680000",145000,18,2.407286e-05,28530000,28675000,28535000,28680000,"chr10",415722,0,2,0,2,"chr10",1,0.00421940928270042
"13295","chr10.5740000.5745000","chr10.5920000.5925000",180000,14,0.001021798,5740000,5920000,5745000,5925000,"chr10",415791,0,3,1,4,"chr10",1,0.00656352555086732
"13296","chr10.60900000.60905000","chr10.60930000.60935000",30000,38,5.669881e-06,60900000,60930000,60905000,60935000,"chr10",415828,0,1,0,1,"chr10",1,0.00445382090951711
"13297","chr10.70265000.70270000","chr10.70520000.70525000",255000,11,0.004982721,70265000,70520000,70270000,70525000,"chr10",415851,1,3,2,6,"chr10",1,0.00773558368495077
"13298","chr10.125765000.125770000","chr10.126090000.126095000",325000,15,1.735286e-06,125765000,126090000,125770000,126095000,"chr10",415881,2,1,2,5,"chr10",1,0.00879043600562588
"13299","chr10.104680000.104685000","chr10.104890000.104895000",210000,13,0.001266212,104680000,104890000,104685000,104895000,"chr10",415949,0,2,0,2,"chr10",1,0.00304735114861697
"13300","chr10.15165000.15170000","chr10.15415000.15420000",250000,11,0.005633679,15165000,15415000,15170000,15420000,"chr10",415975,1,5,3,9,"chr10",1,0.0116033755274262
"13301","chr10.15310000.15315000","chr10.15425000.15430000",115000,15,0.00484355,15310000,15425000,15315000,15430000,"chr10",415989,0,2,2,4,"chr10",1,0.0070323488045007
"13302","chr10.14585000.14590000","chr10.14665000.14670000",80000,21,0.0001371457,14585000,14665000,14590000,14670000,"chr10",416060,0,2,0,2,"chr10",1,0.00492264416315049
"13303","chr10.98340000.98345000","chr10.98585000.98590000",245000,11,0.006240607,98340000,98585000,98345000,98590000,"chr10",416101,0,5,1,6,"chr10",1,0.00773558368495077
"13304","chr10.60020000.60025000","chr10.60155000.60160000",135000,14,0.00573319,60020000,60155000,60025000,60160000,"chr10",416114,0,2,1,3,"chr10",1,0.00492264416315049
"13305","chr10.15365000.15370000","chr10.15385000.15390000",20000,56,1.597381e-10,15365000,15385000,15370000,15390000,"chr10",416123,1,6,5,12,"chr10",1,0.0787623066104079
"13306","chr10.124915000.124920000","chr10.125060000.125065000",145000,24,1.678181e-09,124915000,125060000,124920000,125065000,"chr10",416165,0,2,0,2,"chr10",1,0.00562587904360056
"13307","chr10.15230000.15235000","chr10.15415000.15420000",185000,18,2.54691e-06,15230000,15415000,15235000,15420000,"chr10",416172,3,5,13,21,"chr10",1,0.0443037974683544
"13308","chr10.124060000.124065000","chr10.124460000.124465000",400000,9,0.008314332,124060000,124460000,124065000,124465000,"chr10",416174,0,2,0,2,"chr10",1,0.00210970464135021
"13309","chr10.80195000.80200000","chr10.80945000.80950000",750000,9,0.0002809379,80195000,80945000,80200000,80950000,"chr10",416186,0,2,0,2,"chr10",1,0.00210970464135021
"13310","chr10.35610000.35615000","chr10.35825000.35830000",215000,12,0.003937047,35610000,35825000,35615000,35830000,"chr10",416193,1,3,2,6,"chr10",1,0.00843881856540084
"13311","chr10.74380000.74385000","chr10.74585000.74590000",205000,13,0.001510072,74380000,74585000,74385000,74590000,"chr10",416196,0,2,3,5,"chr10",1,0.00761837787154243
"13312","chr10.104485000.104490000","chr10.104655000.104660000",170000,24,2.031496e-10,104485000,104655000,104490000,104660000,"chr10",416201,0,0,2,2,"chr10",1,0.00562587904360056
"13313","chr10.6190000.6195000","chr10.6445000.6450000",255000,11,0.004982721,6190000,6445000,6195000,6450000,"chr10",416432,0,6,3,9,"chr10",1,0.0116033755274262
"13314","chr10.92840000.92845000","chr10.92910000.92915000",70000,19,0.003959344,92840000,92910000,92845000,92915000,"chr10",416442,0,1,2,3,"chr10",1,0.00668073136427567
"13315","chr10.69375000.69380000","chr10.69410000.69415000",35000,28,0.002322002,69375000,69410000,69380000,69415000,"chr10",416506,2,3,1,6,"chr10",1,0.019690576652602
"13316","chr10.6150000.6155000","chr10.6235000.6240000",85000,31,3.681499e-11,6150000,6235000,6155000,6240000,"chr10",416572,2,11,11,24,"chr10",1,0.0872011251758087
"13317","chr10.97125000.97130000","chr10.97330000.97335000",205000,14,0.0004007507,97125000,97330000,97130000,97335000,"chr10",416636,1,6,7,14,"chr10",1,0.0229723394280356
"13318","chr10.71985000.71990000","chr10.72155000.72160000",170000,15,0.0004220823,71985000,72155000,71990000,72160000,"chr10",416689,2,8,10,20,"chr10",1,0.0351617440225035
"13319","chr10.121440000.121445000","chr10.121625000.121630000",185000,30,2.515178e-16,121440000,121625000,121445000,121630000,"chr10",416728,0,10,5,15,"chr10",1,0.0527426160337553
"13320","chr10.70525000.70530000","chr10.70660000.70665000",135000,14,0.00573319,70525000,70660000,70530000,70665000,"chr10",416781,0,3,1,4,"chr10",1,0.00656352555086732
"13321","chr10.93515000.93520000","chr10.93680000.93685000",165000,14,0.001805313,93515000,93680000,93520000,93685000,"chr10",416798,1,5,0,6,"chr10",1,0.00984528832630099
"13322","chr10.5855000.5860000","chr10.5875000.5880000",20000,40,0.0004347818,5855000,5875000,5860000,5880000,"chr10",416822,2,20,14,36,"chr10",1,0.168776371308017
"13323","chr10.6955000.6960000","chr10.7310000.7315000",355000,10,0.003498104,6955000,7310000,6960000,7315000,"chr10",416927,1,2,6,9,"chr10",1,0.0105485232067511
"13324","chr10.46000000.46005000","chr10.46020000.46025000",20000,64,1.318597e-14,4.6e+07,46020000,46005000,46025000,"chr10",417023,0,2,3,5,"chr10",1,0.0375058602906704
"13325","chr10.104265000.104270000","chr10.104335000.104340000",70000,32,3.261726e-10,104265000,104335000,104270000,104340000,"chr10",417025,2,8,6,16,"chr10",1,0.0600093764650727
"13326","chr10.5685000.5690000","chr10.5920000.5925000",235000,12,0.002251424,5685000,5920000,5690000,5925000,"chr10",417059,0,8,1,9,"chr10",1,0.0126582278481013
"13327","chr10.25465000.25470000","chr10.25500000.25505000",35000,29,0.001038926,25465000,25500000,25470000,25505000,"chr10",417078,0,0,2,2,"chr10",1,0.00679793717768401
"13328","chr10.97195000.97200000","chr10.97325000.97330000",130000,15,0.002331357,97195000,97325000,97200000,97330000,"chr10",417096,1,5,1,7,"chr10",1,0.0123066104078762
"13329","chr10.35410000.35415000","chr10.35530000.35535000",120000,15,0.003759125,35410000,35530000,35415000,35535000,"chr10",417141,4,4,1,9,"chr10",1,0.0158227848101266
"13330","chr10.105660000.105665000","chr10.105875000.105880000",215000,13,0.001081297,105660000,105875000,105665000,105880000,"chr10",417341,0,2,1,3,"chr10",1,0.00457102672292546
"13331","chr10.103755000.103760000","chr10.103790000.103795000",35000,28,0.002322002,103755000,103790000,103760000,103795000,"chr10",417346,0,0,2,2,"chr10",1,0.00656352555086732
"13332","chr10.12330000.12335000","chr10.13090000.13095000",760000,9,0.0002603223,12330000,13090000,12335000,13095000,"chr10",417411,1,7,2,10,"chr10",1,0.0105485232067511
"13333","chr10.15290000.15295000","chr10.15385000.15390000",95000,29,1.305447e-10,15290000,15385000,15295000,15390000,"chr10",417507,2,6,5,13,"chr10",1,0.0441865916549461
"13334","chr10.59980000.59985000","chr10.60020000.60025000",40000,30,5.74208e-05,59980000,60020000,59985000,60025000,"chr10",417529,0,2,1,3,"chr10",1,0.0105485232067511
"13335","chr10.99245000.99250000","chr10.99325000.99330000",80000,21,0.0001371457,99245000,99325000,99250000,99330000,"chr10",417554,0,5,3,8,"chr10",1,0.019690576652602
"13336","chr10.100230000.100235000","chr10.101010000.101015000",780000,28,4.04656e-27,100230000,101010000,100235000,101015000,"chr10",417563,0,7,4,11,"chr10",1,0.0360993905297703
"13337","chr10.20250000.20255000","chr10.20285000.20290000",35000,35,4.050693e-06,20250000,20285000,20255000,20290000,"chr10",417590,0,2,1,3,"chr10",1,0.0123066104078762
"13338","chr10.20045000.20050000","chr10.20085000.20090000",40000,25,0.004677356,20045000,20085000,20050000,20090000,"chr10",417618,2,0,7,9,"chr10",1,0.0263713080168776
"13339","chr10.60030000.60035000","chr10.60120000.60125000",90000,16,0.009113207,60030000,60120000,60035000,60125000,"chr10",417629,1,4,3,8,"chr10",1,0.0150023441162682
"13340","chr10.122890000.122895000","chr10.123365000.123370000",475000,11,0.0001475364,122890000,123365000,122895000,123370000,"chr10",417672,0,3,1,4,"chr10",1,0.00515705578996718
"13341","chr10.97180000.97185000","chr10.97355000.97360000",175000,21,3.143943e-08,97180000,97355000,97185000,97360000,"chr10",417725,0,5,8,13,"chr10",1,0.0319971870604782
"13342","chr10.125740000.125745000","chr10.126090000.126095000",350000,16,1.389931e-07,125740000,126090000,125745000,126095000,"chr10",417731,2,1,2,5,"chr10",1,0.00937646507266761
"13343","chr10.60810000.60815000","chr10.60875000.60880000",65000,19,0.007481698,60810000,60875000,60815000,60880000,"chr10",417733,0,1,2,3,"chr10",1,0.00668073136427567
"13344","chr10.101210000.101215000","chr10.101350000.101355000",140000,14,0.004724005,101210000,101350000,101215000,101355000,"chr10",417757,1,7,10,18,"chr10",1,0.029535864978903
"13345","chr10.74120000.74125000","chr10.74870000.74875000",750000,10,4.004368e-05,74120000,74870000,74125000,74875000,"chr10",417776,0,4,1,5,"chr10",1,0.00586029067041725
"13346","chr10.545000.550000","chr10.845000.850000",300000,13,9.979348e-05,545000,845000,550000,850000,"chr10",417787,0,2,0,2,"chr10",1,0.00304735114861697
"13347","chr10.122280000.122285000","chr10.122350000.122355000",70000,18,0.009681731,122280000,122350000,122285000,122355000,"chr10",417902,0,2,4,6,"chr10",1,0.0126582278481013
"13348","chr10.26730000.26735000","chr10.26765000.26770000",35000,34,1.113447e-05,26730000,26765000,26735000,26770000,"chr10",417909,0,6,1,7,"chr10",1,0.0278949835911861
"13349","chr10.29425000.29430000","chr10.29560000.29565000",135000,17,0.0001619335,29425000,29560000,29430000,29565000,"chr10",418008,1,2,0,3,"chr10",1,0.0059774964838256
"13350","chr10.104520000.104525000","chr10.104580000.104585000",60000,21,0.002650227,104520000,104580000,104525000,104585000,"chr10",418034,0,0,1,1,"chr10",1,0.00246132208157525
"13351","chr10.118980000.118985000","chr10.119080000.119085000",100000,23,7.116648e-07,118980000,119080000,118985000,119085000,"chr10",418038,3,7,7,17,"chr10",1,0.0458274730426629
"13352","chr10.5855000.5860000","chr10.5925000.5930000",70000,19,0.003959344,5855000,5925000,5860000,5930000,"chr10",418120,4,11,12,27,"chr10",1,0.060126582278481
"13353","chr10.34695000.34700000","chr10.34780000.34785000",85000,17,0.005416061,34695000,34780000,34700000,34785000,"chr10",418261,2,9,7,18,"chr10",1,0.0358649789029536
"13354","chr10.70360000.70365000","chr10.70660000.70665000",300000,11,0.002025695,70360000,70660000,70365000,70665000,"chr10",418321,0,7,9,16,"chr10",1,0.0206282231598687
"13355","chr10.6150000.6155000","chr10.6225000.6230000",75000,21,0.0002687144,6150000,6225000,6155000,6230000,"chr10",418335,0,1,2,3,"chr10",1,0.00738396624472574
"13356","chr10.35405000.35410000","chr10.35540000.35545000",135000,17,0.0001619335,35405000,35540000,35410000,35545000,"chr10",418348,3,1,0,4,"chr10",1,0.00796999531176746
"13357","chr10.14230000.14235000","chr10.14520000.14525000",290000,11,0.002418631,14230000,14520000,14235000,14525000,"chr10",418366,0,3,6,9,"chr10",1,0.0116033755274262
"13358","chr10.7025000.7030000","chr10.7115000.7120000",90000,20,0.0001277833,7025000,7115000,7030000,7120000,"chr10",418418,1,2,1,4,"chr10",1,0.00937646507266761
"13359","chr10.29530000.29535000","chr10.29595000.29600000",65000,19,0.007481698,29530000,29595000,29535000,29600000,"chr10",418432,4,5,5,14,"chr10",1,0.0311767463666198
"13360","chr10.71975000.71980000","chr10.72175000.72180000",200000,13,0.001776106,71975000,72175000,71980000,72180000,"chr10",418448,2,4,0,6,"chr10",1,0.00914205344585091
"13361","chr10.121485000.121490000","chr10.121625000.121630000",140000,33,7.818902e-17,121485000,121625000,121490000,121630000,"chr10",418545,0,7,3,10,"chr10",1,0.0386779184247539
"13362","chr10.103960000.103965000","chr10.104275000.104280000",315000,11,0.001529788,103960000,104275000,103965000,104280000,"chr10",418586,4,9,12,25,"chr10",1,0.0322315986872949
"13363","chr10.49760000.49765000","chr10.49840000.49845000",80000,17,0.008561686,49760000,49840000,49765000,49845000,"chr10",418612,0,3,1,4,"chr10",1,0.00796999531176746
"13364","chr10.28975000.28980000","chr10.29425000.29430000",450000,9,0.004870684,28975000,29425000,28980000,29430000,"chr10",418626,0,3,1,4,"chr10",1,0.00421940928270042
"13365","chr10.104300000.104305000","chr10.104345000.104350000",45000,24,0.003089335,104300000,104345000,104305000,104350000,"chr10",418666,3,2,3,8,"chr10",1,0.0225035161744023
"13366","chr10.71990000.71995000","chr10.72105000.72110000",115000,25,5.324947e-09,71990000,72105000,71995000,72110000,"chr10",418670,2,1,2,5,"chr10",1,0.0146507266760431
"13367","chr10.95380000.95385000","chr10.95420000.95425000",40000,32,7.494761e-06,95380000,95420000,95385000,95425000,"chr10",418794,2,8,9,19,"chr10",1,0.0712611345522738
"13368","chr10.86100000.86105000","chr10.86265000.86270000",165000,16,0.000138104,86100000,86265000,86105000,86270000,"chr10",418797,0,2,0,2,"chr10",1,0.00375058602906704
"13369","chr10.103605000.103610000","chr10.103790000.103795000",185000,13,0.002951829,103605000,103790000,103610000,103795000,"chr10",418828,0,0,2,2,"chr10",1,0.00304735114861697
"13370","chr10.105655000.105660000","chr10.105875000.105880000",220000,12,0.003386353,105655000,105875000,105660000,105880000,"chr10",418830,0,2,0,2,"chr10",1,0.00281293952180028
"13371","chr10.103640000.103645000","chr10.103695000.103700000",55000,24,0.0003932834,103640000,103695000,103645000,103700000,"chr10",418866,2,2,3,7,"chr10",1,0.019690576652602
"13372","chr10.31030000.31035000","chr10.31775000.31780000",745000,12,5.710754e-07,31030000,31775000,31035000,31780000,"chr10",418875,0,1,1,2,"chr10",1,0.00281293952180028
"13373","chr10.15255000.15260000","chr10.15415000.15420000",160000,25,7.385232e-11,15255000,15415000,15260000,15420000,"chr10",418885,3,7,3,13,"chr10",1,0.0380918893577121
"13374","chr10.24945000.24950000","chr10.24965000.24970000",20000,36,0.006240607,24945000,24965000,24950000,24970000,"chr10",418917,0,3,0,3,"chr10",1,0.0126582278481013
"13375","chr10.25465000.25470000","chr10.25965000.25970000",500000,13,2.386651e-06,25465000,25965000,25470000,25970000,"chr10",418920,0,0,2,2,"chr10",1,0.00304735114861697
"13376","chr10.103015000.103020000","chr10.103220000.103225000",205000,12,0.005225065,103015000,103220000,103020000,103225000,"chr10",419000,2,9,6,17,"chr10",1,0.0239099859353024
"13377","chr10.23065000.23070000","chr10.23110000.23115000",45000,24,0.003089335,23065000,23110000,23070000,23115000,"chr10",419009,0,4,3,7,"chr10",1,0.019690576652602
"13378","chr10.74185000.74190000","chr10.74380000.74385000",195000,13,0.002121806,74185000,74380000,74190000,74385000,"chr10",419014,2,4,6,12,"chr10",1,0.0182841068917018
"13379","chr10.14520000.14525000","chr10.14875000.14880000",355000,17,1.646357e-08,14520000,14875000,14525000,14880000,"chr10",419029,2,2,7,11,"chr10",1,0.0219174871073605
"13380","chr10.6125000.6130000","chr10.6235000.6240000",110000,16,0.002227343,6125000,6235000,6130000,6240000,"chr10",419077,2,11,5,18,"chr10",1,0.0337552742616034
"13381","chr10.22895000.22900000","chr10.23045000.23050000",150000,19,4.119654e-06,22895000,23045000,22900000,23050000,"chr10",419133,1,2,1,4,"chr10",1,0.00890764181903422
"13382","chr10.103220000.103225000","chr10.103280000.103285000",60000,22,0.001038926,103220000,103280000,103225000,103285000,"chr10",419144,3,14,7,24,"chr10",1,0.0618846694796062
"13383","chr10.126620000.126625000","chr10.126665000.126670000",45000,24,0.003089335,126620000,126665000,126625000,126670000,"chr10",419168,0,3,2,5,"chr10",1,0.0140646976090014
"13384","chr10.122950000.122955000","chr10.123300000.123305000",350000,10,0.003759125,122950000,123300000,122955000,123305000,"chr10",419204,3,16,8,27,"chr10",1,0.0316455696202532
"13385","chr10.62560000.62565000","chr10.62830000.62835000",270000,11,0.003619186,62560000,62830000,62565000,62835000,"chr10",419205,0,5,5,10,"chr10",1,0.012892639474918
"13386","chr10.124915000.124920000","chr10.125140000.125145000",225000,22,1.658724e-10,124915000,125140000,124920000,125145000,"chr10",419222,0,8,3,11,"chr10",1,0.0283638068448195
"13387","chr10.59990000.59995000","chr10.60020000.60025000",30000,34,0.0002087506,59990000,60020000,59995000,60025000,"chr10",419262,0,2,1,3,"chr10",1,0.0119549929676512
"13388","chr10.5840000.5845000","chr10.5920000.5925000",80000,22,4.229726e-05,5840000,5920000,5845000,5925000,"chr10",419328,0,8,1,9,"chr10",1,0.0232067510548523
"13389","chr10.35415000.35420000","chr10.35515000.35520000",100000,21,1.158588e-05,35415000,35515000,35420000,35520000,"chr10",419363,2,1,2,5,"chr10",1,0.0123066104078762
"13390","chr10.121440000.121445000","chr10.121605000.121610000",165000,15,0.0005131903,121440000,121605000,121445000,121610000,"chr10",419365,0,10,5,15,"chr10",1,0.0263713080168776
"13391","chr10.73585000.73590000","chr10.73645000.73650000",60000,34,3.962307e-10,73585000,73645000,73590000,73650000,"chr10",419417,0,0,3,3,"chr10",1,0.0119549929676512
"13392","chr10.123420000.123425000","chr10.123500000.123505000",80000,18,0.003328662,123420000,123500000,123425000,123505000,"chr10",419455,3,5,2,10,"chr10",1,0.0210970464135021
"13393","chr10.72310000.72315000","chr10.72570000.72575000",260000,16,2.20998e-06,72310000,72570000,72315000,72575000,"chr10",419483,6,23,14,43,"chr10",1,0.0806375996249414
"13394","chr10.74185000.74190000","chr10.74585000.74590000",400000,9,0.008314332,74185000,74585000,74190000,74590000,"chr10",419490,0,2,3,5,"chr10",1,0.00527426160337553
"13395","chr10.78945000.78950000","chr10.79465000.79470000",520000,10,0.0004561503,78945000,79465000,78950000,79470000,"chr10",419519,0,3,5,8,"chr10",1,0.00937646507266761
"13396","chr10.102065000.102070000","chr10.102665000.102670000",600000,8,0.005419526,102065000,102665000,102070000,102670000,"chr10",419529,0,4,0,4,"chr10",1,0.00375058602906704
"13397","chr10.100225000.100230000","chr10.100995000.101000000",770000,12,4.255739e-07,100225000,100995000,100230000,1.01e+08,"chr10",419534,0,2,0,2,"chr10",1,0.00281293952180028
"13398","chr10.116635000.116640000","chr10.116850000.116855000",215000,12,0.003937047,116635000,116850000,116640000,116855000,"chr10",419540,1,7,3,11,"chr10",1,0.0154711673699015
"13399","chr10.103640000.103645000","chr10.103745000.103750000",105000,20,2.628045e-05,103640000,103745000,103645000,103750000,"chr10",419542,2,2,4,8,"chr10",1,0.0187529301453352
"13400","chr10.25110000.25115000","chr10.25225000.25230000",115000,18,0.0001507044,25110000,25225000,25115000,25230000,"chr10",419568,3,4,9,16,"chr10",1,0.0337552742616034
"13401","chr10.98585000.98590000","chr10.98670000.98675000",85000,18,0.002017057,98585000,98670000,98590000,98675000,"chr10",419649,0,5,1,6,"chr10",1,0.0126582278481013
"13402","chr10.6145000.6150000","chr10.6445000.6450000",300000,10,0.007688403,6145000,6445000,6150000,6450000,"chr10",419675,0,4,2,6,"chr10",1,0.0070323488045007
"13403","chr10.71975000.71980000","chr10.72105000.72110000",130000,45,7.147145e-28,71975000,72105000,71980000,72110000,"chr10",419680,2,1,2,5,"chr10",1,0.0263713080168776
"13404","chr10.25065000.25070000","chr10.25225000.25230000",160000,19,2.237769e-06,25065000,25225000,25070000,25230000,"chr10",419762,2,4,9,15,"chr10",1,0.0334036568213783
"13405","chr10.70525000.70530000","chr10.70550000.70555000",25000,33,0.008561686,70525000,70550000,70530000,70555000,"chr10",419778,0,3,1,4,"chr10",1,0.0154711673699015
"13406","chr10.480000.485000","chr10.810000.815000",330000,10,0.004908412,480000,810000,485000,815000,"chr10",419799,0,1,1,2,"chr10",1,0.0023441162681669
"13407","chr10.6955000.6960000","chr10.7305000.7310000",350000,11,0.0008876436,6955000,7305000,6960000,7310000,"chr10",419817,1,2,6,9,"chr10",1,0.0116033755274262
"13408","chr10.18300000.18305000","chr10.18340000.18345000",40000,24,0.009865195,18300000,18340000,18305000,18345000,"chr10",419854,3,10,7,20,"chr10",1,0.0562587904360056
"13409","chr10.98405000.98410000","chr10.98465000.98470000",60000,20,0.006321056,98405000,98465000,98410000,98470000,"chr10",419858,0,0,2,2,"chr10",1,0.0046882325363338
"13410","chr10.97195000.97200000","chr10.97330000.97335000",135000,18,4.303271e-05,97195000,97330000,97200000,97335000,"chr10",419859,1,5,1,7,"chr10",1,0.0147679324894515
"13411","chr10.91015000.91020000","chr10.91135000.91140000",120000,29,2.648487e-12,91015000,91135000,91020000,91140000,"chr10",419878,1,6,11,18,"chr10",1,0.0611814345991561
"13412","chr10.104010000.104015000","chr10.104055000.104060000",45000,28,7.933395e-05,104010000,104055000,104015000,104060000,"chr10",419922,1,2,3,6,"chr10",1,0.019690576652602
"13413","chr10.6125000.6130000","chr10.6445000.6450000",320000,19,7.524356e-10,6125000,6445000,6130000,6450000,"chr10",419956,0,6,3,9,"chr10",1,0.020042194092827
"13414","chr10.34990000.34995000","chr10.35085000.35090000",95000,16,0.006240607,34990000,35085000,34995000,35090000,"chr10",419974,4,28,21,53,"chr10",1,0.0993905297702766
"13415","chr10.75185000.75190000","chr10.75235000.75240000",50000,23,0.002650227,75185000,75235000,75190000,75240000,"chr10",419978,2,4,4,10,"chr10",1,0.0269573370839194
"13416","chr10.102675000.102680000","chr10.102750000.102755000",75000,18,0.005637674,102675000,102750000,102680000,102755000,"chr10",420004,0,0,2,2,"chr10",1,0.00421940928270042
"13417","chr10.495000.500000","chr10.545000.550000",50000,29,6.677882e-06,495000,545000,5e+05,550000,"chr10",420033,1,2,1,4,"chr10",1,0.013595874355368
"13418","chr10.13955000.13960000","chr10.14615000.14620000",660000,8,0.003369762,13955000,14615000,13960000,14620000,"chr10",420044,0,9,8,17,"chr10",1,0.0159399906235349
"13419","chr10.25015000.25020000","chr10.25065000.25070000",50000,23,0.002650227,25015000,25065000,25020000,25070000,"chr10",420141,2,3,1,6,"chr10",1,0.0161744022503516
"13420","chr10.97180000.97185000","chr10.97320000.97325000",140000,14,0.004724005,97180000,97320000,97185000,97325000,"chr10",420189,3,5,8,16,"chr10",1,0.0262541022034693
"13421","chr10.5840000.5845000","chr10.5870000.5875000",30000,30,0.004565405,5840000,5870000,5845000,5875000,"chr10",420210,2,11,13,26,"chr10",1,0.0914205344585091
"13422","chr10.97280000.97285000","chr10.97330000.97335000",50000,23,0.002650227,97280000,97330000,97285000,97335000,"chr10",420234,1,8,7,16,"chr10",1,0.043131739334271
"13423","chr10.22600000.22605000","chr10.23390000.23395000",790000,7,0.007360737,22600000,23390000,22605000,23395000,"chr10",420250,6,16,16,38,"chr10",1,0.0311767463666198
"13424","chr10.104275000.104280000","chr10.104305000.104310000",30000,32,0.001038926,104275000,104305000,104280000,104310000,"chr10",420333,1,2,3,6,"chr10",1,0.0225035161744023
"13425","chr10.26785000.26790000","chr10.26840000.26845000",55000,21,0.006045969,26785000,26840000,26790000,26845000,"chr10",420356,0,6,2,8,"chr10",1,0.019690576652602
"13426","chr10.80340000.80345000","chr10.80595000.80600000",255000,13,0.0003258269,80340000,80595000,80345000,80600000,"chr10",420386,1,2,0,3,"chr10",1,0.00457102672292546
"13427","chr10.22615000.22620000","chr10.22845000.22850000",230000,12,0.002575301,22615000,22845000,22620000,22850000,"chr10",420393,2,6,5,13,"chr10",1,0.0182841068917018
"13428","chr10.52905000.52910000","chr10.53030000.53035000",125000,14,0.008561686,52905000,53030000,52910000,53035000,"chr10",420453,2,4,5,11,"chr10",1,0.0180496952648851
"13429","chr10.5855000.5860000","chr10.5915000.5920000",60000,40,3.536205e-14,5855000,5915000,5860000,5920000,"chr10",420490,0,4,1,5,"chr10",1,0.023441162681669
"13430","chr10.97460000.97465000","chr10.97610000.97615000",150000,17,7.376179e-05,97460000,97610000,97465000,97615000,"chr10",420508,2,5,1,8,"chr10",1,0.0159399906235349
"13431","chr10.70230000.70235000","chr10.70660000.70665000",430000,12,4.995094e-05,70230000,70660000,70235000,70665000,"chr10",420558,0,7,6,13,"chr10",1,0.0182841068917018
"13432","chr10.103660000.103665000","chr10.103770000.103775000",110000,15,0.006304029,103660000,103770000,103665000,103775000,"chr10",420568,3,3,6,12,"chr10",1,0.0210970464135021
"13433","chr10.29425000.29430000","chr10.29530000.29535000",105000,15,0.008559542,29425000,29530000,29430000,29535000,"chr10",420577,3,3,5,11,"chr10",1,0.0193389592123769
"13434","chr10.5855000.5860000","chr10.5910000.5915000",55000,33,9.579002e-09,5855000,5910000,5860000,5915000,"chr10",420583,0,4,2,6,"chr10",1,0.0232067510548523
"13435","chr10.103605000.103610000","chr10.103760000.103765000",155000,13,0.008179677,103605000,103760000,103610000,103765000,"chr10",420688,5,11,19,35,"chr10",1,0.053328645100797
"13436","chr10.6145000.6150000","chr10.6235000.6240000",90000,16,0.009113207,6145000,6235000,6150000,6240000,"chr10",420701,2,4,2,8,"chr10",1,0.0150023441162682
"13437","chr10.80065000.80070000","chr10.80345000.80350000",280000,15,6.245605e-06,80065000,80345000,80070000,80350000,"chr10",420777,4,5,17,26,"chr10",1,0.0457102672292546
"13438","chr10.5740000.5745000","chr10.5910000.5915000",170000,14,0.001492468,5740000,5910000,5745000,5915000,"chr10",420784,0,3,2,5,"chr10",1,0.00820440693858415
"13439","chr10.13630000.13635000","chr10.13815000.13820000",185000,14,0.0008425915,13630000,13815000,13635000,13820000,"chr10",420856,0,1,4,5,"chr10",1,0.00820440693858415
"13440","chr10.75035000.75040000","chr10.75140000.75145000",105000,16,0.003071821,75035000,75140000,75040000,75145000,"chr10",420924,3,16,10,29,"chr10",1,0.0543834974214721
"13441","chr10.103610000.103615000","chr10.103780000.103785000",170000,16,0.0001080186,103610000,103780000,103615000,103785000,"chr10",420932,2,1,0,3,"chr10",1,0.00562587904360056
"13442","chr10.74175000.74180000","chr10.74320000.74325000",145000,21,2.585696e-07,74175000,74320000,74180000,74325000,"chr10",421011,4,1,6,11,"chr10",1,0.0270745428973277
"13443","chr10.104685000.104690000","chr10.104780000.104785000",95000,24,3.32387e-07,104685000,104780000,104690000,104785000,"chr10",421017,0,2,0,2,"chr10",1,0.00562587904360056
"13444","chr10.104210000.104215000","chr10.104260000.104265000",50000,28,2.01441e-05,104210000,104260000,104215000,104265000,"chr10",421138,0,2,0,2,"chr10",1,0.00656352555086732
"13445","chr10.69630000.69635000","chr10.69855000.69860000",225000,11,0.009966611,69630000,69855000,69635000,69860000,"chr10",421260,0,2,0,2,"chr10",1,0.00257852789498359
"13446","chr10.6920000.6925000","chr10.6955000.6960000",35000,39,5.090381e-08,6920000,6955000,6925000,6960000,"chr10",421268,0,2,5,7,"chr10",1,0.0319971870604782
"13447","chr10.75235000.75240000","chr10.75475000.75480000",240000,12,0.001986737,75235000,75475000,75240000,75480000,"chr10",421369,2,4,4,10,"chr10",1,0.0140646976090014
"13448","chr10.124060000.124065000","chr10.124090000.124095000",30000,61,1.748546e-18,124060000,124090000,124065000,124095000,"chr10",421382,0,2,0,2,"chr10",1,0.0142991092358181
"13449","chr10.10795000.10800000","chr10.10845000.10850000",50000,26,0.0001624034,10795000,10845000,10800000,10850000,"chr10",421384,0,2,0,2,"chr10",1,0.00609470229723394
"13450","chr10.5740000.5745000","chr10.5775000.5780000",35000,31,0.0001906698,5740000,5775000,5745000,5780000,"chr10",421483,1,3,4,8,"chr10",1,0.0290670417252696
"13451","chr10.25380000.25385000","chr10.25965000.25970000",585000,9,0.001213687,25380000,25965000,25385000,25970000,"chr10",421503,0,0,2,2,"chr10",1,0.00210970464135021
"13452","chr10.12330000.12335000","chr10.12740000.12745000",410000,11,0.0003741337,12330000,12740000,12335000,12745000,"chr10",421509,2,10,14,26,"chr10",1,0.0335208626347867
"13453","chr10.86020000.86025000","chr10.86085000.86090000",65000,19,0.007481698,86020000,86085000,86025000,86090000,"chr10",421521,1,1,0,2,"chr10",1,0.00445382090951711
"13454","chr10.103240000.103245000","chr10.103280000.103285000",40000,26,0.002127745,103240000,103280000,103245000,103285000,"chr10",421524,3,10,7,20,"chr10",1,0.0609470229723394
"13455","chr10.23090000.23095000","chr10.23110000.23115000",20000,48,5.654326e-07,23090000,23110000,23095000,23115000,"chr10",421565,0,3,3,6,"chr10",1,0.0337552742616034
"13456","chr10.14215000.14220000","chr10.14520000.14525000",305000,17,7.23955e-08,14215000,14520000,14220000,14525000,"chr10",421568,3,13,7,23,"chr10",1,0.0458274730426629
"13457","chr10.99245000.99250000","chr10.99305000.99310000",60000,37,4.333167e-12,99245000,99305000,99250000,99310000,"chr10",421573,0,5,3,8,"chr10",1,0.0346929207688701
"13458","chr10.80405000.80410000","chr10.80660000.80665000",255000,12,0.00131968,80405000,80660000,80410000,80665000,"chr10",421740,3,1,1,5,"chr10",1,0.0070323488045007
"13459","chr11.117705000.117710000","chr11.117820000.117825000",115000,22,6.354353e-07,117705000,117820000,117710000,117825000,"chr11",421816,0,1,1,2,"chr11",1,0.00515705578996718
"13460","chr11.116920000.116925000","chr11.116955000.116960000",35000,39,4.770895e-08,116920000,116955000,116925000,116960000,"chr11",421826,4,4,8,16,"chr11",1,0.0731364275668073
"13461","chr11.116770000.116775000","chr11.116895000.116900000",125000,17,0.0002965548,116770000,116895000,116775000,116900000,"chr11",421827,0,0,2,2,"chr11",1,0.00398499765588373
"13462","chr11.119090000.119095000","chr11.119165000.119170000",75000,19,0.002175798,119090000,119165000,119095000,119170000,"chr11",421888,0,3,1,4,"chr11",1,0.00890764181903422
"13463","chr11.118995000.119000000","chr11.119195000.119200000",200000,16,2.682304e-05,118995000,119195000,1.19e+08,119200000,"chr11",421895,6,15,11,32,"chr11",1,0.0600093764650727
"13464","chr11.118190000.118195000","chr11.118220000.118225000",30000,30,0.004387639,118190000,118220000,118195000,118225000,"chr11",421905,0,0,3,3,"chr11",1,0.0105485232067511
"13465","chr11.40200000.40205000","chr11.40225000.40230000",25000,36,0.001061553,40200000,40225000,40205000,40230000,"chr11",421932,0,9,5,14,"chr11",1,0.0590717299578059
"13466","chr11.78150000.78155000","chr11.78270000.78275000",120000,23,8.626493e-08,78150000,78270000,78155000,78275000,"chr11",421962,4,10,8,22,"chr11",1,0.0593061415846226
"13467","chr11.72460000.72465000","chr11.72845000.72850000",385000,9,0.009387803,72460000,72845000,72465000,72850000,"chr11",421975,4,12,9,25,"chr11",1,0.0263713080168776
"13468","chr11.36155000.36160000","chr11.36275000.36280000",120000,18,0.0001128133,36155000,36275000,36160000,36280000,"chr11",421986,0,3,0,3,"chr11",1,0.00632911392405063
"13469","chr11.61945000.61950000","chr11.62080000.62085000",135000,14,0.006073743,61945000,62080000,61950000,62085000,"chr11",421990,5,11,9,25,"chr11",1,0.0410220346929208
"13470","chr11.110565000.110570000","chr11.111080000.111085000",515000,9,0.002189046,110565000,111080000,110570000,111085000,"chr11",422054,0,2,1,3,"chr11",1,0.00316455696202532
"13471","chr11.62665000.62670000","chr11.63505000.63510000",840000,8,0.0007739803,62665000,63505000,62670000,63510000,"chr11",422121,0,4,3,7,"chr11",1,0.00656352555086732
"13472","chr11.71635000.71640000","chr11.71810000.71815000",175000,14,0.00126728,71635000,71810000,71640000,71815000,"chr11",422143,0,3,1,4,"chr11",1,0.00656352555086732
"13473","chr11.57220000.57225000","chr11.57335000.57340000",115000,20,1.125993e-05,57220000,57335000,57225000,57340000,"chr11",422187,0,3,2,5,"chr11",1,0.0117205813408345
"13474","chr11.130890000.130895000","chr11.131540000.131545000",650000,9,0.0005538777,130890000,131540000,130895000,131545000,"chr11",422213,0,1,0,1,"chr11",1,0.00105485232067511
"13475","chr11.64550000.64555000","chr11.64885000.64890000",335000,11,0.001061553,64550000,64885000,64555000,64890000,"chr11",422214,0,4,4,8,"chr11",1,0.0103141115799344
"13476","chr11.36380000.36385000","chr11.36495000.36500000",115000,30,9.989203e-13,36380000,36495000,36385000,36500000,"chr11",422246,1,6,4,11,"chr11",1,0.0386779184247539
"13477","chr11.46825000.46830000","chr11.47160000.47165000",335000,11,0.001061553,46825000,47160000,46830000,47165000,"chr11",422280,2,4,5,11,"chr11",1,0.0141819034224098
"13478","chr11.14065000.14070000","chr11.14145000.14150000",80000,18,0.003390837,14065000,14145000,14070000,14150000,"chr11",422332,2,2,2,6,"chr11",1,0.0126582278481013
"13479","chr11.59535000.59540000","chr11.59565000.59570000",30000,29,0.008756408,59535000,59565000,59540000,59570000,"chr11",422336,3,12,16,31,"chr11",1,0.105368026254102
"13480","chr11.6405000.6410000","chr11.6605000.6610000",200000,12,0.006213648,6405000,6605000,6410000,6610000,"chr11",422338,0,2,1,3,"chr11",1,0.00421940928270042
"13481","chr11.77870000.77875000","chr11.78045000.78050000",175000,13,0.004289421,77870000,78045000,77875000,78050000,"chr11",422389,4,13,8,25,"chr11",1,0.0380918893577121
"13482","chr11.119585000.119590000","chr11.119750000.119755000",165000,18,7.816186e-06,119585000,119750000,119590000,119755000,"chr11",422420,0,2,1,3,"chr11",1,0.00632911392405063
"13483","chr11.112165000.112170000","chr11.112375000.112380000",210000,12,0.004630017,112165000,112375000,112170000,112380000,"chr11",422427,0,3,1,4,"chr11",1,0.00562587904360056
"13484","chr11.111980000.111985000","chr11.112020000.112025000",40000,27,0.000917774,111980000,112020000,111985000,112025000,"chr11",422437,0,5,10,15,"chr11",1,0.0474683544303797
"13485","chr11.72775000.72780000","chr11.72820000.72825000",45000,23,0.007192356,72775000,72820000,72780000,72825000,"chr11",422460,0,1,1,2,"chr11",1,0.00539146741678387
"13486","chr11.112755000.112760000","chr11.112780000.112785000",25000,40,4.569757e-05,112755000,112780000,112760000,112785000,"chr11",422475,0,3,1,4,"chr11",1,0.0187529301453352
"13487","chr11.65495000.65500000","chr11.65520000.65525000",25000,35,0.002175798,65495000,65520000,65500000,65525000,"chr11",422487,0,5,4,9,"chr11",1,0.0369198312236287
"13488","chr11.121195000.121200000","chr11.121460000.121465000",265000,37,2.342217e-27,121195000,121460000,121200000,121465000,"chr11",422500,0,0,2,2,"chr11",1,0.00867323019221753
"13489","chr11.62650000.62655000","chr11.62790000.62795000",140000,14,0.005017178,62650000,62790000,62655000,62795000,"chr11",422502,8,18,32,58,"chr11",1,0.0951711204875762
"13490","chr11.119760000.119765000","chr11.119970000.119975000",210000,18,6.579211e-07,119760000,119970000,119765000,119975000,"chr11",422525,3,2,2,7,"chr11",1,0.0147679324894515
"13491","chr11.78030000.78035000","chr11.78045000.78050000",15000,39,0.0007739803,78030000,78045000,78035000,78050000,"chr11",422541,12,18,31,61,"chr11",1,0.278832630098453
"13492","chr11.116275000.116280000","chr11.116295000.116300000",20000,36,0.005637993,116275000,116295000,116280000,116300000,"chr11",422574,1,1,3,5,"chr11",1,0.0210970464135021
"13493","chr11.86150000.86155000","chr11.86520000.86525000",370000,11,0.0006140401,86150000,86520000,86155000,86525000,"chr11",422579,1,2,6,9,"chr11",1,0.0116033755274262
"13494","chr11.11655000.11660000","chr11.11805000.11810000",150000,18,1.866393e-05,11655000,11805000,11660000,11810000,"chr11",422600,2,3,6,11,"chr11",1,0.0232067510548523
"13495","chr11.47450000.47455000","chr11.47575000.47580000",125000,21,1.191773e-06,47450000,47575000,47455000,47580000,"chr11",422621,2,5,10,17,"chr11",1,0.0418424753867792
"13496","chr11.64970000.64975000","chr11.65080000.65085000",110000,15,0.006750723,64970000,65080000,64975000,65085000,"chr11",422647,5,14,11,30,"chr11",1,0.0527426160337553
"13497","chr11.125465000.125470000","chr11.125495000.125500000",30000,32,0.0009985604,125465000,125495000,125470000,125500000,"chr11",422648,2,0,5,7,"chr11",1,0.0262541022034693
"13498","chr11.107685000.107690000","chr11.107700000.107705000",15000,41,0.0001746852,107685000,107700000,107690000,107705000,"chr11",422656,2,4,2,8,"chr11",1,0.0384435067979372
"13499","chr11.62620000.62625000","chr11.62645000.62650000",25000,42,8.048964e-06,62620000,62645000,62625000,62650000,"chr11",422664,0,0,3,3,"chr11",1,0.0147679324894515
"13500","chr11.113010000.113015000","chr11.113135000.113140000",125000,15,0.003134986,113010000,113135000,113015000,113140000,"chr11",422666,2,6,2,10,"chr11",1,0.0175808720112518
"13501","chr11.35980000.35985000","chr11.36010000.36015000",30000,44,9.08624e-09,35980000,36010000,35985000,36015000,"chr11",422668,0,4,3,7,"chr11",1,0.0360993905297703
"13502","chr11.73175000.73180000","chr11.73335000.73340000",160000,19,2.306531e-06,73175000,73335000,73180000,73340000,"chr11",422676,1,5,3,9,"chr11",1,0.020042194092827
"13503","chr11.35485000.35490000","chr11.36290000.36295000",805000,8,0.0009968861,35485000,36290000,35490000,36295000,"chr11",422698,2,5,5,12,"chr11",1,0.0112517580872011
"13504","chr11.65135000.65140000","chr11.65290000.65295000",155000,14,0.002788217,65135000,65290000,65140000,65295000,"chr11",422705,3,8,9,20,"chr11",1,0.0328176277543366
"13505","chr11.46360000.46365000","chr11.46615000.46620000",255000,11,0.005044969,46360000,46615000,46365000,46620000,"chr11",422739,0,4,2,6,"chr11",1,0.00773558368495077
"13506","chr11.125440000.125445000","chr11.125490000.125495000",50000,28,2.055153e-05,125440000,125490000,125445000,125495000,"chr11",422743,0,8,4,12,"chr11",1,0.0393811533052039
"13507","chr11.62170000.62175000","chr11.62390000.62395000",220000,12,0.003456989,62170000,62390000,62175000,62395000,"chr11",422765,0,6,4,10,"chr11",1,0.0140646976090014
"13508","chr11.83530000.83535000","chr11.84245000.84250000",715000,8,0.001906522,83530000,84245000,83535000,84250000,"chr11",422777,0,3,2,5,"chr11",1,0.0046882325363338
"13509","chr11.65485000.65490000","chr11.65605000.65610000",120000,15,0.004027368,65485000,65605000,65490000,65610000,"chr11",422833,0,2,1,3,"chr11",1,0.00527426160337553
"13510","chr11.65480000.65485000","chr11.65585000.65590000",105000,32,1.276449e-13,65480000,65585000,65485000,65590000,"chr11",422888,0,5,2,7,"chr11",1,0.0262541022034693
"13511","chr11.78000000.78005000","chr11.78105000.78110000",105000,24,9.324127e-08,7.8e+07,78105000,78005000,78110000,"chr11",422890,6,25,26,57,"chr11",1,0.160337552742616
"13512","chr11.131585000.131590000","chr11.131885000.131890000",300000,10,0.007625651,131585000,131885000,131590000,131890000,"chr11",422919,1,3,1,5,"chr11",1,0.00586029067041725
"13513","chr11.40200000.40205000","chr11.40305000.40310000",105000,24,9.324127e-08,40200000,40305000,40205000,40310000,"chr11",422955,2,6,6,14,"chr11",1,0.0393811533052039
"13514","chr11.119090000.119095000","chr11.119145000.119150000",55000,28,5.292552e-06,119090000,119145000,119095000,119150000,"chr11",422957,0,3,1,4,"chr11",1,0.0131270511017346
"13515","chr11.45960000.45965000","chr11.45980000.45985000",20000,36,0.005637993,45960000,45980000,45965000,45985000,"chr11",422968,1,5,7,13,"chr11",1,0.0548523206751055
"13516","chr11.35980000.35985000","chr11.36040000.36045000",60000,29,3.828649e-07,35980000,36040000,35985000,36045000,"chr11",422980,1,3,1,5,"chr11",1,0.01699484294421
"13517","chr11.73125000.73130000","chr11.73315000.73320000",190000,17,9.411327e-06,73125000,73315000,73130000,73320000,"chr11",422997,1,4,1,6,"chr11",1,0.0119549929676512
"13518","chr11.125455000.125460000","chr11.125490000.125495000",35000,38,1.494527e-07,125455000,125490000,125460000,125495000,"chr11",423022,2,13,5,20,"chr11",1,0.0890764181903422
"13519","chr11.121530000.121535000","chr11.122190000.122195000",660000,8,0.002915925,121530000,122190000,121535000,122195000,"chr11",423056,0,4,2,6,"chr11",1,0.00562587904360056
"13520","chr11.61890000.61895000","chr11.62080000.62085000",190000,17,9.411327e-06,61890000,62080000,61895000,62085000,"chr11",423062,7,7,10,24,"chr11",1,0.0478199718706048
"13521","chr11.120390000.120395000","chr11.120665000.120670000",275000,12,0.0008089154,120390000,120665000,120395000,120670000,"chr11",423064,1,1,2,4,"chr11",1,0.00562587904360056
"13522","chr11.26775000.26780000","chr11.27180000.27185000",405000,21,4.45264e-13,26775000,27180000,26780000,27185000,"chr11",423068,0,6,4,10,"chr11",1,0.0246132208157525
"13523","chr11.3855000.3860000","chr11.4070000.4075000",215000,14,0.0002782545,3855000,4070000,3860000,4075000,"chr11",423086,1,1,1,3,"chr11",1,0.00492264416315049
"13524","chr11.35940000.35945000","chr11.36130000.36135000",190000,12,0.00838713,35940000,36130000,35945000,36135000,"chr11",423119,1,2,1,4,"chr11",1,0.00562587904360056
"13525","chr11.64225000.64230000","chr11.64295000.64300000",70000,21,0.0005429726,64225000,64295000,64230000,64300000,"chr11",423177,0,8,12,20,"chr11",1,0.0492264416315049
"13526","chr11.33195000.33200000","chr11.33255000.33260000",60000,20,0.006541073,33195000,33255000,33200000,33260000,"chr11",423191,0,11,3,14,"chr11",1,0.0328176277543366
"13527","chr11.64890000.64895000","chr11.65095000.65100000",205000,15,9.617149e-05,64890000,65095000,64895000,65100000,"chr11",423195,2,4,8,14,"chr11",1,0.0246132208157525
"13528","chr11.33350000.33355000","chr11.33760000.33765000",410000,9,0.007051584,33350000,33760000,33355000,33765000,"chr11",423206,2,3,2,7,"chr11",1,0.00738396624472574
"13529","chr11.66855000.66860000","chr11.67095000.67100000",240000,11,0.007139806,66855000,67095000,66860000,67100000,"chr11",423227,0,4,0,4,"chr11",1,0.00515705578996718
"13530","chr11.580000.585000","chr11.710000.715000",130000,17,0.0002241194,580000,710000,585000,715000,"chr11",423231,8,22,26,56,"chr11",1,0.111579934364744
"13531","chr11.36085000.36090000","chr11.36155000.36160000",70000,23,5.939981e-05,36085000,36155000,36090000,36160000,"chr11",423248,4,6,2,12,"chr11",1,0.0323488045007032
"13532","chr11.18540000.18545000","chr11.18750000.18755000",210000,16,1.705251e-05,18540000,18750000,18545000,18755000,"chr11",423273,0,1,1,2,"chr11",1,0.00375058602906704
"13533","chr11.117705000.117710000","chr11.117935000.117940000",230000,11,0.009090773,117705000,117935000,117710000,117940000,"chr11",423306,0,2,3,5,"chr11",1,0.00644631973745898
"13534","chr11.121195000.121200000","chr11.121220000.121225000",25000,33,0.008119404,121195000,121220000,121200000,121225000,"chr11",423330,0,0,3,3,"chr11",1,0.0116033755274262
"13535","chr11.117720000.117725000","chr11.117835000.117840000",115000,17,0.0005440263,117720000,117835000,117725000,117840000,"chr11",423343,1,0,1,2,"chr11",1,0.00398499765588373
"13536","chr11.117440000.117445000","chr11.117465000.117470000",25000,39,0.0001059285,117440000,117465000,117445000,117470000,"chr11",423367,0,2,1,3,"chr11",1,0.0137130801687764
"13537","chr11.108590000.108595000","chr11.108695000.108700000",105000,15,0.009090773,108590000,108695000,108595000,108700000,"chr11",423377,0,1,0,1,"chr11",1,0.00175808720112518
"13538","chr11.91950000.91955000","chr11.92890000.92895000",940000,7,0.002548105,91950000,92890000,91955000,92895000,"chr11",423419,0,4,1,5,"chr11",1,0.00410220346929208
"13539","chr11.65540000.65545000","chr11.65585000.65590000",45000,26,0.0005538777,65540000,65585000,65545000,65590000,"chr11",423424,0,2,0,2,"chr11",1,0.00609470229723394
"13540","chr11.71800000.71805000","chr11.72140000.72145000",340000,10,0.004203973,71800000,72140000,71805000,72145000,"chr11",423442,2,6,7,15,"chr11",1,0.0175808720112518
"13541","chr11.111740000.111745000","chr11.111840000.111845000",100000,18,0.0005158251,111740000,111840000,111745000,111845000,"chr11",423478,0,6,4,10,"chr11",1,0.0210970464135021
"13542","chr11.83005000.83010000","chr11.83530000.83535000",525000,16,1.785804e-09,83005000,83530000,83010000,83535000,"chr11",423484,0,3,2,5,"chr11",1,0.00937646507266761
"13543","chr11.47255000.47260000","chr11.47430000.47435000",175000,14,0.00126728,47255000,47430000,47260000,47435000,"chr11",423497,12,25,25,62,"chr11",1,0.101734646038444
"13544","chr11.9660000.9665000","chr11.9760000.9765000",100000,17,0.00158388,9660000,9760000,9665000,9765000,"chr11",423507,2,4,1,7,"chr11",1,0.0139474917955931
"13545","chr11.9220000.9225000","chr11.9275000.9280000",55000,28,5.292552e-06,9220000,9275000,9225000,9280000,"chr11",423540,7,44,29,80,"chr11",1,0.262541022034693
"13546","chr11.42780000.42785000","chr11.43310000.43315000",530000,9,0.001869524,42780000,43310000,42785000,43315000,"chr11",423562,0,1,3,4,"chr11",1,0.00421940928270042
"13547","chr11.33195000.33200000","chr11.33305000.33310000",110000,15,0.006750723,33195000,33305000,33200000,33310000,"chr11",423580,5,7,10,22,"chr11",1,0.0386779184247539
"13548","chr11.47515000.47520000","chr11.47540000.47545000",25000,53,1.025192e-10,47515000,47540000,47520000,47545000,"chr11",423583,2,24,17,43,"chr11",1,0.267112048757618
"13549","chr11.110075000.110080000","chr11.110200000.110205000",125000,15,0.003134986,110075000,110200000,110080000,110205000,"chr11",423613,0,2,2,4,"chr11",1,0.0070323488045007
"13550","chr11.62545000.62550000","chr11.62610000.62615000",65000,20,0.003068502,62545000,62610000,62550000,62615000,"chr11",423657,2,3,2,7,"chr11",1,0.0164088138771683
"13551","chr11.124800000.124805000","chr11.125360000.125365000",560000,14,7.816886e-08,124800000,125360000,124805000,125365000,"chr11",423683,4,9,7,20,"chr11",1,0.0328176277543366
"13552","chr11.3810000.3815000","chr11.4095000.4100000",285000,10,0.009894893,3810000,4095000,3815000,4100000,"chr11",423701,4,14,18,36,"chr11",1,0.0421940928270042
"13553","chr11.10450000.10455000","chr11.10735000.10740000",285000,14,2.767108e-05,10450000,10735000,10455000,10740000,"chr11",423827,0,3,3,6,"chr11",1,0.00984528832630099
"13554","chr11.119760000.119765000","chr11.119875000.119880000",115000,18,0.0001596608,119760000,119875000,119765000,119880000,"chr11",423834,0,2,1,3,"chr11",1,0.00632911392405063
"13555","chr11.33195000.33200000","chr11.33730000.33735000",535000,9,0.001765604,33195000,33730000,33200000,33735000,"chr11",423870,2,5,2,9,"chr11",1,0.00949367088607595
"13556","chr11.43905000.43910000","chr11.44065000.44070000",160000,24,5.119382e-10,43905000,44065000,43910000,44070000,"chr11",423892,3,3,1,7,"chr11",1,0.019690576652602
"13557","chr11.63545000.63550000","chr11.63600000.63605000",55000,22,0.002648393,63545000,63600000,63550000,63605000,"chr11",423895,4,15,12,31,"chr11",1,0.0799343647444913
"13558","chr11.118570000.118575000","chr11.118705000.118710000",135000,15,0.002004479,118570000,118705000,118575000,118710000,"chr11",423905,3,23,19,45,"chr11",1,0.0791139240506329
"13559","chr11.20030000.20035000","chr11.20045000.20050000",15000,36,0.005637993,20030000,20045000,20035000,20050000,"chr11",423946,0,2,0,2,"chr11",1,0.00843881856540084
"13560","chr11.119085000.119090000","chr11.119110000.119115000",25000,37,0.0005101673,119085000,119110000,119090000,119115000,"chr11",423947,2,0,1,3,"chr11",1,0.0130098452883263
"13561","chr11.74725000.74730000","chr11.74945000.74950000",220000,12,0.003456989,74725000,74945000,74730000,74950000,"chr11",423952,2,4,5,11,"chr11",1,0.0154711673699015
"13562","chr11.65095000.65100000","chr11.65275000.65280000",180000,27,2.733746e-13,65095000,65275000,65100000,65280000,"chr11",423955,1,4,5,10,"chr11",1,0.0316455696202532
"13563","chr11.34275000.34280000","chr11.34315000.34320000",40000,29,0.0001484255,34275000,34315000,34280000,34320000,"chr11",423970,2,10,3,15,"chr11",1,0.0509845288326301
"13564","chr11.1300000.1305000","chr11.1510000.1515000",210000,12,0.004630017,1300000,1510000,1305000,1515000,"chr11",423971,0,2,1,3,"chr11",1,0.00421940928270042
"13565","chr11.61625000.61630000","chr11.61890000.61895000",265000,13,0.0002376872,61625000,61890000,61630000,61895000,"chr11",424000,0,5,7,12,"chr11",1,0.0182841068917018
"13566","chr11.67940000.67945000","chr11.68255000.68260000",315000,10,0.006050748,67940000,68255000,67945000,68260000,"chr11",424006,0,2,3,5,"chr11",1,0.00586029067041725
"13567","chr11.46845000.46850000","chr11.47330000.47335000",485000,9,0.003028835,46845000,47330000,46850000,47335000,"chr11",424008,0,5,4,9,"chr11",1,0.00949367088607595
"13568","chr11.9200000.9205000","chr11.9230000.9235000",30000,37,1.319731e-05,9200000,9230000,9205000,9235000,"chr11",424063,3,5,8,16,"chr11",1,0.0693858415377403
"13569","chr11.47530000.47535000","chr11.47575000.47580000",45000,23,0.007192356,47530000,47575000,47535000,47580000,"chr11",424064,2,5,10,17,"chr11",1,0.0458274730426629
"13570","chr11.10520000.10525000","chr11.10670000.10675000",150000,15,0.001039364,10520000,10670000,10525000,10675000,"chr11",424074,0,0,2,2,"chr11",1,0.00351617440225035
"13571","chr11.45995000.46000000","chr11.46305000.46310000",310000,12,0.0003756276,45995000,46305000,4.6e+07,46310000,"chr11",424117,1,6,10,17,"chr11",1,0.0239099859353024
"13572","chr11.36300000.36305000","chr11.36495000.36500000",195000,21,8.355782e-09,36300000,36495000,36305000,36500000,"chr11",424148,1,1,0,2,"chr11",1,0.00492264416315049
"13573","chr11.35175000.35180000","chr11.35275000.35280000",100000,20,4.457719e-05,35175000,35275000,35180000,35280000,"chr11",424179,0,4,3,7,"chr11",1,0.0164088138771683
"13574","chr11.63960000.63965000","chr11.64040000.64045000",80000,19,0.001227442,63960000,64040000,63965000,64045000,"chr11",424186,2,2,3,7,"chr11",1,0.0155883731833099
"13575","chr11.72590000.72595000","chr11.72820000.72825000",230000,11,0.009090773,72590000,72820000,72595000,72825000,"chr11",424255,0,1,1,2,"chr11",1,0.00257852789498359
"13576","chr11.6390000.6395000","chr11.6470000.6475000",80000,21,0.0001367635,6390000,6470000,6395000,6475000,"chr11",424259,1,4,6,11,"chr11",1,0.0270745428973277
"13577","chr11.36085000.36090000","chr11.36270000.36275000",185000,12,0.009798271,36085000,36270000,36090000,36275000,"chr11",424330,0,0,6,6,"chr11",1,0.00843881856540084
"13578","chr11.82600000.82605000","chr11.82985000.82990000",385000,11,0.0004880319,82600000,82985000,82605000,82990000,"chr11",424338,2,1,2,5,"chr11",1,0.00644631973745898
"13579","chr11.118080000.118085000","chr11.118220000.118225000",140000,33,1.000729e-16,118080000,118220000,118085000,118225000,"chr11",424339,0,1,2,3,"chr11",1,0.0116033755274262
"13580","chr11.78075000.78080000","chr11.78100000.78105000",25000,46,1.851576e-07,78075000,78100000,78080000,78105000,"chr11",424344,4,16,17,37,"chr11",1,0.199484294421003
"13581","chr11.102285000.102290000","chr11.102320000.102325000",35000,43,3.799879e-10,102285000,102320000,102290000,102325000,"chr11",424357,5,11,8,24,"chr11",1,0.120956399437412
"13582","chr11.119220000.119225000","chr11.119340000.119345000",120000,18,0.0001128133,119220000,119340000,119225000,119345000,"chr11",424488,3,0,2,5,"chr11",1,0.0105485232067511
"13583","chr11.117375000.117380000","chr11.117670000.117675000",295000,13,0.0001083754,117375000,117670000,117380000,117675000,"chr11",424504,0,1,2,3,"chr11",1,0.00457102672292546
"13584","chr11.61760000.61765000","chr11.61825000.61830000",65000,48,2.201797e-21,61760000,61825000,61765000,61830000,"chr11",424572,0,8,3,11,"chr11",1,0.0618846694796062
"13585","chr11.117315000.117320000","chr11.117715000.117720000",400000,9,0.007898701,117315000,117715000,117320000,117720000,"chr11",424592,0,8,5,13,"chr11",1,0.0137130801687764
"13586","chr11.35660000.35665000","chr11.36495000.36500000",835000,8,0.0007973773,35660000,36495000,35665000,36500000,"chr11",424599,3,3,5,11,"chr11",1,0.0103141115799344
"13587","chr11.680000.685000","chr11.760000.765000",80000,20,0.0004232169,680000,760000,685000,765000,"chr11",424682,4,12,10,26,"chr11",1,0.0609470229723394
"13588","chr11.85590000.85595000","chr11.85975000.85980000",385000,9,0.009387803,85590000,85975000,85595000,85980000,"chr11",424718,0,2,2,4,"chr11",1,0.00421940928270042
"13589","chr11.119065000.119070000","chr11.119165000.119170000",100000,25,3.866085e-08,119065000,119165000,119070000,119170000,"chr11",424757,5,11,7,23,"chr11",1,0.0673933427097984
"13590","chr11.117465000.117470000","chr11.117670000.117675000",205000,19,1.573806e-07,117465000,117670000,117470000,117675000,"chr11",424780,0,1,1,2,"chr11",1,0.00445382090951711
"13591","chr11.121380000.121385000","chr11.121460000.121465000",80000,19,0.001227442,121380000,121460000,121385000,121465000,"chr11",424832,2,6,2,10,"chr11",1,0.0222691045475856
"13592","chr11.66405000.66410000","chr11.67005000.67010000",600000,8,0.004759951,66405000,67005000,66410000,67010000,"chr11",424868,2,7,4,13,"chr11",1,0.0121894045944679
"13593","chr11.66890000.66895000","chr11.67095000.67100000",205000,14,0.0004041451,66890000,67095000,66895000,67100000,"chr11",424885,0,28,16,44,"chr11",1,0.0721987810595406
"13594","chr11.117455000.117460000","chr11.117590000.117595000",135000,14,0.006073743,117455000,117590000,117460000,117595000,"chr11",424893,0,2,1,3,"chr11",1,0.00492264416315049
"13595","chr11.121195000.121200000","chr11.121320000.121325000",125000,24,1.06498e-08,121195000,121320000,121200000,121325000,"chr11",425005,0,0,3,3,"chr11",1,0.00843881856540084
"13596","chr11.66385000.66390000","chr11.66415000.66420000",30000,52,5.252058e-13,66385000,66415000,66390000,66420000,"chr11",425098,2,2,1,5,"chr11",1,0.0304735114861697
"13597","chr11.121200000.121205000","chr11.121460000.121465000",260000,20,1.210076e-09,121200000,121460000,121205000,121465000,"chr11",425102,2,6,2,10,"chr11",1,0.023441162681669
"13598","chr11.118080000.118085000","chr11.118100000.118105000",20000,47,1.112089e-06,118080000,118100000,118085000,118105000,"chr11",425105,0,5,2,7,"chr11",1,0.0385607126113455
"13599","chr11.12080000.12085000","chr11.12285000.12290000",205000,24,1.339296e-11,12080000,12285000,12085000,12290000,"chr11",425115,0,2,0,2,"chr11",1,0.00562587904360056
"13600","chr11.84310000.84315000","chr11.84330000.84335000",20000,44,1.55559e-05,84310000,84330000,84315000,84335000,"chr11",425122,1,7,10,18,"chr11",1,0.0928270042194093
"13601","chr11.124835000.124840000","chr11.125215000.125220000",380000,11,0.0005272843,124835000,125215000,124840000,125220000,"chr11",425132,1,5,5,11,"chr11",1,0.0141819034224098
"13602","chr11.131885000.131890000","chr11.131980000.131985000",95000,16,0.006541073,131885000,131980000,131890000,131985000,"chr11",425142,0,3,1,4,"chr11",1,0.00750117205813408
"13603","chr11.67005000.67010000","chr11.67080000.67085000",75000,23,2.600444e-05,67005000,67080000,67010000,67085000,"chr11",425149,15,43,41,99,"chr11",1,0.266877637130802
"13604","chr11.45330000.45335000","chr11.45800000.45805000",470000,9,0.003596168,45330000,45800000,45335000,45805000,"chr11",425162,1,4,2,7,"chr11",1,0.00738396624472574
"13605","chr11.33875000.33880000","chr11.33995000.34000000",120000,17,0.0004018914,33875000,33995000,33880000,3.4e+07,"chr11",425215,0,12,2,14,"chr11",1,0.0278949835911861
"13606","chr11.116770000.116775000","chr11.116865000.116870000",95000,32,8.69927e-13,116770000,116865000,116775000,116870000,"chr11",425233,0,0,2,2,"chr11",1,0.00750117205813408
"13607","chr11.77990000.77995000","chr11.78140000.78145000",150000,16,0.0002926889,77990000,78140000,77995000,78145000,"chr11",425266,7,24,23,54,"chr11",1,0.10126582278481
"13608","chr11.118055000.118060000","chr11.118210000.118215000",155000,14,0.002788217,118055000,118210000,118060000,118215000,"chr11",425283,0,3,6,9,"chr11",1,0.0147679324894515
"13609","chr11.75100000.75105000","chr11.75245000.75250000",145000,17,9.942527e-05,75100000,75245000,75105000,75250000,"chr11",425284,3,8,5,16,"chr11",1,0.0318799812470699
"13610","chr11.64940000.64945000","chr11.65010000.65015000",70000,19,0.003994913,64940000,65010000,64945000,65015000,"chr11",425295,2,6,9,17,"chr11",1,0.0378574777308955
"13611","chr11.83030000.83035000","chr11.83530000.83535000",500000,12,1.350002e-05,83030000,83530000,83035000,83535000,"chr11",425299,0,3,2,5,"chr11",1,0.0070323488045007
"13612","chr11.117315000.117320000","chr11.117590000.117595000",275000,11,0.003252287,117315000,117590000,117320000,117595000,"chr11",425336,3,3,11,17,"chr11",1,0.0219174871073605
"13613","chr11.3860000.3865000","chr11.4085000.4090000",225000,14,0.0001924844,3860000,4085000,3865000,4090000,"chr11",425377,3,1,0,4,"chr11",1,0.00656352555086732
"13614","chr11.1735000.1740000","chr11.1815000.1820000",80000,17,0.008774219,1735000,1815000,1740000,1820000,"chr11",425381,0,1,1,2,"chr11",1,0.00398499765588373
"13615","chr11.117105000.117110000","chr11.117175000.117180000",70000,20,0.00151508,117105000,117175000,117110000,117180000,"chr11",425383,2,34,15,51,"chr11",1,0.119549929676512
"13616","chr11.62570000.62575000","chr11.62610000.62615000",40000,30,5.610646e-05,62570000,62610000,62575000,62615000,"chr11",425402,0,3,2,5,"chr11",1,0.0175808720112518
"13617","chr11.16820000.16825000","chr11.16860000.16865000",40000,25,0.004759951,16820000,16860000,16825000,16865000,"chr11",425423,1,4,7,12,"chr11",1,0.0351617440225035
"13618","chr11.74700000.74705000","chr11.74940000.74945000",240000,16,4.676643e-06,74700000,74940000,74705000,74945000,"chr11",425449,3,2,1,6,"chr11",1,0.0112517580872011
"13619","chr11.102275000.102280000","chr11.102320000.102325000",45000,31,3.286126e-06,102275000,102320000,102280000,102325000,"chr11",425482,3,13,11,27,"chr11",1,0.0981012658227848
"13620","chr11.121200000.121205000","chr11.121470000.121475000",270000,12,0.000917774,121200000,121470000,121205000,121475000,"chr11",425489,4,15,4,23,"chr11",1,0.0323488045007032
"13621","chr11.117705000.117710000","chr11.117835000.117840000",130000,18,5.950879e-05,117705000,117835000,117710000,117840000,"chr11",425501,0,2,1,3,"chr11",1,0.00632911392405063
"13622","chr11.116875000.116880000","chr11.117045000.117050000",170000,16,0.000110804,116875000,117045000,116880000,117050000,"chr11",425514,1,3,2,6,"chr11",1,0.0112517580872011
"13623","chr11.66220000.66225000","chr11.66590000.66595000",370000,16,7.603607e-08,66220000,66590000,66225000,66595000,"chr11",425515,1,1,2,4,"chr11",1,0.00750117205813408
"13624","chr11.250000.255000","chr11.350000.355000",100000,16,0.004591244,250000,350000,255000,355000,"chr11",425537,0,1,1,2,"chr11",1,0.00375058602906704
"13625","chr11.65150000.65155000","chr11.65260000.65265000",110000,17,0.0007739803,65150000,65260000,65155000,65265000,"chr11",425540,5,24,21,50,"chr11",1,0.0996249413970933
"13626","chr11.73315000.73320000","chr11.73335000.73340000",20000,48,4.383315e-07,73315000,73335000,73320000,73340000,"chr11",425543,1,4,1,6,"chr11",1,0.0337552742616034
"13627","chr11.73390000.73395000","chr11.73595000.73600000",205000,15,9.617149e-05,73390000,73595000,73395000,73600000,"chr11",425563,1,1,4,6,"chr11",1,0.0105485232067511
"13628","chr11.66675000.66680000","chr11.66725000.66730000",50000,27,5.956403e-05,66675000,66725000,66680000,66730000,"chr11",425583,0,2,2,4,"chr11",1,0.0126582278481013
"13629","chr11.118570000.118575000","chr11.118635000.118640000",65000,22,0.0004299726,118570000,118635000,118575000,118640000,"chr11",425615,0,1,2,3,"chr11",1,0.00773558368495077
"13630","chr11.122980000.122985000","chr11.123120000.123125000",140000,41,2.348322e-24,122980000,123120000,122985000,123125000,"chr11",425640,3,6,11,20,"chr11",1,0.0961087669948429
"13631","chr11.11415000.11420000","chr11.11655000.11660000",240000,13,0.0005000665,11415000,11655000,11420000,11660000,"chr11",425656,0,2,1,3,"chr11",1,0.00457102672292546
"13632","chr11.65470000.65475000","chr11.65660000.65665000",190000,12,0.00838713,65470000,65660000,65475000,65665000,"chr11",425671,6,8,21,35,"chr11",1,0.0492264416315049
"13633","chr11.66385000.66390000","chr11.66430000.66435000",45000,33,3.322813e-07,66385000,66430000,66390000,66435000,"chr11",425673,10,29,18,57,"chr11",1,0.220464135021097
"13634","chr11.131885000.131890000","chr11.132840000.132845000",955000,8,0.0003221559,131885000,132840000,131890000,132845000,"chr11",425790,1,3,1,5,"chr11",1,0.0046882325363338
"13635","chr11.118315000.118320000","chr11.118355000.118360000",40000,33,2.495727e-06,118315000,118355000,118320000,118360000,"chr11",425819,0,7,3,10,"chr11",1,0.0386779184247539
"13636","chr11.22700000.22705000","chr11.22725000.22730000",25000,33,0.008119404,22700000,22725000,22705000,22730000,"chr11",425827,0,2,2,4,"chr11",1,0.0154711673699015
"13637","chr11.62675000.62680000","chr11.62785000.62790000",110000,25,1.050285e-08,62675000,62785000,62680000,62790000,"chr11",425847,4,13,9,26,"chr11",1,0.0761837787154243
"13638","chr11.30330000.30335000","chr11.30940000.30945000",610000,9,0.0008163543,30330000,30940000,30335000,30945000,"chr11",425849,0,2,0,2,"chr11",1,0.00210970464135021
"13639","chr11.62500000.62505000","chr11.62595000.62600000",95000,38,1.183182e-17,62500000,62595000,62505000,62600000,"chr11",425854,0,0,2,2,"chr11",1,0.00890764181903422
"13640","chr11.119110000.119115000","chr11.119145000.119150000",35000,37,4.446715e-07,119110000,119145000,119115000,119150000,"chr11",425857,2,0,1,3,"chr11",1,0.0130098452883263
"13641","chr11.122440000.122445000","chr11.122745000.122750000",305000,11,0.001808533,122440000,122745000,122445000,122750000,"chr11",425898,0,2,1,3,"chr11",1,0.00386779184247539
"13642","chr11.131235000.131240000","chr11.131510000.131515000",275000,11,0.003252287,131235000,131510000,131240000,131515000,"chr11",425919,0,2,2,4,"chr11",1,0.00515705578996718
"13643","chr11.116710000.116715000","chr11.116970000.116975000",260000,22,2.048247e-11,116710000,116970000,116715000,116975000,"chr11",425921,0,6,3,9,"chr11",1,0.0232067510548523
"13644","chr11.119605000.119610000","chr11.120030000.120035000",425000,11,0.0002656666,119605000,120030000,119610000,120035000,"chr11",425923,0,0,3,3,"chr11",1,0.00386779184247539
"13645","chr11.118610000.118615000","chr11.118650000.118655000",40000,28,0.0003782187,118610000,118650000,118615000,118655000,"chr11",425950,0,2,1,3,"chr11",1,0.00984528832630099
"13646","chr11.116840000.116845000","chr11.116920000.116925000",80000,26,2.204965e-07,116840000,116920000,116845000,116925000,"chr11",426010,5,20,20,45,"chr11",1,0.137130801687764
"13647","chr11.86100000.86105000","chr11.86520000.86525000",420000,11,0.0002869861,86100000,86520000,86105000,86525000,"chr11",426013,1,2,6,9,"chr11",1,0.0116033755274262
"13648","chr11.64580000.64585000","chr11.65025000.65030000",445000,18,1.385752e-10,64580000,65025000,64585000,65030000,"chr11",426020,0,2,2,4,"chr11",1,0.00843881856540084
"13649","chr11.48040000.48045000","chr11.48080000.48085000",40000,26,0.002147236,48040000,48080000,48045000,48085000,"chr11",426030,6,17,11,34,"chr11",1,0.103609939052977
"13650","chr11.116865000.116870000","chr11.116895000.116900000",30000,32,0.0009985604,116865000,116895000,116870000,116900000,"chr11",426038,0,2,2,4,"chr11",1,0.0150023441162682
"13651","chr11.46490000.46495000","chr11.46825000.46830000",335000,10,0.004503137,46490000,46825000,46495000,46830000,"chr11",426050,0,1,2,3,"chr11",1,0.00351617440225035
"13652","chr11.46610000.46615000","chr11.46645000.46650000",35000,32,7.227617e-05,46610000,46645000,46615000,46650000,"chr11",426058,13,32,40,85,"chr11",1,0.318799812470699
"13653","chr11.117440000.117445000","chr11.117660000.117665000",220000,13,0.0009431827,117440000,117660000,117445000,117665000,"chr11",426073,0,2,0,2,"chr11",1,0.00304735114861697
"13654","chr11.118080000.118085000","chr11.118210000.118215000",130000,16,0.0007775766,118080000,118210000,118085000,118215000,"chr11",426087,0,5,2,7,"chr11",1,0.0131270511017346
"13655","chr11.111600000.111605000","chr11.111635000.111640000",35000,30,0.0004391258,111600000,111635000,111605000,111640000,"chr11",426097,0,3,0,3,"chr11",1,0.0105485232067511
"13656","chr11.129860000.129865000","chr11.130010000.130015000",150000,16,0.0002926889,129860000,130010000,129865000,130015000,"chr11",426114,0,7,9,16,"chr11",1,0.0300046882325363
"13657","chr11.9185000.9190000","chr11.9310000.9315000",125000,19,2.087924e-05,9185000,9310000,9190000,9315000,"chr11",426143,0,4,2,6,"chr11",1,0.0133614627285513
"13658","chr11.35555000.35560000","chr11.35605000.35610000",50000,23,0.002788217,35555000,35605000,35560000,35610000,"chr11",426170,1,7,4,12,"chr11",1,0.0323488045007032
"13659","chr11.82600000.82605000","chr11.82845000.82850000",245000,11,0.006332282,82600000,82845000,82605000,82850000,"chr11",426175,1,1,1,3,"chr11",1,0.00386779184247539
"13660","chr11.65585000.65590000","chr11.65695000.65700000",110000,16,0.002366381,65585000,65695000,65590000,65700000,"chr11",426231,0,5,2,7,"chr11",1,0.0131270511017346
"13661","chr11.118080000.118085000","chr11.118195000.118200000",115000,20,1.125993e-05,118080000,118195000,118085000,118200000,"chr11",426238,0,4,2,6,"chr11",1,0.0140646976090014
"13662","chr11.119585000.119590000","chr11.120030000.120035000",445000,11,0.0001948214,119585000,120030000,119590000,120035000,"chr11",426309,0,0,3,3,"chr11",1,0.00386779184247539
"13663","chr11.17420000.17425000","chr11.17525000.17530000",105000,15,0.009090773,17420000,17525000,17425000,17530000,"chr11",426321,0,1,1,2,"chr11",1,0.00351617440225035
"13664","chr11.120210000.120215000","chr11.120545000.120550000",335000,11,0.001061553,120210000,120545000,120215000,120550000,"chr11",426341,0,0,1,1,"chr11",1,0.0012892639474918
"13665","chr11.131590000.131595000","chr11.131885000.131890000",295000,11,0.002179846,131590000,131885000,131595000,131890000,"chr11",426374,1,3,1,5,"chr11",1,0.00644631973745898
"13666","chr11.129920000.129925000","chr11.130010000.130015000",90000,17,0.003610923,129920000,130010000,129925000,130015000,"chr11",426405,0,2,0,2,"chr11",1,0.00398499765588373
"13667","chr11.10320000.10325000","chr11.10770000.10775000",450000,11,0.0001815381,10320000,10770000,10325000,10775000,"chr11",426523,0,2,1,3,"chr11",1,0.00386779184247539
"13668","chr11.65040000.65045000","chr11.65115000.65120000",75000,25,2.097476e-06,65040000,65115000,65045000,65120000,"chr11",426546,3,5,2,10,"chr11",1,0.0293014533520863
"13669","chr11.125340000.125345000","chr11.125440000.125445000",100000,16,0.004591244,125340000,125440000,125345000,125445000,"chr11",426548,0,4,1,5,"chr11",1,0.00937646507266761
"13670","chr11.77045000.77050000","chr11.77150000.77155000",105000,20,2.737129e-05,77045000,77150000,77050000,77155000,"chr11",426603,3,4,5,12,"chr11",1,0.0281293952180028
"13671","chr11.83020000.83025000","chr11.83530000.83535000",510000,11,7.534125e-05,83020000,83530000,83025000,83535000,"chr11",426623,0,1,2,3,"chr11",1,0.00386779184247539
"13672","chr11.20475000.20480000","chr11.20635000.20640000",160000,13,0.007192356,20475000,20635000,20480000,20640000,"chr11",426626,2,1,10,13,"chr11",1,0.0198077824660103
"13673","chr11.66340000.66345000","chr11.66430000.66435000",90000,16,0.009624967,66340000,66430000,66345000,66435000,"chr11",426661,1,9,3,13,"chr11",1,0.0243788091889358
"13674","chr11.64140000.64145000","chr11.64305000.64310000",165000,13,0.006060268,64140000,64305000,64145000,64310000,"chr11",426711,0,3,7,10,"chr11",1,0.0152367557430849
"13675","chr11.65830000.65835000","chr11.65900000.65905000",70000,19,0.003994913,65830000,65900000,65835000,65905000,"chr11",426749,1,8,3,12,"chr11",1,0.0267229254571027
"13676","chr11.116740000.116745000","chr11.116970000.116975000",230000,25,2.556627e-13,116740000,116970000,116745000,116975000,"chr11",426760,6,9,8,23,"chr11",1,0.0673933427097984
"13677","chr11.121315000.121320000","chr11.121460000.121465000",145000,33,5.293419e-17,121315000,121460000,121320000,121465000,"chr11",426762,1,6,2,9,"chr11",1,0.0348101265822785
"13678","chr11.121320000.121325000","chr11.121380000.121385000",60000,28,1.335512e-06,121320000,121380000,121325000,121385000,"chr11",426768,3,8,6,17,"chr11",1,0.0557899671823722
"13679","chr11.111980000.111985000","chr11.112070000.112075000",90000,16,0.009624967,111980000,112070000,111985000,112075000,"chr11",426810,0,5,4,9,"chr11",1,0.0168776371308017
"13680","chr11.122140000.122145000","chr11.122320000.122325000",180000,20,1.300481e-07,122140000,122320000,122145000,122325000,"chr11",426813,4,1,2,7,"chr11",1,0.0164088138771683
"13681","chr11.118175000.118180000","chr11.118220000.118225000",45000,30,9.963157e-06,118175000,118220000,118180000,118225000,"chr11",426855,2,1,3,6,"chr11",1,0.0210970464135021
"13682","chr11.62665000.62670000","chr11.62785000.62790000",120000,23,8.626493e-08,62665000,62785000,62670000,62790000,"chr11",426911,3,4,17,24,"chr11",1,0.0646976090014065
"13683","chr11.122505000.122510000","chr11.122655000.122660000",150000,17,7.601346e-05,122505000,122655000,122510000,122660000,"chr11",426953,1,4,3,8,"chr11",1,0.0159399906235349
"13684","chr11.102265000.102270000","chr11.102365000.102370000",100000,29,6.124229e-11,102265000,102365000,102270000,102370000,"chr11",426981,3,4,12,19,"chr11",1,0.0645804031879981
"13685","chr11.121200000.121205000","chr11.121490000.121495000",290000,12,0.0005709472,121200000,121490000,121205000,121495000,"chr11",427028,4,16,14,34,"chr11",1,0.0478199718706048
"13686","chr11.35680000.35685000","chr11.36290000.36295000",610000,8,0.004381487,35680000,36290000,35685000,36295000,"chr11",427033,2,9,5,16,"chr11",1,0.0150023441162682
"13687","chr11.6605000.6610000","chr11.6670000.6675000",65000,19,0.007548068,6605000,6670000,6610000,6675000,"chr11",427060,0,2,0,2,"chr11",1,0.00445382090951711
"13688","chr11.48080000.48085000","chr11.48100000.48105000",20000,45,6.594591e-06,48080000,48100000,48085000,48105000,"chr11",427074,2,10,7,19,"chr11",1,0.100210970464135
"13689","chr11.118625000.118630000","chr11.118650000.118655000",25000,37,0.0005101673,118625000,118650000,118630000,118655000,"chr11",427077,0,3,1,4,"chr11",1,0.0173464603844351
"13690","chr11.116770000.116775000","chr11.116900000.116905000",130000,20,3.567333e-06,116770000,116900000,116775000,116905000,"chr11",427091,2,0,6,8,"chr11",1,0.0187529301453352
"13691","chr11.9685000.9690000","chr11.9745000.9750000",60000,21,0.002710311,9685000,9745000,9690000,9750000,"chr11",427100,0,0,3,3,"chr11",1,0.00738396624472574
"13692","chr11.121530000.121535000","chr11.122035000.122040000",505000,10,0.0004735847,121530000,122035000,121535000,122040000,"chr11",427111,0,2,3,5,"chr11",1,0.00586029067041725
"13693","chr11.33505000.33510000","chr11.33615000.33620000",110000,16,0.002366381,33505000,33615000,33510000,33620000,"chr11",427144,1,1,0,2,"chr11",1,0.00375058602906704
"13694","chr11.117295000.117300000","chr11.117670000.117675000",375000,16,6.671582e-08,117295000,117670000,117300000,117675000,"chr11",427149,0,1,5,6,"chr11",1,0.0112517580872011
"13695","chr11.36220000.36225000","chr11.36270000.36275000",50000,23,0.002788217,36220000,36270000,36225000,36275000,"chr11",427238,0,0,6,6,"chr11",1,0.0161744022503516
"13696","chr11.33730000.33735000","chr11.33760000.33765000",30000,30,0.004387639,33730000,33760000,33735000,33765000,"chr11",427254,2,3,2,7,"chr11",1,0.0246132208157525
"13697","chr11.78000000.78005000","chr11.78075000.78080000",75000,24,7.487435e-06,7.8e+07,78075000,78005000,78080000,"chr11",427258,8,16,17,41,"chr11",1,0.115330520393812
"13698","chr11.72590000.72595000","chr11.72845000.72850000",255000,12,0.00132137,72590000,72845000,72595000,72850000,"chr11",427325,3,11,10,24,"chr11",1,0.0337552742616034
"13699","chr11.116840000.116845000","chr11.116875000.116880000",35000,47,2.092715e-12,116840000,116875000,116845000,116880000,"chr11",427333,1,3,2,6,"chr11",1,0.0330520393811533
"13700","chr11.66070000.66075000","chr11.66890000.66895000",820000,7,0.005357256,66070000,66890000,66075000,66895000,"chr11",427338,0,1,3,4,"chr11",1,0.00328176277543366
"13701","chr11.9220000.9225000","chr11.9310000.9315000",90000,19,0.0004232169,9220000,9310000,9225000,9315000,"chr11",427344,2,4,17,23,"chr11",1,0.0512189404594468
"13702","chr11.117510000.117515000","chr11.117535000.117540000",25000,33,0.008119404,117510000,117535000,117515000,117540000,"chr11",427348,0,3,1,4,"chr11",1,0.0154711673699015
"13703","chr11.125360000.125365000","chr11.125440000.125445000",80000,23,1.20113e-05,125360000,125440000,125365000,125445000,"chr11",427358,0,8,4,12,"chr11",1,0.0323488045007032
"13704","chr11.8720000.8725000","chr11.8830000.8835000",110000,25,1.050285e-08,8720000,8830000,8725000,8835000,"chr11",427365,0,0,3,3,"chr11",1,0.00879043600562588
"13705","chr11.63485000.63490000","chr11.63505000.63510000",20000,70,3.921726e-18,63485000,63505000,63490000,63510000,"chr11",427382,0,0,3,3,"chr11",1,0.0246132208157525
"13706","chr11.121530000.121535000","chr11.122315000.122320000",785000,9,0.0001688891,121530000,122315000,121535000,122320000,"chr11",427417,0,6,4,10,"chr11",1,0.0105485232067511
"13707","chr11.35925000.35930000","chr11.35945000.35950000",20000,38,0.001528665,35925000,35945000,35930000,35950000,"chr11",427421,2,2,7,11,"chr11",1,0.0489920300046882
"13708","chr11.85665000.85670000","chr11.85755000.85760000",90000,31,1.357524e-11,85665000,85755000,85670000,85760000,"chr11",427472,0,1,1,2,"chr11",1,0.00726676043131739
"13709","chr11.119605000.119610000","chr11.119750000.119755000",145000,26,5.199846e-11,119605000,119750000,119610000,119755000,"chr11",427481,0,2,1,3,"chr11",1,0.00914205344585091
"13710","chr11.61760000.61765000","chr11.61795000.61800000",35000,27,0.004903844,61760000,61795000,61765000,61800000,"chr11",427504,0,8,3,11,"chr11",1,0.0348101265822785
"13711","chr11.6400000.6405000","chr11.6700000.6705000",300000,17,8.079848e-08,6400000,6700000,6405000,6705000,"chr11",427515,0,2,0,2,"chr11",1,0.00398499765588373
"13712","chr11.62495000.62500000","chr11.62555000.62560000",60000,25,4.569093e-05,62495000,62555000,62500000,62560000,"chr11",427557,3,19,16,38,"chr11",1,0.111345522737928
"13713","chr11.111435000.111440000","chr11.111635000.111640000",200000,33,6.351945e-20,111435000,111635000,111440000,111640000,"chr11",427568,0,3,0,3,"chr11",1,0.0116033755274262
"13714","chr11.121320000.121325000","chr11.121460000.121465000",140000,32,7.938647e-16,121320000,121460000,121325000,121465000,"chr11",427576,2,6,2,10,"chr11",1,0.0375058602906704
"13715","chr11.117295000.117300000","chr11.117620000.117625000",325000,15,1.610807e-06,117295000,117620000,117300000,117625000,"chr11",427590,0,3,0,3,"chr11",1,0.00527426160337553
"13716","chr11.46935000.46940000","chr11.47160000.47165000",225000,14,0.0001924844,46935000,47160000,46940000,47165000,"chr11",427623,2,4,5,11,"chr11",1,0.0180496952648851
"13717","chr11.35740000.35745000","chr11.35800000.35805000",60000,35,9.371305e-11,35740000,35800000,35745000,35805000,"chr11",427649,0,4,3,7,"chr11",1,0.0287154242850445
"13718","chr11.119445000.119450000","chr11.119470000.119475000",25000,33,0.008119404,119445000,119470000,119450000,119475000,"chr11",427656,1,4,2,7,"chr11",1,0.0270745428973277
"13719","chr11.73140000.73145000","chr11.73315000.73320000",175000,13,0.004289421,73140000,73315000,73145000,73320000,"chr11",427717,0,0,1,1,"chr11",1,0.00152367557430849
"13720","chr11.64885000.64890000","chr11.65095000.65100000",210000,21,3.094174e-09,64885000,65095000,64890000,65100000,"chr11",427743,4,5,4,13,"chr11",1,0.0319971870604782
"13721","chr11.131510000.131515000","chr11.131530000.131535000",20000,36,0.005637993,131510000,131530000,131515000,131535000,"chr11",427749,1,2,1,4,"chr11",1,0.0168776371308017
"13722","chr11.9185000.9190000","chr11.9205000.9210000",20000,37,0.00299301,9185000,9205000,9190000,9210000,"chr11",427766,0,1,2,3,"chr11",1,0.0130098452883263
"13723","chr11.62595000.62600000","chr11.62620000.62625000",25000,45,4.908128e-07,62595000,62620000,62600000,62625000,"chr11",427767,0,0,2,2,"chr11",1,0.0105485232067511
"13724","chr11.66840000.66845000","chr11.66970000.66975000",130000,16,0.0007775766,66840000,66970000,66845000,66975000,"chr11",427799,5,11,8,24,"chr11",1,0.0450070323488045
"13725","chr11.35925000.35930000","chr11.36015000.36020000",90000,17,0.003610923,35925000,36015000,35930000,36020000,"chr11",427804,0,3,4,7,"chr11",1,0.0139474917955931
"13726","chr11.35800000.35805000","chr11.35820000.35825000",20000,43,3.546213e-05,35800000,35820000,35805000,35825000,"chr11",427805,0,2,1,3,"chr11",1,0.0151195499296765
"13727","chr11.46885000.46890000","chr11.47160000.47165000",275000,12,0.0008089154,46885000,47160000,46890000,47165000,"chr11",427812,2,4,5,11,"chr11",1,0.0154711673699015
"13728","chr11.116770000.116775000","chr11.116810000.116815000",40000,26,0.002147236,116770000,116810000,116775000,116815000,"chr11",427822,2,0,6,8,"chr11",1,0.0243788091889358
"13729","chr11.65830000.65835000","chr11.65885000.65890000",55000,21,0.006262805,65830000,65885000,65835000,65890000,"chr11",427858,1,8,3,12,"chr11",1,0.029535864978903
"13730","chr11.33425000.33430000","chr11.33615000.33620000",190000,12,0.00838713,33425000,33615000,33430000,33620000,"chr11",427901,0,3,0,3,"chr11",1,0.00421940928270042
"13731","chr11.117365000.117370000","chr11.117670000.117675000",305000,12,0.0004159643,117365000,117670000,117370000,117675000,"chr11",427914,0,1,1,2,"chr11",1,0.00281293952180028
"13732","chr11.121320000.121325000","chr11.121445000.121450000",125000,19,2.087924e-05,121320000,121445000,121325000,121450000,"chr11",427935,3,4,2,9,"chr11",1,0.020042194092827
"13733","chr11.33305000.33310000","chr11.33340000.33345000",35000,30,0.0004391258,33305000,33340000,33310000,33345000,"chr11",427936,1,7,7,15,"chr11",1,0.0527426160337553
"13734","chr11.73980000.73985000","chr11.74010000.74015000",30000,30,0.004387639,73980000,74010000,73985000,74015000,"chr11",428001,1,1,0,2,"chr11",1,0.0070323488045007
"13735","chr11.17380000.17385000","chr11.17990000.17995000",610000,8,0.004381487,17380000,17990000,17385000,17995000,"chr11",428013,0,2,1,3,"chr11",1,0.00281293952180028
"13736","chr11.33360000.33365000","chr11.33700000.33705000",340000,11,0.0009961185,33360000,33700000,33365000,33705000,"chr11",428051,2,1,3,6,"chr11",1,0.00773558368495077
"13737","chr11.116705000.116710000","chr11.117035000.117040000",330000,12,0.0002494524,116705000,117035000,116710000,117040000,"chr11",428086,1,12,10,23,"chr11",1,0.0323488045007032
"13738","chr11.65490000.65495000","chr11.65660000.65665000",170000,25,3.442786e-11,65490000,65660000,65495000,65665000,"chr11",428128,1,8,2,11,"chr11",1,0.0322315986872949
"13739","chr11.118565000.118570000","chr11.118635000.118640000",70000,20,0.00151508,118565000,118635000,118570000,118640000,"chr11",428129,0,1,2,3,"chr11",1,0.0070323488045007
"13740","chr11.129880000.129885000","chr11.129950000.129955000",70000,32,3.233708e-10,129880000,129950000,129885000,129955000,"chr11",428135,2,1,4,7,"chr11",1,0.0262541022034693
"13741","chr11.77870000.77875000","chr11.78120000.78125000",250000,12,0.001520643,77870000,78120000,77875000,78125000,"chr11",428145,4,13,8,25,"chr11",1,0.0351617440225035
"13742","chr11.133920000.133925000","chr11.134015000.134020000",95000,27,3.679822e-09,133920000,134015000,133925000,134020000,"chr11",428150,2,0,2,4,"chr11",1,0.0126582278481013
"13743","chr11.121965000.121970000","chr11.122075000.122080000",110000,34,1.154562e-15,121965000,122075000,121970000,122080000,"chr11",428161,0,4,1,5,"chr11",1,0.0199249882794187
"13744","chr11.12840000.12845000","chr11.12910000.12915000",70000,25,5.370125e-06,12840000,12910000,12845000,12915000,"chr11",428177,0,1,2,3,"chr11",1,0.00879043600562588
"13745","chr11.8700000.8705000","chr11.8840000.8845000",140000,18,3.32889e-05,8700000,8840000,8705000,8845000,"chr11",428178,4,4,6,14,"chr11",1,0.029535864978903
"13746","chr11.77995000.78000000","chr11.78095000.78100000",100000,16,0.004591244,77995000,78095000,7.8e+07,78100000,"chr11",428183,2,10,7,19,"chr11",1,0.0356305672761369
"13747","chr11.32070000.32075000","chr11.32315000.32320000",245000,21,3.693426e-10,32070000,32315000,32075000,32320000,"chr11",428192,0,2,2,4,"chr11",1,0.00984528832630099
"13748","chr11.47945000.47950000","chr11.48090000.48095000",145000,17,9.942527e-05,47945000,48090000,47950000,48095000,"chr11",428199,0,5,1,6,"chr11",1,0.0119549929676512
"13749","chr11.65135000.65140000","chr11.65225000.65230000",90000,23,2.780433e-06,65135000,65225000,65140000,65230000,"chr11",428206,6,13,15,34,"chr11",1,0.0916549460853258
"13750","chr11.73315000.73320000","chr11.73340000.73345000",25000,40,4.569757e-05,73315000,73340000,73320000,73345000,"chr11",428291,1,4,1,6,"chr11",1,0.0281293952180028
"13751","chr11.73390000.73395000","chr11.73410000.73415000",20000,41,0.0001746852,73390000,73410000,73395000,73415000,"chr11",428306,1,1,2,4,"chr11",1,0.0192217533989686
"13752","chr11.119065000.119070000","chr11.119205000.119210000",140000,29,3.120614e-13,119065000,119205000,119070000,119210000,"chr11",428329,0,6,1,7,"chr11",1,0.023792780121894
"13753","chr11.75530000.75535000","chr11.75545000.75550000",15000,41,0.0001746852,75530000,75545000,75535000,75550000,"chr11",428411,1,7,2,10,"chr11",1,0.0480543834974215
"13754","chr11.61950000.61955000","chr11.62295000.62300000",345000,10,0.003925567,61950000,62295000,61955000,62300000,"chr11",428422,1,6,3,10,"chr11",1,0.0117205813408345
"13755","chr11.445000.450000","chr11.505000.510000",60000,31,2.751052e-08,445000,505000,450000,510000,"chr11",428434,0,11,12,23,"chr11",1,0.08356774496015
"13756","chr11.116710000.116715000","chr11.117010000.117015000",300000,10,0.007625651,116710000,117010000,116715000,117015000,"chr11",428474,0,6,3,9,"chr11",1,0.0105485232067511
"13757","chr11.62595000.62600000","chr11.62650000.62655000",55000,22,0.002648393,62595000,62650000,62600000,62655000,"chr11",428580,0,0,2,2,"chr11",1,0.00515705578996718
"13758","chr11.73980000.73985000","chr11.74135000.74140000",155000,13,0.008607758,73980000,74135000,73985000,74140000,"chr11",428596,3,4,0,7,"chr11",1,0.0106657290201594
"13759","chr11.35950000.35955000","chr11.36290000.36295000",340000,11,0.0009961185,35950000,36290000,35955000,36295000,"chr11",428618,0,2,2,4,"chr11",1,0.00515705578996718
"13760","chr11.66370000.66375000","chr11.66430000.66435000",60000,23,0.0003939866,66370000,66430000,66375000,66435000,"chr11",428658,0,15,13,28,"chr11",1,0.0754805438349742
"13761","chr11.118070000.118075000","chr11.118220000.118225000",150000,43,4.058957e-27,118070000,118220000,118075000,118225000,"chr11",428660,1,1,3,5,"chr11",1,0.0251992498827942
"13762","chr11.62505000.62510000","chr11.62545000.62550000",40000,30,5.610646e-05,62505000,62545000,62510000,62550000,"chr11",428662,3,15,11,29,"chr11",1,0.10196905766526
"13763","chr11.36155000.36160000","chr11.36270000.36275000",115000,21,2.736836e-06,36155000,36270000,36160000,36275000,"chr11",428671,0,0,2,2,"chr11",1,0.00492264416315049
"13764","chr11.6405000.6410000","chr11.6530000.6535000",125000,14,0.00910339,6405000,6530000,6410000,6535000,"chr11",428700,2,6,4,12,"chr11",1,0.019690576652602
"13765","chr11.66315000.66320000","chr11.66345000.66350000",30000,40,6.79804e-07,66315000,66345000,66320000,66350000,"chr11",428741,0,6,5,11,"chr11",1,0.0515705578996718
"13766","chr11.121195000.121200000","chr11.121315000.121320000",120000,29,3.208015e-12,121195000,121315000,121200000,121320000,"chr11",428754,0,0,2,2,"chr11",1,0.00679793717768401
"13767","chr11.9660000.9665000","chr11.9745000.9750000",85000,19,0.0007201925,9660000,9745000,9665000,9750000,"chr11",428792,0,0,3,3,"chr11",1,0.00668073136427567
"13768","chr11.117000000.117005000","chr11.117080000.117085000",80000,34,8.897788e-13,1.17e+08,117080000,117005000,117085000,"chr11",428796,3,5,9,17,"chr11",1,0.0677449601500234
"13769","chr11.129880000.129885000","chr11.129920000.129925000",40000,44,2.537124e-12,129880000,129920000,129885000,129925000,"chr11",428800,0,1,0,1,"chr11",1,0.00515705578996718
"13770","chr11.4185000.4190000","chr11.4535000.4540000",350000,11,0.0008378185,4185000,4535000,4190000,4540000,"chr11",428820,2,1,1,4,"chr11",1,0.00515705578996718
"13771","chr11.116740000.116745000","chr11.116840000.116845000",100000,17,0.00158388,116740000,116840000,116745000,116845000,"chr11",428883,5,20,18,43,"chr11",1,0.0856774496015002
"13772","chr11.3825000.3830000","chr11.3855000.3860000",30000,39,1.877398e-06,3825000,3855000,3830000,3860000,"chr11",428913,0,1,4,5,"chr11",1,0.0228551336146273
"13773","chr11.68025000.68030000","chr11.68065000.68070000",40000,35,2.622182e-07,68025000,68065000,68030000,68070000,"chr11",428941,2,7,1,10,"chr11",1,0.0410220346929208
"13774","chr11.48005000.48010000","chr11.48090000.48095000",85000,21,7.092982e-05,48005000,48090000,48010000,48095000,"chr11",428988,0,5,1,6,"chr11",1,0.0147679324894515
"13775","chr11.117465000.117470000","chr11.117675000.117680000",210000,16,1.705251e-05,117465000,117675000,117470000,117680000,"chr11",428997,0,2,1,3,"chr11",1,0.00562587904360056
"13776","chr11.117365000.117370000","chr11.117675000.117680000",310000,16,3.873415e-07,117365000,117675000,117370000,117680000,"chr11",429000,1,3,1,5,"chr11",1,0.00937646507266761
"13777","chr11.121315000.121320000","chr11.121380000.121385000",65000,24,4.783243e-05,121315000,121380000,121320000,121385000,"chr11",429008,1,6,2,9,"chr11",1,0.0253164556962025
"13778","chr11.117710000.117715000","chr11.117820000.117825000",110000,19,6.478452e-05,117710000,117820000,117715000,117825000,"chr11",429042,1,1,1,3,"chr11",1,0.00668073136427567
"13779","chr11.65150000.65155000","chr11.65180000.65185000",30000,40,6.79804e-07,65150000,65180000,65155000,65185000,"chr11",429049,1,1,2,4,"chr11",1,0.0187529301453352
"13780","chr11.3005000.3010000","chr11.3040000.3045000",35000,45,2.95124e-11,3005000,3040000,3010000,3045000,"chr11",429059,1,3,7,11,"chr11",1,0.0580168776371308
"13781","chr11.118220000.118225000","chr11.118355000.118360000",135000,16,0.0006032158,118220000,118355000,118225000,118360000,"chr11",429062,2,1,3,6,"chr11",1,0.0112517580872011
"13782","chr11.117510000.117515000","chr11.117660000.117665000",150000,17,7.601346e-05,117510000,117660000,117515000,117665000,"chr11",429091,0,2,0,2,"chr11",1,0.00398499765588373
"13783","chr11.72790000.72795000","chr11.72820000.72825000",30000,31,0.002145814,72790000,72820000,72795000,72825000,"chr11",429112,0,1,1,2,"chr11",1,0.00726676043131739
"13784","chr11.31130000.31135000","chr11.32070000.32075000",940000,7,0.002548105,31130000,32070000,31135000,32075000,"chr11",429144,0,2,4,6,"chr11",1,0.00492264416315049
"13785","chr11.13690000.13695000","chr11.14265000.14270000",575000,12,4.17174e-06,13690000,14265000,13695000,14270000,"chr11",429145,1,7,4,12,"chr11",1,0.0168776371308017
"13786","chr11.85665000.85670000","chr11.85945000.85950000",280000,13,0.0001596608,85665000,85945000,85670000,85950000,"chr11",429153,2,0,2,4,"chr11",1,0.00609470229723394
"13787","chr11.117535000.117540000","chr11.117670000.117675000",135000,21,5.532462e-07,117535000,117670000,117540000,117675000,"chr11",429156,0,1,1,2,"chr11",1,0.00492264416315049
"13788","chr11.66265000.66270000","chr11.66855000.66860000",590000,8,0.005171771,66265000,66855000,66270000,66860000,"chr11",429163,0,2,0,2,"chr11",1,0.00187529301453352
"13789","chr11.40200000.40205000","chr11.40290000.40295000",90000,18,0.00126728,40200000,40290000,40205000,40295000,"chr11",429165,1,1,1,3,"chr11",1,0.00632911392405063
"13790","chr11.36130000.36135000","chr11.36265000.36270000",135000,16,0.0006032158,36130000,36265000,36135000,36270000,"chr11",429196,2,3,1,6,"chr11",1,0.0112517580872011
"13791","chr11.36340000.36345000","chr11.36495000.36500000",155000,29,6.149534e-14,36340000,36495000,36345000,36500000,"chr11",429220,3,9,7,19,"chr11",1,0.0645804031879981
"13792","chr11.118080000.118085000","chr11.118175000.118180000",95000,18,0.0008007308,118080000,118175000,118085000,118180000,"chr11",429224,0,5,2,7,"chr11",1,0.0147679324894515
"13793","chr11.62550000.62555000","chr11.62610000.62615000",60000,33,1.720084e-09,62550000,62610000,62555000,62615000,"chr11",429227,2,3,2,7,"chr11",1,0.0270745428973277
"13794","chr11.111450000.111455000","chr11.111635000.111640000",185000,12,0.009798271,111450000,111635000,111455000,111640000,"chr11",429234,0,2,0,2,"chr11",1,0.00281293952180028
"13795","chr11.129930000.129935000","chr11.129950000.129955000",20000,36,0.005637993,129930000,129950000,129935000,129955000,"chr11",429348,4,1,4,9,"chr11",1,0.0379746835443038
"13796","chr11.65450000.65455000","chr11.65610000.65615000",160000,20,4.747061e-07,65450000,65610000,65455000,65615000,"chr11",429352,0,2,0,2,"chr11",1,0.0046882325363338
"13797","chr11.40165000.40170000","chr11.40225000.40230000",60000,20,0.006541073,40165000,40225000,40170000,40230000,"chr11",429364,0,5,0,5,"chr11",1,0.0117205813408345
"13798","chr11.64920000.64925000","chr11.65025000.65030000",105000,22,1.760541e-06,64920000,65025000,64925000,65030000,"chr11",429394,7,16,22,45,"chr11",1,0.116033755274262
"13799","chr11.47450000.47455000","chr11.47590000.47595000",140000,20,1.806626e-06,47450000,47590000,47455000,47595000,"chr11",429430,0,4,1,5,"chr11",1,0.0117205813408345
"13800","chr11.33290000.33295000","chr11.33690000.33695000",400000,9,0.007898701,33290000,33690000,33295000,33695000,"chr11",429447,2,1,1,4,"chr11",1,0.00421940928270042
"13801","chr11.63600000.63605000","chr11.63945000.63950000",345000,16,1.446558e-07,63600000,63945000,63605000,63950000,"chr11",429455,4,15,22,41,"chr11",1,0.0768870135958744
"13802","chr11.61600000.61605000","chr11.61625000.61630000",25000,36,0.001061553,61600000,61625000,61605000,61630000,"chr11",429485,0,5,7,12,"chr11",1,0.0506329113924051
"13803","chr11.117440000.117445000","chr11.117490000.117495000",50000,27,5.956403e-05,117440000,117490000,117445000,117495000,"chr11",429495,0,2,2,4,"chr11",1,0.0126582278481013
"13804","chr11.130870000.130875000","chr11.130890000.130895000",20000,47,1.112089e-06,130870000,130890000,130875000,130895000,"chr11",429532,0,1,0,1,"chr11",1,0.00550867323019222
"13805","chr11.62495000.62500000","chr11.62645000.62650000",150000,15,0.001039364,62495000,62645000,62500000,62650000,"chr11",429579,0,0,3,3,"chr11",1,0.00527426160337553
"13806","chr11.124515000.124520000","chr11.124640000.124645000",125000,20,5.147408e-06,124515000,124640000,124520000,124645000,"chr11",429605,0,2,1,3,"chr11",1,0.0070323488045007
"13807","chr11.30345000.30350000","chr11.30940000.30945000",595000,16,3.856949e-10,30345000,30940000,30350000,30945000,"chr11",429607,0,2,0,2,"chr11",1,0.00375058602906704
"13808","chr11.62550000.62555000","chr11.62645000.62650000",95000,19,0.0002530364,62550000,62645000,62555000,62650000,"chr11",429653,0,0,3,3,"chr11",1,0.00668073136427567
"13809","chr11.119100000.119105000","chr11.119155000.119160000",55000,29,1.613618e-06,119100000,119155000,119105000,119160000,"chr11",429678,0,2,4,6,"chr11",1,0.020393811533052
"13810","chr11.64920000.64925000","chr11.65605000.65610000",685000,8,0.002385703,64920000,65605000,64925000,65610000,"chr11",429679,0,2,3,5,"chr11",1,0.0046882325363338
"13811","chr11.116770000.116775000","chr11.116970000.116975000",200000,35,5.697031e-22,116770000,116970000,116775000,116975000,"chr11",429692,2,0,6,8,"chr11",1,0.0328176277543366
"13812","chr11.45995000.46000000","chr11.46275000.46280000",280000,11,0.002958416,45995000,46275000,4.6e+07,46280000,"chr11",429727,0,2,1,3,"chr11",1,0.00386779184247539
"13813","chr11.65415000.65420000","chr11.65480000.65485000",65000,21,0.001170751,65415000,65480000,65420000,65485000,"chr11",429771,0,3,0,3,"chr11",1,0.00738396624472574
"13814","chr11.117315000.117320000","chr11.117805000.117810000",490000,9,0.002886368,117315000,117805000,117320000,117810000,"chr11",429787,0,8,2,10,"chr11",1,0.0105485232067511
"13815","chr11.83570000.83575000","chr11.83980000.83985000",410000,9,0.007051584,83570000,83980000,83575000,83985000,"chr11",429793,0,6,1,7,"chr11",1,0.00738396624472574
"13816","chr11.119085000.119090000","chr11.119145000.119150000",60000,27,4.521494e-06,119085000,119145000,119090000,119150000,"chr11",429823,3,10,12,25,"chr11",1,0.0791139240506329
"13817","chr11.118635000.118640000","chr11.118870000.118875000",235000,12,0.002286979,118635000,118870000,118640000,118875000,"chr11",429880,0,1,2,3,"chr11",1,0.00421940928270042
"13818","chr11.124835000.124840000","chr11.125395000.125400000",560000,8,0.006664393,124835000,125395000,124840000,125400000,"chr11",429900,1,1,0,2,"chr11",1,0.00187529301453352
"13819","chr11.73950000.73955000","chr11.73980000.73985000",30000,29,0.008756408,73950000,73980000,73955000,73985000,"chr11",429974,3,4,0,7,"chr11",1,0.023792780121894
"13820","chr11.116875000.116880000","chr11.116920000.116925000",45000,39,1.504567e-10,116875000,116920000,116880000,116925000,"chr11",429978,1,3,2,6,"chr11",1,0.0274261603375527
"13821","chr11.35605000.35610000","chr11.36300000.36305000",695000,9,0.0003731472,35605000,36300000,35610000,36305000,"chr11",430000,1,1,0,2,"chr11",1,0.00210970464135021
"13822","chr11.118870000.118875000","chr11.118950000.118955000",80000,22,4.133075e-05,118870000,118950000,118875000,118955000,"chr11",430001,2,5,6,13,"chr11",1,0.0335208626347867
"13823","chr11.117590000.117595000","chr11.117635000.117640000",45000,27,0.0002168683,117590000,117635000,117595000,117640000,"chr11",430003,0,2,2,4,"chr11",1,0.0126582278481013
"13824","chr11.65180000.65185000","chr11.65275000.65280000",95000,72,3.598795e-52,65180000,65275000,65185000,65280000,"chr11",430016,1,1,2,4,"chr11",1,0.0337552742616034
"13825","chr11.85665000.85670000","chr11.85975000.85980000",310000,10,0.006512553,85665000,85975000,85670000,85980000,"chr11",430034,0,2,2,4,"chr11",1,0.0046882325363338
"13826","chr11.65490000.65495000","chr11.65540000.65545000",50000,33,5.675616e-08,65490000,65540000,65495000,65545000,"chr11",430045,0,2,0,2,"chr11",1,0.00773558368495077
"13827","chr11.122140000.122145000","chr11.122315000.122320000",175000,17,2.039847e-05,122140000,122315000,122145000,122320000,"chr11",430067,0,6,6,12,"chr11",1,0.0239099859353024
"13828","chr11.3860000.3865000","chr11.4065000.4070000",205000,13,0.001528665,3860000,4065000,3865000,4070000,"chr11",430107,3,1,5,9,"chr11",1,0.0137130801687764
"13829","chr11.118610000.118615000","chr11.118635000.118640000",25000,34,0.004277218,118610000,118635000,118615000,118640000,"chr11",430127,0,1,1,2,"chr11",1,0.00796999531176746
"13830","chr11.12080000.12085000","chr11.12245000.12250000",165000,18,7.816186e-06,12080000,12245000,12085000,12250000,"chr11",430129,0,2,0,2,"chr11",1,0.00421940928270042
"13831","chr11.117125000.117130000","chr11.117145000.117150000",20000,39,0.0007739803,117125000,117145000,117130000,117150000,"chr11",430131,4,9,9,22,"chr11",1,0.10056258790436
"13832","chr11.116700000.116705000","chr11.117025000.117030000",325000,12,0.0002766024,116700000,117025000,116705000,117030000,"chr11",430136,0,8,4,12,"chr11",1,0.0168776371308017
"13833","chr11.45850000.45855000","chr11.45960000.45965000",110000,18,0.0002301419,45850000,45960000,45855000,45965000,"chr11",430148,1,5,1,7,"chr11",1,0.0147679324894515
"13834","chr11.75530000.75535000","chr11.75590000.75595000",60000,30,1.04161e-07,75530000,75590000,75535000,75595000,"chr11",430153,0,2,1,3,"chr11",1,0.0105485232067511
"13835","chr11.75620000.75625000","chr11.75895000.75900000",275000,13,0.0001815381,75620000,75895000,75625000,75900000,"chr11",430162,3,5,5,13,"chr11",1,0.0198077824660103
"13836","chr11.119100000.119105000","chr11.119145000.119150000",45000,31,3.286126e-06,119100000,119145000,119105000,119150000,"chr11",430185,0,6,4,10,"chr11",1,0.036333802156587
"13837","chr11.235000.240000","chr11.465000.470000",230000,11,0.009090773,235000,465000,240000,470000,"chr11",430238,2,9,6,17,"chr11",1,0.0219174871073605
"13838","chr11.83735000.83740000","chr11.83980000.83985000",245000,11,0.006332282,83735000,83980000,83740000,83985000,"chr11",430269,0,1,1,2,"chr11",1,0.00257852789498359
"13839","chr11.46915000.46920000","chr11.47180000.47185000",265000,32,1.037559e-21,46915000,47180000,46920000,47185000,"chr11",430276,3,9,2,14,"chr11",1,0.0525082044069386
"13840","chr11.36085000.36090000","chr11.36130000.36135000",45000,25,0.001354609,36085000,36130000,36090000,36135000,"chr11",430302,5,6,6,17,"chr11",1,0.0498124706985466
"13841","chr11.118625000.118630000","chr11.118655000.118660000",30000,30,0.004387639,118625000,118655000,118630000,118660000,"chr11",430336,0,3,1,4,"chr11",1,0.0140646976090014
"13842","chr11.66345000.66350000","chr11.66915000.66920000",570000,8,0.006134852,66345000,66915000,66350000,66920000,"chr11",430340,0,6,5,11,"chr11",1,0.0103141115799344
"13843","chr11.116900000.116905000","chr11.116990000.116995000",90000,17,0.003610923,116900000,116990000,116905000,116995000,"chr11",430358,2,3,7,12,"chr11",1,0.0239099859353024
"13844","chr11.116770000.116775000","chr11.116920000.116925000",150000,14,0.003390837,116770000,116920000,116775000,116925000,"chr11",430382,2,0,6,8,"chr11",1,0.0131270511017346
"13845","chr11.73980000.73985000","chr11.74025000.74030000",45000,26,0.0005538777,73980000,74025000,73985000,74030000,"chr11",430399,3,4,0,7,"chr11",1,0.0213314580403188
"13846","chr11.65480000.65485000","chr11.65590000.65595000",110000,20,1.727155e-05,65480000,65590000,65485000,65595000,"chr11",430453,1,8,6,15,"chr11",1,0.0351617440225035
"13847","chr11.35675000.35680000","chr11.35940000.35945000",265000,11,0.004049008,35675000,35940000,35680000,35945000,"chr11",430457,1,2,1,4,"chr11",1,0.00515705578996718
"13848","chr11.27470000.27475000","chr11.27485000.27490000",15000,42,7.950065e-05,27470000,27485000,27475000,27490000,"chr11",430464,1,3,1,5,"chr11",1,0.0246132208157525
"13849","chr11.116865000.116870000","chr11.116920000.116925000",55000,30,4.747061e-07,116865000,116920000,116870000,116925000,"chr11",430472,0,2,2,4,"chr11",1,0.0140646976090014
"13850","chr11.116840000.116845000","chr11.116955000.116960000",115000,30,9.989203e-13,116840000,116955000,116845000,116960000,"chr11",430480,4,4,8,16,"chr11",1,0.0562587904360056
"13851","chr11.126480000.126485000","chr11.126875000.126880000",395000,9,0.00838713,126480000,126875000,126485000,126880000,"chr11",430481,0,4,0,4,"chr11",1,0.00421940928270042
"13852","chr11.62495000.62500000","chr11.62570000.62575000",75000,20,0.0007826491,62495000,62570000,62500000,62575000,"chr11",430487,0,4,4,8,"chr11",1,0.0187529301453352
"13853","chr11.74985000.74990000","chr11.75100000.75105000",115000,29,6.107407e-12,74985000,75100000,74990000,75105000,"chr11",430541,3,2,9,14,"chr11",1,0.0475855602437881
"13854","chr11.35820000.35825000","chr11.36290000.36295000",470000,9,0.003596168,35820000,36290000,35825000,36295000,"chr11",430542,0,2,1,3,"chr11",1,0.00316455696202532
"13855","chr11.14065000.14070000","chr11.14245000.14250000",180000,13,0.003608701,14065000,14245000,14070000,14250000,"chr11",430567,2,1,2,5,"chr11",1,0.00761837787154243
"13856","chr11.66315000.66320000","chr11.66405000.66410000",90000,22,1.060914e-05,66315000,66405000,66320000,66410000,"chr11",430569,2,7,4,13,"chr11",1,0.0335208626347867
"13857","chr11.72670000.72675000","chr11.72820000.72825000",150000,17,7.601346e-05,72670000,72820000,72675000,72825000,"chr11",430592,0,1,1,2,"chr11",1,0.00398499765588373
"13858","chr11.100555000.100560000","chr11.100725000.100730000",170000,19,1.252723e-06,100555000,100725000,100560000,100730000,"chr11",430616,1,6,5,12,"chr11",1,0.0267229254571027
"13859","chr11.11845000.11850000","chr11.12040000.12045000",195000,13,0.002168029,11845000,12040000,11850000,12045000,"chr11",430642,1,1,0,2,"chr11",1,0.00304735114861697
"13860","chr11.63475000.63480000","chr11.63600000.63605000",125000,16,0.001007677,63475000,63600000,63480000,63605000,"chr11",430661,0,4,3,7,"chr11",1,0.0131270511017346
"13861","chr11.117295000.117300000","chr11.117660000.117665000",365000,13,2.392905e-05,117295000,117660000,117300000,117665000,"chr11",430667,0,2,0,2,"chr11",1,0.00304735114861697
"13862","chr11.47180000.47185000","chr11.47255000.47260000",75000,19,0.002175798,47180000,47255000,47185000,47260000,"chr11",430669,4,12,8,24,"chr11",1,0.0534458509142053
"13863","chr11.119565000.119570000","chr11.119875000.119880000",310000,11,0.001636352,119565000,119875000,119570000,119880000,"chr11",430680,0,2,1,3,"chr11",1,0.00386779184247539
"13864","chr11.68035000.68040000","chr11.68210000.68215000",175000,14,0.00126728,68035000,68210000,68040000,68215000,"chr11",430695,1,2,0,3,"chr11",1,0.00492264416315049
"13865","chr11.46910000.46915000","chr11.47180000.47185000",270000,33,5.306117e-23,46910000,47180000,46915000,47185000,"chr11",430703,3,6,8,17,"chr11",1,0.0657524613220816
"13866","chr11.46900000.46905000","chr11.47210000.47215000",310000,10,0.006512553,46900000,47210000,46905000,47215000,"chr11",430759,1,8,8,17,"chr11",1,0.0199249882794187
"13867","chr11.116875000.116880000","chr11.116965000.116970000",90000,24,6.9976e-07,116875000,116965000,116880000,116970000,"chr11",430762,1,3,2,6,"chr11",1,0.0168776371308017
"13868","chr11.110585000.110590000","chr11.111080000.111085000",495000,10,0.0005369069,110585000,111080000,110590000,111085000,"chr11",430781,0,1,1,2,"chr11",1,0.0023441162681669
"13869","chr11.63505000.63510000","chr11.63575000.63580000",70000,18,0.0098191,63505000,63575000,63510000,63580000,"chr11",430805,0,5,2,7,"chr11",1,0.0147679324894515
"13870","chr11.18360000.18365000","chr11.18390000.18395000",30000,34,0.0001927165,18360000,18390000,18365000,18395000,"chr11",430811,5,19,20,44,"chr11",1,0.175339896858884
"13871","chr11.119445000.119450000","chr11.120030000.120035000",585000,10,0.0001779827,119445000,120030000,119450000,120035000,"chr11",430821,0,0,3,3,"chr11",1,0.00351617440225035
"13872","chr11.116865000.116870000","chr11.116900000.116905000",35000,31,0.0001815381,116865000,116900000,116870000,116905000,"chr11",430827,0,2,2,4,"chr11",1,0.0145335208626348
"13873","chr11.116770000.116775000","chr11.116875000.116880000",105000,32,1.276449e-13,116770000,116875000,116775000,116880000,"chr11",430844,1,0,2,3,"chr11",1,0.0112517580872011
"13874","chr11.116900000.116905000","chr11.116955000.116960000",55000,27,1.661895e-05,116900000,116955000,116905000,116960000,"chr11",430858,2,3,7,12,"chr11",1,0.0379746835443038
"13875","chr11.118070000.118075000","chr11.118190000.118195000",120000,17,0.0004018914,118070000,118190000,118075000,118195000,"chr11",430872,0,0,6,6,"chr11",1,0.0119549929676512
"13876","chr11.113070000.113075000","chr11.113105000.113110000",35000,27,0.004903844,113070000,113105000,113075000,113110000,"chr11",430915,0,3,6,9,"chr11",1,0.0284810126582278
"13877","chr11.83285000.83290000","chr11.83305000.83310000",20000,43,3.546213e-05,83285000,83305000,83290000,83310000,"chr11",430952,1,8,6,15,"chr11",1,0.0755977496483826
"13878","chr11.8705000.8710000","chr11.8840000.8845000",135000,18,4.437997e-05,8705000,8840000,8710000,8845000,"chr11",430958,4,6,3,13,"chr11",1,0.0274261603375527
"13879","chr11.35605000.35610000","chr11.35800000.35805000",195000,12,0.007192356,35605000,35800000,35610000,35805000,"chr11",430966,0,7,3,10,"chr11",1,0.0140646976090014
"13880","chr11.35605000.35610000","chr11.36155000.36160000",550000,11,4.297223e-05,35605000,36155000,35610000,36160000,"chr11",430976,1,6,2,9,"chr11",1,0.0116033755274262
"13881","chr11.7555000.7560000","chr11.7585000.7590000",30000,34,0.0001927165,7555000,7585000,7560000,7590000,"chr11",430978,0,3,5,8,"chr11",1,0.0318799812470699
"13882","chr11.72665000.72670000","chr11.72820000.72825000",155000,15,0.0008295768,72665000,72820000,72670000,72825000,"chr11",431000,0,1,1,2,"chr11",1,0.00351617440225035
"13883","chr11.47255000.47260000","chr11.47640000.47645000",385000,12,9.324166e-05,47255000,47640000,47260000,47645000,"chr11",431012,2,15,10,27,"chr11",1,0.0379746835443038
"13884","chr11.33855000.33860000","chr11.34265000.34270000",410000,9,0.007051584,33855000,34265000,33860000,34270000,"chr11",431043,2,1,4,7,"chr11",1,0.00738396624472574
"13885","chr11.109995000.110000000","chr11.110100000.110105000",105000,15,0.009090773,109995000,110100000,1.1e+08,110105000,"chr11",431061,5,7,14,26,"chr11",1,0.0457102672292546
"13886","chr11.10410000.10415000","chr11.10750000.10755000",340000,11,0.0009961185,10410000,10750000,10415000,10755000,"chr11",431128,2,2,6,10,"chr11",1,0.012892639474918
"13887","chr11.78000000.78005000","chr11.78270000.78275000",270000,11,0.003615715,7.8e+07,78270000,78005000,78275000,"chr11",431134,4,18,21,43,"chr11",1,0.0554383497421472
"13888","chr11.3855000.3860000","chr11.4085000.4090000",230000,12,0.002625012,3855000,4085000,3860000,4090000,"chr11",431163,1,1,0,2,"chr11",1,0.00281293952180028
"13889","chr11.36210000.36215000","chr11.36265000.36270000",55000,21,0.006262805,36210000,36265000,36215000,36270000,"chr11",431172,1,2,1,4,"chr11",1,0.00984528832630099
"13890","chr11.110175000.110180000","chr11.110215000.110220000",40000,25,0.004759951,110175000,110215000,110180000,110220000,"chr11",431189,2,5,0,7,"chr11",1,0.0205110173464604
"13891","chr11.35605000.35610000","chr11.36265000.36270000",660000,9,0.000506213,35605000,36265000,35610000,36270000,"chr11",431256,1,3,1,5,"chr11",1,0.00527426160337553
"13892","chr11.46845000.46850000","chr11.47150000.47155000",305000,11,0.001808533,46845000,47150000,46850000,47155000,"chr11",431284,0,9,6,15,"chr11",1,0.0193389592123769
"13893","chr11.46445000.46450000","chr11.46550000.46555000",105000,19,9.942527e-05,46445000,46550000,46450000,46555000,"chr11",431338,4,17,13,34,"chr11",1,0.0757149554617909
"13894","chr11.124735000.124740000","chr11.125495000.125500000",760000,7,0.007618237,124735000,125495000,124740000,125500000,"chr11",431353,0,0,2,2,"chr11",1,0.00164088138771683
"13895","chr11.35915000.35920000","chr11.35940000.35945000",25000,33,0.008119404,35915000,35940000,35920000,35945000,"chr11",431364,1,2,1,4,"chr11",1,0.0154711673699015
"13896","chr11.85755000.85760000","chr11.85810000.85815000",55000,26,4.976647e-05,85755000,85810000,85760000,85815000,"chr11",431390,0,1,1,2,"chr11",1,0.00609470229723394
"13897","chr11.66855000.66860000","chr11.66890000.66895000",35000,27,0.004903844,66855000,66890000,66860000,66895000,"chr11",431400,0,4,0,4,"chr11",1,0.0126582278481013
"13898","chr11.119080000.119085000","chr11.119205000.119210000",125000,18,8.05065e-05,119080000,119205000,119085000,119210000,"chr11",431405,0,6,1,7,"chr11",1,0.0147679324894515
"13899","chr11.75530000.75535000","chr11.75555000.75560000",25000,47,6.837502e-08,75530000,75555000,75535000,75560000,"chr11",431432,2,0,1,3,"chr11",1,0.0165260196905767
"13900","chr11.33305000.33310000","chr11.33350000.33355000",45000,40,3.802389e-11,33305000,33350000,33310000,33355000,"chr11",431485,2,7,6,15,"chr11",1,0.070323488045007
"13901","chr11.20030000.20035000","chr11.20075000.20080000",45000,26,0.0005538777,20030000,20075000,20035000,20080000,"chr11",431512,0,2,0,2,"chr11",1,0.00609470229723394
"13902","chr11.19730000.19735000","chr11.19920000.19925000",190000,14,0.0007200501,19730000,19920000,19735000,19925000,"chr11",431514,0,2,0,2,"chr11",1,0.00328176277543366
"13903","chr11.120380000.120385000","chr11.120545000.120550000",165000,14,0.001886065,120380000,120545000,120385000,120550000,"chr11",431527,0,0,1,1,"chr11",1,0.00164088138771683
"13904","chr11.121530000.121535000","chr11.121570000.121575000",40000,31,2.055153e-05,121530000,121570000,121535000,121575000,"chr11",431557,0,2,0,2,"chr11",1,0.00726676043131739
"13905","chr11.46650000.46655000","chr11.46710000.46715000",60000,21,0.002710311,46650000,46710000,46655000,46715000,"chr11",431579,15,25,23,63,"chr11",1,0.15506329113924
"13906","chr11.129920000.129925000","chr11.129950000.129955000",30000,31,0.002145814,129920000,129950000,129925000,129955000,"chr11",431633,0,2,0,2,"chr11",1,0.00726676043131739
"13907","chr11.45995000.46000000","chr11.46075000.46080000",80000,17,0.008774219,45995000,46075000,4.6e+07,46080000,"chr11",431647,0,5,2,7,"chr11",1,0.0139474917955931
"13908","chr11.66880000.66885000","chr11.67005000.67010000",125000,16,0.001007677,66880000,67005000,66885000,67010000,"chr11",431654,6,17,20,43,"chr11",1,0.0806375996249414
"13909","chr11.85530000.85535000","chr11.85965000.85970000",435000,9,0.005319061,85530000,85965000,85535000,85970000,"chr11",431655,2,9,6,17,"chr11",1,0.0179324894514768
"13910","chr11.116865000.116870000","chr11.116885000.116890000",20000,40,0.0003756276,116865000,116885000,116870000,116890000,"chr11",431710,0,2,2,4,"chr11",1,0.0187529301453352
"13911","chr11.91775000.91780000","chr11.92380000.92385000",605000,8,0.004560815,91775000,92380000,91780000,92385000,"chr11",431763,0,5,0,5,"chr11",1,0.0046882325363338
"13912","chr11.34315000.34320000","chr11.34345000.34350000",30000,36,3.32889e-05,34315000,34345000,34320000,34350000,"chr11",431823,0,3,1,4,"chr11",1,0.0168776371308017
"13913","chr11.35740000.35745000","chr11.36155000.36160000",415000,12,5.569496e-05,35740000,36155000,35745000,36160000,"chr11",431853,2,4,2,8,"chr11",1,0.0112517580872011
"13914","chr11.117375000.117380000","chr11.117675000.117680000",300000,12,0.0004572997,117375000,117675000,117380000,117680000,"chr11",431882,1,3,2,6,"chr11",1,0.00843881856540084
"13915","chr11.125495000.125500000","chr11.126080000.126085000",585000,9,0.001052859,125495000,126080000,125500000,126085000,"chr11",431903,1,0,2,3,"chr11",1,0.00316455696202532
"13916","chr11.3975000.3980000","chr11.4095000.4100000",120000,16,0.001297565,3975000,4095000,3980000,4100000,"chr11",431919,4,14,14,32,"chr11",1,0.0600093764650727
"13917","chr11.9220000.9225000","chr11.9260000.9265000",40000,25,0.004759951,9220000,9260000,9225000,9265000,"chr11",431946,2,7,12,21,"chr11",1,0.0615330520393812
"13918","chr11.33860000.33865000","chr11.33995000.34000000",135000,22,1.168677e-07,33860000,33995000,33865000,3.4e+07,"chr11",431955,0,2,2,4,"chr11",1,0.0103141115799344
"13919","chr11.47980000.47985000","chr11.48090000.48095000",110000,21,4.374867e-06,47980000,48090000,47985000,48095000,"chr11",431968,0,5,1,6,"chr11",1,0.0147679324894515
"13920","chr11.120210000.120215000","chr11.120250000.120255000",40000,34,8.193798e-07,120210000,120250000,120215000,120255000,"chr11",432001,2,0,1,3,"chr11",1,0.0119549929676512
"13921","chr11.85805000.85810000","chr11.85825000.85830000",20000,50,6.494343e-08,85805000,85825000,85810000,85830000,"chr11",432028,0,0,2,2,"chr11",1,0.0117205813408345
"13922","chr11.46885000.46890000","chr11.47180000.47185000",295000,13,0.0001083754,46885000,47180000,46890000,47185000,"chr11",432082,4,12,8,24,"chr11",1,0.0365682137834037
"13923","chr11.121570000.121575000","chr11.122075000.122080000",505000,9,0.002442518,121570000,122075000,121575000,122080000,"chr11",432095,0,2,0,2,"chr11",1,0.00210970464135021
"13924","chr11.48005000.48010000","chr11.48135000.48140000",130000,25,1.243403e-09,48005000,48135000,48010000,48140000,"chr11",432103,0,5,2,7,"chr11",1,0.0205110173464604
"13925","chr11.36040000.36045000","chr11.36155000.36160000",115000,16,0.001742096,36040000,36155000,36045000,36160000,"chr11",432157,1,3,1,5,"chr11",1,0.00937646507266761
"13926","chr11.10970000.10975000","chr11.11020000.11025000",50000,22,0.006416007,10970000,11020000,10975000,11025000,"chr11",432204,0,2,0,2,"chr11",1,0.00515705578996718
"13927","chr11.118570000.118575000","chr11.118655000.118660000",85000,17,0.005623782,118570000,118655000,118575000,118660000,"chr11",432223,0,3,1,4,"chr11",1,0.00796999531176746
"13928","chr11.113875000.113880000","chr11.114055000.114060000",180000,13,0.003608701,113875000,114055000,113880000,114060000,"chr11",432262,1,1,2,4,"chr11",1,0.00609470229723394
"13929","chr11.61585000.61590000","chr11.61635000.61640000",50000,24,0.001138728,61585000,61635000,61590000,61640000,"chr11",432276,0,2,1,3,"chr11",1,0.00843881856540084
"13930","chr11.16965000.16970000","chr11.16995000.17000000",30000,33,0.0004447369,16965000,16995000,16970000,1.7e+07,"chr11",432281,0,0,6,6,"chr11",1,0.0232067510548523
"13931","chr11.46915000.46920000","chr11.47160000.47165000",245000,15,1.994231e-05,46915000,47160000,46920000,47165000,"chr11",432289,2,4,2,8,"chr11",1,0.0140646976090014
"13932","chr11.17915000.17920000","chr11.17990000.17995000",75000,19,0.002175798,17915000,17990000,17920000,17995000,"chr11",432297,0,3,2,5,"chr11",1,0.0111345522737928
"13933","chr11.122190000.122195000","chr11.122320000.122325000",130000,18,5.950879e-05,122190000,122320000,122195000,122325000,"chr11",432308,1,1,2,4,"chr11",1,0.00843881856540084
"13934","chr11.78060000.78065000","chr11.78085000.78090000",25000,44,1.297103e-06,78060000,78085000,78065000,78090000,"chr11",432311,3,11,13,27,"chr11",1,0.139240506329114
"13935","chr11.235000.240000","chr11.450000.455000",215000,13,0.001095992,235000,450000,240000,455000,"chr11",432316,2,5,6,13,"chr11",1,0.0198077824660103
"13936","chr11.8710000.8715000","chr11.8830000.8835000",120000,26,6.268804e-10,8710000,8830000,8715000,8835000,"chr11",432363,0,4,1,5,"chr11",1,0.0152367557430849
"13937","chr11.66415000.66420000","chr11.66430000.66435000",15000,58,1.298602e-11,66415000,66430000,66420000,66435000,"chr11",432400,2,2,1,5,"chr11",1,0.0339896858884201
"13938","chr11.47945000.47950000","chr11.48135000.48140000",190000,33,2.082588e-19,47945000,48135000,47950000,48140000,"chr11",432432,0,5,2,7,"chr11",1,0.0270745428973277
"13939","chr11.35475000.35480000","chr11.36220000.36225000",745000,8,0.001520643,35475000,36220000,35480000,36225000,"chr11",432472,4,5,2,11,"chr11",1,0.0103141115799344
"13940","chr11.86170000.86175000","chr11.86515000.86520000",345000,10,0.003925567,86170000,86515000,86175000,86520000,"chr11",432500,0,4,4,8,"chr11",1,0.00937646507266761
"13941","chr11.65090000.65095000","chr11.65275000.65280000",185000,17,1.211481e-05,65090000,65275000,65095000,65280000,"chr11",432562,1,4,5,10,"chr11",1,0.0199249882794187
"13942","chr11.64550000.64555000","chr11.64890000.64895000",340000,14,6.849638e-06,64550000,64890000,64555000,64895000,"chr11",432573,0,4,4,8,"chr11",1,0.0131270511017346
"13943","chr11.66070000.66075000","chr11.67005000.67010000",935000,9,4.569093e-05,66070000,67005000,66075000,67010000,"chr11",432584,2,1,3,6,"chr11",1,0.00632911392405063
"13944","chr11.117440000.117445000","chr11.117675000.117680000",235000,17,1.070746e-06,117440000,117675000,117445000,117680000,"chr11",432666,0,2,2,4,"chr11",1,0.00796999531176746
"13945","chr11.3825000.3830000","chr11.4095000.4100000",270000,11,0.003615715,3825000,4095000,3830000,4100000,"chr11",432688,0,3,5,8,"chr11",1,0.0103141115799344
"13946","chr11.123505000.123510000","chr11.123565000.123570000",60000,21,0.002710311,123505000,123565000,123510000,123570000,"chr11",432725,2,3,6,11,"chr11",1,0.0270745428973277
"13947","chr11.121220000.121225000","chr11.121320000.121325000",100000,21,1.210377e-05,121220000,121320000,121225000,121325000,"chr11",432771,3,7,6,16,"chr11",1,0.0393811533052039
"13948","chr11.47255000.47260000","chr11.47605000.47610000",350000,12,0.0001736969,47255000,47605000,47260000,47610000,"chr11",432807,8,25,24,57,"chr11",1,0.080168776371308
"13949","chr11.122075000.122080000","chr11.122320000.122325000",245000,21,3.693426e-10,122075000,122320000,122080000,122325000,"chr11",432890,1,1,2,4,"chr11",1,0.00984528832630099
"13950","chr11.72625000.72630000","chr11.72845000.72850000",220000,17,2.129751e-06,72625000,72845000,72630000,72850000,"chr11",432897,0,0,2,2,"chr11",1,0.00398499765588373
"13951","chr11.565000.570000","chr11.695000.700000",130000,18,5.950879e-05,565000,695000,570000,7e+05,"chr11",432936,0,2,5,7,"chr11",1,0.0147679324894515
"13952","chr11.109805000.109810000","chr11.109995000.110000000",190000,13,0.002567712,109805000,109995000,109810000,1.1e+08,"chr11",432969,2,2,8,12,"chr11",1,0.0182841068917018
"13953","chr11.119090000.119095000","chr11.119120000.119125000",30000,37,1.319731e-05,119090000,119120000,119095000,119125000,"chr11",433011,0,3,1,4,"chr11",1,0.0173464603844351
"13954","chr11.36210000.36215000","chr11.36495000.36500000",285000,11,0.002660958,36210000,36495000,36215000,36500000,"chr11",433032,1,2,2,5,"chr11",1,0.00644631973745898
"13955","chr11.126480000.126485000","chr11.127225000.127230000",745000,8,0.001520643,126480000,127225000,126485000,127230000,"chr11",433051,0,4,0,4,"chr11",1,0.00375058602906704
"13956","chr11.17405000.17410000","chr11.17525000.17530000",120000,21,1.774998e-06,17405000,17525000,17410000,17530000,"chr11",433089,2,2,5,9,"chr11",1,0.0221518987341772
"13957","chr11.62390000.62395000","chr11.62500000.62505000",110000,15,0.006750723,62390000,62500000,62395000,62505000,"chr11",433096,3,6,4,13,"chr11",1,0.0228551336146273
"13958","chr11.6505000.6510000","chr11.6635000.6640000",130000,16,0.0007775766,6505000,6635000,6510000,6640000,"chr11",433111,2,3,1,6,"chr11",1,0.0112517580872011
"13959","chr11.117705000.117710000","chr11.117805000.117810000",100000,21,1.210377e-05,117705000,117805000,117710000,117810000,"chr11",433121,0,2,2,4,"chr11",1,0.00984528832630099
"13960","chr11.9205000.9210000","chr11.9220000.9225000",15000,36,0.005637993,9205000,9220000,9210000,9225000,"chr11",433122,3,1,4,8,"chr11",1,0.0337552742616034
"13961","chr11.117315000.117320000","chr11.117365000.117370000",50000,22,0.006416007,117315000,117365000,117320000,117370000,"chr11",433144,1,3,1,5,"chr11",1,0.012892639474918
"13962","chr11.64815000.64820000","chr11.64865000.64870000",50000,25,0.0004464974,64815000,64865000,64820000,64870000,"chr11",433204,1,5,7,13,"chr11",1,0.0380918893577121
"13963","chr11.34265000.34270000","chr11.34345000.34350000",80000,20,0.0004232169,34265000,34345000,34270000,34350000,"chr11",433253,0,3,1,4,"chr11",1,0.00937646507266761
"13964","chr11.122035000.122040000","chr11.122315000.122320000",280000,13,0.0001596608,122035000,122315000,122040000,122320000,"chr11",433274,0,2,3,5,"chr11",1,0.00761837787154243
"13965","chr11.85755000.85760000","chr11.85850000.85855000",95000,26,1.760026e-08,85755000,85850000,85760000,85855000,"chr11",433288,0,1,1,2,"chr11",1,0.00609470229723394
"13966","chr11.112085000.112090000","chr11.112150000.112155000",65000,28,3.596447e-07,112085000,112150000,112090000,112155000,"chr11",433299,0,4,2,6,"chr11",1,0.019690576652602
"13967","chr11.66335000.66340000","chr11.66415000.66420000",80000,17,0.008774219,66335000,66415000,66340000,66420000,"chr11",433332,1,2,1,4,"chr11",1,0.00796999531176746
"13968","chr11.6410000.6415000","chr11.6635000.6640000",225000,13,0.0007992574,6410000,6635000,6415000,6640000,"chr11",433336,2,8,10,20,"chr11",1,0.0304735114861697
"13969","chr11.73340000.73345000","chr11.73595000.73600000",255000,12,0.00132137,73340000,73595000,73345000,73600000,"chr11",433357,2,4,6,12,"chr11",1,0.0168776371308017
"13970","chr11.125330000.125335000","chr11.125360000.125365000",30000,44,9.08624e-09,125330000,125360000,125335000,125365000,"chr11",433396,1,0,1,2,"chr11",1,0.0103141115799344
"13971","chr11.72660000.72665000","chr11.72820000.72825000",160000,13,0.007192356,72660000,72820000,72665000,72825000,"chr11",433403,0,1,1,2,"chr11",1,0.00304735114861697
"13972","chr11.65590000.65595000","chr11.65610000.65615000",20000,45,6.594591e-06,65590000,65610000,65595000,65615000,"chr11",433411,0,2,0,2,"chr11",1,0.0105485232067511
"13973","chr11.77870000.77875000","chr11.78270000.78275000",400000,14,1.877398e-06,77870000,78270000,77875000,78275000,"chr11",433416,4,13,8,25,"chr11",1,0.0410220346929208
"13974","chr11.72200000.72205000","chr11.72225000.72230000",25000,43,3.273002e-06,72200000,72225000,72205000,72230000,"chr11",433444,0,2,0,2,"chr11",1,0.0100796999531177
"13975","chr11.122505000.122510000","chr11.122680000.122685000",175000,14,0.00126728,122505000,122680000,122510000,122685000,"chr11",433466,5,14,6,25,"chr11",1,0.0410220346929208
"13976","chr11.100590000.100595000","chr11.100725000.100730000",135000,17,0.0001702143,100590000,100725000,100595000,100730000,"chr11",433476,0,2,0,2,"chr11",1,0.00398499765588373
"13977","chr11.10450000.10455000","chr11.10670000.10675000",220000,13,0.0009431827,10450000,10670000,10455000,10675000,"chr11",433484,0,3,2,5,"chr11",1,0.00761837787154243
"13978","chr11.35740000.35745000","chr11.36290000.36295000",550000,9,0.00151508,35740000,36290000,35745000,36295000,"chr11",433565,2,4,5,11,"chr11",1,0.0116033755274262
"13979","chr11.9185000.9190000","chr11.9315000.9320000",130000,15,0.00249608,9185000,9315000,9190000,9320000,"chr11",433566,0,7,2,9,"chr11",1,0.0158227848101266
"13980","chr11.94800000.94805000","chr11.95485000.95490000",685000,11,7.494855e-06,94800000,95485000,94805000,95490000,"chr11",433598,0,0,1,1,"chr11",1,0.0012892639474918
"13981","chr11.35735000.35740000","chr11.36495000.36500000",760000,8,0.001352334,35735000,36495000,35740000,36500000,"chr11",433630,3,9,4,16,"chr11",1,0.0150023441162682
"13982","chr11.33195000.33200000","chr11.33360000.33365000",165000,21,6.614228e-08,33195000,33360000,33200000,33365000,"chr11",433631,6,16,11,33,"chr11",1,0.0812236286919831
"13983","chr11.6465000.6470000","chr11.6530000.6535000",65000,19,0.007548068,6465000,6530000,6470000,6535000,"chr11",433632,2,3,4,9,"chr11",1,0.020042194092827
"13984","chr11.62545000.62550000","chr11.62600000.62605000",55000,23,0.001056029,62545000,62600000,62550000,62605000,"chr11",433638,0,3,1,4,"chr11",1,0.0107829348335677
"13985","chr11.131500000.131505000","chr11.131530000.131535000",30000,34,0.0001927165,131500000,131530000,131505000,131535000,"chr11",433644,1,2,1,4,"chr11",1,0.0159399906235349
"13986","chr11.117300000.117305000","chr11.117665000.117670000",365000,11,0.000669902,117300000,117665000,117305000,117670000,"chr11",433650,1,6,1,8,"chr11",1,0.0103141115799344
"13987","chr11.117620000.117625000","chr11.117675000.117680000",55000,21,0.006262805,117620000,117675000,117625000,117680000,"chr11",433668,0,3,0,3,"chr11",1,0.00738396624472574
"13988","chr11.14240000.14245000","chr11.14265000.14270000",25000,34,0.004277218,14240000,14265000,14245000,14270000,"chr11",433682,1,6,4,11,"chr11",1,0.0438349742147211
"13989","chr11.131745000.131750000","chr11.131885000.131890000",140000,21,3.905967e-07,131745000,131885000,131750000,131890000,"chr11",433688,0,3,1,4,"chr11",1,0.00984528832630099
"13990","chr11.73285000.73290000","chr11.73315000.73320000",30000,30,0.004387639,73285000,73315000,73290000,73320000,"chr11",433702,1,0,0,1,"chr11",1,0.00351617440225035
"13991","chr11.32115000.32120000","chr11.32185000.32190000",70000,19,0.003994913,32115000,32185000,32120000,32190000,"chr11",433710,1,2,1,4,"chr11",1,0.00890764181903422
"13992","chr11.112830000.112835000","chr11.113135000.113140000",305000,10,0.007059608,112830000,113135000,112835000,113140000,"chr11",433713,0,0,3,3,"chr11",1,0.00351617440225035
"13993","chr11.46390000.46395000","chr11.46550000.46555000",160000,14,0.002286979,46390000,46550000,46395000,46555000,"chr11",433726,1,6,2,9,"chr11",1,0.0147679324894515
"13994","chr11.47255000.47260000","chr11.47280000.47285000",25000,55,9.999941e-12,47255000,47280000,47260000,47285000,"chr11",433728,10,25,17,52,"chr11",1,0.335208626347867
"13995","chr11.77870000.77875000","chr11.78140000.78145000",270000,23,1.363761e-12,77870000,78140000,77875000,78145000,"chr11",433746,4,13,8,25,"chr11",1,0.0673933427097984
"13996","chr11.35735000.35740000","chr11.36155000.36160000",420000,9,0.006274983,35735000,36155000,35740000,36160000,"chr11",433765,3,6,2,11,"chr11",1,0.0116033755274262
"13997","chr11.116840000.116845000","chr11.116900000.116905000",60000,27,4.521494e-06,116840000,116900000,116845000,116905000,"chr11",433799,2,3,7,12,"chr11",1,0.0379746835443038
"13998","chr11.61825000.61830000","chr11.61850000.61855000",25000,38,0.0002343275,61825000,61850000,61830000,61855000,"chr11",433827,0,7,6,13,"chr11",1,0.0578996718237225
"13999","chr11.35940000.35945000","chr11.36030000.36035000",90000,17,0.003610923,35940000,36030000,35945000,36035000,"chr11",433865,1,2,1,4,"chr11",1,0.00796999531176746
"14000","chr11.63475000.63480000","chr11.63505000.63510000",30000,64,1.772383e-20,63475000,63505000,63480000,63510000,"chr11",433884,0,4,3,7,"chr11",1,0.0525082044069386
"14001","chr11.116810000.116815000","chr11.116840000.116845000",30000,30,0.004387639,116810000,116840000,116815000,116845000,"chr11",433889,5,7,6,18,"chr11",1,0.0632911392405063
"14002","chr11.64970000.64975000","chr11.65010000.65015000",40000,26,0.002147236,64970000,65010000,64975000,65015000,"chr11",433937,8,27,22,57,"chr11",1,0.173699015471167
"14003","chr11.119605000.119610000","chr11.119985000.119990000",380000,10,0.002430846,119605000,119985000,119610000,119990000,"chr11",433990,1,1,0,2,"chr11",1,0.0023441162681669
"14004","chr11.85810000.85815000","chr11.85945000.85950000",135000,16,0.0006032158,85810000,85945000,85815000,85950000,"chr11",434000,2,0,2,4,"chr11",1,0.00750117205813408
"14005","chr11.62500000.62505000","chr11.62650000.62655000",150000,17,7.601346e-05,62500000,62650000,62505000,62655000,"chr11",434015,3,12,4,19,"chr11",1,0.0378574777308955
"14006","chr11.62675000.62680000","chr11.62770000.62775000",95000,26,1.760026e-08,62675000,62770000,62680000,62775000,"chr11",434027,2,13,9,24,"chr11",1,0.0731364275668073
"14007","chr11.46845000.46850000","chr11.47160000.47165000",315000,11,0.001513469,46845000,47160000,46850000,47165000,"chr11",434034,2,4,5,11,"chr11",1,0.0141819034224098
"14008","chr11.75530000.75535000","chr11.75560000.75565000",30000,40,6.79804e-07,75530000,75560000,75535000,75565000,"chr11",434069,0,1,1,2,"chr11",1,0.00937646507266761
"14009","chr11.124800000.124805000","chr11.125215000.125220000",415000,9,0.006618691,124800000,125215000,124805000,125220000,"chr11",434085,1,8,5,14,"chr11",1,0.0147679324894515
"14010","chr11.62495000.62500000","chr11.62595000.62600000",100000,24,1.748735e-07,62495000,62595000,62500000,62600000,"chr11",434093,0,0,2,2,"chr11",1,0.00562587904360056
"14011","chr11.35275000.35280000","chr11.35360000.35365000",85000,17,0.005623782,35275000,35360000,35280000,35365000,"chr11",434111,0,3,3,6,"chr11",1,0.0119549929676512
"14012","chr11.47945000.47950000","chr11.48080000.48085000",135000,14,0.006073743,47945000,48080000,47950000,48085000,"chr11",434125,11,28,22,61,"chr11",1,0.100093764650727
"14013","chr11.118070000.118075000","chr11.118240000.118245000",170000,13,0.005092878,118070000,118240000,118075000,118245000,"chr11",434252,0,1,0,1,"chr11",1,0.00152367557430849
"14014","chr11.131585000.131590000","chr11.131980000.131985000",395000,11,0.0004220777,131585000,131980000,131590000,131985000,"chr11",434293,0,5,5,10,"chr11",1,0.012892639474918
"14015","chr11.67350000.67355000","chr11.67420000.67425000",70000,19,0.003994913,67350000,67420000,67355000,67425000,"chr11",434296,1,0,8,9,"chr11",1,0.020042194092827
"14016","chr11.78000000.78005000","chr11.78060000.78065000",60000,27,4.521494e-06,7.8e+07,78060000,78005000,78065000,"chr11",434300,6,11,16,33,"chr11",1,0.104430379746835
"14017","chr11.47540000.47545000","chr11.47575000.47580000",35000,32,7.227617e-05,47540000,47575000,47545000,47580000,"chr11",434306,2,5,10,17,"chr11",1,0.0637599624941397
"14018","chr11.95785000.95790000","chr11.96045000.96050000",260000,15,1.165266e-05,95785000,96045000,95790000,96050000,"chr11",434326,0,1,1,2,"chr11",1,0.00351617440225035
"14019","chr11.3745000.3750000","chr11.3800000.3805000",55000,21,0.006262805,3745000,3800000,3750000,3805000,"chr11",434365,7,22,30,59,"chr11",1,0.14521800281294
"14020","chr11.47930000.47935000","chr11.48135000.48140000",205000,17,4.426209e-06,47930000,48135000,47935000,48140000,"chr11",434386,0,5,2,7,"chr11",1,0.0139474917955931
"14021","chr11.10455000.10460000","chr11.10525000.10530000",70000,20,0.00151508,10455000,10525000,10460000,10530000,"chr11",434389,0,1,3,4,"chr11",1,0.00937646507266761
"14022","chr11.46900000.46905000","chr11.47355000.47360000",455000,12,2.815104e-05,46900000,47355000,46905000,47360000,"chr11",434392,0,2,2,4,"chr11",1,0.00562587904360056
"14023","chr11.35800000.35805000","chr11.36100000.36105000",300000,12,0.0004572997,35800000,36100000,35805000,36105000,"chr11",434393,0,3,3,6,"chr11",1,0.00843881856540084
"14024","chr11.119205000.119210000","chr11.119340000.119345000",135000,15,0.002004479,119205000,119340000,119210000,119345000,"chr11",434423,0,0,1,1,"chr11",1,0.00175808720112518
"14025","chr11.126480000.126485000","chr11.126755000.126760000",275000,11,0.003252287,126480000,126755000,126485000,126760000,"chr11",434455,0,3,0,3,"chr11",1,0.00386779184247539
"14026","chr11.78030000.78035000","chr11.78060000.78065000",30000,37,1.319731e-05,78030000,78060000,78035000,78065000,"chr11",434498,6,11,16,33,"chr11",1,0.143108298171589
"14027","chr11.45995000.46000000","chr11.46360000.46365000",365000,12,0.0001337761,45995000,46360000,4.6e+07,46365000,"chr11",434535,0,4,2,6,"chr11",1,0.00843881856540084
"14028","chr11.47005000.47010000","chr11.47155000.47160000",150000,16,0.0002926889,47005000,47155000,47010000,47160000,"chr11",434541,2,5,1,8,"chr11",1,0.0150023441162682
"14029","chr11.102285000.102290000","chr11.102365000.102370000",80000,26,2.204965e-07,102285000,102365000,102290000,102370000,"chr11",434602,3,4,8,15,"chr11",1,0.0457102672292546
"14030","chr11.118995000.119000000","chr11.119090000.119095000",95000,17,0.002376085,118995000,119090000,1.19e+08,119095000,"chr11",434610,0,3,1,4,"chr11",1,0.00796999531176746
"14031","chr11.118065000.118070000","chr11.118210000.118215000",145000,18,2.487399e-05,118065000,118210000,118070000,118215000,"chr11",434627,7,7,8,22,"chr11",1,0.0464135021097046
"14032","chr11.116740000.116745000","chr11.116955000.116960000",215000,20,1.471409e-08,116740000,116955000,116745000,116960000,"chr11",434629,4,4,8,16,"chr11",1,0.0375058602906704
"14033","chr11.46590000.46595000","chr11.46845000.46850000",255000,11,0.005044969,46590000,46845000,46595000,46850000,"chr11",434658,6,14,17,37,"chr11",1,0.0477027660571964
"14034","chr11.120380000.120385000","chr11.120825000.120830000",445000,13,5.190333e-06,120380000,120825000,120385000,120830000,"chr11",434670,0,0,1,1,"chr11",1,0.00152367557430849
"14035","chr11.117300000.117305000","chr11.117440000.117445000",140000,16,0.0004735847,117300000,117440000,117305000,117445000,"chr11",434710,0,2,4,6,"chr11",1,0.0112517580872011
"14036","chr11.113920000.113925000","chr11.114085000.114090000",165000,15,0.0005365909,113920000,114085000,113925000,114090000,"chr11",434729,0,2,0,2,"chr11",1,0.00351617440225035
"14037","chr11.112830000.112835000","chr11.113110000.113115000",280000,12,0.0007246773,112830000,113110000,112835000,113115000,"chr11",434752,0,0,1,1,"chr11",1,0.00140646976090014
"14038","chr11.117365000.117370000","chr11.117465000.117470000",100000,21,1.210377e-05,117365000,117465000,117370000,117470000,"chr11",434791,0,2,1,3,"chr11",1,0.00738396624472574
"14039","chr11.65040000.65045000","chr11.65080000.65085000",40000,99,9.056095e-58,65040000,65080000,65045000,65085000,"chr11",434814,5,14,11,30,"chr11",1,0.348101265822785
"14040","chr11.21180000.21185000","chr11.22150000.22155000",970000,7,0.002074038,21180000,22150000,21185000,22155000,"chr11",434820,1,0,3,4,"chr11",1,0.00328176277543366
"14041","chr11.85685000.85690000","chr11.85755000.85760000",70000,23,5.939981e-05,85685000,85755000,85690000,85760000,"chr11",434844,0,1,1,2,"chr11",1,0.00539146741678387
"14042","chr11.95785000.95790000","chr11.96055000.96060000",270000,14,4.321983e-05,95785000,96055000,95790000,96060000,"chr11",434869,0,1,3,4,"chr11",1,0.00656352555086732
"14043","chr11.26295000.26300000","chr11.27180000.27185000",885000,7,0.003610923,26295000,27180000,26300000,27185000,"chr11",434919,0,5,4,9,"chr11",1,0.00738396624472574
"14044","chr11.63610000.63615000","chr11.63635000.63640000",25000,52,3.229786e-10,63610000,63635000,63615000,63640000,"chr11",435026,3,15,6,24,"chr11",1,0.146272855133615
"14045","chr11.63600000.63605000","chr11.63635000.63640000",35000,54,8.876906e-17,63600000,63635000,63605000,63640000,"chr11",435033,3,15,6,24,"chr11",1,0.151898734177215
"14046","chr11.86170000.86175000","chr11.86520000.86525000",350000,11,0.0008378185,86170000,86520000,86175000,86525000,"chr11",435094,1,2,6,9,"chr11",1,0.0116033755274262
"14047","chr11.66345000.66350000","chr11.66605000.66610000",260000,11,0.004516084,66345000,66605000,66350000,66610000,"chr11",435097,0,6,5,11,"chr11",1,0.0141819034224098
"14048","chr11.8710000.8715000","chr11.8840000.8845000",130000,14,0.007397049,8710000,8840000,8715000,8845000,"chr11",435141,0,5,1,6,"chr11",1,0.00984528832630099
"14049","chr11.118080000.118085000","chr11.118170000.118175000",90000,18,0.00126728,118080000,118170000,118085000,118175000,"chr11",435159,0,1,2,3,"chr11",1,0.00632911392405063
"14050","chr11.124600000.124605000","chr11.124650000.124655000",50000,22,0.006416007,124600000,124650000,124605000,124655000,"chr11",435168,0,10,2,12,"chr11",1,0.0309423347398031
"14051","chr11.46245000.46250000","chr11.46345000.46350000",100000,18,0.0005158251,46245000,46345000,46250000,46350000,"chr11",435207,0,1,1,2,"chr11",1,0.00421940928270042
"14052","chr11.118240000.118245000","chr11.118315000.118320000",75000,23,2.600444e-05,118240000,118315000,118245000,118320000,"chr11",435250,0,1,0,1,"chr11",1,0.00269573370839194
"14053","chr11.66315000.66320000","chr11.66480000.66485000",165000,13,0.006060268,66315000,66480000,66320000,66485000,"chr11",435274,0,8,12,20,"chr11",1,0.0304735114861697
"14054","chr11.13925000.13930000","chr11.14265000.14270000",340000,10,0.004203973,13925000,14265000,13930000,14270000,"chr11",435286,0,3,0,3,"chr11",1,0.00351617440225035
"14055","chr11.122115000.122120000","chr11.122140000.122145000",25000,37,0.0005101673,122115000,122140000,122120000,122145000,"chr11",435309,0,5,1,6,"chr11",1,0.0260196905766526
"14056","chr11.46890000.46895000","chr11.47180000.47185000",290000,14,2.398897e-05,46890000,47180000,46895000,47185000,"chr11",435312,4,12,8,24,"chr11",1,0.0393811533052039
"14057","chr11.33195000.33200000","chr11.33340000.33345000",145000,14,0.004132733,33195000,33340000,33200000,33345000,"chr11",435316,1,11,7,19,"chr11",1,0.0311767463666198
"14058","chr11.47000000.47005000","chr11.47155000.47160000",155000,15,0.0008295768,4.7e+07,47155000,47005000,47160000,"chr11",435324,2,5,0,7,"chr11",1,0.0123066104078762
"14059","chr11.85755000.85760000","chr11.85775000.85780000",20000,81,6.262192e-25,85755000,85775000,85760000,85780000,"chr11",435335,0,1,1,2,"chr11",1,0.0189873417721519
"14060","chr11.10670000.10675000","chr11.10750000.10755000",80000,17,0.008774219,10670000,10750000,10675000,10755000,"chr11",435345,0,8,2,10,"chr11",1,0.0199249882794187
"14061","chr11.35925000.35930000","chr11.36145000.36150000",220000,12,0.003456989,35925000,36145000,35930000,36150000,"chr11",435380,5,7,20,32,"chr11",1,0.0450070323488045
"14062","chr11.122450000.122455000","chr11.122625000.122630000",175000,14,0.00126728,122450000,122625000,122455000,122630000,"chr11",435414,1,3,7,11,"chr11",1,0.0180496952648851
"14063","chr11.35950000.35955000","chr11.36145000.36150000",195000,12,0.007192356,35950000,36145000,35955000,36150000,"chr11",435438,0,2,2,4,"chr11",1,0.00562587904360056
"14064","chr11.122110000.122115000","chr11.122215000.122220000",105000,15,0.009090773,122110000,122215000,122115000,122220000,"chr11",435509,0,2,1,3,"chr11",1,0.00527426160337553
"14065","chr11.126695000.126700000","chr11.126755000.126760000",60000,29,3.828649e-07,126695000,126755000,126700000,126760000,"chr11",435514,0,1,1,2,"chr11",1,0.00679793717768401
"14066","chr11.118070000.118075000","chr11.118355000.118360000",285000,14,2.767108e-05,118070000,118355000,118075000,118360000,"chr11",435548,1,10,4,15,"chr11",1,0.0246132208157525
"14067","chr11.110145000.110150000","chr11.110200000.110205000",55000,21,0.006262805,110145000,110200000,110150000,110205000,"chr11",435556,0,0,4,4,"chr11",1,0.00984528832630099
"14068","chr11.33305000.33310000","chr11.33690000.33695000",385000,9,0.009387803,33305000,33690000,33310000,33695000,"chr11",435560,2,1,1,4,"chr11",1,0.00421940928270042
"14069","chr11.47460000.47465000","chr11.47790000.47795000",330000,10,0.004832243,47460000,47790000,47465000,47795000,"chr11",435564,7,28,24,59,"chr11",1,0.0691514299109236
"14070","chr11.119090000.119095000","chr11.119155000.119160000",65000,19,0.007548068,119090000,119155000,119095000,119160000,"chr11",435589,0,2,1,3,"chr11",1,0.00668073136427567
"14071","chr11.115465000.115470000","chr11.116065000.116070000",600000,8,0.004759951,115465000,116065000,115470000,116070000,"chr11",435603,0,1,0,1,"chr11",1,0.00093764650726676
"14072","chr11.71810000.71815000","chr11.72140000.72145000",330000,20,5.90473e-11,71810000,72140000,71815000,72145000,"chr11",435627,0,3,1,4,"chr11",1,0.00937646507266761
"14073","chr11.46610000.46615000","chr11.46695000.46700000",85000,20,0.0002305393,46610000,46695000,46615000,46700000,"chr11",435633,0,6,4,10,"chr11",1,0.023441162681669
"14074","chr11.66335000.66340000","chr11.66435000.66440000",100000,23,7.498965e-07,66335000,66435000,66340000,66440000,"chr11",435634,1,4,1,6,"chr11",1,0.0161744022503516
"14075","chr11.73125000.73130000","chr11.73285000.73290000",160000,15,0.0006715136,73125000,73285000,73130000,73290000,"chr11",435656,2,0,0,2,"chr11",1,0.00351617440225035
"14076","chr11.66890000.66895000","chr11.66970000.66975000",80000,18,0.003390837,66890000,66970000,66895000,66975000,"chr11",435663,0,28,19,47,"chr11",1,0.0991561181434599
"14077","chr11.48025000.48030000","chr11.48090000.48095000",65000,19,0.007548068,48025000,48090000,48030000,48095000,"chr11",435701,0,5,1,6,"chr11",1,0.0133614627285513
"14078","chr11.117935000.117940000","chr11.118065000.118070000",130000,15,0.00249608,117935000,118065000,117940000,118070000,"chr11",435736,3,9,10,22,"chr11",1,0.0386779184247539
"14079","chr11.118995000.119000000","chr11.119220000.119225000",225000,16,8.78765e-06,118995000,119220000,1.19e+08,119225000,"chr11",435741,10,27,30,67,"chr11",1,0.125644631973746
"14080","chr11.125440000.125445000","chr11.125495000.125500000",55000,25,0.0001461445,125440000,125495000,125445000,125500000,"chr11",435776,0,0,4,4,"chr11",1,0.0117205813408345
"14081","chr11.116875000.116880000","chr11.116895000.116900000",20000,40,0.0003756276,116875000,116895000,116880000,116900000,"chr11",435800,0,3,2,5,"chr11",1,0.023441162681669
"14082","chr11.64225000.64230000","chr11.64815000.64820000",590000,8,0.005171771,64225000,64815000,64230000,64820000,"chr11",435804,0,12,12,24,"chr11",1,0.0225035161744023
"14083","chr11.46935000.46940000","chr11.47155000.47160000",220000,13,0.0009431827,46935000,47155000,46940000,47160000,"chr11",435812,2,5,1,8,"chr11",1,0.0121894045944679
"14084","chr11.9205000.9210000","chr11.9230000.9235000",25000,35,0.002175798,9205000,9230000,9210000,9235000,"chr11",435816,3,1,4,8,"chr11",1,0.0328176277543366
"14085","chr11.112510000.112515000","chr11.113135000.113140000",625000,14,2.430191e-08,112510000,113135000,112515000,113140000,"chr11",435818,0,4,3,7,"chr11",1,0.0114861697140178
"14086","chr11.112830000.112835000","chr11.113010000.113015000",180000,15,0.0002792772,112830000,113010000,112835000,113015000,"chr11",435820,0,0,2,2,"chr11",1,0.00351617440225035
"14087","chr11.68025000.68030000","chr11.68210000.68215000",185000,17,1.211481e-05,68025000,68210000,68030000,68215000,"chr11",435853,1,2,1,4,"chr11",1,0.00796999531176746
"14088","chr11.35660000.35665000","chr11.36275000.36280000",615000,8,0.004204102,35660000,36275000,35665000,36280000,"chr11",435863,0,3,0,3,"chr11",1,0.00281293952180028
"14089","chr11.119755000.119760000","chr11.119875000.119880000",120000,18,0.0001128133,119755000,119875000,119760000,119880000,"chr11",435873,0,2,0,2,"chr11",1,0.00421940928270042
"14090","chr11.45965000.45970000","chr11.46275000.46280000",310000,10,0.006512553,45965000,46275000,45970000,46280000,"chr11",435876,0,2,1,3,"chr11",1,0.00351617440225035
"14091","chr11.111740000.111745000","chr11.111845000.111850000",105000,20,2.737129e-05,111740000,111845000,111745000,111850000,"chr11",435878,0,6,4,10,"chr11",1,0.023441162681669
"14092","chr11.75530000.75535000","chr11.76150000.76155000",620000,11,1.68355e-05,75530000,76150000,75535000,76155000,"chr11",435894,1,6,3,10,"chr11",1,0.012892639474918
"14093","chr11.35680000.35685000","chr11.36145000.36150000",465000,9,0.00380647,35680000,36145000,35685000,36150000,"chr11",435911,2,7,9,18,"chr11",1,0.0189873417721519
"14094","chr11.6400000.6405000","chr11.6480000.6485000",80000,18,0.003390837,6400000,6480000,6405000,6485000,"chr11",435928,0,2,0,2,"chr11",1,0.00421940928270042
"14095","chr11.73650000.73655000","chr11.73670000.73675000",20000,37,0.00299301,73650000,73670000,73655000,73675000,"chr11",435964,4,6,10,20,"chr11",1,0.0867323019221753
"14096","chr11.11370000.11375000","chr11.11805000.11810000",435000,10,0.001164174,11370000,11805000,11375000,11810000,"chr11",435980,0,0,2,2,"chr11",1,0.0023441162681669
"14097","chr11.9185000.9190000","chr11.9275000.9280000",90000,22,1.060914e-05,9185000,9275000,9190000,9280000,"chr11",435985,0,7,2,9,"chr11",1,0.0232067510548523
"14098","chr11.13205000.13210000","chr11.13365000.13370000",160000,25,8.243304e-11,13205000,13365000,13210000,13370000,"chr11",436007,0,3,0,3,"chr11",1,0.00879043600562588
"14099","chr11.121535000.121540000","chr11.122075000.122080000",540000,10,0.0003072755,121535000,122075000,121540000,122080000,"chr11",436031,1,4,4,9,"chr11",1,0.0105485232067511
"14100","chr11.61795000.61800000","chr11.61815000.61820000",20000,37,0.00299301,61795000,61815000,61800000,61820000,"chr11",436135,1,7,10,18,"chr11",1,0.0780590717299578
"14101","chr11.46615000.46620000","chr11.47185000.47190000",570000,8,0.006134852,46615000,47185000,46620000,47190000,"chr11",436137,1,6,4,11,"chr11",1,0.0103141115799344
"14102","chr11.83720000.83725000","chr11.83740000.83745000",20000,40,0.0003756276,83720000,83740000,83725000,83745000,"chr11",436146,0,1,2,3,"chr11",1,0.0140646976090014
"14103","chr11.83020000.83025000","chr11.83550000.83555000",530000,8,0.008774219,83020000,83550000,83025000,83555000,"chr11",436147,2,1,1,4,"chr11",1,0.00375058602906704
"14104","chr11.68015000.68020000","chr11.68210000.68215000",195000,16,3.378109e-05,68015000,68210000,68020000,68215000,"chr11",436204,1,2,5,8,"chr11",1,0.0150023441162682
"14105","chr11.19695000.19700000","chr11.19730000.19735000",35000,38,1.494527e-07,19695000,19730000,19700000,19735000,"chr11",436264,1,2,0,3,"chr11",1,0.0133614627285513
"14106","chr11.83550000.83555000","chr11.84140000.84145000",590000,10,0.0001688891,83550000,84140000,83555000,84145000,"chr11",436290,0,1,1,2,"chr11",1,0.0023441162681669
"14107","chr11.95790000.95795000","chr11.95920000.95925000",130000,16,0.0007775766,95790000,95920000,95795000,95925000,"chr11",436297,4,9,8,21,"chr11",1,0.0393811533052039
"14108","chr11.3810000.3815000","chr11.4090000.4095000",280000,13,0.0001596608,3810000,4090000,3815000,4095000,"chr11",436308,1,5,5,11,"chr11",1,0.0167604313173933
"14109","chr11.126615000.126620000","chr11.126875000.126880000",260000,11,0.004516084,126615000,126875000,126620000,126880000,"chr11",436331,0,3,2,5,"chr11",1,0.00644631973745898
"14110","chr11.66955000.66960000","chr11.67005000.67010000",50000,22,0.006416007,66955000,67005000,66960000,67010000,"chr11",436332,3,6,7,16,"chr11",1,0.0412564463197375
"14111","chr11.6670000.6675000","chr11.6700000.6705000",30000,31,0.002145814,6670000,6700000,6675000,6705000,"chr11",436336,2,4,0,6,"chr11",1,0.0218002812939522
"14112","chr11.64865000.64870000","chr11.65095000.65100000",230000,11,0.009090773,64865000,65095000,64870000,65100000,"chr11",436390,1,5,7,13,"chr11",1,0.0167604313173933
"14113","chr11.46445000.46450000","chr11.46505000.46510000",60000,21,0.002710311,46445000,46505000,46450000,46510000,"chr11",436392,0,0,5,5,"chr11",1,0.0123066104078762
"14114","chr11.83550000.83555000","chr11.83980000.83985000",430000,10,0.001246533,83550000,83980000,83555000,83985000,"chr11",436397,0,1,1,2,"chr11",1,0.0023441162681669
"14115","chr11.118220000.118225000","chr11.118240000.118245000",20000,44,1.55559e-05,118220000,118240000,118225000,118245000,"chr11",436463,0,1,0,1,"chr11",1,0.00515705578996718
"14116","chr11.46695000.46700000","chr11.46845000.46850000",150000,16,0.0002926889,46695000,46845000,46700000,46850000,"chr11",436482,0,6,4,10,"chr11",1,0.0187529301453352
"14117","chr11.40225000.40230000","chr11.40305000.40310000",80000,20,0.0004232169,40225000,40305000,40230000,40310000,"chr11",436502,0,6,5,11,"chr11",1,0.0257852789498359
"14118","chr11.36145000.36150000","chr11.36495000.36500000",350000,12,0.0001736969,36145000,36495000,36150000,36500000,"chr11",436546,3,7,10,20,"chr11",1,0.0281293952180028
"14119","chr11.73670000.73675000","chr11.73950000.73955000",280000,11,0.002958416,73670000,73950000,73675000,73955000,"chr11",436596,3,10,19,32,"chr11",1,0.0412564463197375
"14120","chr11.65135000.65140000","chr11.65300000.65305000",165000,15,0.0005365909,65135000,65300000,65140000,65305000,"chr11",436638,6,21,28,55,"chr11",1,0.0966947960618847
"14121","chr11.117295000.117300000","chr11.117675000.117680000",380000,29,1.661421e-21,117295000,117675000,117300000,117680000,"chr11",436691,0,3,2,5,"chr11",1,0.01699484294421
"14122","chr11.119085000.119090000","chr11.119175000.119180000",90000,21,3.803727e-05,119085000,119175000,119090000,119180000,"chr11",436720,3,17,25,45,"chr11",1,0.110759493670886
"14123","chr11.116875000.116880000","chr11.116990000.116995000",115000,15,0.005171771,116875000,116990000,116880000,116995000,"chr11",436724,1,3,2,6,"chr11",1,0.0105485232067511
"14124","chr11.116705000.116710000","chr11.116955000.116960000",250000,11,0.005637993,116705000,116955000,116710000,116960000,"chr11",436759,1,4,8,13,"chr11",1,0.0167604313173933
"14125","chr11.19755000.19760000","chr11.19830000.19835000",75000,19,0.002175798,19755000,19830000,19760000,19835000,"chr11",436786,0,0,1,1,"chr11",1,0.00222691045475856
"14126","chr11.65040000.65045000","chr11.65275000.65280000",235000,26,1.980335e-14,65040000,65275000,65045000,65280000,"chr11",436788,1,4,5,10,"chr11",1,0.0304735114861697
"14127","chr11.67025000.67030000","chr11.67080000.67085000",55000,33,9.817516e-09,67025000,67080000,67030000,67085000,"chr11",436916,9,18,15,42,"chr11",1,0.162447257383966
"14128","chr11.66315000.66320000","chr11.66890000.66895000",575000,8,0.005876324,66315000,66890000,66320000,66895000,"chr11",436922,0,8,13,21,"chr11",1,0.019690576652602
"14129","chr11.72520000.72525000","chr11.72845000.72850000",325000,12,0.0002766024,72520000,72845000,72525000,72850000,"chr11",437062,1,7,5,13,"chr11",1,0.0182841068917018
"14130","chr11.63600000.63605000","chr11.63735000.63740000",135000,28,3.546857e-12,63600000,63735000,63605000,63740000,"chr11",437095,4,15,16,35,"chr11",1,0.114861697140178
"14131","chr11.47450000.47455000","chr11.47585000.47590000",135000,21,5.532462e-07,47450000,47585000,47455000,47590000,"chr11",437114,3,4,11,18,"chr11",1,0.0443037974683544
"14132","chr11.14500000.14505000","chr11.14520000.14525000",20000,38,0.001528665,14500000,14520000,14505000,14525000,"chr11",437175,5,12,17,34,"chr11",1,0.151429910923582
"14133","chr11.61600000.61605000","chr11.61970000.61975000",370000,10,0.002788217,61600000,61970000,61605000,61975000,"chr11",437220,3,10,8,21,"chr11",1,0.0246132208157525
"14134","chr11.117835000.117840000","chr11.117860000.117865000",25000,33,0.008119404,117835000,117860000,117840000,117865000,"chr11",437237,0,2,1,3,"chr11",1,0.0116033755274262
"14135","chr11.19595000.19600000","chr11.19720000.19725000",125000,16,0.001007677,19595000,19720000,19600000,19725000,"chr11",437255,1,1,0,2,"chr11",1,0.00375058602906704
"14136","chr11.113875000.113880000","chr11.113895000.113900000",20000,36,0.005637993,113875000,113895000,113880000,113900000,"chr11",437259,4,1,1,6,"chr11",1,0.0253164556962025
"14137","chr11.10455000.10460000","chr11.10670000.10675000",215000,13,0.001095992,10455000,10670000,10460000,10675000,"chr11",437278,0,8,2,10,"chr11",1,0.0152367557430849
"14138","chr11.78140000.78145000","chr11.78270000.78275000",130000,24,6.804195e-09,78140000,78270000,78145000,78275000,"chr11",437279,4,18,21,43,"chr11",1,0.120956399437412
"14139","chr11.119085000.119090000","chr11.119195000.119200000",110000,16,0.002366381,119085000,119195000,119090000,119200000,"chr11",437287,3,15,11,29,"chr11",1,0.0543834974214721
"14140","chr11.20440000.20445000","chr11.20635000.20640000",195000,12,0.007192356,20440000,20635000,20445000,20640000,"chr11",437341,2,1,8,11,"chr11",1,0.0154711673699015
"14141","chr11.66405000.66410000","chr11.66435000.66440000",30000,32,0.0009985604,66405000,66435000,66410000,66440000,"chr11",437361,2,7,4,13,"chr11",1,0.0487576183778715
"14142","chr11.116700000.116705000","chr11.116955000.116960000",255000,11,0.005044969,116700000,116955000,116705000,116960000,"chr11",437417,0,4,4,8,"chr11",1,0.0103141115799344
"14143","chr11.108120000.108125000","chr11.108495000.108500000",375000,13,1.973556e-05,108120000,108495000,108125000,108500000,"chr11",437446,11,18,30,59,"chr11",1,0.0898968588842007
"14144","chr11.27180000.27185000","chr11.27495000.27500000",315000,12,0.0003398971,27180000,27495000,27185000,27500000,"chr11",437481,0,9,4,13,"chr11",1,0.0182841068917018
"14145","chr11.121200000.121205000","chr11.122075000.122080000",875000,9,7.847559e-05,121200000,122075000,121205000,122080000,"chr11",437523,1,4,4,9,"chr11",1,0.00949367088607595
"14146","chr11.83740000.83745000","chr11.83980000.83985000",240000,17,8.521639e-07,83740000,83980000,83745000,83985000,"chr11",437528,0,1,1,2,"chr11",1,0.00398499765588373
"14147","chr11.132605000.132610000","chr11.132630000.132635000",25000,36,0.001061553,132605000,132630000,132610000,132635000,"chr11",437541,1,2,3,6,"chr11",1,0.0253164556962025
"14148","chr11.36395000.36400000","chr11.36495000.36500000",100000,19,0.0001577547,36395000,36495000,36400000,36500000,"chr11",437548,3,9,10,22,"chr11",1,0.0489920300046882
"14149","chr11.117315000.117320000","chr11.117660000.117665000",345000,15,9.760801e-07,117315000,117660000,117320000,117665000,"chr11",437556,0,2,0,2,"chr11",1,0.00351617440225035
"14150","chr11.123055000.123060000","chr11.123120000.123125000",65000,23,0.0001480939,123055000,123120000,123060000,123125000,"chr11",437560,5,11,10,26,"chr11",1,0.0700890764181903
"14151","chr11.65480000.65485000","chr11.65610000.65615000",130000,24,6.804195e-09,65480000,65610000,65485000,65615000,"chr11",437585,0,2,0,2,"chr11",1,0.00562587904360056
"14152","chr11.6505000.6510000","chr11.6700000.6705000",195000,17,7.245682e-06,6505000,6700000,6510000,6705000,"chr11",437609,2,3,1,6,"chr11",1,0.0119549929676512
"14153","chr11.121535000.121540000","chr11.122320000.122325000",785000,7,0.006541073,121535000,122320000,121540000,122325000,"chr11",437627,1,1,2,4,"chr11",1,0.00328176277543366
"14154","chr11.121220000.121225000","chr11.121380000.121385000",160000,14,0.002286979,121220000,121380000,121225000,121385000,"chr11",437659,4,7,9,20,"chr11",1,0.0328176277543366
"14155","chr11.46900000.46905000","chr11.47180000.47185000",280000,25,8.455145e-15,46900000,47180000,46905000,47185000,"chr11",437662,1,8,8,17,"chr11",1,0.0498124706985466
"14156","chr11.6400000.6405000","chr11.6465000.6470000",65000,26,4.50204e-06,6400000,6465000,6405000,6470000,"chr11",437670,0,2,0,2,"chr11",1,0.00609470229723394
"14157","chr11.46590000.46595000","chr11.46825000.46830000",235000,12,0.002286979,46590000,46825000,46595000,46830000,"chr11",437672,5,9,8,22,"chr11",1,0.0309423347398031
"14158","chr11.12690000.12695000","chr11.12910000.12915000",220000,28,7.980953e-16,12690000,12910000,12695000,12915000,"chr11",437723,0,4,2,6,"chr11",1,0.019690576652602
"14159","chr11.123505000.123510000","chr11.123575000.123580000",70000,20,0.00151508,123505000,123575000,123510000,123580000,"chr11",437740,3,6,7,16,"chr11",1,0.0375058602906704
"14160","chr11.61635000.61640000","chr11.61825000.61830000",190000,13,0.002567712,61635000,61825000,61640000,61830000,"chr11",437741,0,4,6,10,"chr11",1,0.0152367557430849
"14161","chr11.110320000.110325000","chr11.111170000.111175000",850000,7,0.004493171,110320000,111170000,110325000,111175000,"chr11",437758,1,6,7,14,"chr11",1,0.0114861697140178
"14162","chr11.111635000.111640000","chr11.111690000.111695000",55000,21,0.006262805,111635000,111690000,111640000,111695000,"chr11",437759,0,3,0,3,"chr11",1,0.00738396624472574
"14163","chr11.117465000.117470000","chr11.117560000.117565000",95000,16,0.006541073,117465000,117560000,117470000,117565000,"chr11",437770,0,2,1,3,"chr11",1,0.00562587904360056
"14164","chr11.66125000.66130000","chr11.66865000.66870000",740000,7,0.008652419,66125000,66865000,66130000,66870000,"chr11",437791,0,3,1,4,"chr11",1,0.00328176277543366
"14165","chr11.46900000.46905000","chr11.47255000.47260000",355000,10,0.003390837,46900000,47255000,46905000,47260000,"chr11",437793,1,8,8,17,"chr11",1,0.0199249882794187
"14166","chr11.62265000.62270000","chr11.62335000.62340000",70000,20,0.00151508,62265000,62335000,62270000,62340000,"chr11",437797,0,6,4,10,"chr11",1,0.023441162681669
"14167","chr11.102265000.102270000","chr11.102340000.102345000",75000,31,3.975921e-10,102265000,102340000,102270000,102345000,"chr11",437800,3,5,3,11,"chr11",1,0.0399671823722457
"14168","chr11.63600000.63605000","chr11.63680000.63685000",80000,23,1.20113e-05,63600000,63680000,63605000,63685000,"chr11",437802,4,15,15,34,"chr11",1,0.0916549460853258
"14169","chr11.116865000.116870000","chr11.116955000.116960000",90000,22,1.060914e-05,116865000,116955000,116870000,116960000,"chr11",437811,0,2,2,4,"chr11",1,0.0103141115799344
"14170","chr11.66335000.66340000","chr11.66385000.66390000",50000,22,0.006416007,66335000,66385000,66340000,66390000,"chr11",437840,1,4,1,6,"chr11",1,0.0154711673699015
"14171","chr11.131460000.131465000","chr11.131530000.131535000",70000,30,6.285735e-09,131460000,131530000,131465000,131535000,"chr11",437844,0,2,1,3,"chr11",1,0.0105485232067511
"14172","chr11.11415000.11420000","chr11.11805000.11810000",390000,11,0.000449659,11415000,11805000,11420000,11810000,"chr11",437845,0,2,1,3,"chr11",1,0.00386779184247539
"14173","chr11.65520000.65525000","chr11.65940000.65945000",420000,12,5.079107e-05,65520000,65940000,65525000,65945000,"chr11",437878,6,17,23,46,"chr11",1,0.0646976090014065
"14174","chr11.119080000.119085000","chr11.119165000.119170000",85000,21,7.092982e-05,119080000,119165000,119085000,119170000,"chr11",437942,7,14,6,27,"chr11",1,0.0664556962025316
"14175","chr11.35675000.35680000","chr11.36300000.36305000",625000,9,0.0007149209,35675000,36300000,35680000,36305000,"chr11",437943,1,1,0,2,"chr11",1,0.00210970464135021
"14176","chr11.119100000.119105000","chr11.119165000.119170000",65000,25,1.51749e-05,119100000,119165000,119105000,119170000,"chr11",437964,0,6,4,10,"chr11",1,0.0293014533520863
"14177","chr11.67350000.67355000","chr11.67425000.67430000",75000,22,8.403174e-05,67350000,67425000,67355000,67430000,"chr11",437972,1,0,13,14,"chr11",1,0.0360993905297703
"14178","chr11.18540000.18545000","chr11.18730000.18735000",190000,12,0.00838713,18540000,18730000,18545000,18735000,"chr11",437979,2,3,1,6,"chr11",1,0.00843881856540084
"14179","chr11.33875000.33880000","chr11.33985000.33990000",110000,26,2.075712e-09,33875000,33985000,33880000,33990000,"chr11",437981,0,12,6,18,"chr11",1,0.0548523206751055
"14180","chr11.73140000.73145000","chr11.73335000.73340000",195000,15,0.0001476586,73140000,73335000,73145000,73340000,"chr11",438002,0,0,2,2,"chr11",1,0.00351617440225035
"14181","chr11.35675000.35680000","chr11.36265000.36270000",590000,11,2.487399e-05,35675000,36265000,35680000,36270000,"chr11",438047,1,3,1,5,"chr11",1,0.00644631973745898
"14182","chr11.6595000.6600000","chr11.6700000.6705000",105000,21,7.114763e-06,6595000,6700000,6600000,6705000,"chr11",438060,4,8,7,19,"chr11",1,0.0467651195499297
"14183","chr11.66335000.66340000","chr11.66430000.66435000",95000,19,0.0002530364,66335000,66430000,66340000,66435000,"chr11",438084,1,4,1,6,"chr11",1,0.0133614627285513
"14184","chr11.35820000.35825000","chr11.36145000.36150000",325000,13,5.398544e-05,35820000,36145000,35825000,36150000,"chr11",438128,0,2,1,3,"chr11",1,0.00457102672292546
"14185","chr11.118935000.118940000","chr11.118955000.118960000",20000,69,1.537817e-17,118935000,118955000,118940000,118960000,"chr11",438144,4,12,12,28,"chr11",1,0.226441631504923
"14186","chr11.71790000.71795000","chr11.71810000.71815000",20000,46,2.736836e-06,71790000,71810000,71795000,71815000,"chr11",438160,0,3,1,4,"chr11",1,0.0215658696671355
"14187","chr11.121200000.121205000","chr11.121220000.121225000",20000,37,0.00299301,121200000,121220000,121205000,121225000,"chr11",438191,4,7,9,20,"chr11",1,0.0867323019221753
"14188","chr11.117440000.117445000","chr11.117590000.117595000",150000,14,0.003390837,117440000,117590000,117445000,117595000,"chr11",438204,0,2,4,6,"chr11",1,0.00984528832630099
"14189","chr11.118935000.118940000","chr11.119065000.119070000",130000,16,0.0007775766,118935000,119065000,118940000,119070000,"chr11",438233,5,11,7,23,"chr11",1,0.043131739334271
"14190","chr11.48005000.48010000","chr11.48035000.48040000",30000,34,0.0001927165,48005000,48035000,48010000,48040000,"chr11",438236,0,10,6,16,"chr11",1,0.0637599624941397
"14191","chr11.65150000.65155000","chr11.65225000.65230000",75000,20,0.0007826491,65150000,65225000,65155000,65230000,"chr11",438260,7,13,15,35,"chr11",1,0.0820440693858415
"14192","chr11.61635000.61640000","chr11.61850000.61855000",215000,18,4.992146e-07,61635000,61850000,61640000,61855000,"chr11",438288,0,4,9,13,"chr11",1,0.0274261603375527
"14193","chr11.83555000.83560000","chr11.84085000.84090000",530000,10,0.0003505904,83555000,84085000,83560000,84090000,"chr11",438300,1,0,2,3,"chr11",1,0.00351617440225035
"14194","chr11.111985000.111990000","chr11.112025000.112030000",40000,28,0.0003782187,111985000,112025000,111990000,112030000,"chr11",438315,2,13,10,25,"chr11",1,0.0820440693858415
"14195","chr11.119085000.119090000","chr11.119165000.119170000",80000,30,5.904441e-10,119085000,119165000,119090000,119170000,"chr11",438348,3,17,25,45,"chr11",1,0.158227848101266
"14196","chr11.117365000.117370000","chr11.117655000.117660000",290000,10,0.009090773,117365000,117655000,117370000,117660000,"chr11",438380,1,3,0,4,"chr11",1,0.0046882325363338
"14197","chr11.118100000.118105000","chr11.118220000.118225000",120000,17,0.0004018914,118100000,118220000,118105000,118225000,"chr11",438385,2,1,3,6,"chr11",1,0.0119549929676512
"14198","chr11.113175000.113180000","chr11.113575000.113580000",400000,14,1.877398e-06,113175000,113575000,113180000,113580000,"chr11",438401,0,2,2,4,"chr11",1,0.00656352555086732
"14199","chr11.62390000.62395000","chr11.62540000.62545000",150000,15,0.001039364,62390000,62540000,62395000,62545000,"chr11",438413,1,1,0,2,"chr11",1,0.00351617440225035
"14200","chr11.66890000.66895000","chr11.66915000.66920000",25000,47,6.837502e-08,66890000,66915000,66895000,66920000,"chr11",438444,0,20,21,41,"chr11",1,0.225855602437881
"14201","chr11.116920000.116925000","chr11.116965000.116970000",45000,28,7.968688e-05,116920000,116965000,116925000,116970000,"chr11",438460,7,23,26,56,"chr11",1,0.183778715424285
"14202","chr11.112780000.112785000","chr11.112830000.112835000",50000,24,0.001138728,112780000,112830000,112785000,112835000,"chr11",438489,0,0,3,3,"chr11",1,0.00843881856540084
"14203","chr11.83305000.83310000","chr11.84210000.84215000",905000,8,0.0004757497,83305000,84210000,83310000,84215000,"chr11",438534,4,7,6,17,"chr11",1,0.0159399906235349
"14204","chr11.95255000.95260000","chr11.95350000.95355000",95000,16,0.006541073,95255000,95350000,95260000,95355000,"chr11",438560,1,2,2,5,"chr11",1,0.00937646507266761
"14205","chr11.47515000.47520000","chr11.47575000.47580000",60000,23,0.0003939866,47515000,47575000,47520000,47580000,"chr11",438573,2,5,10,17,"chr11",1,0.0458274730426629
"14206","chr11.120210000.120215000","chr11.120325000.120330000",115000,15,0.005171771,120210000,120325000,120215000,120330000,"chr11",438574,0,0,1,1,"chr11",1,0.00175808720112518
"14207","chr11.83555000.83560000","chr11.84090000.84095000",535000,8,0.00838713,83555000,84090000,83560000,84095000,"chr11",438590,1,3,2,6,"chr11",1,0.00562587904360056
"14208","chr11.78060000.78065000","chr11.78105000.78110000",45000,26,0.0005538777,78060000,78105000,78065000,78110000,"chr11",438610,6,11,16,33,"chr11",1,0.10056258790436
"14209","chr11.83050000.83055000","chr11.83305000.83310000",255000,12,0.00132137,83050000,83305000,83055000,83310000,"chr11",438663,3,8,6,17,"chr11",1,0.0239099859353024
"14210","chr11.121220000.121225000","chr11.121315000.121320000",95000,21,2.089396e-05,121220000,121315000,121225000,121320000,"chr11",438689,1,6,2,9,"chr11",1,0.0221518987341772
"14211","chr11.64970000.64975000","chr11.65095000.65100000",125000,15,0.003134986,64970000,65095000,64975000,65100000,"chr11",438723,8,35,22,65,"chr11",1,0.114275668073136
"14212","chr11.117225000.117230000","chr11.117705000.117710000",480000,10,0.000655038,117225000,117705000,117230000,117710000,"chr11",438734,0,2,3,5,"chr11",1,0.00586029067041725
"14213","chr11.3730000.3735000","chr11.4095000.4100000",365000,11,0.000669902,3730000,4095000,3735000,4100000,"chr11",438758,4,14,18,36,"chr11",1,0.0464135021097046
"14214","chr11.72035000.72040000","chr11.72085000.72090000",50000,22,0.006416007,72035000,72085000,72040000,72090000,"chr11",438799,1,1,0,2,"chr11",1,0.00515705578996718
"14215","chr11.77820000.77825000","chr11.78105000.78110000",285000,10,0.009894893,77820000,78105000,77825000,78110000,"chr11",438802,4,7,20,31,"chr11",1,0.036333802156587
"14216","chr11.113770000.113775000","chr11.114085000.114090000",315000,15,2.106484e-06,113770000,114085000,113775000,114090000,"chr11",438810,0,2,0,2,"chr11",1,0.00351617440225035
"14217","chr11.9200000.9205000","chr11.9460000.9465000",260000,11,0.004516084,9200000,9460000,9205000,9465000,"chr11",438834,3,5,8,16,"chr11",1,0.0206282231598687
"14218","chr11.117295000.117300000","chr11.117595000.117600000",300000,15,3.227199e-06,117295000,117595000,117300000,117600000,"chr11",438864,0,2,1,3,"chr11",1,0.00527426160337553
"14219","chr11.111510000.111515000","chr11.111635000.111640000",125000,15,0.003134986,111510000,111635000,111515000,111640000,"chr11",438866,0,1,0,1,"chr11",1,0.00175808720112518
"14220","chr11.73315000.73320000","chr11.73350000.73355000",35000,43,3.799879e-10,73315000,73350000,73320000,73355000,"chr11",438868,0,4,1,5,"chr11",1,0.0251992498827942
"14221","chr11.6390000.6395000","chr11.6530000.6535000",140000,17,0.0001313646,6390000,6530000,6395000,6535000,"chr11",438875,1,4,4,9,"chr11",1,0.0179324894514768
"14222","chr11.9230000.9235000","chr11.9275000.9280000",45000,30,9.963157e-06,9230000,9275000,9235000,9280000,"chr11",438895,5,10,13,28,"chr11",1,0.0984528832630098
"14223","chr11.33350000.33355000","chr11.33690000.33695000",340000,10,0.004203973,33350000,33690000,33355000,33695000,"chr11",438908,2,1,1,4,"chr11",1,0.0046882325363338
"14224","chr11.46975000.46980000","chr11.47150000.47155000",175000,14,0.00126728,46975000,47150000,46980000,47155000,"chr11",438922,0,9,4,13,"chr11",1,0.0213314580403188
"14225","chr11.119145000.119150000","chr11.119165000.119170000",20000,38,0.001528665,119145000,119165000,119150000,119170000,"chr11",438934,5,10,12,27,"chr11",1,0.120253164556962
"14226","chr11.46900000.46905000","chr11.47150000.47155000",250000,13,0.0003756276,46900000,47150000,46905000,47155000,"chr11",438936,0,8,6,14,"chr11",1,0.0213314580403188
"14227","chr11.35915000.35920000","chr11.36145000.36150000",230000,13,0.0006868944,35915000,36145000,35920000,36150000,"chr11",439002,2,4,13,19,"chr11",1,0.0289498359118612
"14228","chr11.35800000.35805000","chr11.36155000.36160000",355000,12,0.0001588471,35800000,36155000,35805000,36160000,"chr11",439006,0,6,2,8,"chr11",1,0.0112517580872011
"14229","chr11.117300000.117305000","chr11.117660000.117665000",360000,14,4.421894e-06,117300000,117660000,117305000,117665000,"chr11",439009,0,2,0,2,"chr11",1,0.00328176277543366
"14230","chr11.125380000.125385000","chr11.125430000.125435000",50000,23,0.002788217,125380000,125430000,125385000,125435000,"chr11",439020,0,5,3,8,"chr11",1,0.0215658696671355
"14231","chr11.63600000.63605000","chr11.63920000.63925000",320000,21,9.671311e-12,63600000,63920000,63605000,63925000,"chr11",439072,2,15,11,28,"chr11",1,0.0689170182841069
"14232","chr11.91950000.91955000","chr11.92330000.92335000",380000,11,0.0005272843,91950000,92330000,91955000,92335000,"chr11",439075,1,2,2,5,"chr11",1,0.00644631973745898
"14233","chr11.119080000.119085000","chr11.119100000.119105000",20000,40,0.0003756276,119080000,119100000,119085000,119105000,"chr11",439094,0,6,4,10,"chr11",1,0.046882325363338
"14234","chr11.117380000.117385000","chr11.117675000.117680000",295000,13,0.0001083754,117380000,117675000,117385000,117680000,"chr11",439119,0,3,2,5,"chr11",1,0.00761837787154243
"14235","chr11.13690000.13695000","chr11.14520000.14525000",830000,9,0.0001149493,13690000,14520000,13695000,14525000,"chr11",439125,1,7,4,12,"chr11",1,0.0126582278481013
"14236","chr11.64580000.64585000","chr11.64685000.64690000",105000,16,0.003252287,64580000,64685000,64585000,64690000,"chr11",439157,0,1,1,2,"chr11",1,0.00375058602906704
"14237","chr11.9220000.9225000","chr11.9385000.9390000",165000,15,0.0005365909,9220000,9385000,9225000,9390000,"chr11",439177,7,38,21,66,"chr11",1,0.116033755274262
"14238","chr11.118650000.118655000","chr11.118790000.118795000",140000,14,0.005017178,118650000,118790000,118655000,118795000,"chr11",439186,0,3,0,3,"chr11",1,0.00492264416315049
"14239","chr11.117300000.117305000","chr11.117560000.117565000",260000,13,0.000276648,117300000,117560000,117305000,117565000,"chr11",439263,3,11,11,25,"chr11",1,0.0380918893577121
"14240","chr11.72200000.72205000","chr11.72355000.72360000",155000,15,0.0008295768,72200000,72355000,72205000,72360000,"chr11",439268,0,3,1,4,"chr11",1,0.0070323488045007
"14241","chr11.78030000.78035000","chr11.78085000.78090000",55000,27,1.661895e-05,78030000,78085000,78035000,78090000,"chr11",439282,3,19,13,35,"chr11",1,0.110759493670886
"14242","chr11.40165000.40170000","chr11.40305000.40310000",140000,19,7.938325e-06,40165000,40305000,40170000,40310000,"chr11",439301,2,5,0,7,"chr11",1,0.0155883731833099
"14243","chr11.61950000.61955000","chr11.61995000.62000000",45000,24,0.003204564,61950000,61995000,61955000,6.2e+07,"chr11",439326,3,19,18,40,"chr11",1,0.112517580872011
"14244","chr11.33195000.33200000","chr11.33290000.33295000",95000,21,2.089396e-05,33195000,33290000,33200000,33295000,"chr11",439336,4,12,13,29,"chr11",1,0.0713783403656821
"14245","chr11.105145000.105150000","chr11.105485000.105490000",340000,10,0.004203973,105145000,105485000,105150000,105490000,"chr11",439471,0,1,1,2,"chr11",1,0.0023441162681669
"14246","chr11.119080000.119085000","chr11.119110000.119115000",30000,29,0.008756408,119080000,119110000,119085000,119115000,"chr11",439490,2,0,1,3,"chr11",1,0.010196905766526
"14247","chr11.305000.310000","chr11.350000.355000",45000,23,0.007192356,305000,350000,310000,355000,"chr11",439556,0,1,6,7,"chr11",1,0.0188701359587436
"14248","chr11.117620000.117625000","chr11.117835000.117840000",215000,13,0.001095992,117620000,117835000,117625000,117840000,"chr11",439594,0,3,0,3,"chr11",1,0.00457102672292546
"14249","chr11.117510000.117515000","chr11.117670000.117675000",160000,15,0.0006715136,117510000,117670000,117515000,117675000,"chr11",439696,0,1,1,2,"chr11",1,0.00351617440225035
"14250","chr11.72725000.72730000","chr11.72820000.72825000",95000,20,7.534125e-05,72725000,72820000,72730000,72825000,"chr11",439713,0,1,1,2,"chr11",1,0.0046882325363338
"14251","chr11.125465000.125470000","chr11.125490000.125495000",25000,57,8.983062e-13,125465000,125490000,125470000,125495000,"chr11",439718,7,16,12,35,"chr11",1,0.233825597749648
"14252","chr11.9200000.9205000","chr11.9310000.9315000",110000,20,1.727155e-05,9200000,9310000,9205000,9315000,"chr11",439721,2,4,8,14,"chr11",1,0.0328176277543366
"14253","chr11.9755000.9760000","chr11.10320000.10325000",565000,9,0.001279571,9755000,10320000,9760000,10325000,"chr11",439736,0,2,3,5,"chr11",1,0.00527426160337553
"14254","chr11.119760000.119765000","chr11.119800000.119805000",40000,33,2.495727e-06,119760000,119800000,119765000,119805000,"chr11",439742,0,2,2,4,"chr11",1,0.0154711673699015
"14255","chr11.27425000.27430000","chr11.27495000.27500000",70000,24,1.834963e-05,27425000,27495000,27430000,27500000,"chr11",439765,3,15,18,36,"chr11",1,0.10126582278481
"14256","chr11.10930000.10935000","chr11.11805000.11810000",875000,11,9.272362e-07,10930000,11805000,10935000,11810000,"chr11",439766,1,3,6,10,"chr11",1,0.012892639474918
"14257","chr11.8730000.8735000","chr11.8830000.8835000",100000,21,1.210377e-05,8730000,8830000,8735000,8835000,"chr11",439776,1,4,5,10,"chr11",1,0.0246132208157525
"14258","chr11.65480000.65485000","chr11.65645000.65650000",165000,13,0.006060268,65480000,65645000,65485000,65650000,"chr11",439805,1,9,2,12,"chr11",1,0.0182841068917018
"14259","chr11.64695000.64700000","chr11.65095000.65100000",400000,9,0.007898701,64695000,65095000,64700000,65100000,"chr11",439823,0,2,1,3,"chr11",1,0.00316455696202532
"14260","chr11.46425000.46430000","chr11.46490000.46495000",65000,20,0.003068502,46425000,46490000,46430000,46495000,"chr11",439843,0,1,2,3,"chr11",1,0.0070323488045007
"14261","chr11.117315000.117320000","chr11.117490000.117495000",175000,13,0.004289421,117315000,117490000,117320000,117495000,"chr11",439882,2,6,2,10,"chr11",1,0.0152367557430849
"14262","chr11.118065000.118070000","chr11.118355000.118360000",290000,20,2.963426e-10,118065000,118355000,118070000,118360000,"chr11",439937,5,13,4,22,"chr11",1,0.0515705578996718
"14263","chr11.83245000.83250000","chr11.83305000.83310000",60000,23,0.0003939866,83245000,83305000,83250000,83310000,"chr11",439938,4,8,6,18,"chr11",1,0.0485232067510548
"14264","chr11.121380000.121385000","chr11.121425000.121430000",45000,23,0.007192356,121380000,121425000,121385000,121430000,"chr11",439941,3,4,1,8,"chr11",1,0.0215658696671355
"14265","chr11.7120000.7125000","chr11.7585000.7590000",465000,16,7.216637e-09,7120000,7585000,7125000,7590000,"chr11",439977,0,2,1,3,"chr11",1,0.00562587904360056
"14266","chr11.121195000.121200000","chr11.121435000.121440000",240000,17,8.521639e-07,121195000,121435000,121200000,121440000,"chr11",439982,0,0,1,1,"chr11",1,0.00199249882794187
"14267","chr11.46425000.46430000","chr11.46550000.46555000",125000,15,0.003134986,46425000,46550000,46430000,46555000,"chr11",439989,0,6,6,12,"chr11",1,0.0210970464135021
"14268","chr11.63600000.63605000","chr11.63930000.63935000",330000,10,0.004832243,63600000,63930000,63605000,63935000,"chr11",439992,4,15,22,41,"chr11",1,0.0480543834974215
"14269","chr11.63545000.63550000","chr11.63590000.63595000",45000,27,0.0002168683,63545000,63590000,63550000,63595000,"chr11",439999,3,8,2,13,"chr11",1,0.0411392405063291
"14270","chr11.47400000.47405000","chr11.47425000.47430000",25000,35,0.002175798,47400000,47425000,47405000,47430000,"chr11",440003,7,12,9,28,"chr11",1,0.114861697140178
"14271","chr11.125310000.125315000","chr11.125440000.125445000",130000,14,0.007397049,125310000,125440000,125315000,125445000,"chr11",440065,0,5,4,9,"chr11",1,0.0147679324894515
"14272","chr11.47515000.47520000","chr11.47550000.47555000",35000,30,0.0004391258,47515000,47550000,47520000,47555000,"chr11",440085,2,17,9,28,"chr11",1,0.0984528832630098
"14273","chr11.62500000.62505000","chr11.62610000.62615000",110000,22,1.046613e-06,62500000,62610000,62505000,62615000,"chr11",440086,2,3,2,7,"chr11",1,0.0180496952648851
"14274","chr11.47985000.47990000","chr11.48095000.48100000",110000,18,0.0002301419,47985000,48095000,47990000,48100000,"chr11",440101,1,5,5,11,"chr11",1,0.0232067510548523
"14275","chr11.65490000.65495000","chr11.65520000.65525000",30000,29,0.008756408,65490000,65520000,65495000,65525000,"chr11",440148,1,9,2,12,"chr11",1,0.0407876230661041
"14276","chr11.11990000.11995000","chr11.12065000.12070000",75000,18,0.005637993,11990000,12065000,11995000,12070000,"chr11",440158,2,1,2,5,"chr11",1,0.0105485232067511
"14277","chr11.75560000.75565000","chr11.75590000.75595000",30000,29,0.008756408,75560000,75590000,75565000,75595000,"chr11",440194,0,1,1,2,"chr11",1,0.00679793717768401
"14278","chr11.117365000.117370000","chr11.117660000.117665000",295000,13,0.0001083754,117365000,117660000,117370000,117665000,"chr11",440199,0,2,0,2,"chr11",1,0.00304735114861697
"14279","chr11.47530000.47535000","chr11.47550000.47555000",20000,39,0.0007739803,47530000,47550000,47535000,47555000,"chr11",440204,2,17,9,28,"chr11",1,0.127988748241913
"14280","chr11.46275000.46280000","chr11.46305000.46310000",30000,39,1.877398e-06,46275000,46305000,46280000,46310000,"chr11",440218,0,2,1,3,"chr11",1,0.0137130801687764
"14281","chr11.95760000.95765000","chr11.96045000.96050000",285000,10,0.009894893,95760000,96045000,95765000,96050000,"chr11",440278,1,1,1,3,"chr11",1,0.00351617440225035
"14282","chr11.70295000.70300000","chr11.70800000.70805000",505000,9,0.002442518,70295000,70800000,70300000,70805000,"chr11",440287,3,0,3,6,"chr11",1,0.00632911392405063
"14283","chr11.122980000.122985000","chr11.123100000.123105000",120000,17,0.0004018914,122980000,123100000,122985000,123105000,"chr11",440307,3,6,11,20,"chr11",1,0.0398499765588373
"14284","chr11.118635000.118640000","chr11.118655000.118660000",20000,42,7.950065e-05,118635000,118655000,118640000,118660000,"chr11",440316,0,1,1,2,"chr11",1,0.00984528832630099
"14285","chr11.110100000.110105000","chr11.110145000.110150000",45000,24,0.003204564,110100000,110145000,110105000,110150000,"chr11",440328,0,0,4,4,"chr11",1,0.0112517580872011
"14286","chr11.36100000.36105000","chr11.36145000.36150000",45000,23,0.007192356,36100000,36145000,36105000,36150000,"chr11",440329,1,3,9,13,"chr11",1,0.0350445382090952
"14287","chr11.11650000.11655000","chr11.11805000.11810000",155000,13,0.008607758,11650000,11805000,11655000,11810000,"chr11",440335,4,3,6,13,"chr11",1,0.0198077824660103
"14288","chr11.121200000.121205000","chr11.121315000.121320000",115000,23,1.414133e-07,121200000,121315000,121205000,121320000,"chr11",440468,1,6,2,9,"chr11",1,0.0242616033755274
"14289","chr11.46540000.46545000","chr11.46645000.46650000",105000,17,0.001084652,46540000,46645000,46545000,46650000,"chr11",440483,0,3,1,4,"chr11",1,0.00796999531176746
"14290","chr11.62105000.62110000","chr11.62440000.62445000",335000,10,0.004503137,62105000,62440000,62110000,62445000,"chr11",440496,4,17,11,32,"chr11",1,0.0375058602906704
"14291","chr11.110075000.110080000","chr11.110145000.110150000",70000,34,1.430405e-11,110075000,110145000,110080000,110150000,"chr11",440498,0,0,2,2,"chr11",1,0.00796999531176746
"14292","chr11.65470000.65475000","chr11.65585000.65590000",115000,17,0.0005440263,65470000,65585000,65475000,65590000,"chr11",440509,0,5,2,7,"chr11",1,0.0139474917955931
"14293","chr11.46930000.46935000","chr11.47160000.47165000",230000,12,0.002625012,46930000,47160000,46935000,47165000,"chr11",440513,2,4,5,11,"chr11",1,0.0154711673699015
"14294","chr11.62545000.62550000","chr11.62595000.62600000",50000,26,0.0001688891,62545000,62595000,62550000,62600000,"chr11",440532,0,0,2,2,"chr11",1,0.00609470229723394
"14295","chr11.62495000.62500000","chr11.62540000.62545000",45000,25,0.001354609,62495000,62540000,62500000,62545000,"chr11",440541,1,1,0,2,"chr11",1,0.00586029067041725
"14296","chr11.61625000.61630000","chr11.61840000.61845000",215000,15,6.368419e-05,61625000,61840000,61630000,61845000,"chr11",440546,0,5,7,12,"chr11",1,0.0210970464135021
"14297","chr11.118060000.118065000","chr11.118220000.118225000",160000,21,9.374725e-08,118060000,118220000,118065000,118225000,"chr11",440676,2,1,3,6,"chr11",1,0.0147679324894515
"14298","chr11.34620000.34625000","chr11.34890000.34895000",270000,12,0.000917774,34620000,34890000,34625000,34895000,"chr11",440695,0,1,0,1,"chr11",1,0.00140646976090014
"14299","chr11.83550000.83555000","chr11.83735000.83740000",185000,16,5.398544e-05,83550000,83735000,83555000,83740000,"chr11",440702,0,1,1,2,"chr11",1,0.00375058602906704
"14300","chr11.116710000.116715000","chr11.117045000.117050000",335000,14,7.629269e-06,116710000,117045000,116715000,117050000,"chr11",440739,0,6,3,9,"chr11",1,0.0147679324894515
"14301","chr11.11990000.11995000","chr11.12040000.12045000",50000,22,0.006416007,11990000,12040000,11995000,12045000,"chr11",440760,1,1,0,2,"chr11",1,0.00515705578996718
"14302","chr11.73595000.73600000","chr11.73855000.73860000",260000,11,0.004516084,73595000,73855000,73600000,73860000,"chr11",440810,4,8,18,30,"chr11",1,0.0386779184247539
"14303","chr11.111980000.111985000","chr11.112150000.112155000",170000,24,2.232095e-10,111980000,112150000,111985000,112155000,"chr11",440818,0,5,10,15,"chr11",1,0.0421940928270042
"14304","chr11.45980000.45985000","chr11.46025000.46030000",45000,23,0.007192356,45980000,46025000,45985000,46030000,"chr11",440827,0,6,1,7,"chr11",1,0.0188701359587436
"14305","chr11.66265000.66270000","chr11.66415000.66420000",150000,14,0.003390837,66265000,66415000,66270000,66420000,"chr11",440856,1,2,1,4,"chr11",1,0.00656352555086732
"14306","chr11.45915000.45920000","chr11.46025000.46030000",110000,22,1.046613e-06,45915000,46025000,45920000,46030000,"chr11",440879,0,4,1,5,"chr11",1,0.012892639474918
"14307","chr11.61600000.61605000","chr11.61850000.61855000",250000,16,3.1353e-06,61600000,61850000,61605000,61855000,"chr11",440896,0,7,8,15,"chr11",1,0.0281293952180028
"14308","chr11.46025000.46030000","chr11.46120000.46125000",95000,19,0.0002530364,46025000,46120000,46030000,46125000,"chr11",440958,0,1,1,2,"chr11",1,0.00445382090951711
"14309","chr11.36170000.36175000","chr11.36275000.36280000",105000,22,1.760541e-06,36170000,36275000,36175000,36280000,"chr11",441032,0,3,0,3,"chr11",1,0.00773558368495077
"14310","chr11.47255000.47260000","chr11.47370000.47375000",115000,20,1.125993e-05,47255000,47370000,47260000,47375000,"chr11",441049,2,20,10,32,"chr11",1,0.0750117205813408
"14311","chr11.46490000.46495000","chr11.46610000.46615000",120000,21,1.774998e-06,46490000,46610000,46495000,46615000,"chr11",441052,0,1,2,3,"chr11",1,0.00738396624472574
"14312","chr11.46975000.46980000","chr11.47000000.47005000",25000,33,0.008119404,46975000,4.7e+07,46980000,47005000,"chr11",441067,4,8,0,12,"chr11",1,0.0464135021097046
"14313","chr11.7120000.7125000","chr11.8005000.8010000",885000,7,0.003610923,7120000,8005000,7125000,8010000,"chr11",441177,0,2,1,3,"chr11",1,0.00246132208157525
"14314","chr11.86660000.86665000","chr11.86745000.86750000",85000,18,0.002082171,86660000,86745000,86665000,86750000,"chr11",441230,0,1,1,2,"chr11",1,0.00421940928270042
"14315","chr11.77410000.77415000","chr11.77430000.77435000",20000,50,6.494343e-08,77410000,77430000,77415000,77435000,"chr11",441317,2,8,5,15,"chr11",1,0.0879043600562588
"14316","chr11.113070000.113075000","chr11.113110000.113115000",40000,53,2.985231e-18,113070000,113110000,113075000,113115000,"chr11",441348,0,2,1,3,"chr11",1,0.0186357243319269
"14317","chr11.63610000.63615000","chr11.63735000.63740000",125000,16,0.001007677,63610000,63735000,63615000,63740000,"chr11",441442,7,15,16,38,"chr11",1,0.0712611345522738
"14318","chr11.116740000.116745000","chr11.116900000.116905000",160000,16,0.0001795382,116740000,116900000,116745000,116905000,"chr11",441490,2,3,7,12,"chr11",1,0.0225035161744023
"14319","chr11.590000.595000","chr11.710000.715000",120000,19,2.986887e-05,590000,710000,595000,715000,"chr11",441560,7,16,25,48,"chr11",1,0.106891701828411
"14320","chr11.47575000.47580000","chr11.47595000.47600000",20000,58,1.298602e-11,47575000,47595000,47580000,47600000,"chr11",441609,2,5,10,17,"chr11",1,0.115564932020628
"14321","chr11.75525000.75530000","chr11.75560000.75565000",35000,28,0.002286979,75525000,75560000,75530000,75565000,"chr11",441631,0,1,1,2,"chr11",1,0.00656352555086732
"14322","chr11.10970000.10975000","chr11.11805000.11810000",835000,15,7.121843e-11,10970000,11805000,10975000,11810000,"chr11",441691,0,2,0,2,"chr11",1,0.00351617440225035
"14323","chr11.7600000.7605000","chr11.7670000.7675000",70000,23,5.939981e-05,7600000,7670000,7605000,7675000,"chr11",441702,2,2,4,8,"chr11",1,0.0215658696671355
"14324","chr11.6410000.6415000","chr11.6495000.6500000",85000,17,0.005623782,6410000,6495000,6415000,6500000,"chr11",441718,2,8,10,20,"chr11",1,0.0398499765588373
"14325","chr11.117455000.117460000","chr11.117675000.117680000",220000,21,1.661028e-09,117455000,117675000,117460000,117680000,"chr11",441782,0,2,1,3,"chr11",1,0.00738396624472574
"14326","chr11.83570000.83575000","chr11.84140000.84145000",570000,10,0.000213221,83570000,84140000,83575000,84145000,"chr11",441783,0,6,2,8,"chr11",1,0.00937646507266761
"14327","chr11.124800000.124805000","chr11.125465000.125470000",665000,9,0.0004826064,124800000,125465000,124805000,125470000,"chr11",441789,6,12,8,26,"chr11",1,0.0274261603375527
"14328","chr11.122440000.122445000","chr11.122665000.122670000",225000,12,0.003005846,122440000,122665000,122445000,122670000,"chr11",441793,1,5,5,11,"chr11",1,0.0154711673699015
"14329","chr11.40165000.40170000","chr11.40290000.40295000",125000,16,0.001007677,40165000,40290000,40170000,40295000,"chr11",441799,1,1,0,2,"chr11",1,0.00375058602906704
"14330","chr11.75620000.75625000","chr11.75765000.75770000",145000,17,9.942527e-05,75620000,75765000,75625000,75770000,"chr11",441811,0,1,9,10,"chr11",1,0.0199249882794187
"14331","chr11.9685000.9690000","chr11.10320000.10325000",635000,9,0.0006446838,9685000,10320000,9690000,10325000,"chr11",441841,1,2,4,7,"chr11",1,0.00738396624472574
"14332","chr11.11805000.11810000","chr11.12065000.12070000",260000,15,1.165266e-05,11805000,12065000,11810000,12070000,"chr11",441855,3,3,6,12,"chr11",1,0.0210970464135021
"14333","chr11.116740000.116745000","chr11.116875000.116880000",135000,17,0.0001702143,116740000,116875000,116745000,116880000,"chr11",441886,1,3,2,6,"chr11",1,0.0119549929676512
"14334","chr11.10525000.10530000","chr11.10670000.10675000",145000,16,0.0003756276,10525000,10670000,10530000,10675000,"chr11",441888,0,1,2,3,"chr11",1,0.00562587904360056
"14335","chr11.121270000.121275000","chr11.122075000.122080000",805000,7,0.005834459,121270000,122075000,121275000,122080000,"chr11",441910,1,4,1,6,"chr11",1,0.00492264416315049
"14336","chr11.119065000.119070000","chr11.119195000.119200000",130000,21,8.083127e-07,119065000,119195000,119070000,119200000,"chr11",441924,5,11,7,23,"chr11",1,0.0566104078762307
"14337","chr11.47200000.47205000","chr11.47270000.47275000",70000,22,0.0001835664,47200000,47270000,47205000,47275000,"chr11",441954,0,3,2,5,"chr11",1,0.012892639474918
"14338","chr11.62650000.62655000","chr11.62785000.62790000",135000,15,0.002004479,62650000,62785000,62655000,62790000,"chr11",441992,5,24,17,46,"chr11",1,0.0808720112517581
"14339","chr11.13210000.13215000","chr11.13365000.13370000",155000,13,0.008607758,13210000,13365000,13215000,13370000,"chr11",442013,0,2,0,2,"chr11",1,0.00304735114861697
"14340","chr11.65135000.65140000","chr11.65275000.65280000",140000,47,1.483555e-30,65135000,65275000,65140000,65280000,"chr11",442018,1,4,5,10,"chr11",1,0.0550867323019222
"14341","chr11.130310000.130315000","chr11.130710000.130715000",400000,15,2.677539e-07,130310000,130710000,130315000,130715000,"chr11",442036,2,5,3,10,"chr11",1,0.0175808720112518
"14342","chr11.62665000.62670000","chr11.62790000.62795000",125000,24,1.06498e-08,62665000,62790000,62670000,62795000,"chr11",442064,3,4,22,29,"chr11",1,0.0815752461322082
"14343","chr11.6635000.6640000","chr11.6700000.6705000",65000,34,7.114555e-11,6635000,6700000,6640000,6705000,"chr11",442067,5,12,15,32,"chr11",1,0.127519924988279
"14344","chr11.119605000.119610000","chr11.119970000.119975000",365000,12,0.0001337761,119605000,119970000,119610000,119975000,"chr11",442070,4,2,2,8,"chr11",1,0.0112517580872011
"14345","chr11.110075000.110080000","chr11.110215000.110220000",140000,17,0.0001313646,110075000,110215000,110080000,110220000,"chr11",442076,0,2,2,4,"chr11",1,0.00796999531176746
"14346","chr11.64585000.64590000","chr11.65025000.65030000",440000,10,0.00108906,64585000,65025000,64590000,65030000,"chr11",442119,3,14,6,23,"chr11",1,0.0269573370839194
"14347","chr11.9855000.9860000","chr11.10320000.10325000",465000,14,4.858521e-07,9855000,10320000,9860000,10325000,"chr11",442128,0,0,3,3,"chr11",1,0.00492264416315049
"14348","chr11.117365000.117370000","chr11.117620000.117625000",255000,13,0.0003215854,117365000,117620000,117370000,117625000,"chr11",442134,0,3,0,3,"chr11",1,0.00457102672292546
"14349","chr11.62500000.62505000","chr11.62560000.62565000",60000,23,0.0003939866,62500000,62560000,62505000,62565000,"chr11",442145,3,12,4,19,"chr11",1,0.0512189404594468
"14350","chr11.30345000.30350000","chr11.30945000.30950000",600000,9,0.0009093222,30345000,30945000,30350000,30950000,"chr11",442149,0,4,1,5,"chr11",1,0.00527426160337553
"14351","chr11.117535000.117540000","chr11.117665000.117670000",130000,18,5.950879e-05,117535000,117665000,117540000,117670000,"chr11",442156,0,5,1,6,"chr11",1,0.0126582278481013
"14352","chr11.122450000.122455000","chr11.122745000.122750000",295000,11,0.002179846,122450000,122745000,122455000,122750000,"chr11",442183,0,2,1,3,"chr11",1,0.00386779184247539
"14353","chr11.11520000.11525000","chr11.11805000.11810000",285000,12,0.0006446838,11520000,11805000,11525000,11810000,"chr11",442192,0,1,2,3,"chr11",1,0.00421940928270042
"14354","chr11.65115000.65120000","chr11.65275000.65280000",160000,22,1.753446e-08,65115000,65275000,65120000,65280000,"chr11",442203,1,4,2,7,"chr11",1,0.0180496952648851
"14355","chr11.66345000.66350000","chr11.66405000.66410000",60000,27,4.521494e-06,66345000,66405000,66350000,66410000,"chr11",442215,0,6,4,10,"chr11",1,0.0316455696202532
"14356","chr11.117295000.117300000","chr11.117425000.117430000",130000,15,0.00249608,117295000,117425000,117300000,117430000,"chr11",442221,0,3,7,10,"chr11",1,0.0175808720112518
"14357","chr11.110075000.110080000","chr11.110315000.110320000",240000,13,0.0005000665,110075000,110315000,110080000,110320000,"chr11",442294,0,2,2,4,"chr11",1,0.00609470229723394
"14358","chr11.40225000.40230000","chr11.40290000.40295000",65000,27,1.297689e-06,40225000,40290000,40230000,40295000,"chr11",442325,0,1,1,2,"chr11",1,0.00632911392405063
"14359","chr11.62495000.62500000","chr11.62620000.62625000",125000,27,6.403537e-11,62495000,62620000,62500000,62625000,"chr11",442348,3,26,16,45,"chr11",1,0.142405063291139
"14360","chr11.6405000.6410000","chr11.6465000.6470000",60000,21,0.002710311,6405000,6465000,6410000,6470000,"chr11",442349,3,3,6,12,"chr11",1,0.029535864978903
"14361","chr11.113920000.113925000","chr11.114055000.114060000",135000,17,0.0001702143,113920000,114055000,113925000,114060000,"chr11",442353,1,1,2,4,"chr11",1,0.00796999531176746
"14362","chr11.46935000.46940000","chr11.47150000.47155000",215000,16,1.371102e-05,46935000,47150000,46940000,47155000,"chr11",442406,0,9,6,15,"chr11",1,0.0281293952180028
"14363","chr11.130870000.130875000","chr11.131510000.131515000",640000,10,9.482268e-05,130870000,131510000,130875000,131515000,"chr11",442425,1,1,0,2,"chr11",1,0.0023441162681669
"14364","chr11.119085000.119090000","chr11.119205000.119210000",120000,15,0.004027368,119085000,119205000,119090000,119210000,"chr11",442447,0,6,1,7,"chr11",1,0.0123066104078762
"14365","chr11.72090000.72095000","chr11.72140000.72145000",50000,26,0.0001688891,72090000,72140000,72095000,72145000,"chr11",442449,2,3,4,9,"chr11",1,0.0274261603375527
"14366","chr11.9315000.9320000","chr11.9460000.9465000",145000,15,0.001278044,9315000,9460000,9320000,9465000,"chr11",442469,5,22,21,48,"chr11",1,0.0843881856540084
"14367","chr11.66890000.66895000","chr11.66950000.66955000",60000,22,0.001056029,66890000,66950000,66895000,66955000,"chr11",442490,0,18,13,31,"chr11",1,0.0799343647444913
"14368","chr11.72180000.72185000","chr11.72225000.72230000",45000,24,0.003204564,72180000,72225000,72185000,72230000,"chr11",442503,0,2,0,2,"chr11",1,0.00562587904360056
"14369","chr11.47985000.47990000","chr11.48090000.48095000",105000,25,1.994318e-08,47985000,48090000,47990000,48095000,"chr11",442508,0,5,1,6,"chr11",1,0.0175808720112518
"14370","chr11.17405000.17410000","chr11.17515000.17520000",110000,15,0.006750723,17405000,17515000,17410000,17520000,"chr11",442516,0,1,2,3,"chr11",1,0.00527426160337553
"14371","chr11.118995000.119000000","chr11.119080000.119085000",85000,31,3.981968e-11,118995000,119080000,1.19e+08,119085000,"chr11",442543,7,14,6,27,"chr11",1,0.0981012658227848
"14372","chr11.64685000.64690000","chr11.64760000.64765000",75000,22,8.403174e-05,64685000,64760000,64690000,64765000,"chr11",442596,0,1,1,2,"chr11",1,0.00515705578996718
"14373","chr11.111435000.111440000","chr11.111715000.111720000",280000,19,3.454521e-09,111435000,111715000,111440000,111720000,"chr11",442677,0,4,2,6,"chr11",1,0.0133614627285513
"14374","chr11.72470000.72475000","chr11.72520000.72525000",50000,27,5.956403e-05,72470000,72520000,72475000,72525000,"chr11",442703,1,6,2,9,"chr11",1,0.0284810126582278
"14375","chr11.36155000.36160000","chr11.36290000.36295000",135000,14,0.006073743,36155000,36290000,36160000,36295000,"chr11",442716,2,6,2,10,"chr11",1,0.0164088138771683
"14376","chr11.65490000.65495000","chr11.65605000.65610000",115000,22,6.354353e-07,65490000,65605000,65495000,65610000,"chr11",442747,0,2,2,4,"chr11",1,0.0103141115799344
"14377","chr11.66345000.66350000","chr11.66385000.66390000",40000,29,0.0001484255,66345000,66385000,66350000,66390000,"chr11",442756,0,6,5,11,"chr11",1,0.0373886544772621
"14378","chr11.3860000.3865000","chr11.4095000.4100000",235000,17,1.070746e-06,3860000,4095000,3865000,4100000,"chr11",442776,4,6,5,15,"chr11",1,0.029887482419128
"14379","chr11.118080000.118085000","chr11.118240000.118245000",160000,22,1.753446e-08,118080000,118240000,118085000,118245000,"chr11",442809,0,1,0,1,"chr11",1,0.00257852789498359
"14380","chr11.46650000.46655000","chr11.46680000.46685000",30000,30,0.004387639,46650000,46680000,46655000,46685000,"chr11",442810,1,6,6,13,"chr11",1,0.0457102672292546
"14381","chr11.34630000.34635000","chr11.34890000.34895000",260000,14,5.884328e-05,34630000,34890000,34635000,34895000,"chr11",442834,0,1,0,1,"chr11",1,0.00164088138771683
"14382","chr11.116875000.116880000","chr11.116970000.116975000",95000,26,1.760026e-08,116875000,116970000,116880000,116975000,"chr11",442851,1,3,2,6,"chr11",1,0.0182841068917018
"14383","chr11.6405000.6410000","chr11.6435000.6440000",30000,30,0.004387639,6405000,6435000,6410000,6440000,"chr11",442882,3,8,8,19,"chr11",1,0.0668073136427567
"14384","chr11.119090000.119095000","chr11.119175000.119180000",85000,17,0.005623782,119090000,119175000,119095000,119180000,"chr11",442885,0,3,1,4,"chr11",1,0.00796999531176746
"14385","chr11.35980000.35985000","chr11.36085000.36090000",105000,16,0.003252287,35980000,36085000,35985000,36090000,"chr11",442926,3,9,8,20,"chr11",1,0.0375058602906704
"14386","chr11.65475000.65480000","chr11.65590000.65595000",115000,20,1.125993e-05,65475000,65590000,65480000,65595000,"chr11",442928,1,8,6,15,"chr11",1,0.0351617440225035
"14387","chr11.46885000.46890000","chr11.46975000.46980000",90000,18,0.00126728,46885000,46975000,46890000,46980000,"chr11",442950,5,15,4,24,"chr11",1,0.0506329113924051
"14388","chr11.117560000.117565000","chr11.117670000.117675000",110000,15,0.006750723,117560000,117670000,117565000,117675000,"chr11",442958,0,1,5,6,"chr11",1,0.0105485232067511
"14389","chr11.117315000.117320000","chr11.117620000.117625000",305000,14,1.60443e-05,117315000,117620000,117320000,117625000,"chr11",443016,0,3,0,3,"chr11",1,0.00492264416315049
"14390","chr11.64585000.64590000","chr11.64760000.64765000",175000,14,0.00126728,64585000,64760000,64590000,64765000,"chr11",443021,0,5,1,6,"chr11",1,0.00984528832630099
"14391","chr11.62390000.62395000","chr11.62470000.62475000",80000,18,0.003390837,62390000,62470000,62395000,62475000,"chr11",443022,3,6,4,13,"chr11",1,0.0274261603375527
"14392","chr11.17410000.17415000","chr11.17515000.17520000",105000,16,0.003252287,17410000,17515000,17415000,17520000,"chr11",443027,0,1,2,3,"chr11",1,0.00562587904360056
"14393","chr11.36340000.36345000","chr11.36395000.36400000",55000,21,0.006262805,36340000,36395000,36345000,36400000,"chr11",443031,4,9,7,20,"chr11",1,0.0492264416315049
"14394","chr11.102275000.102280000","chr11.102365000.102370000",90000,16,0.009624967,102275000,102365000,102280000,102370000,"chr11",443072,3,4,11,18,"chr11",1,0.0337552742616034
"14395","chr11.75590000.75595000","chr11.75850000.75855000",260000,11,0.004516084,75590000,75850000,75595000,75855000,"chr11",443084,0,2,1,3,"chr11",1,0.00386779184247539
"14396","chr11.62170000.62175000","chr11.62265000.62270000",95000,27,3.679822e-09,62170000,62265000,62175000,62270000,"chr11",443088,0,6,4,10,"chr11",1,0.0316455696202532
"14397","chr11.113880000.113885000","chr11.114175000.114180000",295000,10,0.008351826,113880000,114175000,113885000,114180000,"chr11",443108,2,17,20,39,"chr11",1,0.0457102672292546
"14398","chr11.10895000.10900000","chr11.11850000.11855000",955000,7,0.002286979,10895000,11850000,10900000,11855000,"chr11",443117,0,0,2,2,"chr11",1,0.00164088138771683
"14399","chr11.46490000.46495000","chr11.46615000.46620000",125000,14,0.00910339,46490000,46615000,46495000,46620000,"chr11",443119,0,1,2,3,"chr11",1,0.00492264416315049
"14400","chr11.122505000.122510000","chr11.122625000.122630000",120000,18,0.0001128133,122505000,122625000,122510000,122630000,"chr11",443192,2,16,6,24,"chr11",1,0.0506329113924051
"14401","chr11.72180000.72185000","chr11.72200000.72205000",20000,37,0.00299301,72180000,72200000,72185000,72205000,"chr11",443216,3,11,13,27,"chr11",1,0.117088607594937
"14402","chr11.64685000.64690000","chr11.64860000.64865000",175000,16,8.595666e-05,64685000,64860000,64690000,64865000,"chr11",443225,2,1,1,4,"chr11",1,0.00750117205813408
"14403","chr11.46900000.46905000","chr11.47160000.47165000",260000,24,2.803811e-13,46900000,47160000,46905000,47165000,"chr11",443294,1,4,5,10,"chr11",1,0.0281293952180028
"14404","chr11.110075000.110080000","chr11.110295000.110300000",220000,13,0.0009431827,110075000,110295000,110080000,110300000,"chr11",443314,0,2,2,4,"chr11",1,0.00609470229723394
"14405","chr11.46910000.46915000","chr11.47160000.47165000",250000,13,0.0003756276,46910000,47160000,46915000,47165000,"chr11",443327,2,4,5,11,"chr11",1,0.0167604313173933
"14406","chr11.129860000.129865000","chr11.129950000.129955000",90000,17,0.003610923,129860000,129950000,129865000,129955000,"chr11",443338,0,7,7,14,"chr11",1,0.0278949835911861
"14407","chr11.12110000.12115000","chr11.12285000.12290000",175000,13,0.004289421,12110000,12285000,12115000,12290000,"chr11",443362,3,2,2,7,"chr11",1,0.0106657290201594
"14408","chr11.120390000.120395000","chr11.120545000.120550000",155000,20,6.66283e-07,120390000,120545000,120395000,120550000,"chr11",443399,0,1,1,2,"chr11",1,0.0046882325363338
"14409","chr11.85665000.85670000","chr11.85685000.85690000",20000,50,6.494343e-08,85665000,85685000,85670000,85690000,"chr11",443401,3,9,8,20,"chr11",1,0.117205813408345
"14410","chr11.117595000.117600000","chr11.117635000.117640000",40000,26,0.002147236,117595000,117635000,117600000,117640000,"chr11",443404,0,2,1,3,"chr11",1,0.00914205344585091
"14411","chr11.122505000.122510000","chr11.122630000.122635000",125000,18,8.05065e-05,122505000,122630000,122510000,122635000,"chr11",443415,6,20,6,32,"chr11",1,0.0675105485232067
"14412","chr11.35850000.35855000","chr11.36145000.36150000",295000,11,0.002179846,35850000,36145000,35855000,36150000,"chr11",443422,2,5,8,15,"chr11",1,0.0193389592123769
"14413","chr11.107440000.107445000","chr11.107565000.107570000",125000,16,0.001007677,107440000,107565000,107445000,107570000,"chr11",443479,3,4,5,12,"chr11",1,0.0225035161744023
"14414","chr11.112300000.112305000","chr11.112360000.112365000",60000,22,0.001056029,112300000,112360000,112305000,112365000,"chr11",443483,0,5,3,8,"chr11",1,0.0206282231598687
"14415","chr11.36040000.36045000","chr11.36495000.36500000",455000,9,0.004263791,36040000,36495000,36045000,36500000,"chr11",443497,1,3,1,5,"chr11",1,0.00527426160337553
"14416","chr11.44745000.44750000","chr11.44910000.44915000",165000,13,0.006060268,44745000,44910000,44750000,44915000,"chr11",443499,2,7,5,14,"chr11",1,0.0213314580403188
"14417","chr11.78000000.78005000","chr11.78140000.78145000",140000,17,0.0001313646,7.8e+07,78140000,78005000,78145000,"chr11",443515,7,24,23,54,"chr11",1,0.107594936708861
"14418","chr11.130315000.130320000","chr11.130710000.130715000",395000,17,4.960268e-09,130315000,130710000,130320000,130715000,"chr11",443519,2,5,3,10,"chr11",1,0.0199249882794187
"14419","chr11.47515000.47520000","chr11.47570000.47575000",55000,22,0.002648393,47515000,47570000,47520000,47575000,"chr11",443520,2,5,1,8,"chr11",1,0.0206282231598687
"14420","chr11.65040000.65045000","chr11.65295000.65300000",255000,11,0.005044969,65040000,65295000,65045000,65300000,"chr11",443532,2,7,5,14,"chr11",1,0.0180496952648851
"14421","chr11.113110000.113115000","chr11.113135000.113140000",25000,38,0.0002343275,113110000,113135000,113115000,113140000,"chr11",443539,0,2,1,3,"chr11",1,0.0133614627285513
"14422","chr11.119340000.119345000","chr11.119970000.119975000",630000,8,0.003694031,119340000,119970000,119345000,119975000,"chr11",443546,3,0,2,5,"chr11",1,0.0046882325363338
"14423","chr11.61625000.61630000","chr11.61825000.61830000",200000,14,0.0004860211,61625000,61825000,61630000,61830000,"chr11",443551,0,5,6,11,"chr11",1,0.0180496952648851
"14424","chr11.121490000.121495000","chr11.122110000.122115000",620000,9,0.0007488935,121490000,122110000,121495000,122115000,"chr11",443595,5,11,13,29,"chr11",1,0.0305907172995781
"14425","chr11.117535000.117540000","chr11.117595000.117600000",60000,21,0.002710311,117535000,117595000,117540000,117600000,"chr11",443615,0,2,1,3,"chr11",1,0.00738396624472574
"14426","chr11.6565000.6570000","chr11.6605000.6610000",40000,26,0.002147236,6565000,6605000,6570000,6610000,"chr11",443639,0,0,1,1,"chr11",1,0.00304735114861697
"14427","chr11.46845000.46850000","chr11.47180000.47185000",335000,14,7.629269e-06,46845000,47180000,46850000,47185000,"chr11",443643,4,12,8,24,"chr11",1,0.0393811533052039
"14428","chr11.117365000.117370000","chr11.117490000.117495000",125000,20,5.147408e-06,117365000,117490000,117370000,117495000,"chr11",443664,1,3,1,5,"chr11",1,0.0117205813408345
"14429","chr11.117535000.117540000","chr11.117590000.117595000",55000,24,0.0004039018,117535000,117590000,117540000,117595000,"chr11",443724,0,3,1,4,"chr11",1,0.0112517580872011
"14430","chr11.66070000.66075000","chr11.66605000.66610000",535000,8,0.00838713,66070000,66605000,66075000,66610000,"chr11",443738,2,1,3,6,"chr11",1,0.00562587904360056
"14431","chr11.85685000.85690000","chr11.85945000.85950000",260000,12,0.001165298,85685000,85945000,85690000,85950000,"chr11",443753,2,0,2,4,"chr11",1,0.00562587904360056
"14432","chr11.45995000.46000000","chr11.46025000.46030000",30000,33,0.0004447369,45995000,46025000,4.6e+07,46030000,"chr11",443773,0,6,1,7,"chr11",1,0.0270745428973277
"14433","chr11.34620000.34625000","chr11.34935000.34940000",315000,10,0.006050748,34620000,34935000,34625000,34940000,"chr11",443792,0,2,1,3,"chr11",1,0.00351617440225035
"14434","chr11.116895000.116900000","chr11.116920000.116925000",25000,33,0.008119404,116895000,116920000,116900000,116925000,"chr11",443800,0,4,2,6,"chr11",1,0.0232067510548523
"14435","chr11.64695000.64700000","chr11.64890000.64895000",195000,12,0.007192356,64695000,64890000,64700000,64895000,"chr11",443805,0,2,1,3,"chr11",1,0.00421940928270042
"14436","chr11.122505000.122510000","chr11.122665000.122670000",160000,17,4.457719e-05,122505000,122665000,122510000,122670000,"chr11",443808,3,8,6,17,"chr11",1,0.0338724800750117
"14437","chr11.116865000.116870000","chr11.116965000.116970000",100000,20,4.457719e-05,116865000,116965000,116870000,116970000,"chr11",443810,0,2,2,4,"chr11",1,0.00937646507266761
"14438","chr11.62545000.62550000","chr11.62645000.62650000",100000,16,0.004591244,62545000,62645000,62550000,62650000,"chr11",443826,0,0,3,3,"chr11",1,0.00562587904360056
"14439","chr11.46975000.46980000","chr11.47155000.47160000",180000,22,3.927881e-09,46975000,47155000,46980000,47160000,"chr11",443844,2,5,1,8,"chr11",1,0.0206282231598687
"14440","chr11.83020000.83025000","chr11.83405000.83410000",385000,10,0.002286979,83020000,83405000,83025000,83410000,"chr11",443905,2,1,2,5,"chr11",1,0.00586029067041725
"14441","chr11.34935000.34940000","chr11.35425000.35430000",490000,9,0.002886368,34935000,35425000,34940000,35430000,"chr11",443914,0,2,2,4,"chr11",1,0.00421940928270042
"14442","chr11.117620000.117625000","chr11.117670000.117675000",50000,23,0.002788217,117620000,117670000,117625000,117675000,"chr11",443959,0,1,0,1,"chr11",1,0.00269573370839194
"14443","chr11.46645000.46650000","chr11.46680000.46685000",35000,29,0.001027929,46645000,46680000,46650000,46685000,"chr11",443968,1,6,6,13,"chr11",1,0.0441865916549461
"14444","chr11.118055000.118060000","chr11.118220000.118225000",165000,31,3.232838e-16,118055000,118220000,118060000,118225000,"chr11",443981,0,1,3,4,"chr11",1,0.0145335208626348
"14445","chr11.57510000.57515000","chr11.57565000.57570000",55000,44,5.958263e-16,57510000,57565000,57515000,57570000,"chr11",444014,3,1,2,6,"chr11",1,0.0309423347398031
"14446","chr11.47280000.47285000","chr11.47450000.47455000",170000,13,0.005092878,47280000,47450000,47285000,47455000,"chr11",444034,10,27,17,54,"chr11",1,0.0822784810126582
"14447","chr11.109995000.110000000","chr11.110020000.110025000",25000,50,2.91392e-09,109995000,110020000,1.1e+08,110025000,"chr11",444057,3,13,11,27,"chr11",1,0.158227848101266
"14448","chr11.119065000.119070000","chr11.119085000.119090000",20000,41,0.0001746852,119065000,119085000,119070000,119090000,"chr11",444084,3,11,7,21,"chr11",1,0.100914205344585
"14449","chr11.118485000.118490000","chr11.118870000.118875000",385000,9,0.009387803,118485000,118870000,118490000,118875000,"chr11",444088,2,5,6,13,"chr11",1,0.0137130801687764
"14450","chr11.110175000.110180000","chr11.110200000.110205000",25000,35,0.002175798,110175000,110200000,110180000,110205000,"chr11",444107,2,12,0,14,"chr11",1,0.0574308485700891
"14451","chr11.62410000.62415000","chr11.62620000.62625000",210000,13,0.001292185,62410000,62620000,62415000,62625000,"chr11",444145,4,16,10,30,"chr11",1,0.0457102672292546
"14452","chr11.131510000.131515000","chr11.131980000.131985000",470000,11,0.0001364084,131510000,131980000,131515000,131985000,"chr11",444148,0,3,3,6,"chr11",1,0.00773558368495077
"14453","chr11.65025000.65030000","chr11.65095000.65100000",70000,43,2.583251e-18,65025000,65095000,65030000,65100000,"chr11",444172,13,16,26,55,"chr11",1,0.277191748710736
"14454","chr11.9200000.9205000","chr11.9220000.9225000",20000,57,4.010108e-11,9200000,9220000,9205000,9225000,"chr11",444247,3,5,8,16,"chr11",1,0.106891701828411
"14455","chr11.118065000.118070000","chr11.118220000.118225000",155000,79,3.10775e-71,118065000,118220000,118070000,118225000,"chr11",444299,2,1,3,6,"chr11",1,0.0555555555555556
"14456","chr11.85755000.85760000","chr11.85805000.85810000",50000,30,2.1624e-06,85755000,85805000,85760000,85810000,"chr11",444329,0,1,1,2,"chr11",1,0.0070323488045007
"14457","chr11.95565000.95570000","chr11.96105000.96110000",540000,8,0.0080193,95565000,96105000,95570000,96110000,"chr11",444348,2,1,1,4,"chr11",1,0.00375058602906704
"14458","chr11.63580000.63585000","chr11.63600000.63605000",20000,45,6.594591e-06,63580000,63600000,63585000,63605000,"chr11",444374,2,12,8,22,"chr11",1,0.116033755274262
"14459","chr11.65315000.65320000","chr11.65610000.65615000",295000,10,0.008351826,65315000,65610000,65320000,65615000,"chr11",444388,0,2,0,2,"chr11",1,0.0023441162681669
"14460","chr11.119605000.119610000","chr11.119875000.119880000",270000,11,0.003615715,119605000,119875000,119610000,119880000,"chr11",444394,0,2,1,3,"chr11",1,0.00386779184247539
"14461","chr11.72665000.72670000","chr11.72775000.72780000",110000,18,0.0002301419,72665000,72775000,72670000,72780000,"chr11",444425,0,3,3,6,"chr11",1,0.0126582278481013
"14462","chr11.26305000.26310000","chr11.27180000.27185000",875000,11,9.272362e-07,26305000,27180000,26310000,27185000,"chr11",444429,0,9,4,13,"chr11",1,0.0167604313173933
"14463","chr11.83550000.83555000","chr11.84090000.84095000",540000,11,4.876661e-05,83550000,84090000,83555000,84095000,"chr11",444454,1,1,1,3,"chr11",1,0.00386779184247539
"14464","chr11.83555000.83560000","chr11.83990000.83995000",435000,10,0.001164174,83555000,83990000,83560000,83995000,"chr11",444523,1,3,2,6,"chr11",1,0.0070323488045007
"14465","chr11.95565000.95570000","chr11.96150000.96155000",585000,8,0.005398946,95565000,96150000,95570000,96155000,"chr11",444540,2,2,1,5,"chr11",1,0.0046882325363338
"14466","chr11.62540000.62545000","chr11.62620000.62625000",80000,30,5.904441e-10,62540000,62620000,62545000,62625000,"chr11",444563,1,1,0,2,"chr11",1,0.0070323488045007
"14467","chr11.64695000.64700000","chr11.64885000.64890000",190000,14,0.0007200501,64695000,64885000,64700000,64890000,"chr11",444572,0,2,1,3,"chr11",1,0.00492264416315049
"14468","chr11.118870000.118875000","chr11.119175000.119180000",305000,14,1.60443e-05,118870000,119175000,118875000,119180000,"chr11",444598,2,5,6,13,"chr11",1,0.0213314580403188
"14469","chr11.118565000.118570000","chr11.118650000.118655000",85000,39,2.657817e-17,118565000,118650000,118570000,118655000,"chr11",444608,1,9,3,13,"chr11",1,0.0594233473980309
"14470","chr11.3840000.3845000","chr11.4095000.4100000",255000,13,0.0003215854,3840000,4095000,3845000,4100000,"chr11",444613,4,14,6,24,"chr11",1,0.0365682137834037
"14471","chr11.75530000.75535000","chr11.75550000.75555000",20000,45,6.594591e-06,75530000,75550000,75535000,75555000,"chr11",444659,2,7,4,13,"chr11",1,0.0685654008438819
"14472","chr11.61445000.61450000","chr11.61495000.61500000",50000,24,0.001138728,61445000,61495000,61450000,61500000,"chr11",444683,0,4,0,4,"chr11",1,0.0112517580872011
"14473","chr11.8715000.8720000","chr11.8840000.8845000",125000,14,0.00910339,8715000,8840000,8720000,8845000,"chr11",444699,0,3,0,3,"chr11",1,0.00492264416315049
"14474","chr11.62500000.62505000","chr11.62570000.62575000",70000,18,0.0098191,62500000,62570000,62505000,62575000,"chr11",444755,0,4,4,8,"chr11",1,0.0168776371308017
"14475","chr11.47000000.47005000","chr11.47180000.47185000",180000,19,6.766065e-07,4.7e+07,47180000,47005000,47185000,"chr11",444768,4,8,0,12,"chr11",1,0.0267229254571027
"14476","chr11.77870000.77875000","chr11.78085000.78090000",215000,14,0.0002782545,77870000,78085000,77875000,78090000,"chr11",444780,3,13,8,24,"chr11",1,0.0393811533052039
"14477","chr11.66345000.66350000","chr11.66435000.66440000",90000,22,1.060914e-05,66345000,66435000,66350000,66440000,"chr11",444792,0,6,5,11,"chr11",1,0.0283638068448195
"14478","chr11.47230000.47235000","chr11.47280000.47285000",50000,23,0.002788217,47230000,47280000,47235000,47285000,"chr11",444805,10,18,16,44,"chr11",1,0.118612283169245
"14479","chr11.117300000.117305000","chr11.117510000.117515000",210000,12,0.004630017,117300000,117510000,117305000,117515000,"chr11",444811,0,3,1,4,"chr11",1,0.00562587904360056
"14480","chr11.64775000.64780000","chr11.64885000.64890000",110000,20,1.727155e-05,64775000,64885000,64780000,64890000,"chr11",444846,0,2,0,2,"chr11",1,0.0046882325363338
"14481","chr11.110100000.110105000","chr11.110215000.110220000",115000,15,0.005171771,110100000,110215000,110105000,110220000,"chr11",444888,3,5,12,20,"chr11",1,0.0351617440225035
"14482","chr11.66345000.66350000","chr11.66430000.66435000",85000,25,3.807625e-07,66345000,66430000,66350000,66435000,"chr11",444893,0,6,5,11,"chr11",1,0.0322315986872949
"14483","chr11.86175000.86180000","chr11.86520000.86525000",345000,13,3.546213e-05,86175000,86520000,86180000,86525000,"chr11",444916,0,2,6,8,"chr11",1,0.0121894045944679
"14484","chr11.117300000.117305000","chr11.117465000.117470000",165000,13,0.006060268,117300000,117465000,117305000,117470000,"chr11",444917,0,2,1,3,"chr11",1,0.00457102672292546
"14485","chr11.77445000.77450000","chr11.78175000.78180000",730000,7,0.009142568,77445000,78175000,77450000,78180000,"chr11",444945,1,4,1,6,"chr11",1,0.00492264416315049
"14486","chr11.117715000.117720000","chr11.117805000.117810000",90000,24,6.9976e-07,117715000,117805000,117720000,117810000,"chr11",444952,0,8,2,10,"chr11",1,0.0281293952180028
"14487","chr11.34260000.34265000","chr11.34315000.34320000",55000,24,0.0004039018,34260000,34315000,34265000,34320000,"chr11",444959,1,6,3,10,"chr11",1,0.0281293952180028
"14488","chr11.118055000.118060000","chr11.118240000.118245000",185000,13,0.003026915,118055000,118240000,118060000,118245000,"chr11",444960,0,1,0,1,"chr11",1,0.00152367557430849
"14489","chr11.1335000.1340000","chr11.1405000.1410000",70000,23,5.939981e-05,1335000,1405000,1340000,1410000,"chr11",444966,0,0,2,2,"chr11",1,0.00539146741678387
"14490","chr11.3855000.3860000","chr11.4095000.4100000",240000,21,4.930494e-10,3855000,4095000,3860000,4100000,"chr11",444977,1,1,4,6,"chr11",1,0.0147679324894515
"14491","chr11.126255000.126260000","chr11.126285000.126290000",30000,33,0.0004447369,126255000,126285000,126260000,126290000,"chr11",445000,5,7,18,30,"chr11",1,0.116033755274262
"14492","chr11.122450000.122455000","chr11.122645000.122650000",195000,21,8.355782e-09,122450000,122645000,122455000,122650000,"chr11",445062,1,3,7,11,"chr11",1,0.0270745428973277
"14493","chr11.48040000.48045000","chr11.48090000.48095000",50000,22,0.006416007,48040000,48090000,48045000,48095000,"chr11",445135,0,5,1,6,"chr11",1,0.0154711673699015
"14494","chr11.131630000.131635000","chr11.131745000.131750000",115000,16,0.001742096,131630000,131745000,131635000,131750000,"chr11",445152,0,0,1,1,"chr11",1,0.00187529301453352
"14495","chr11.73625000.73630000","chr11.73650000.73655000",25000,36,0.001061553,73625000,73650000,73630000,73655000,"chr11",445191,4,6,10,20,"chr11",1,0.0843881856540084
"14496","chr11.64685000.64690000","chr11.65025000.65030000",340000,11,0.0009961185,64685000,65025000,64690000,65030000,"chr11",445193,2,1,1,4,"chr11",1,0.00515705578996718
"14497","chr11.10900000.10905000","chr11.11805000.11810000",905000,9,5.98749e-05,10900000,11805000,10905000,11810000,"chr11",445194,0,3,6,9,"chr11",1,0.00949367088607595
"14498","chr11.47450000.47455000","chr11.47570000.47575000",120000,18,0.0001128133,47450000,47570000,47455000,47575000,"chr11",445219,2,5,1,8,"chr11",1,0.0168776371308017
"14499","chr11.92965000.92970000","chr11.93285000.93290000",320000,12,0.000305306,92965000,93285000,92970000,93290000,"chr11",445226,0,0,1,1,"chr11",1,0.00140646976090014
"14500","chr11.119065000.119070000","chr11.119100000.119105000",35000,27,0.004903844,119065000,119100000,119070000,119105000,"chr11",445239,0,6,4,10,"chr11",1,0.0316455696202532
"14501","chr11.62170000.62175000","chr11.62335000.62340000",165000,22,1.190912e-08,62170000,62335000,62175000,62340000,"chr11",445240,0,7,5,12,"chr11",1,0.0309423347398031
"14502","chr11.36290000.36295000","chr11.36495000.36500000",205000,28,3.192285e-15,36290000,36495000,36295000,36500000,"chr11",445243,2,9,5,16,"chr11",1,0.0525082044069386
"14503","chr11.33900000.33905000","chr11.33995000.34000000",95000,18,0.0008007308,33900000,33995000,33905000,3.4e+07,"chr11",445274,0,3,2,5,"chr11",1,0.0105485232067511
"14504","chr11.131800000.131805000","chr11.131980000.131985000",180000,17,1.56904e-05,131800000,131980000,131805000,131985000,"chr11",445277,0,2,1,3,"chr11",1,0.0059774964838256
"14505","chr11.65040000.65045000","chr11.65095000.65100000",55000,158,7.223261e-139,65040000,65095000,65045000,65100000,"chr11",445288,7,24,23,54,"chr11",1,1
"14506","chr11.45850000.45855000","chr11.45995000.46000000",145000,16,0.0003756276,45850000,45995000,45855000,4.6e+07,"chr11",445295,1,5,1,7,"chr11",1,0.0131270511017346
"14507","chr11.129950000.129955000","chr11.130010000.130015000",60000,23,0.0003939866,129950000,130010000,129955000,130015000,"chr11",445304,4,15,7,26,"chr11",1,0.0700890764181903
"14508","chr11.46695000.46700000","chr11.47180000.47185000",485000,21,3.020628e-14,46695000,47180000,46700000,47185000,"chr11",445322,0,6,4,10,"chr11",1,0.0246132208157525
"14509","chr11.121570000.121575000","chr11.121965000.121970000",395000,14,2.097476e-06,121570000,121965000,121575000,121970000,"chr11",445323,0,2,0,2,"chr11",1,0.00328176277543366
"14510","chr11.20025000.20030000","chr11.20045000.20050000",20000,48,4.383315e-07,20025000,20045000,20030000,20050000,"chr11",445354,0,1,0,1,"chr11",1,0.00562587904360056
"14511","chr11.27425000.27430000","chr11.27485000.27490000",60000,36,2.104824e-11,27425000,27485000,27430000,27490000,"chr11",445410,3,23,16,42,"chr11",1,0.177215189873418
"14512","chr11.36085000.36090000","chr11.36290000.36295000",205000,17,4.426209e-06,36085000,36290000,36090000,36295000,"chr11",445412,2,9,5,16,"chr11",1,0.0318799812470699
"14513","chr11.131225000.131230000","chr11.131510000.131515000",285000,11,0.002660958,131225000,131510000,131230000,131515000,"chr11",445428,2,1,0,3,"chr11",1,0.00386779184247539
"14514","chr11.62670000.62675000","chr11.63505000.63510000",835000,10,1.338265e-05,62670000,63505000,62675000,63510000,"chr11",445500,0,5,3,8,"chr11",1,0.00937646507266761
"14515","chr11.117295000.117300000","chr11.118050000.118055000",755000,7,0.007881103,117295000,118050000,117300000,118055000,"chr11",445504,0,6,7,13,"chr11",1,0.0106657290201594
"14516","chr11.72665000.72670000","chr11.72845000.72850000",180000,16,6.850202e-05,72665000,72845000,72670000,72850000,"chr11",445505,2,3,7,12,"chr11",1,0.0225035161744023
"14517","chr11.65025000.65030000","chr11.65100000.65105000",75000,26,5.51609e-07,65025000,65100000,65030000,65105000,"chr11",445539,5,16,19,40,"chr11",1,0.121894045944679
"14518","chr11.11175000.11180000","chr11.11805000.11810000",630000,9,0.0006769633,11175000,11805000,11180000,11810000,"chr11",445545,1,3,1,5,"chr11",1,0.00527426160337553
"14519","chr11.118935000.118940000","chr11.119205000.119210000",270000,11,0.003615715,118935000,119205000,118940000,119210000,"chr11",445581,0,6,1,7,"chr11",1,0.00902484763244257
"14520","chr11.94800000.94805000","chr11.95790000.95795000",990000,7,0.001761834,94800000,95790000,94805000,95795000,"chr11",445584,2,0,1,3,"chr11",1,0.00246132208157525
"14521","chr11.59545000.59550000","chr11.59565000.59570000",20000,52,8.584672e-09,59545000,59565000,59550000,59570000,"chr11",445602,3,10,12,25,"chr11",1,0.152367557430849
"14522","chr11.19595000.19600000","chr11.19675000.19680000",80000,21,0.0001367635,19595000,19675000,19600000,19680000,"chr11",445622,0,1,0,1,"chr11",1,0.00246132208157525
"14523","chr11.33895000.33900000","chr11.33950000.33955000",55000,21,0.006262805,33895000,33950000,33900000,33955000,"chr11",445639,1,5,5,11,"chr11",1,0.0270745428973277
"14524","chr11.19985000.19990000","chr11.20045000.20050000",60000,22,0.001056029,19985000,20045000,19990000,20050000,"chr11",445665,0,3,0,3,"chr11",1,0.00773558368495077
"14525","chr11.63595000.63600000","chr11.63735000.63740000",140000,15,0.001587814,63595000,63735000,63600000,63740000,"chr11",445674,1,4,6,11,"chr11",1,0.0193389592123769
"14526","chr11.44590000.44595000","chr11.44630000.44635000",40000,31,2.055153e-05,44590000,44630000,44595000,44635000,"chr11",445680,0,5,5,10,"chr11",1,0.036333802156587
"14527","chr11.13690000.13695000","chr11.14270000.14275000",580000,8,0.005637993,13690000,14270000,13695000,14275000,"chr11",445718,1,7,4,12,"chr11",1,0.0112517580872011
"14528","chr11.118995000.119000000","chr11.119065000.119070000",70000,25,5.370125e-06,118995000,119065000,1.19e+08,119070000,"chr11",445722,5,11,7,23,"chr11",1,0.0673933427097984
"14529","chr11.66890000.66895000","chr11.66920000.66925000",30000,41,2.421593e-07,66890000,66920000,66895000,66925000,"chr11",445739,0,20,24,44,"chr11",1,0.211439287388654
"14530","chr11.9745000.9750000","chr11.10365000.10370000",620000,8,0.004027368,9745000,10365000,9750000,10370000,"chr11",445742,0,0,1,1,"chr11",1,0.00093764650726676
"14531","chr11.121530000.121535000","chr11.121965000.121970000",435000,22,1.325434e-14,121530000,121965000,121535000,121970000,"chr11",445745,0,4,1,5,"chr11",1,0.012892639474918
"14532","chr11.7590000.7595000","chr11.7670000.7675000",80000,32,2.463434e-11,7590000,7670000,7595000,7675000,"chr11",445749,0,2,8,10,"chr11",1,0.0375058602906704
"14533","chr11.116840000.116845000","chr11.116965000.116970000",125000,23,5.435998e-08,116840000,116965000,116845000,116970000,"chr11",445805,5,20,20,45,"chr11",1,0.121308016877637
"14534","chr11.45895000.45900000","chr11.46025000.46030000",130000,19,1.51749e-05,45895000,46025000,45900000,46030000,"chr11",445831,0,3,1,4,"chr11",1,0.00890764181903422
"14535","chr11.11975000.11980000","chr11.12040000.12045000",65000,27,1.297689e-06,11975000,12040000,11980000,12045000,"chr11",445833,1,2,0,3,"chr11",1,0.00949367088607595
"14536","chr11.73755000.73760000","chr11.73795000.73800000",40000,29,0.0001484255,73755000,73795000,73760000,73800000,"chr11",445841,5,14,16,35,"chr11",1,0.11896390060947
"14537","chr11.46975000.46980000","chr11.47105000.47110000",130000,15,0.00249608,46975000,47105000,46980000,47110000,"chr11",445842,3,8,4,15,"chr11",1,0.0263713080168776
"14538","chr11.124755000.124760000","chr11.124950000.124955000",195000,12,0.007192356,124755000,124950000,124760000,124955000,"chr11",445848,0,2,1,3,"chr11",1,0.00421940928270042
"14539","chr11.95760000.95765000","chr11.96055000.96060000",295000,13,0.0001083754,95760000,96055000,95765000,96060000,"chr11",445851,0,6,3,9,"chr11",1,0.0137130801687764
"14540","chr11.64865000.64870000","chr11.65025000.65030000",160000,14,0.002286979,64865000,65025000,64870000,65030000,"chr11",445855,1,5,7,13,"chr11",1,0.0213314580403188
"14541","chr11.46105000.46110000","chr11.46275000.46280000",170000,13,0.005092878,46105000,46275000,46110000,46280000,"chr11",445861,0,2,0,2,"chr11",1,0.00304735114861697
"14542","chr11.121315000.121320000","chr11.121435000.121440000",120000,20,7.485708e-06,121315000,121435000,121320000,121440000,"chr11",445900,0,2,1,3,"chr11",1,0.0070323488045007
"14543","chr11.110075000.110080000","chr11.110175000.110180000",100000,21,1.210377e-05,110075000,110175000,110080000,110180000,"chr11",445911,0,2,0,2,"chr11",1,0.00492264416315049
"14544","chr11.9505000.9510000","chr11.10300000.10305000",795000,7,0.006202999,9505000,10300000,9510000,10305000,"chr11",445925,1,7,6,14,"chr11",1,0.0114861697140178
"14545","chr11.47515000.47520000","chr11.47590000.47595000",75000,18,0.005637993,47515000,47590000,47520000,47595000,"chr11",445926,0,4,1,5,"chr11",1,0.0105485232067511
"14546","chr11.112165000.112170000","chr11.113140000.113145000",975000,9,3.09438e-05,112165000,113140000,112170000,113145000,"chr11",445947,0,2,1,3,"chr11",1,0.00316455696202532
"14547","chr11.36310000.36315000","chr11.36500000.36505000",190000,14,0.0007200501,36310000,36500000,36315000,36505000,"chr11",446036,0,2,0,2,"chr11",1,0.00328176277543366
"14548","chr11.121195000.121200000","chr11.122075000.122080000",880000,8,0.0005720536,121195000,122075000,121200000,122080000,"chr11",446046,0,0,3,3,"chr11",1,0.00281293952180028
"14549","chr11.3855000.3860000","chr11.4065000.4070000",210000,13,0.001292185,3855000,4065000,3860000,4070000,"chr11",446117,1,1,4,6,"chr11",1,0.00914205344585091
"14550","chr11.116970000.116975000","chr11.116990000.116995000",20000,55,3.683826e-10,116970000,116990000,116975000,116995000,"chr11",446173,5,9,8,22,"chr11",1,0.141819034224098
"14551","chr11.11970000.11975000","chr11.12050000.12055000",80000,17,0.008774219,11970000,12050000,11975000,12055000,"chr11",446211,2,3,1,6,"chr11",1,0.0119549929676512
"14552","chr11.12690000.12695000","chr11.12815000.12820000",125000,15,0.003134986,12690000,12815000,12695000,12820000,"chr11",446222,0,0,2,2,"chr11",1,0.00351617440225035
"14553","chr11.110145000.110150000","chr11.110170000.110175000",25000,34,0.004277218,110145000,110170000,110150000,110175000,"chr11",446228,0,0,2,2,"chr11",1,0.00796999531176746
"14554","chr11.78000000.78005000","chr11.78135000.78140000",135000,19,1.097871e-05,7.8e+07,78135000,78005000,78140000,"chr11",446232,8,15,14,37,"chr11",1,0.0823956868260666
"14555","chr11.66335000.66340000","chr11.66405000.66410000",70000,32,3.233708e-10,66335000,66405000,66340000,66410000,"chr11",446263,1,4,1,6,"chr11",1,0.0225035161744023
"14556","chr11.61600000.61605000","chr11.61890000.61895000",290000,12,0.0005709472,61600000,61890000,61605000,61895000,"chr11",446278,3,7,8,18,"chr11",1,0.0253164556962025
"14557","chr11.66415000.66420000","chr11.66890000.66895000",475000,10,0.000701693,66415000,66890000,66420000,66895000,"chr11",446338,0,2,1,3,"chr11",1,0.00351617440225035
"14558","chr11.3860000.3865000","chr11.4090000.4095000",230000,24,2.113171e-12,3860000,4090000,3865000,4095000,"chr11",446438,1,5,5,11,"chr11",1,0.0309423347398031
"14559","chr11.126315000.126320000","chr11.127225000.127230000",910000,7,0.003080783,126315000,127225000,126320000,127230000,"chr11",446441,0,4,1,5,"chr11",1,0.00410220346929208
"14560","chr11.61610000.61615000","chr11.62080000.62085000",470000,9,0.003596168,61610000,62080000,61615000,62085000,"chr11",446445,0,6,1,7,"chr11",1,0.00738396624472574
"14561","chr11.124960000.124965000","chr11.125215000.125220000",255000,18,7.261894e-08,124960000,125215000,124965000,125220000,"chr11",446454,1,5,5,11,"chr11",1,0.0232067510548523
"14562","chr11.645000.650000","chr11.760000.765000",115000,15,0.005171771,645000,760000,650000,765000,"chr11",446465,6,12,10,28,"chr11",1,0.0492264416315049
"14563","chr11.47200000.47205000","chr11.47280000.47285000",80000,35,1.603222e-13,47200000,47280000,47205000,47285000,"chr11",446476,10,27,17,54,"chr11",1,0.221518987341772
"14564","chr11.735000.740000","chr11.760000.765000",25000,33,0.008119404,735000,760000,740000,765000,"chr11",446484,7,12,10,29,"chr11",1,0.112165963431786
"14565","chr11.83530000.83535000","chr11.84090000.84095000",560000,9,0.001348356,83530000,84090000,83535000,84095000,"chr11",446531,0,3,2,5,"chr11",1,0.00527426160337553
"14566","chr11.77870000.77875000","chr11.78060000.78065000",190000,12,0.00838713,77870000,78060000,77875000,78065000,"chr11",446546,4,11,8,23,"chr11",1,0.0323488045007032
"14567","chr11.121195000.121200000","chr11.121445000.121450000",250000,16,3.1353e-06,121195000,121445000,121200000,121450000,"chr11",446550,0,0,2,2,"chr11",1,0.00375058602906704
"14568","chr11.83550000.83555000","chr11.84020000.84025000",470000,9,0.003596168,83550000,84020000,83555000,84025000,"chr11",446574,0,1,1,2,"chr11",1,0.00210970464135021
"14569","chr11.46610000.46615000","chr11.46845000.46850000",235000,11,0.008057482,46610000,46845000,46615000,46850000,"chr11",446622,6,14,17,37,"chr11",1,0.0477027660571964
"14570","chr11.75620000.75625000","chr11.75965000.75970000",345000,10,0.003925567,75620000,75965000,75625000,75970000,"chr11",446680,0,0,2,2,"chr11",1,0.0023441162681669
"14571","chr11.121530000.121535000","chr11.121935000.121940000",405000,19,4.604851e-11,121530000,121935000,121535000,121940000,"chr11",446682,0,2,1,3,"chr11",1,0.00668073136427567
"14572","chr11.62560000.62565000","chr11.62595000.62600000",35000,29,0.001027929,62560000,62595000,62565000,62600000,"chr11",446753,0,0,2,2,"chr11",1,0.00679793717768401
"14573","chr11.114260000.114265000","chr11.114280000.114285000",20000,37,0.00299301,114260000,114280000,114265000,114285000,"chr11",446758,1,1,2,4,"chr11",1,0.0173464603844351
"14574","chr11.64920000.64925000","chr11.65010000.65015000",90000,20,0.0001316662,64920000,65010000,64925000,65015000,"chr11",446763,7,16,22,45,"chr11",1,0.105485232067511
"14575","chr11.65830000.65835000","chr11.66020000.66025000",190000,14,0.0007200501,65830000,66020000,65835000,66025000,"chr11",446793,1,8,3,12,"chr11",1,0.019690576652602
"14576","chr11.77820000.77825000","chr11.78140000.78145000",320000,12,0.000305306,77820000,78140000,77825000,78145000,"chr11",446826,4,7,20,31,"chr11",1,0.0436005625879044
"14577","chr11.62390000.62395000","chr11.62595000.62600000",205000,14,0.0004041451,62390000,62595000,62395000,62600000,"chr11",446832,0,0,2,2,"chr11",1,0.00328176277543366
"14578","chr11.1300000.1305000","chr11.1540000.1545000",240000,13,0.0005000665,1300000,1540000,1305000,1545000,"chr11",446860,0,2,1,3,"chr11",1,0.00457102672292546
"14579","chr11.117490000.117495000","chr11.117660000.117665000",170000,14,0.001532594,117490000,117660000,117495000,117665000,"chr11",446870,0,2,0,2,"chr11",1,0.00328176277543366
"14580","chr11.36100000.36105000","chr11.36275000.36280000",175000,16,8.595666e-05,36100000,36275000,36105000,36280000,"chr11",446882,0,3,0,3,"chr11",1,0.00562587904360056
"14581","chr11.120390000.120395000","chr11.120800000.120805000",410000,14,1.51447e-06,120390000,120800000,120395000,120805000,"chr11",446883,0,1,2,3,"chr11",1,0.00492264416315049
"14582","chr11.46955000.46960000","chr11.47180000.47185000",225000,15,4.297223e-05,46955000,47180000,46960000,47185000,"chr11",446899,4,12,8,24,"chr11",1,0.0421940928270042
"14583","chr11.44595000.44600000","chr11.44620000.44625000",25000,37,0.0005101673,44595000,44620000,44600000,44625000,"chr11",446917,0,5,0,5,"chr11",1,0.0216830754805438
"14584","chr11.61625000.61630000","chr11.61850000.61855000",225000,16,8.78765e-06,61625000,61850000,61630000,61855000,"chr11",446940,0,5,7,12,"chr11",1,0.0225035161744023
"14585","chr11.64885000.64890000","chr11.65025000.65030000",140000,21,3.905967e-07,64885000,65025000,64890000,65030000,"chr11",446965,4,5,4,13,"chr11",1,0.0319971870604782
"14586","chr11.9745000.9750000","chr11.10320000.10325000",575000,12,4.17174e-06,9745000,10320000,9750000,10325000,"chr11",446982,0,0,3,3,"chr11",1,0.00421940928270042
"14587","chr11.62610000.62615000","chr11.63490000.63495000",880000,7,0.003730184,62610000,63490000,62615000,63495000,"chr11",446987,0,0,2,2,"chr11",1,0.00164088138771683
"14588","chr11.72640000.72645000","chr11.72845000.72850000",205000,23,9.614731e-11,72640000,72845000,72645000,72850000,"chr11",447026,0,2,1,3,"chr11",1,0.00808720112517581
"14589","chr11.72180000.72185000","chr11.72355000.72360000",175000,15,0.0003507838,72180000,72355000,72185000,72360000,"chr11",447040,0,3,1,4,"chr11",1,0.0070323488045007
"14590","chr11.33545000.33550000","chr11.33615000.33620000",70000,18,0.0098191,33545000,33615000,33550000,33620000,"chr11",447056,1,3,0,4,"chr11",1,0.00843881856540084
"14591","chr11.35980000.35985000","chr11.36145000.36150000",165000,15,0.0005365909,35980000,36145000,35985000,36150000,"chr11",447075,3,7,12,22,"chr11",1,0.0386779184247539
"14592","chr11.125470000.125475000","chr11.125490000.125495000",20000,47,1.112089e-06,125470000,125490000,125475000,125495000,"chr11",447078,5,16,12,33,"chr11",1,0.181786216596343
"14593","chr11.121200000.121205000","chr11.121320000.121325000",120000,20,7.485708e-06,121200000,121320000,121205000,121325000,"chr11",447092,3,8,6,17,"chr11",1,0.0398499765588373
"14594","chr11.43905000.43910000","chr11.44090000.44095000",185000,13,0.003026915,43905000,44090000,43910000,44095000,"chr11",447157,3,3,1,7,"chr11",1,0.0106657290201594
"14595","chr11.121570000.121575000","chr11.121935000.121940000",365000,11,0.000669902,121570000,121935000,121575000,121940000,"chr11",447196,0,2,0,2,"chr11",1,0.00257852789498359
"14596","chr11.75615000.75620000","chr11.75850000.75855000",235000,13,0.000580854,75615000,75850000,75620000,75855000,"chr11",447242,0,4,0,4,"chr11",1,0.00609470229723394
"14597","chr11.119205000.119210000","chr11.119235000.119240000",30000,41,2.421593e-07,119205000,119235000,119210000,119240000,"chr11",447249,0,6,1,7,"chr11",1,0.033638068448195
"14598","chr11.11145000.11150000","chr11.11765000.11770000",620000,8,0.004027368,11145000,11765000,11150000,11770000,"chr11",447320,1,4,5,10,"chr11",1,0.00937646507266761
"14599","chr11.3855000.3860000","chr11.4090000.4095000",235000,13,0.000580854,3855000,4090000,3860000,4095000,"chr11",447389,1,1,4,6,"chr11",1,0.00914205344585091
"14600","chr11.6405000.6410000","chr11.6505000.6510000",100000,20,4.457719e-05,6405000,6505000,6410000,6510000,"chr11",447400,2,3,1,6,"chr11",1,0.0140646976090014
"14601","chr11.85755000.85760000","chr11.85945000.85950000",190000,18,1.920264e-06,85755000,85945000,85760000,85950000,"chr11",447408,0,0,1,1,"chr11",1,0.00210970464135021
"14602","chr11.118050000.118055000","chr11.118210000.118215000",160000,13,0.007192356,118050000,118210000,118055000,118215000,"chr11",447436,0,6,8,14,"chr11",1,0.0213314580403188
"14603","chr11.77870000.77875000","chr11.78150000.78155000",280000,18,2.456927e-08,77870000,78150000,77875000,78155000,"chr11",447440,4,10,8,22,"chr11",1,0.0464135021097046
"14604","chr11.116740000.116745000","chr11.116865000.116870000",125000,17,0.0002965548,116740000,116865000,116745000,116870000,"chr11",447474,0,2,2,4,"chr11",1,0.00796999531176746
"14605","chr11.65040000.65045000","chr11.65100000.65105000",60000,36,2.104824e-11,65040000,65100000,65045000,65105000,"chr11",447481,5,21,19,45,"chr11",1,0.189873417721519
"14606","chr11.111435000.111440000","chr11.111690000.111695000",255000,23,3.337026e-12,111435000,111690000,111440000,111695000,"chr11",447514,0,4,2,6,"chr11",1,0.0161744022503516
"14607","chr11.117365000.117370000","chr11.117440000.117445000",75000,19,0.002175798,117365000,117440000,117370000,117445000,"chr11",447584,0,2,1,3,"chr11",1,0.00668073136427567
"14608","chr11.118650000.118655000","chr11.118995000.119000000",345000,11,0.0009140559,118650000,118995000,118655000,1.19e+08,"chr11",447588,1,9,3,13,"chr11",1,0.0167604313173933
"14609","chr11.7585000.7590000","chr11.7670000.7675000",85000,25,3.807625e-07,7585000,7670000,7590000,7675000,"chr11",447641,1,2,5,8,"chr11",1,0.023441162681669
"14610","chr11.47440000.47445000","chr11.47575000.47580000",135000,15,0.002004479,47440000,47575000,47445000,47580000,"chr11",447645,2,5,10,17,"chr11",1,0.029887482419128
"14611","chr11.122250000.122255000","chr11.122285000.122290000",35000,27,0.004903844,122250000,122285000,122255000,122290000,"chr11",447646,0,1,1,2,"chr11",1,0.00632911392405063
"14612","chr11.46855000.46860000","chr11.47180000.47185000",325000,11,0.001261786,46855000,47180000,46860000,47185000,"chr11",447768,2,0,3,5,"chr11",1,0.00644631973745898
"14613","chr11.83030000.83035000","chr11.83370000.83375000",340000,10,0.004203973,83030000,83370000,83035000,83375000,"chr11",447847,3,9,6,18,"chr11",1,0.0210970464135021
"14614","chr11.118170000.118175000","chr11.118220000.118225000",50000,28,2.055153e-05,118170000,118220000,118175000,118225000,"chr11",447856,2,1,3,6,"chr11",1,0.019690576652602
"14615","chr11.83550000.83555000","chr11.83825000.83830000",275000,12,0.0008089154,83550000,83825000,83555000,83830000,"chr11",447934,2,1,1,4,"chr11",1,0.00562587904360056
"14616","chr11.47595000.47600000","chr11.47790000.47795000",195000,12,0.007192356,47595000,47790000,47600000,47795000,"chr11",447964,7,25,22,54,"chr11",1,0.0759493670886076
"14617","chr11.116740000.116745000","chr11.117105000.117110000",365000,10,0.002987893,116740000,117105000,116745000,117110000,"chr11",448007,10,36,18,64,"chr11",1,0.0750117205813408
"14618","chr11.8715000.8720000","chr11.8870000.8875000",155000,16,0.0002289263,8715000,8870000,8720000,8875000,"chr11",448027,0,2,0,2,"chr11",1,0.00375058602906704
"14619","chr11.36380000.36385000","chr11.36490000.36495000",110000,16,0.002366381,36380000,36490000,36385000,36495000,"chr11",448093,1,1,0,2,"chr11",1,0.00375058602906704
"14620","chr11.73125000.73130000","chr11.73175000.73180000",50000,25,0.0004464974,73125000,73175000,73130000,73180000,"chr11",448126,1,9,3,13,"chr11",1,0.0380918893577121
"14621","chr11.48005000.48010000","chr11.48080000.48085000",75000,21,0.0002656666,48005000,48080000,48010000,48085000,"chr11",448189,0,13,9,22,"chr11",1,0.0541490857946554
"14622","chr11.122780000.122785000","chr11.122880000.122885000",100000,17,0.00158388,122780000,122880000,122785000,122885000,"chr11",448249,7,6,2,15,"chr11",1,0.029887482419128
"14623","chr11.73125000.73130000","chr11.73360000.73365000",235000,11,0.008057482,73125000,73360000,73130000,73365000,"chr11",448273,1,1,2,4,"chr11",1,0.00515705578996718
"14624","chr11.119520000.119525000","chr11.119985000.119990000",465000,12,2.391871e-05,119520000,119985000,119525000,119990000,"chr11",448294,0,1,0,1,"chr11",1,0.00140646976090014
"14625","chr11.63610000.63615000","chr11.63930000.63935000",320000,10,0.005623782,63610000,63930000,63615000,63935000,"chr11",448317,7,17,20,44,"chr11",1,0.0515705578996718
"14626","chr11.118995000.119000000","chr11.119055000.119060000",60000,21,0.002710311,118995000,119055000,1.19e+08,119060000,"chr11",448345,3,23,15,41,"chr11",1,0.100914205344585
"14627","chr11.75720000.75725000","chr11.75775000.75780000",55000,21,0.006262805,75720000,75775000,75725000,75780000,"chr11",448399,0,1,3,4,"chr11",1,0.00984528832630099
"14628","chr11.107440000.107445000","chr11.107560000.107565000",120000,18,0.0001128133,107440000,107560000,107445000,107565000,"chr11",448452,0,4,2,6,"chr11",1,0.0126582278481013
"14629","chr11.73575000.73580000","chr11.73595000.73600000",20000,42,7.950065e-05,73575000,73595000,73580000,73600000,"chr11",448459,0,6,1,7,"chr11",1,0.0344585091420534
"14630","chr11.66840000.66845000","chr11.66915000.66920000",75000,18,0.005637993,66840000,66915000,66845000,66920000,"chr11",448476,5,11,8,24,"chr11",1,0.0506329113924051
"14631","chr11.121530000.121535000","chr11.122075000.122080000",545000,22,3.131557e-16,121530000,122075000,121535000,122080000,"chr11",448485,0,4,4,8,"chr11",1,0.0206282231598687
"14632","chr11.61635000.61640000","chr11.61840000.61845000",205000,12,0.005366988,61635000,61840000,61640000,61845000,"chr11",448491,2,4,9,15,"chr11",1,0.0210970464135021
"14633","chr11.83555000.83560000","chr11.83720000.83725000",165000,25,5.307897e-11,83555000,83720000,83560000,83725000,"chr11",448500,0,3,2,5,"chr11",1,0.0146507266760431
"14634","chr11.73125000.73130000","chr11.73340000.73345000",215000,13,0.001095992,73125000,73340000,73130000,73345000,"chr11",448517,2,4,6,12,"chr11",1,0.0182841068917018
"14635","chr11.1340000.1345000","chr11.1405000.1410000",65000,26,4.50204e-06,1340000,1405000,1345000,1410000,"chr11",448531,0,0,2,2,"chr11",1,0.00609470229723394
"14636","chr11.61965000.61970000","chr11.61995000.62000000",30000,30,0.004387639,61965000,61995000,61970000,6.2e+07,"chr11",448548,0,4,3,7,"chr11",1,0.0246132208157525
"14637","chr11.73595000.73600000","chr11.73625000.73630000",30000,35,8.05065e-05,73595000,73625000,73600000,73630000,"chr11",448560,4,8,11,23,"chr11",1,0.0943506797937178
"14638","chr11.72820000.72825000","chr11.72845000.72850000",25000,41,1.967653e-05,72820000,72845000,72825000,72850000,"chr11",448591,0,1,1,2,"chr11",1,0.00961087669948429
"14639","chr11.118050000.118055000","chr11.118355000.118360000",305000,15,2.772813e-06,118050000,118355000,118055000,118360000,"chr11",448607,0,6,4,10,"chr11",1,0.0175808720112518
"14640","chr11.10450000.10455000","chr11.10750000.10755000",300000,11,0.002001367,10450000,10750000,10455000,10755000,"chr11",448632,0,3,3,6,"chr11",1,0.00773558368495077
"14641","chr11.117510000.117515000","chr11.117590000.117595000",80000,19,0.001227442,117510000,117590000,117515000,117595000,"chr11",448651,0,3,1,4,"chr11",1,0.00890764181903422
"14642","chr11.73125000.73130000","chr11.73335000.73340000",210000,21,3.094174e-09,73125000,73335000,73130000,73340000,"chr11",448657,4,5,5,14,"chr11",1,0.0344585091420534
"14643","chr11.119065000.119070000","chr11.119175000.119180000",110000,20,1.727155e-05,119065000,119175000,119070000,119180000,"chr11",448678,5,11,7,23,"chr11",1,0.0539146741678387
"14644","chr11.121490000.121495000","chr11.122320000.122325000",830000,9,0.0001149493,121490000,122320000,121495000,122325000,"chr11",448709,4,1,2,7,"chr11",1,0.00738396624472574
"14645","chr11.9205000.9210000","chr11.9275000.9280000",70000,21,0.0005429726,9205000,9275000,9210000,9280000,"chr11",448738,3,1,4,8,"chr11",1,0.019690576652602
"14646","chr11.117300000.117305000","chr11.117705000.117710000",405000,13,1.107124e-05,117300000,117705000,117305000,117710000,"chr11",448743,0,2,3,5,"chr11",1,0.00761837787154243
"14647","chr11.82990000.82995000","chr11.83530000.83535000",540000,20,7.224891e-14,82990000,83530000,82995000,83535000,"chr11",448772,0,2,2,4,"chr11",1,0.00937646507266761
"14648","chr11.48005000.48010000","chr11.48100000.48105000",95000,18,0.0008007308,48005000,48100000,48010000,48105000,"chr11",448810,0,10,7,17,"chr11",1,0.0358649789029536
"14649","chr11.107695000.107700000","chr11.107765000.107770000",70000,21,0.0005429726,107695000,107765000,107700000,107770000,"chr11",448838,4,14,8,26,"chr11",1,0.0639943741209564
"14650","chr11.75620000.75625000","chr11.75850000.75855000",230000,21,9.004501e-10,75620000,75850000,75625000,75855000,"chr11",448874,6,18,22,46,"chr11",1,0.113220815752461
"14651","chr11.34175000.34180000","chr11.34345000.34350000",170000,15,0.0004306263,34175000,34345000,34180000,34350000,"chr11",448915,0,3,1,4,"chr11",1,0.0070323488045007
"14652","chr11.18360000.18365000","chr11.18395000.18400000",35000,27,0.004903844,18360000,18395000,18365000,18400000,"chr11",448948,5,11,19,35,"chr11",1,0.110759493670886
"14653","chr11.78000000.78005000","chr11.78100000.78105000",100000,23,7.498965e-07,7.8e+07,78100000,78005000,78105000,"chr11",448965,4,24,26,54,"chr11",1,0.145569620253165
"14654","chr11.121195000.121200000","chr11.121470000.121475000",275000,18,3.007801e-08,121195000,121470000,121200000,121475000,"chr11",448967,0,0,3,3,"chr11",1,0.00632911392405063
"14655","chr11.117315000.117320000","chr11.117670000.117675000",355000,21,2.581301e-12,117315000,117670000,117320000,117675000,"chr11",448987,0,1,5,6,"chr11",1,0.0147679324894515
"14656","chr11.18310000.18315000","chr11.18550000.18555000",240000,12,0.002001367,18310000,18550000,18315000,18555000,"chr11",448997,7,13,9,29,"chr11",1,0.0407876230661041
"14657","chr11.9205000.9210000","chr11.9260000.9265000",55000,22,0.002648393,9205000,9260000,9210000,9265000,"chr11",449000,2,1,4,7,"chr11",1,0.0180496952648851
"14658","chr11.75655000.75660000","chr11.75865000.75870000",210000,14,0.0003385072,75655000,75865000,75660000,75870000,"chr11",449007,0,3,6,9,"chr11",1,0.0147679324894515
"14659","chr11.6400000.6405000","chr11.6495000.6500000",95000,23,1.42065e-06,6400000,6495000,6405000,6500000,"chr11",449021,0,2,0,2,"chr11",1,0.00539146741678387
"14660","chr11.117455000.117460000","chr11.117655000.117660000",200000,14,0.0004860211,117455000,117655000,117460000,117660000,"chr11",449028,0,2,0,2,"chr11",1,0.00328176277543366
"14661","chr11.67030000.67035000","chr11.67080000.67085000",50000,55,5.354685e-23,67030000,67080000,67035000,67085000,"chr11",449055,2,6,3,11,"chr11",1,0.0709095171120488
"14662","chr11.45870000.45875000","chr11.45915000.45920000",45000,23,0.007192356,45870000,45915000,45875000,45920000,"chr11",449056,1,4,1,6,"chr11",1,0.0161744022503516
"14663","chr11.18320000.18325000","chr11.18550000.18555000",230000,12,0.002625012,18320000,18550000,18325000,18555000,"chr11",449089,4,12,10,26,"chr11",1,0.0365682137834037
"14664","chr11.46975000.46980000","chr11.47160000.47165000",185000,22,2.752451e-09,46975000,47160000,46980000,47165000,"chr11",449091,2,4,4,10,"chr11",1,0.0257852789498359
"14665","chr11.78000000.78005000","chr11.78030000.78035000",30000,36,3.32889e-05,7.8e+07,78030000,78005000,78035000,"chr11",449143,8,19,26,53,"chr11",1,0.223628691983122
"14666","chr11.64920000.64925000","chr11.64940000.64945000",20000,38,0.001528665,64920000,64940000,64925000,64945000,"chr11",449164,2,6,9,17,"chr11",1,0.0757149554617909
"14667","chr11.35660000.35665000","chr11.36510000.36515000",850000,7,0.004493171,35660000,36510000,35665000,36515000,"chr11",449179,2,3,5,10,"chr11",1,0.00820440693858415
"14668","chr11.112510000.112515000","chr11.112745000.112750000",235000,12,0.002286979,112510000,112745000,112515000,112750000,"chr11",449218,0,2,3,5,"chr11",1,0.0070323488045007
"14669","chr11.118570000.118575000","chr11.118650000.118655000",80000,32,2.463434e-11,118570000,118650000,118575000,118655000,"chr11",449248,1,9,3,13,"chr11",1,0.0487576183778715
"14670","chr11.62610000.62615000","chr11.62645000.62650000",35000,49,1.323962e-13,62610000,62645000,62615000,62650000,"chr11",449252,0,0,2,2,"chr11",1,0.0114861697140178
"14671","chr11.116705000.116710000","chr11.116965000.116970000",260000,13,0.000276648,116705000,116965000,116710000,116970000,"chr11",449284,1,12,16,29,"chr11",1,0.0441865916549461
"14672","chr11.128030000.128035000","chr11.128830000.128835000",800000,7,0.006038309,128030000,128830000,128035000,128835000,"chr11",449287,0,1,1,2,"chr11",1,0.00164088138771683
"14673","chr11.14065000.14070000","chr11.14095000.14100000",30000,37,1.319731e-05,14065000,14095000,14070000,14100000,"chr11",449327,1,1,2,4,"chr11",1,0.0173464603844351
"14674","chr11.6565000.6570000","chr11.6595000.6600000",30000,37,1.319731e-05,6565000,6595000,6570000,6600000,"chr11",449329,0,0,4,4,"chr11",1,0.0173464603844351
"14675","chr11.122285000.122290000","chr11.122320000.122325000",35000,32,7.227617e-05,122285000,122320000,122290000,122325000,"chr11",449335,0,1,1,2,"chr11",1,0.00750117205813408
"14676","chr11.64225000.64230000","chr11.64285000.64290000",60000,23,0.0003939866,64225000,64285000,64230000,64290000,"chr11",449343,0,0,2,2,"chr11",1,0.00539146741678387
"14677","chr11.118565000.118570000","chr11.118820000.118825000",255000,11,0.005044969,118565000,118820000,118570000,118825000,"chr11",449361,5,25,11,41,"chr11",1,0.0528598218471636
"14678","chr11.123515000.123520000","chr11.123565000.123570000",50000,24,0.001138728,123515000,123565000,123520000,123570000,"chr11",449373,2,3,4,9,"chr11",1,0.0253164556962025
"14679","chr11.47985000.47990000","chr11.48035000.48040000",50000,24,0.001138728,47985000,48035000,47990000,48040000,"chr11",449431,2,10,6,18,"chr11",1,0.0506329113924051
"14680","chr11.119760000.119765000","chr11.119865000.119870000",105000,16,0.003252287,119760000,119865000,119765000,119870000,"chr11",449433,0,1,1,2,"chr11",1,0.00375058602906704
"14681","chr11.121220000.121225000","chr11.121460000.121465000",240000,18,1.463656e-07,121220000,121460000,121225000,121465000,"chr11",449475,2,6,2,10,"chr11",1,0.0210970464135021
"14682","chr11.61585000.61590000","chr11.61890000.61895000",305000,15,2.772813e-06,61585000,61890000,61590000,61895000,"chr11",449503,0,2,1,3,"chr11",1,0.00527426160337553
"14683","chr11.9970000.9975000","chr11.10320000.10325000",350000,19,2.594017e-10,9970000,10320000,9975000,10325000,"chr11",449514,3,2,8,13,"chr11",1,0.0289498359118612
"14684","chr11.117715000.117720000","chr11.117935000.117940000",220000,14,0.000230503,117715000,117935000,117720000,117940000,"chr11",449564,0,8,5,13,"chr11",1,0.0213314580403188
"14685","chr11.61945000.61950000","chr11.61995000.62000000",50000,22,0.006416007,61945000,61995000,61950000,6.2e+07,"chr11",449634,3,11,9,23,"chr11",1,0.0593061415846226
"14686","chr11.205000.210000","chr11.235000.240000",30000,38,5.063321e-06,205000,235000,210000,240000,"chr11",449653,2,9,6,17,"chr11",1,0.0757149554617909
"14687","chr11.72445000.72450000","chr11.72520000.72525000",75000,19,0.002175798,72445000,72520000,72450000,72525000,"chr11",449658,0,1,4,5,"chr11",1,0.0111345522737928
"14688","chr11.119585000.119590000","chr11.119970000.119975000",385000,17,6.550248e-09,119585000,119970000,119590000,119975000,"chr11",449672,4,2,2,8,"chr11",1,0.0159399906235349
"14689","chr11.82995000.83000000","chr11.83530000.83535000",535000,27,3.628726e-22,82995000,83530000,8.3e+07,83535000,"chr11",449677,0,2,2,4,"chr11",1,0.0126582278481013
"14690","chr11.78060000.78065000","chr11.78140000.78145000",80000,18,0.003390837,78060000,78140000,78065000,78145000,"chr11",449715,6,11,16,33,"chr11",1,0.069620253164557
"14691","chr11.66915000.66920000","chr11.66955000.66960000",40000,28,0.0003782187,66915000,66955000,66920000,66960000,"chr11",449717,3,6,7,16,"chr11",1,0.0525082044069386
"14692","chr11.70295000.70300000","chr11.70625000.70630000",330000,10,0.004832243,70295000,70625000,70300000,70630000,"chr11",449738,2,6,3,11,"chr11",1,0.012892639474918
"14693","chr11.73410000.73415000","chr11.73435000.73440000",25000,37,0.0005101673,73410000,73435000,73415000,73440000,"chr11",449760,2,1,2,5,"chr11",1,0.0216830754805438
"14694","chr11.12690000.12695000","chr11.12840000.12845000",150000,17,7.601346e-05,12690000,12840000,12695000,12845000,"chr11",449806,0,1,2,3,"chr11",1,0.0059774964838256
"14695","chr11.14555000.14560000","chr11.14750000.14755000",195000,12,0.007192356,14555000,14750000,14560000,14755000,"chr11",449834,4,7,5,16,"chr11",1,0.0225035161744023
"14696","chr11.47450000.47455000","chr11.47580000.47585000",130000,23,3.495394e-08,47450000,47580000,47455000,47585000,"chr11",449856,8,15,16,39,"chr11",1,0.105133614627286
"14697","chr11.121460000.121465000","chr11.122075000.122080000",615000,9,0.0007804324,121460000,122075000,121465000,122080000,"chr11",449866,1,4,2,7,"chr11",1,0.00738396624472574
"14698","chr11.94510000.94515000","chr11.94560000.94565000",50000,24,0.001138728,94510000,94560000,94515000,94565000,"chr11",449909,0,3,2,5,"chr11",1,0.0140646976090014
"14699","chr11.35605000.35610000","chr11.36170000.36175000",565000,10,0.0002263617,35605000,36170000,35610000,36175000,"chr11",449916,1,4,3,8,"chr11",1,0.00937646507266761
"14700","chr11.47255000.47260000","chr11.47425000.47430000",170000,14,0.001532594,47255000,47425000,47260000,47430000,"chr11",449927,7,14,21,42,"chr11",1,0.0689170182841069
"14701","chr11.62670000.62675000","chr11.62785000.62790000",115000,41,2.235978e-22,62670000,62785000,62675000,62790000,"chr11",449932,4,18,10,32,"chr11",1,0.153774027191749
"14702","chr11.8715000.8720000","chr11.8830000.8835000",115000,15,0.005171771,8715000,8830000,8720000,8835000,"chr11",449992,0,3,0,3,"chr11",1,0.00527426160337553
"14703","chr11.12815000.12820000","chr11.12840000.12845000",25000,39,0.0001059285,12815000,12840000,12820000,12845000,"chr11",450020,0,0,2,2,"chr11",1,0.00914205344585091
"14704","chr11.86135000.86140000","chr11.86520000.86525000",385000,10,0.002286979,86135000,86520000,86140000,86525000,"chr11",450030,1,2,5,8,"chr11",1,0.00937646507266761
"14705","chr11.34260000.34265000","chr11.34345000.34350000",85000,17,0.005623782,34260000,34345000,34265000,34350000,"chr11",450075,0,3,1,4,"chr11",1,0.00796999531176746
"14706","chr11.8840000.8845000","chr11.8870000.8875000",30000,34,0.0001927165,8840000,8870000,8845000,8875000,"chr11",450083,1,2,3,6,"chr11",1,0.0239099859353024
"14707","chr11.40165000.40170000","chr11.40200000.40205000",35000,30,0.0004391258,40165000,40200000,40170000,40205000,"chr11",450119,2,5,0,7,"chr11",1,0.0246132208157525
"14708","chr11.116840000.116845000","chr11.116970000.116975000",130000,16,0.0007775766,116840000,116970000,116845000,116975000,"chr11",450128,5,9,8,22,"chr11",1,0.0412564463197375
"14709","chr11.101890000.101895000","chr11.101910000.101915000",20000,37,0.00299301,101890000,101910000,101895000,101915000,"chr11",450139,1,2,4,7,"chr11",1,0.0303563056727614
"14710","chr11.36340000.36345000","chr11.36380000.36385000",40000,26,0.002147236,36340000,36380000,36345000,36385000,"chr11",450191,1,6,4,11,"chr11",1,0.0335208626347867
"14711","chr11.3825000.3830000","chr11.4065000.4070000",240000,11,0.007139806,3825000,4065000,3830000,4070000,"chr11",450200,0,1,5,6,"chr11",1,0.00773558368495077
"14712","chr11.130920000.130925000","chr11.131540000.131545000",620000,8,0.004027368,130920000,131540000,130925000,131545000,"chr11",450229,0,1,1,2,"chr11",1,0.00187529301453352
"14713","chr11.117715000.117720000","chr11.117765000.117770000",50000,26,0.0001688891,117715000,117765000,117720000,117770000,"chr11",450247,0,2,4,6,"chr11",1,0.0182841068917018
"14714","chr11.65095000.65100000","chr11.65115000.65120000",20000,42,7.950065e-05,65095000,65115000,65100000,65120000,"chr11",450273,3,5,2,10,"chr11",1,0.0492264416315049
"14715","chr11.3810000.3815000","chr11.4085000.4090000",275000,13,0.0001815381,3810000,4085000,3815000,4090000,"chr11",450293,3,1,0,4,"chr11",1,0.00609470229723394
"14716","chr11.112755000.112760000","chr11.112830000.112835000",75000,25,2.097476e-06,112755000,112830000,112760000,112835000,"chr11",450336,0,0,1,1,"chr11",1,0.00293014533520863
"14717","chr11.6405000.6410000","chr11.6700000.6705000",295000,13,0.0001083754,6405000,6700000,6410000,6705000,"chr11",450355,6,10,16,32,"chr11",1,0.0487576183778715
"14718","chr11.116900000.116905000","chr11.116965000.116970000",65000,22,0.0004299726,116900000,116965000,116905000,116970000,"chr11",450356,2,3,7,12,"chr11",1,0.0309423347398031
"14719","chr11.111740000.111745000","chr11.111870000.111875000",130000,14,0.007397049,111740000,111870000,111745000,111875000,"chr11",450382,0,6,4,10,"chr11",1,0.0164088138771683
"14720","chr11.62650000.62655000","chr11.62670000.62675000",20000,38,0.001528665,62650000,62670000,62655000,62675000,"chr11",450428,4,18,10,32,"chr11",1,0.142522269104548
"14721","chr11.65330000.65335000","chr11.65605000.65610000",275000,11,0.003252287,65330000,65605000,65335000,65610000,"chr11",450490,0,2,3,5,"chr11",1,0.00644631973745898
"14722","chr11.62570000.62575000","chr11.62620000.62625000",50000,30,2.1624e-06,62570000,62620000,62575000,62625000,"chr11",450496,0,4,4,8,"chr11",1,0.0281293952180028
"14723","chr11.116740000.116745000","chr11.116990000.116995000",250000,16,3.1353e-06,116740000,116990000,116745000,116995000,"chr11",450550,5,16,10,31,"chr11",1,0.0581340834505391
"14724","chr11.117300000.117305000","chr11.117670000.117675000",370000,28,3.96909e-20,117300000,117670000,117305000,117675000,"chr11",450564,0,1,5,6,"chr11",1,0.019690576652602
"14725","chr11.19720000.19725000","chr11.19875000.19880000",155000,13,0.008607758,19720000,19875000,19725000,19880000,"chr11",450580,1,3,8,12,"chr11",1,0.0182841068917018
"14726","chr11.7120000.7125000","chr11.7590000.7595000",470000,11,0.0001364084,7120000,7590000,7125000,7595000,"chr11",450605,0,2,1,3,"chr11",1,0.00386779184247539
"14727","chr11.117455000.117460000","chr11.117670000.117675000",215000,13,0.001095992,117455000,117670000,117460000,117675000,"chr11",450618,0,1,1,2,"chr11",1,0.00304735114861697
"14728","chr11.62555000.62560000","chr11.62645000.62650000",90000,16,0.009624967,62555000,62645000,62560000,62650000,"chr11",450629,0,0,3,3,"chr11",1,0.00562587904360056
"14729","chr11.126390000.126395000","chr11.126460000.126465000",70000,18,0.0098191,126390000,126460000,126395000,126465000,"chr11",450630,1,2,2,5,"chr11",1,0.0105485232067511
"14730","chr11.19595000.19600000","chr11.19735000.19740000",140000,22,8.038751e-08,19595000,19735000,19600000,19740000,"chr11",450647,1,1,0,2,"chr11",1,0.00515705578996718
"14731","chr11.73335000.73340000","chr11.73360000.73365000",25000,44,1.297103e-06,73335000,73360000,73340000,73365000,"chr11",450650,1,1,2,4,"chr11",1,0.0206282231598687
"14732","chr11.119615000.119620000","chr11.119750000.119755000",135000,17,0.0001702143,119615000,119750000,119620000,119755000,"chr11",450722,0,1,1,2,"chr11",1,0.00398499765588373
"14733","chr11.17915000.17920000","chr11.18000000.18005000",85000,17,0.005623782,17915000,1.8e+07,17920000,18005000,"chr11",450747,1,4,2,7,"chr11",1,0.0139474917955931
"14734","chr11.35800000.35805000","chr11.36290000.36295000",490000,12,1.579951e-05,35800000,36290000,35805000,36295000,"chr11",450769,0,7,3,10,"chr11",1,0.0140646976090014
"14735","chr11.3850000.3855000","chr11.4095000.4100000",245000,21,3.693426e-10,3850000,4095000,3855000,4100000,"chr11",450796,4,7,12,23,"chr11",1,0.0566104078762307
"14736","chr11.61750000.61755000","chr11.61825000.61830000",75000,18,0.005637993,61750000,61825000,61755000,61830000,"chr11",450826,0,6,6,12,"chr11",1,0.0253164556962025
"14737","chr11.129860000.129865000","chr11.129990000.129995000",130000,14,0.007397049,129860000,129990000,129865000,129995000,"chr11",450828,0,7,9,16,"chr11",1,0.0262541022034693
"14738","chr11.118050000.118055000","chr11.118220000.118225000",170000,22,8.240899e-09,118050000,118220000,118055000,118225000,"chr11",450846,0,1,3,4,"chr11",1,0.0103141115799344
"14739","chr11.46975000.46980000","chr11.47540000.47545000",565000,9,0.001279571,46975000,47540000,46980000,47545000,"chr11",450860,5,15,4,24,"chr11",1,0.0253164556962025
"14740","chr11.128170000.128175000","chr11.128475000.128480000",305000,11,0.001808533,128170000,128475000,128175000,128480000,"chr11",450875,0,0,2,2,"chr11",1,0.00257852789498359
"14741","chr11.117365000.117370000","chr11.117455000.117460000",90000,21,3.803727e-05,117365000,117455000,117370000,117460000,"chr11",450905,0,2,1,3,"chr11",1,0.00738396624472574
"14742","chr11.66890000.66895000","chr11.67005000.67010000",115000,19,4.356814e-05,66890000,67005000,66895000,67010000,"chr11",450908,0,28,24,52,"chr11",1,0.115799343647445
"14743","chr11.73670000.73675000","chr11.73795000.73800000",125000,17,0.0002965548,73670000,73795000,73675000,73800000,"chr11",450910,5,14,24,43,"chr11",1,0.0856774496015002
"14744","chr11.78000000.78005000","chr11.78045000.78050000",45000,41,9.285818e-12,7.8e+07,78045000,78005000,78050000,"chr11",450950,8,18,26,52,"chr11",1,0.249882794186592
"14745","chr11.10670000.10675000","chr11.10735000.10740000",65000,21,0.001170751,10670000,10735000,10675000,10740000,"chr11",450998,0,8,2,10,"chr11",1,0.0246132208157525
"14746","chr11.83550000.83555000","chr11.84245000.84250000",695000,8,0.00221132,83550000,84245000,83555000,84250000,"chr11",451029,0,1,1,2,"chr11",1,0.00187529301453352
"14747","chr11.62610000.62615000","chr11.63575000.63580000",965000,7,0.002147236,62610000,63575000,62615000,63580000,"chr11",451084,2,3,2,7,"chr11",1,0.00574308485700891
"14748","chr11.62570000.62575000","chr11.62595000.62600000",25000,65,2.663359e-17,62570000,62595000,62575000,62600000,"chr11",451106,0,0,2,2,"chr11",1,0.0152367557430849
"14749","chr11.82985000.82990000","chr11.83530000.83535000",545000,14,1.022138e-07,82985000,83530000,82990000,83535000,"chr11",451198,0,3,2,5,"chr11",1,0.00820440693858415
"14750","chr11.78045000.78050000","chr11.78120000.78125000",75000,20,0.0007826491,78045000,78120000,78050000,78125000,"chr11",451200,8,18,15,41,"chr11",1,0.0961087669948429
"14751","chr11.36310000.36315000","chr11.36495000.36500000",185000,31,3.28387e-17,36310000,36495000,36315000,36500000,"chr11",451271,0,2,2,4,"chr11",1,0.0145335208626348
"14752","chr11.111450000.111455000","chr11.111690000.111695000",240000,14,0.0001140389,111450000,111690000,111455000,111695000,"chr11",451312,0,2,2,4,"chr11",1,0.00656352555086732
"14753","chr11.66890000.66895000","chr11.67070000.67075000",180000,14,0.001049378,66890000,67070000,66895000,67075000,"chr11",451333,0,23,12,35,"chr11",1,0.0574308485700891
"14754","chr11.111740000.111745000","chr11.111940000.111945000",200000,21,6.01822e-09,111740000,111940000,111745000,111945000,"chr11",451335,0,6,4,10,"chr11",1,0.0246132208157525
"14755","chr11.48005000.48010000","chr11.48025000.48030000",20000,39,0.0007739803,48005000,48025000,48010000,48030000,"chr11",451345,0,7,4,11,"chr11",1,0.05028129395218
"14756","chr11.36300000.36305000","chr11.36510000.36515000",210000,14,0.0003385072,36300000,36510000,36305000,36515000,"chr11",451358,1,1,0,2,"chr11",1,0.00328176277543366
"14757","chr11.3835000.3840000","chr11.3855000.3860000",20000,46,2.736836e-06,3835000,3855000,3840000,3860000,"chr11",451369,0,1,1,2,"chr11",1,0.0107829348335677
"14758","chr11.33040000.33045000","chr11.33060000.33065000",20000,48,4.383315e-07,33040000,33060000,33045000,33065000,"chr11",451382,6,10,11,27,"chr11",1,0.151898734177215
"14759","chr11.83550000.83555000","chr11.83720000.83725000",170000,18,5.889818e-06,83550000,83720000,83555000,83725000,"chr11",451387,0,1,1,2,"chr11",1,0.00421940928270042
"14760","chr11.73335000.73340000","chr11.73355000.73360000",20000,37,0.00299301,73335000,73355000,73340000,73360000,"chr11",451448,0,3,0,3,"chr11",1,0.0130098452883263
"14761","chr11.9685000.9690000","chr11.9755000.9760000",70000,19,0.003994913,9685000,9755000,9690000,9760000,"chr11",451492,0,4,3,7,"chr11",1,0.0155883731833099
"14762","chr11.47245000.47250000","chr11.47280000.47285000",35000,30,0.0004391258,47245000,47280000,47250000,47285000,"chr11",451514,3,5,3,11,"chr11",1,0.0386779184247539
"14763","chr11.33040000.33045000","chr11.33065000.33070000",25000,51,9.729137e-10,33040000,33065000,33045000,33070000,"chr11",451516,1,9,3,13,"chr11",1,0.0777074542897328
"14764","chr11.85810000.85815000","chr11.85850000.85855000",40000,29,0.0001484255,85810000,85850000,85815000,85855000,"chr11",451539,2,6,2,10,"chr11",1,0.0339896858884201
"14765","chr11.10895000.10900000","chr11.11805000.11810000",910000,17,7.917394e-14,10895000,11805000,10900000,11810000,"chr11",451552,2,3,4,9,"chr11",1,0.0179324894514768
"14766","chr11.121200000.121205000","chr11.121435000.121440000",235000,14,0.0001367635,121200000,121435000,121205000,121440000,"chr11",451565,0,2,1,3,"chr11",1,0.00492264416315049
"14767","chr11.66650000.66655000","chr11.66675000.66680000",25000,33,0.008119404,66650000,66675000,66655000,66680000,"chr11",451582,3,5,4,12,"chr11",1,0.0464135021097046
"14768","chr11.11805000.11810000","chr11.12050000.12055000",245000,13,0.0004299726,11805000,12050000,11810000,12055000,"chr11",451624,2,3,2,7,"chr11",1,0.0106657290201594
"14769","chr11.32915000.32920000","chr11.33040000.33045000",125000,21,1.191773e-06,32915000,33040000,32920000,33045000,"chr11",451662,6,18,12,36,"chr11",1,0.0886075949367089
"14770","chr11.88360000.88365000","chr11.88420000.88425000",60000,20,0.006541073,88360000,88420000,88365000,88425000,"chr11",451669,0,4,1,5,"chr11",1,0.0117205813408345
"14771","chr11.6530000.6535000","chr11.6700000.6705000",170000,16,0.000110804,6530000,6700000,6535000,6705000,"chr11",451674,2,6,4,12,"chr11",1,0.0225035161744023
"14772","chr11.30250000.30255000","chr11.30940000.30945000",690000,8,0.002293812,30250000,30940000,30255000,30945000,"chr11",451746,0,2,0,2,"chr11",1,0.00187529301453352
"14773","chr11.118610000.118615000","chr11.118905000.118910000",295000,10,0.008351826,118610000,118905000,118615000,118910000,"chr11",451759,0,2,1,3,"chr11",1,0.00351617440225035
"14774","chr11.66385000.66390000","chr11.66405000.66410000",20000,75,3.892227e-21,66385000,66405000,66390000,66410000,"chr11",451809,2,7,4,13,"chr11",1,0.114275668073136
"14775","chr11.73175000.73180000","chr11.73315000.73320000",140000,17,0.0001313646,73175000,73315000,73180000,73320000,"chr11",451849,1,4,1,6,"chr11",1,0.0119549929676512
"14776","chr11.47985000.47990000","chr11.48135000.48140000",150000,31,1.853787e-15,47985000,48135000,47990000,48140000,"chr11",451856,0,5,2,7,"chr11",1,0.0254336615096109
"14777","chr11.111420000.111425000","chr11.111690000.111695000",270000,14,4.321983e-05,111420000,111690000,111425000,111695000,"chr11",451902,0,5,4,9,"chr11",1,0.0147679324894515
"14778","chr11.117705000.117710000","chr11.117945000.117950000",240000,13,0.0005000665,117705000,117945000,117710000,117950000,"chr11",451906,0,2,3,5,"chr11",1,0.00761837787154243
"14779","chr11.66415000.66420000","chr11.66435000.66440000",20000,42,7.950065e-05,66415000,66435000,66420000,66440000,"chr11",451907,2,2,1,5,"chr11",1,0.0246132208157525
"14780","chr11.64860000.64865000","chr11.64885000.64890000",25000,45,4.908128e-07,64860000,64885000,64865000,64890000,"chr11",451938,4,5,4,13,"chr11",1,0.0685654008438819
"14781","chr11.109805000.109810000","chr11.110020000.110025000",215000,14,0.0002782545,109805000,110020000,109810000,110025000,"chr11",451967,2,2,8,12,"chr11",1,0.019690576652602
"14782","chr11.94930000.94935000","chr11.95485000.95490000",555000,8,0.007006004,94930000,95485000,94935000,95490000,"chr11",452041,0,1,1,2,"chr11",1,0.00187529301453352
"14783","chr11.6530000.6535000","chr11.6755000.6760000",225000,12,0.003005846,6530000,6755000,6535000,6760000,"chr11",452068,1,6,4,11,"chr11",1,0.0154711673699015
"14784","chr11.78000000.78005000","chr11.78085000.78090000",85000,25,3.807625e-07,7.8e+07,78085000,78005000,78090000,"chr11",452107,3,19,13,35,"chr11",1,0.102555086732302
"14785","chr11.65180000.65185000","chr11.65290000.65295000",110000,22,1.046613e-06,65180000,65290000,65185000,65295000,"chr11",452120,1,1,2,4,"chr11",1,0.0103141115799344
"14786","chr11.61760000.61765000","chr11.61840000.61845000",80000,28,1.235927e-08,61760000,61840000,61765000,61845000,"chr11",452138,0,8,3,11,"chr11",1,0.0360993905297703
"14787","chr11.32915000.32920000","chr11.33060000.33065000",145000,21,2.716593e-07,32915000,33060000,32920000,33065000,"chr11",452160,6,10,11,27,"chr11",1,0.0664556962025316
"14788","chr11.9685000.9690000","chr11.10310000.10315000",625000,11,1.578603e-05,9685000,10310000,9690000,10315000,"chr11",452179,1,6,4,11,"chr11",1,0.0141819034224098
"14789","chr11.121530000.121535000","chr11.121825000.121830000",295000,11,0.002179846,121530000,121825000,121535000,121830000,"chr11",452222,0,6,0,6,"chr11",1,0.00773558368495077
"14790","chr11.6635000.6640000","chr11.6670000.6675000",35000,30,0.0004391258,6635000,6670000,6640000,6675000,"chr11",452228,2,4,0,6,"chr11",1,0.0210970464135021
"14791","chr11.125360000.125365000","chr11.125455000.125460000",95000,23,1.42065e-06,125360000,125455000,125365000,125460000,"chr11",452232,2,9,5,16,"chr11",1,0.043131739334271
"14792","chr11.66315000.66320000","chr11.66335000.66340000",20000,51,2.41668e-08,66315000,66335000,66320000,66340000,"chr11",452240,1,4,1,6,"chr11",1,0.0358649789029536
"14793","chr11.78030000.78035000","chr11.78140000.78145000",110000,15,0.006750723,78030000,78140000,78035000,78145000,"chr11",452249,7,19,23,49,"chr11",1,0.0861462728551336
"14794","chr11.3800000.3805000","chr11.4085000.4090000",285000,14,2.767108e-05,3800000,4085000,3805000,4090000,"chr11",452253,3,1,0,4,"chr11",1,0.00656352555086732
"14795","chr11.6400000.6405000","chr11.6530000.6535000",130000,14,0.007397049,6400000,6530000,6405000,6535000,"chr11",452256,0,2,0,2,"chr11",1,0.00328176277543366
"14796","chr11.116875000.116880000","chr11.116900000.116905000",25000,61,5.732176e-15,116875000,116900000,116880000,116905000,"chr11",452260,1,3,2,6,"chr11",1,0.0428973277074543
"14797","chr11.65605000.65610000","chr11.65705000.65710000",100000,16,0.004591244,65605000,65705000,65610000,65710000,"chr11",452265,0,2,3,5,"chr11",1,0.00937646507266761
"14798","chr11.44590000.44595000","chr11.44620000.44625000",30000,35,8.05065e-05,44590000,44620000,44595000,44625000,"chr11",452285,0,5,0,5,"chr11",1,0.0205110173464604
"14799","chr11.3835000.3840000","chr11.4085000.4090000",250000,14,8.05065e-05,3835000,4085000,3840000,4090000,"chr11",452287,0,1,0,1,"chr11",1,0.00164088138771683
"14800","chr11.125360000.125365000","chr11.125490000.125495000",130000,22,1.72859e-07,125360000,125490000,125365000,125495000,"chr11",452315,4,9,7,20,"chr11",1,0.0515705578996718
"14801","chr11.117295000.117300000","chr11.117720000.117725000",425000,9,0.005950057,117295000,117720000,117300000,117725000,"chr11",452338,0,0,3,3,"chr11",1,0.00316455696202532
"14802","chr11.46360000.46365000","chr11.46650000.46655000",290000,10,0.009090773,46360000,46650000,46365000,46655000,"chr11",452365,0,4,2,6,"chr11",1,0.0070323488045007
"14803","chr11.64225000.64230000","chr11.64315000.64320000",90000,20,0.0001316662,64225000,64315000,64230000,64320000,"chr11",452400,0,3,0,3,"chr11",1,0.0070323488045007
"14804","chr11.111740000.111745000","chr11.111850000.111855000",110000,16,0.002366381,111740000,111850000,111745000,111855000,"chr11",452422,0,6,4,10,"chr11",1,0.0187529301453352
"14805","chr11.47210000.47215000","chr11.47230000.47235000",20000,49,1.721009e-07,47210000,47230000,47215000,47235000,"chr11",452431,11,18,16,45,"chr11",1,0.258438818565401
"14806","chr11.47980000.47985000","chr11.48080000.48085000",100000,24,1.748735e-07,47980000,48080000,47985000,48085000,"chr11",452437,0,6,4,10,"chr11",1,0.0281293952180028
"14807","chr11.47945000.47950000","chr11.47985000.47990000",40000,25,0.004759951,47945000,47985000,47950000,47990000,"chr11",452444,11,31,26,68,"chr11",1,0.199249882794187
"14808","chr11.75525000.75530000","chr11.75590000.75595000",65000,21,0.001170751,75525000,75590000,75530000,75595000,"chr11",452460,0,2,1,3,"chr11",1,0.00738396624472574
"14809","chr11.117510000.117515000","chr11.117675000.117680000",165000,22,1.190912e-08,117510000,117675000,117515000,117680000,"chr11",452510,0,3,1,4,"chr11",1,0.0103141115799344
"14810","chr11.118950000.118955000","chr11.119195000.119200000",245000,11,0.006332282,118950000,119195000,118955000,119200000,"chr11",452531,6,15,11,32,"chr11",1,0.0412564463197375
"14811","chr11.34940000.34945000","chr11.35425000.35430000",485000,14,3.310794e-07,34940000,35425000,34945000,35430000,"chr11",452576,0,3,2,5,"chr11",1,0.00820440693858415
"14812","chr11.47590000.47595000","chr11.47790000.47795000",200000,12,0.006213648,47590000,47790000,47595000,47795000,"chr11",452621,0,4,1,5,"chr11",1,0.0070323488045007
"14813","chr11.63600000.63605000","chr11.63960000.63965000",360000,12,0.000146018,63600000,63960000,63605000,63965000,"chr11",452678,4,15,22,41,"chr11",1,0.0576652601969058
"14814","chr11.13365000.13370000","chr11.13690000.13695000",325000,10,0.005180401,13365000,13690000,13370000,13695000,"chr11",452686,0,3,0,3,"chr11",1,0.00351617440225035
"14815","chr11.36155000.36160000","chr11.36495000.36500000",340000,10,0.004203973,36155000,36495000,36160000,36500000,"chr11",452697,3,6,2,11,"chr11",1,0.012892639474918
"14816","chr11.86670000.86675000","chr11.86940000.86945000",270000,13,0.0002084944,86670000,86940000,86675000,86945000,"chr11",452711,1,0,0,1,"chr11",1,0.00152367557430849
"14817","chr11.18550000.18555000","chr11.18745000.18750000",195000,12,0.007192356,18550000,18745000,18555000,18750000,"chr11",452758,0,5,5,10,"chr11",1,0.0140646976090014
"14818","chr11.35485000.35490000","chr11.36275000.36280000",790000,7,0.006375177,35485000,36275000,35490000,36280000,"chr11",452778,0,3,0,3,"chr11",1,0.00246132208157525
"14819","chr11.117025000.117030000","chr11.117045000.117050000",20000,47,1.112089e-06,117025000,117045000,117030000,117050000,"chr11",452787,2,13,7,22,"chr11",1,0.121190811064229
"14820","chr11.82855000.82860000","chr11.83530000.83535000",675000,9,0.0004391258,82855000,83530000,82860000,83535000,"chr11",452818,0,1,2,3,"chr11",1,0.00316455696202532
"14821","chr11.122625000.122630000","chr11.122645000.122650000",20000,38,0.001528665,122625000,122645000,122630000,122650000,"chr11",452830,2,16,7,25,"chr11",1,0.111345522737928
"14822","chr11.116770000.116775000","chr11.116955000.116960000",185000,22,2.752451e-09,116770000,116955000,116775000,116960000,"chr11",452838,2,0,6,8,"chr11",1,0.0206282231598687
"14823","chr11.63545000.63550000","chr11.63570000.63575000",25000,44,1.297103e-06,63545000,63570000,63550000,63575000,"chr11",452843,7,15,12,34,"chr11",1,0.175339896858884
"14824","chr11.925000.930000","chr11.945000.950000",20000,38,0.001528665,925000,945000,930000,950000,"chr11",452940,4,3,6,13,"chr11",1,0.0578996718237225
"14825","chr11.64815000.64820000","chr11.65565000.65570000",750000,7,0.008119404,64815000,65565000,64820000,65570000,"chr11",452951,8,23,29,60,"chr11",1,0.0492264416315049
"14826","chr11.113175000.113180000","chr11.113600000.113605000",425000,34,1.023638e-28,113175000,113600000,113180000,113605000,"chr11",453013,0,3,3,6,"chr11",1,0.0239099859353024
"14827","chr11.121195000.121200000","chr11.121425000.121430000",230000,20,6.107531e-09,121195000,121425000,121200000,121430000,"chr11",453038,0,0,1,1,"chr11",1,0.0023441162681669
"14828","chr11.129880000.129885000","chr11.130010000.130015000",130000,25,1.243403e-09,129880000,130010000,129885000,130015000,"chr11",453040,2,1,4,7,"chr11",1,0.0205110173464604
"14829","chr11.62505000.62510000","chr11.62620000.62625000",115000,15,0.005171771,62505000,62620000,62510000,62625000,"chr11",453048,7,18,20,45,"chr11",1,0.0791139240506329
"14830","chr11.78085000.78090000","chr11.78105000.78110000",20000,52,8.584672e-09,78085000,78105000,78090000,78110000,"chr11",453056,3,19,13,35,"chr11",1,0.213314580403188
"14831","chr11.57220000.57225000","chr11.57290000.57295000",70000,43,2.583251e-18,57220000,57290000,57225000,57295000,"chr11",453070,1,4,3,8,"chr11",1,0.0403187998124707
"14832","chr11.36380000.36385000","chr11.36510000.36515000",130000,19,1.51749e-05,36380000,36510000,36385000,36515000,"chr11",453078,1,3,4,8,"chr11",1,0.0178152836380684
"14833","chr11.71635000.71640000","chr11.72140000.72145000",505000,9,0.002442518,71635000,72140000,71640000,72145000,"chr11",453095,3,12,7,22,"chr11",1,0.0232067510548523
"14834","chr11.122505000.122510000","chr11.122780000.122785000",275000,12,0.0008089154,122505000,122780000,122510000,122785000,"chr11",453108,6,20,6,32,"chr11",1,0.0450070323488045
"14835","chr11.57525000.57530000","chr11.57565000.57570000",40000,64,2.058473e-26,57525000,57565000,57530000,57570000,"chr11",453113,0,1,2,3,"chr11",1,0.0225035161744023
"14836","chr11.35675000.35680000","chr11.36290000.36295000",615000,8,0.004204102,35675000,36290000,35680000,36295000,"chr11",453131,1,9,5,15,"chr11",1,0.0140646976090014
"14837","chr11.45995000.46000000","chr11.46550000.46555000",555000,8,0.007006004,45995000,46550000,4.6e+07,46555000,"chr11",453177,1,6,10,17,"chr11",1,0.0159399906235349
"14838","chr11.66265000.66270000","chr11.66430000.66435000",165000,15,0.0005365909,66265000,66430000,66270000,66435000,"chr11",453194,1,2,3,6,"chr11",1,0.0105485232067511
"14839","chr11.11975000.11980000","chr11.12065000.12070000",90000,16,0.009624967,11975000,12065000,11980000,12070000,"chr11",453332,3,2,6,11,"chr11",1,0.0206282231598687
"14840","chr11.117300000.117305000","chr11.117490000.117495000",190000,20,6.837502e-08,117300000,117490000,117305000,117495000,"chr11",453339,2,6,2,10,"chr11",1,0.023441162681669
"14841","chr11.27425000.27430000","chr11.27455000.27460000",30000,37,1.319731e-05,27425000,27455000,27430000,27460000,"chr11",453349,3,18,12,33,"chr11",1,0.143108298171589
"14842","chr11.66315000.66320000","chr11.66510000.66515000",195000,13,0.002168029,66315000,66510000,66320000,66515000,"chr11",453389,2,8,6,16,"chr11",1,0.0243788091889358
"14843","chr11.6400000.6405000","chr11.6435000.6440000",35000,32,7.227617e-05,6400000,6435000,6405000,6440000,"chr11",453405,0,2,0,2,"chr11",1,0.00750117205813408
"14844","chr11.119100000.119105000","chr11.119120000.119125000",20000,47,1.112089e-06,119100000,119120000,119105000,119125000,"chr11",453415,0,6,4,10,"chr11",1,0.0550867323019222
"14845","chr11.46930000.46935000","chr11.47180000.47185000",250000,16,3.1353e-06,46930000,47180000,46935000,47185000,"chr11",453427,4,12,8,24,"chr11",1,0.0450070323488045
"14846","chr11.117835000.117840000","chr11.117855000.117860000",20000,40,0.0003756276,117835000,117855000,117840000,117860000,"chr11",453428,0,4,0,4,"chr11",1,0.0187529301453352
"14847","chr11.61580000.61585000","chr11.61890000.61895000",310000,15,2.433873e-06,61580000,61890000,61585000,61895000,"chr11",453448,3,2,3,8,"chr11",1,0.0140646976090014
"14848","chr11.46975000.46980000","chr11.47180000.47185000",205000,24,1.339296e-11,46975000,47180000,46980000,47185000,"chr11",453461,4,12,4,20,"chr11",1,0.0562587904360056
"14849","chr11.117300000.117305000","chr11.117455000.117460000",155000,17,5.840342e-05,117300000,117455000,117305000,117460000,"chr11",453464,0,2,1,3,"chr11",1,0.0059774964838256
"14850","chr11.3805000.3810000","chr11.3855000.3860000",50000,22,0.006416007,3805000,3855000,3810000,3860000,"chr11",453517,1,1,4,6,"chr11",1,0.0154711673699015
"14851","chr11.63605000.63610000","chr11.63635000.63640000",30000,50,6.825115e-12,63605000,63635000,63610000,63640000,"chr11",453610,2,11,6,19,"chr11",1,0.111345522737928
"14852","chr11.17820000.17825000","chr11.17975000.17980000",155000,13,0.008607758,17820000,17975000,17825000,17980000,"chr11",453650,0,1,2,3,"chr11",1,0.00457102672292546
"14853","chr11.33470000.33475000","chr11.33505000.33510000",35000,27,0.004903844,33470000,33505000,33475000,33510000,"chr11",453676,3,1,6,10,"chr11",1,0.0316455696202532
"14854","chr11.117000000.117005000","chr11.117045000.117050000",45000,23,0.007192356,1.17e+08,117045000,117005000,117050000,"chr11",453738,5,11,11,27,"chr11",1,0.0727848101265823
"14855","chr11.116740000.116745000","chr11.117025000.117030000",285000,10,0.009894893,116740000,117025000,116745000,117030000,"chr11",453783,2,13,7,22,"chr11",1,0.0257852789498359
"14856","chr11.119080000.119085000","chr11.119195000.119200000",115000,28,3.632752e-11,119080000,119195000,119085000,119200000,"chr11",453788,6,14,6,26,"chr11",1,0.0853258321612752
"14857","chr11.122505000.122510000","chr11.122645000.122650000",140000,41,2.348322e-24,122505000,122645000,122510000,122650000,"chr11",453796,6,20,6,32,"chr11",1,0.153774027191749
"14858","chr11.131570000.131575000","chr11.131800000.131805000",230000,12,0.002625012,131570000,131800000,131575000,131805000,"chr11",453810,0,2,1,3,"chr11",1,0.00421940928270042
"14859","chr11.117715000.117720000","chr11.117820000.117825000",105000,20,2.737129e-05,117715000,117820000,117720000,117825000,"chr11",453851,0,1,1,2,"chr11",1,0.0046882325363338
"14860","chr11.116885000.116890000","chr11.116955000.116960000",70000,26,1.50198e-06,116885000,116955000,116890000,116960000,"chr11",453872,4,4,8,16,"chr11",1,0.0487576183778715
"14861","chr11.102265000.102270000","chr11.102320000.102325000",55000,25,0.0001461445,102265000,102320000,102270000,102325000,"chr11",453880,5,5,12,22,"chr11",1,0.0644631973745898
"14862","chr11.112150000.112155000","chr11.113135000.113140000",985000,10,2.767368e-06,112150000,113135000,112155000,113140000,"chr11",453892,4,16,11,31,"chr11",1,0.036333802156587
"14863","chr11.62555000.62560000","chr11.62620000.62625000",65000,21,0.001170751,62555000,62620000,62560000,62625000,"chr11",453916,7,19,20,46,"chr11",1,0.113220815752461
"14864","chr11.47230000.47235000","chr11.47270000.47275000",40000,26,0.002147236,47230000,47270000,47235000,47275000,"chr11",453923,0,3,2,5,"chr11",1,0.0152367557430849
"14865","chr11.36220000.36225000","chr11.36265000.36270000",45000,27,0.0002168683,36220000,36265000,36225000,36270000,"chr11",453938,2,3,1,6,"chr11",1,0.0189873417721519
"14866","chr11.46490000.46495000","chr11.46590000.46595000",100000,16,0.004591244,46490000,46590000,46495000,46595000,"chr11",453939,0,1,2,3,"chr11",1,0.00562587904360056
"14867","chr11.111985000.111990000","chr11.112070000.112075000",85000,20,0.0002305393,111985000,112070000,111990000,112075000,"chr11",453946,2,6,4,12,"chr11",1,0.0281293952180028
"14868","chr11.33720000.33725000","chr11.33760000.33765000",40000,39,2.032121e-09,33720000,33760000,33725000,33765000,"chr11",454021,2,3,2,7,"chr11",1,0.0319971870604782
"14869","chr11.47980000.47985000","chr11.48135000.48140000",155000,15,0.0008295768,47980000,48135000,47985000,48140000,"chr11",454103,0,5,2,7,"chr11",1,0.0123066104078762
"14870","chr11.116770000.116775000","chr11.116990000.116995000",220000,17,2.129751e-06,116770000,116990000,116775000,116995000,"chr11",454128,2,0,6,8,"chr11",1,0.0159399906235349
"14871","chr11.655000.660000","chr11.760000.765000",105000,15,0.009090773,655000,760000,660000,765000,"chr11",454130,2,7,7,16,"chr11",1,0.0281293952180028
"14872","chr11.113875000.113880000","chr11.114175000.114180000",300000,10,0.007625651,113875000,114175000,113880000,114180000,"chr11",454164,2,13,9,24,"chr11",1,0.0281293952180028
"14873","chr11.65040000.65045000","chr11.65090000.65095000",50000,64,1.911202e-30,65040000,65090000,65045000,65095000,"chr11",454176,7,24,23,54,"chr11",1,0.40506329113924
"14874","chr11.61950000.61955000","chr11.62080000.62085000",130000,14,0.007397049,61950000,62080000,61955000,62085000,"chr11",454200,9,20,18,47,"chr11",1,0.077121425222691
"14875","chr11.8695000.8700000","chr11.8840000.8845000",145000,14,0.004132733,8695000,8840000,8700000,8845000,"chr11",454248,2,4,2,8,"chr11",1,0.0131270511017346
"14876","chr11.35925000.35930000","chr11.36085000.36090000",160000,15,0.0006715136,35925000,36085000,35930000,36090000,"chr11",454266,5,9,8,22,"chr11",1,0.0386779184247539
"14877","chr11.10970000.10975000","chr11.11765000.11770000",795000,8,0.001056029,10970000,11765000,10975000,11770000,"chr11",454286,0,2,0,2,"chr11",1,0.00187529301453352
"14878","chr11.43810000.43815000","chr11.43830000.43835000",20000,36,0.005637993,43810000,43830000,43815000,43835000,"chr11",454316,0,2,1,3,"chr11",1,0.0126582278481013
"14879","chr11.124500000.124505000","chr11.124725000.124730000",225000,13,0.0007992574,124500000,124725000,124505000,124730000,"chr11",454345,1,3,0,4,"chr11",1,0.00609470229723394
"14880","chr11.47215000.47220000","chr11.47255000.47260000",40000,27,0.000917774,47215000,47255000,47220000,47260000,"chr11",454352,5,20,25,50,"chr11",1,0.158227848101266
"14881","chr11.110075000.110080000","chr11.110170000.110175000",95000,21,2.089396e-05,110075000,110170000,110080000,110175000,"chr11",454357,0,2,2,4,"chr11",1,0.00984528832630099
"14882","chr11.62570000.62575000","chr11.62600000.62605000",30000,32,0.0009985604,62570000,62600000,62575000,62605000,"chr11",454415,0,3,1,4,"chr11",1,0.0150023441162682
"14883","chr11.64685000.64690000","chr11.65040000.65045000",355000,12,0.0001588471,64685000,65040000,64690000,65045000,"chr11",454473,2,1,1,4,"chr11",1,0.00562587904360056
"14884","chr11.6250000.6255000","chr11.6495000.6500000",245000,11,0.006332282,6250000,6495000,6255000,6500000,"chr11",454476,1,0,1,2,"chr11",1,0.00257852789498359
"14885","chr11.117590000.117595000","chr11.117670000.117675000",80000,17,0.008774219,117590000,117670000,117595000,117675000,"chr11",454502,0,1,5,6,"chr11",1,0.0119549929676512
"14886","chr11.64810000.64815000","chr11.64885000.64890000",75000,18,0.005637993,64810000,64885000,64815000,64890000,"chr11",454504,4,5,4,13,"chr11",1,0.0274261603375527
"14887","chr11.6575000.6580000","chr11.6595000.6600000",20000,39,0.0007739803,6575000,6595000,6580000,6600000,"chr11",454539,4,7,2,13,"chr11",1,0.0594233473980309
"14888","chr11.117720000.117725000","chr11.117805000.117810000",85000,25,3.807625e-07,117720000,117805000,117725000,117810000,"chr11",454545,0,0,2,2,"chr11",1,0.00586029067041725
"14889","chr11.36395000.36400000","chr11.36455000.36460000",60000,20,0.006541073,36395000,36455000,36400000,36460000,"chr11",454550,0,0,4,4,"chr11",1,0.00937646507266761
"14890","chr11.48005000.48010000","chr11.48040000.48045000",35000,39,4.770895e-08,48005000,48040000,48010000,48045000,"chr11",454553,0,13,9,22,"chr11",1,0.10056258790436
"14891","chr11.65150000.65155000","chr11.65290000.65295000",140000,23,1.544261e-08,65150000,65290000,65155000,65295000,"chr11",454570,3,8,9,20,"chr11",1,0.0539146741678387
"14892","chr11.17410000.17415000","chr11.17525000.17530000",115000,20,1.125993e-05,17410000,17525000,17415000,17530000,"chr11",454574,2,2,5,9,"chr11",1,0.0210970464135021
"14893","chr11.46590000.46595000","chr11.46610000.46615000",20000,48,4.383315e-07,46590000,46610000,46595000,46615000,"chr11",454597,10,19,24,53,"chr11",1,0.29817158931083
"14894","chr11.63960000.63965000","chr11.63985000.63990000",25000,36,0.001061553,63960000,63985000,63965000,63990000,"chr11",454611,4,19,15,38,"chr11",1,0.160337552742616
"14895","chr11.125465000.125470000","chr11.126145000.126150000",680000,8,0.00248846,125465000,126145000,125470000,126150000,"chr11",454639,4,11,11,26,"chr11",1,0.0243788091889358
"14896","chr11.124500000.124505000","chr11.124735000.124740000",235000,13,0.000580854,124500000,124735000,124505000,124740000,"chr11",454653,0,3,0,3,"chr11",1,0.00457102672292546
"14897","chr11.66220000.66225000","chr11.66405000.66410000",185000,14,0.000862795,66220000,66405000,66225000,66410000,"chr11",454671,2,7,4,13,"chr11",1,0.0213314580403188
"14898","chr11.85665000.85670000","chr11.85850000.85855000",185000,15,0.0002257865,85665000,85850000,85670000,85855000,"chr11",454701,2,12,12,26,"chr11",1,0.0457102672292546
"14899","chr11.122110000.122115000","chr11.122140000.122145000",30000,38,5.063321e-06,122110000,122140000,122115000,122145000,"chr11",454752,5,6,8,19,"chr11",1,0.0846225972808251
"14900","chr11.35980000.35985000","chr11.36015000.36020000",35000,36,1.318566e-06,35980000,36015000,35985000,36020000,"chr11",454762,0,3,4,7,"chr11",1,0.029535864978903
"14901","chr11.33900000.33905000","chr11.33970000.33975000",70000,19,0.003994913,33900000,33970000,33905000,33975000,"chr11",454793,2,3,5,10,"chr11",1,0.0222691045475856
"14902","chr11.111450000.111455000","chr11.111730000.111735000",280000,11,0.002958416,111450000,111730000,111455000,111735000,"chr11",454812,0,2,0,2,"chr11",1,0.00257852789498359
"14903","chr11.62555000.62560000","chr11.62595000.62600000",40000,35,2.622182e-07,62555000,62595000,62560000,62600000,"chr11",454837,0,0,2,2,"chr11",1,0.00820440693858415
"14904","chr11.125360000.125365000","chr11.125465000.125470000",105000,24,9.324127e-08,125360000,125465000,125365000,125470000,"chr11",454874,4,9,7,20,"chr11",1,0.0562587904360056
"14905","chr11.9855000.9860000","chr11.10310000.10315000",455000,9,0.004263791,9855000,10310000,9860000,10315000,"chr11",454882,0,0,3,3,"chr11",1,0.00316455696202532
"14906","chr11.63610000.63615000","chr11.63920000.63925000",310000,13,7.560574e-05,63610000,63920000,63615000,63925000,"chr11",454898,2,17,11,30,"chr11",1,0.0457102672292546
"14907","chr11.118955000.118960000","chr11.119065000.119070000",110000,18,0.0002301419,118955000,119065000,118960000,119070000,"chr11",454900,4,11,7,22,"chr11",1,0.0464135021097046
"14908","chr11.116705000.116710000","chr11.116970000.116975000",265000,14,4.992377e-05,116705000,116970000,116710000,116975000,"chr11",454943,1,9,8,18,"chr11",1,0.029535864978903
"14909","chr11.62495000.62500000","chr11.62610000.62615000",115000,24,2.914377e-08,62495000,62610000,62500000,62615000,"chr11",454953,2,3,2,7,"chr11",1,0.019690576652602
"14910","chr11.118565000.118570000","chr11.118625000.118630000",60000,23,0.0003939866,118565000,118625000,118570000,118630000,"chr11",454975,0,3,1,4,"chr11",1,0.0107829348335677
"14911","chr11.19735000.19740000","chr11.19755000.19760000",20000,43,3.546213e-05,19735000,19755000,19740000,19760000,"chr11",454997,0,0,3,3,"chr11",1,0.0151195499296765
"14912","chr11.8700000.8705000","chr11.8830000.8835000",130000,22,1.72859e-07,8700000,8830000,8705000,8835000,"chr11",455012,1,4,5,10,"chr11",1,0.0257852789498359
"14913","chr11.65010000.65015000","chr11.65095000.65100000",85000,18,0.002082171,65010000,65095000,65015000,65100000,"chr11",455047,11,27,32,70,"chr11",1,0.147679324894515
"14914","chr11.92970000.92975000","chr11.93330000.93335000",360000,11,0.0007225999,92970000,93330000,92975000,93335000,"chr11",455069,1,6,3,10,"chr11",1,0.012892639474918
"14915","chr11.47425000.47430000","chr11.47605000.47610000",180000,17,1.56904e-05,47425000,47605000,47430000,47610000,"chr11",455071,7,14,21,42,"chr11",1,0.0836849507735584
"14916","chr11.11805000.11810000","chr11.11990000.11995000",185000,13,0.003026915,11805000,11990000,11810000,11995000,"chr11",455088,2,1,2,5,"chr11",1,0.00761837787154243
"14917","chr11.6390000.6395000","chr11.6505000.6510000",115000,16,0.001742096,6390000,6505000,6395000,6510000,"chr11",455090,1,3,1,5,"chr11",1,0.00937646507266761
"14918","chr11.33875000.33880000","chr11.34265000.34270000",390000,9,0.008857878,33875000,34265000,33880000,34270000,"chr11",455099,0,8,4,12,"chr11",1,0.0126582278481013
"14919","chr11.102265000.102270000","chr11.102285000.102290000",20000,49,1.721009e-07,102265000,102285000,102270000,102290000,"chr11",455126,6,5,8,19,"chr11",1,0.109118612283169
"14920","chr11.46615000.46620000","chr11.46635000.46640000",20000,36,0.005637993,46615000,46635000,46620000,46640000,"chr11",455179,4,19,19,42,"chr11",1,0.177215189873418
"14921","chr11.83250000.83255000","chr11.83305000.83310000",55000,25,0.0001461445,83250000,83305000,83255000,83310000,"chr11",455197,1,3,4,8,"chr11",1,0.023441162681669
"14922","chr11.61625000.61630000","chr11.61760000.61765000",135000,14,0.006073743,61625000,61760000,61630000,61765000,"chr11",455248,0,5,3,8,"chr11",1,0.0131270511017346
"14923","chr11.117300000.117305000","chr11.117675000.117680000",375000,29,2.137194e-21,117300000,117675000,117305000,117680000,"chr11",455261,1,3,2,6,"chr11",1,0.020393811533052
"14924","chr11.83720000.83725000","chr11.83980000.83985000",260000,11,0.004516084,83720000,83980000,83725000,83985000,"chr11",455263,0,6,1,7,"chr11",1,0.00902484763244257
"14925","chr11.131590000.131595000","chr11.132165000.132170000",575000,9,0.001156895,131590000,132165000,131595000,132170000,"chr11",455265,1,2,3,6,"chr11",1,0.00632911392405063
"14926","chr11.61850000.61855000","chr11.62080000.62085000",230000,15,3.515331e-05,61850000,62080000,61855000,62085000,"chr11",455277,0,7,12,19,"chr11",1,0.0334036568213783
"14927","chr11.62500000.62505000","chr11.62550000.62555000",50000,28,2.055153e-05,62500000,62550000,62505000,62555000,"chr11",455290,3,12,4,19,"chr11",1,0.0623534927332396
"14928","chr11.65490000.65495000","chr11.65590000.65595000",100000,21,1.210377e-05,65490000,65590000,65495000,65595000,"chr11",455303,1,8,2,11,"chr11",1,0.0270745428973277
"14929","chr11.117595000.117600000","chr11.117620000.117625000",25000,33,0.008119404,117595000,117620000,117600000,117625000,"chr11",455319,0,2,0,2,"chr11",1,0.00773558368495077
"14930","chr11.66345000.66350000","chr11.66415000.66420000",70000,29,2.615657e-08,66345000,66415000,66350000,66420000,"chr11",455363,0,2,1,3,"chr11",1,0.010196905766526
"14931","chr11.62675000.62680000","chr11.62790000.62795000",115000,59,4.536713e-41,62675000,62790000,62680000,62795000,"chr11",455391,4,13,9,26,"chr11",1,0.179793717768401
"14932","chr11.34250000.34255000","chr11.34275000.34280000",25000,38,0.0002343275,34250000,34275000,34255000,34280000,"chr11",455395,2,4,0,6,"chr11",1,0.0267229254571027
"14933","chr11.82995000.83000000","chr11.83405000.83410000",410000,9,0.007051584,82995000,83405000,8.3e+07,83410000,"chr11",455399,2,2,2,6,"chr11",1,0.00632911392405063
"14934","chr11.61760000.61765000","chr11.61850000.61855000",90000,35,1.207671e-14,61760000,61850000,61765000,61855000,"chr11",455401,0,7,3,10,"chr11",1,0.0410220346929208
"14935","chr11.27425000.27430000","chr11.27460000.27465000",35000,34,1.046716e-05,27425000,27460000,27430000,27465000,"chr11",455420,3,8,7,18,"chr11",1,0.0717299578059072
"14936","chr11.62540000.62545000","chr11.62610000.62615000",70000,24,1.834963e-05,62540000,62610000,62545000,62615000,"chr11",455455,1,1,0,2,"chr11",1,0.00562587904360056
"14937","chr11.117225000.117230000","chr11.117835000.117840000",610000,9,0.0008163543,117225000,117835000,117230000,117840000,"chr11",455461,2,5,1,8,"chr11",1,0.00843881856540084
"14938","chr11.95785000.95790000","chr11.96105000.96110000",320000,10,0.005623782,95785000,96105000,95790000,96110000,"chr11",455472,0,1,3,4,"chr11",1,0.0046882325363338
"14939","chr11.71790000.71795000","chr11.72140000.72145000",350000,11,0.0008378185,71790000,72140000,71795000,72145000,"chr11",455477,6,12,7,25,"chr11",1,0.0322315986872949
"14940","chr11.11395000.11400000","chr11.11785000.11790000",390000,10,0.002147236,11395000,11785000,11400000,11790000,"chr11",455482,1,1,0,2,"chr11",1,0.0023441162681669
"14941","chr11.121195000.121200000","chr11.121380000.121385000",185000,17,1.211481e-05,121195000,121380000,121200000,121385000,"chr11",455499,0,0,3,3,"chr11",1,0.0059774964838256
"14942","chr11.85665000.85670000","chr11.85825000.85830000",160000,16,0.0001795382,85665000,85825000,85670000,85830000,"chr11",455518,0,0,2,2,"chr11",1,0.00375058602906704
"14943","chr11.65120000.65125000","chr11.65275000.65280000",155000,19,3.137748e-06,65120000,65275000,65125000,65280000,"chr11",455519,1,4,5,10,"chr11",1,0.0222691045475856
"14944","chr11.78150000.78155000","chr11.78175000.78180000",25000,33,0.008119404,78150000,78175000,78155000,78180000,"chr11",455544,2,9,8,19,"chr11",1,0.0734880450070323
"14945","chr11.61600000.61605000","chr11.61635000.61640000",35000,27,0.004903844,61600000,61635000,61605000,61640000,"chr11",455550,2,4,8,14,"chr11",1,0.0443037974683544
"14946","chr11.46610000.46615000","chr11.46710000.46715000",100000,16,0.004591244,46610000,46710000,46615000,46715000,"chr11",455597,14,49,40,103,"chr11",1,0.193155180496953
"14947","chr11.112770000.112775000","chr11.112830000.112835000",60000,25,4.569093e-05,112770000,112830000,112775000,112835000,"chr11",455601,0,0,3,3,"chr11",1,0.00879043600562588
"14948","chr11.116770000.116775000","chr11.116965000.116970000",195000,16,3.378109e-05,116770000,116965000,116775000,116970000,"chr11",455614,2,0,6,8,"chr11",1,0.0150023441162682
"14949","chr11.9230000.9235000","chr11.9260000.9265000",30000,42,8.414065e-08,9230000,9260000,9235000,9265000,"chr11",455618,2,7,12,21,"chr11",1,0.10337552742616
"14950","chr11.117535000.117540000","chr11.117675000.117680000",140000,14,0.005017178,117535000,117675000,117540000,117680000,"chr11",455634,0,3,1,4,"chr11",1,0.00656352555086732
"14951","chr11.13300000.13305000","chr11.13365000.13370000",65000,19,0.007548068,13300000,13365000,13305000,13370000,"chr11",455644,0,3,0,3,"chr11",1,0.00668073136427567
"14952","chr11.72665000.72670000","chr11.72790000.72795000",125000,15,0.003134986,72665000,72790000,72670000,72795000,"chr11",455683,2,3,7,12,"chr11",1,0.0210970464135021
"14953","chr11.77430000.77435000","chr11.78315000.78320000",885000,7,0.003610923,77430000,78315000,77435000,78320000,"chr11",455693,0,5,1,6,"chr11",1,0.00492264416315049
"14954","chr11.66650000.66655000","chr11.66715000.66720000",65000,19,0.007548068,66650000,66715000,66655000,66720000,"chr11",455696,0,2,5,7,"chr11",1,0.0155883731833099
"14955","chr11.62390000.62395000","chr11.62440000.62445000",50000,27,5.956403e-05,62390000,62440000,62395000,62445000,"chr11",455782,3,6,4,13,"chr11",1,0.0411392405063291
"14956","chr11.450000.455000","chr11.500000.505000",50000,22,0.006416007,450000,5e+05,455000,505000,"chr11",455820,0,2,2,4,"chr11",1,0.0103141115799344
"14957","chr11.33735000.33740000","chr11.33760000.33765000",25000,38,0.0002343275,33735000,33760000,33740000,33765000,"chr11",455827,2,3,2,7,"chr11",1,0.0311767463666198
"14958","chr11.62500000.62505000","chr11.62645000.62650000",145000,19,5.822505e-06,62500000,62645000,62505000,62650000,"chr11",455845,0,0,3,3,"chr11",1,0.00668073136427567
"14959","chr11.72785000.72790000","chr11.72845000.72850000",60000,21,0.002710311,72785000,72845000,72790000,72850000,"chr11",455869,4,9,7,20,"chr11",1,0.0492264416315049
"14960","chr11.117490000.117495000","chr11.117670000.117675000",180000,18,3.333889e-06,117490000,117670000,117495000,117675000,"chr11",455925,0,1,2,3,"chr11",1,0.00632911392405063
"14961","chr11.83020000.83025000","chr11.83250000.83255000",230000,11,0.009090773,83020000,83250000,83025000,83255000,"chr11",455929,1,1,3,5,"chr11",1,0.00644631973745898
"14962","chr11.35940000.35945000","chr11.35980000.35985000",40000,28,0.0003782187,35940000,35980000,35945000,35985000,"chr11",455933,1,2,1,4,"chr11",1,0.0131270511017346
"14963","chr11.9185000.9190000","chr11.9460000.9465000",275000,13,0.0001815381,9185000,9460000,9190000,9465000,"chr11",455971,0,7,2,9,"chr11",1,0.0137130801687764
"14964","chr11.78045000.78050000","chr11.78085000.78090000",40000,29,0.0001484255,78045000,78085000,78050000,78090000,"chr11",456022,3,18,13,34,"chr11",1,0.115564932020628
"14965","chr11.3805000.3810000","chr11.4095000.4100000",290000,14,2.398897e-05,3805000,4095000,3810000,4100000,"chr11",456079,4,14,12,30,"chr11",1,0.0492264416315049
"14966","chr11.66890000.66895000","chr11.66910000.66915000",20000,44,1.55559e-05,66890000,66910000,66895000,66915000,"chr11",456132,0,20,11,31,"chr11",1,0.159868729488983
"14967","chr11.119080000.119085000","chr11.119175000.119180000",95000,17,0.002376085,119080000,119175000,119085000,119180000,"chr11",456159,7,14,6,27,"chr11",1,0.0537974683544304
"14968","chr11.65475000.65480000","chr11.65585000.65590000",110000,29,1.25081e-11,65475000,65585000,65480000,65590000,"chr11",456180,0,5,2,7,"chr11",1,0.023792780121894
"14969","chr11.128830000.128835000","chr11.129595000.129600000",765000,7,0.007397049,128830000,129595000,128835000,129600000,"chr11",456267,0,1,0,1,"chr11",1,0.000820440693858415
"14970","chr11.78060000.78065000","chr11.78095000.78100000",35000,31,0.0001815381,78060000,78095000,78065000,78100000,"chr11",456281,2,10,14,26,"chr11",1,0.0944678856071261
"14971","chr11.116810000.116815000","chr11.116955000.116960000",145000,18,2.487399e-05,116810000,116955000,116815000,116960000,"chr11",456363,4,4,6,14,"chr11",1,0.029535864978903
"14972","chr11.62670000.62675000","chr11.62770000.62775000",100000,24,1.748735e-07,62670000,62770000,62675000,62775000,"chr11",456380,2,18,10,30,"chr11",1,0.0843881856540084
"14973","chr11.4065000.4070000","chr11.4085000.4090000",20000,48,4.383315e-07,4065000,4085000,4070000,4090000,"chr11",456404,3,1,0,4,"chr11",1,0.0225035161744023
"14974","chr11.116890000.116895000","chr11.116955000.116960000",65000,23,0.0001480939,116890000,116955000,116895000,116960000,"chr11",456411,4,4,8,16,"chr11",1,0.043131739334271
"14975","chr11.124495000.124500000","chr11.124735000.124740000",240000,13,0.0005000665,124495000,124735000,124500000,124740000,"chr11",456416,0,3,2,5,"chr11",1,0.00761837787154243
"14976","chr11.12090000.12095000","chr11.12905000.12910000",815000,7,0.005533772,12090000,12905000,12095000,12910000,"chr11",456430,4,7,20,31,"chr11",1,0.0254336615096109
"14977","chr11.47000000.47005000","chr11.47160000.47165000",160000,14,0.002286979,4.7e+07,47160000,47005000,47165000,"chr11",456432,2,4,0,6,"chr11",1,0.00984528832630099
"14978","chr11.62550000.62555000","chr11.62595000.62600000",45000,23,0.007192356,62550000,62595000,62555000,62600000,"chr11",456483,0,0,2,2,"chr11",1,0.00539146741678387
"14979","chr11.62495000.62500000","chr11.62600000.62605000",105000,15,0.009090773,62495000,62600000,62500000,62605000,"chr11",456484,0,3,1,4,"chr11",1,0.0070323488045007
"14980","chr11.47180000.47185000","chr11.47280000.47285000",100000,17,0.00158388,47180000,47280000,47185000,47285000,"chr11",456487,4,12,8,24,"chr11",1,0.0478199718706048
"14981","chr11.118240000.118245000","chr11.118355000.118360000",115000,18,0.0001596608,118240000,118355000,118245000,118360000,"chr11",456499,0,1,0,1,"chr11",1,0.00210970464135021
"14982","chr11.83010000.83015000","chr11.83305000.83310000",295000,11,0.002179846,83010000,83305000,83015000,83310000,"chr11",456502,4,8,6,18,"chr11",1,0.0232067510548523
"14983","chr11.117375000.117380000","chr11.117465000.117470000",90000,18,0.00126728,117375000,117465000,117380000,117470000,"chr11",456519,0,2,1,3,"chr11",1,0.00632911392405063
"14984","chr11.117315000.117320000","chr11.117655000.117660000",340000,12,0.0002077962,117315000,117655000,117320000,117660000,"chr11",456523,2,5,0,7,"chr11",1,0.00984528832630099
"14985","chr11.62685000.62690000","chr11.62790000.62795000",105000,16,0.003252287,62685000,62790000,62690000,62795000,"chr11",456538,6,18,30,54,"chr11",1,0.10126582278481
"14986","chr11.7120000.7125000","chr11.7570000.7575000",450000,10,0.0009686617,7120000,7570000,7125000,7575000,"chr11",456557,0,2,1,3,"chr11",1,0.00351617440225035
"14987","chr11.116900000.116905000","chr11.116920000.116925000",20000,37,0.00299301,116900000,116920000,116905000,116925000,"chr11",456584,2,3,7,12,"chr11",1,0.0520393811533052
"14988","chr11.121315000.121320000","chr11.121445000.121450000",130000,20,3.567333e-06,121315000,121445000,121320000,121450000,"chr11",456605,1,4,2,7,"chr11",1,0.0164088138771683
"14989","chr11.118065000.118070000","chr11.118190000.118195000",125000,15,0.003134986,118065000,118190000,118070000,118195000,"chr11",456608,0,0,8,8,"chr11",1,0.0140646976090014
"14990","chr11.118995000.119000000","chr11.119085000.119090000",90000,16,0.009624967,118995000,119085000,1.19e+08,119090000,"chr11",456626,3,17,25,45,"chr11",1,0.0843881856540084
"14991","chr11.695000.700000","chr11.760000.765000",65000,21,0.001170751,695000,760000,7e+05,765000,"chr11",456645,7,12,10,29,"chr11",1,0.0713783403656821
"14992","chr11.112745000.112750000","chr11.112780000.112785000",35000,35,3.743886e-06,112745000,112780000,112750000,112785000,"chr11",456653,1,2,4,7,"chr11",1,0.0287154242850445
"14993","chr11.126425000.126430000","chr11.127225000.127230000",800000,9,0.0001483062,126425000,127225000,126430000,127230000,"chr11",456660,0,2,1,3,"chr11",1,0.00316455696202532
"14994","chr11.35675000.35680000","chr11.35800000.35805000",125000,18,8.05065e-05,35675000,35800000,35680000,35805000,"chr11",456695,0,7,3,10,"chr11",1,0.0210970464135021
"14995","chr11.111450000.111455000","chr11.111715000.111720000",265000,16,1.760541e-06,111450000,111715000,111455000,111720000,"chr11",456698,0,2,2,4,"chr11",1,0.00750117205813408
"14996","chr11.117465000.117470000","chr11.117655000.117660000",190000,13,0.002567712,117465000,117655000,117470000,117660000,"chr11",456731,0,2,0,2,"chr11",1,0.00304735114861697
"14997","chr11.66855000.66860000","chr11.67005000.67010000",150000,17,7.601346e-05,66855000,67005000,66860000,67010000,"chr11",456781,0,4,0,4,"chr11",1,0.00796999531176746
"14998","chr11.116885000.116890000","chr11.116900000.116905000",15000,36,0.005637993,116885000,116900000,116890000,116905000,"chr11",456784,2,3,7,12,"chr11",1,0.0506329113924051
"14999","chr11.117300000.117305000","chr11.117365000.117370000",65000,20,0.003068502,117300000,117365000,117305000,117370000,"chr11",456788,1,3,1,5,"chr11",1,0.0117205813408345
"15000","chr11.46900000.46905000","chr11.47185000.47190000",285000,13,0.0001405476,46900000,47185000,46905000,47190000,"chr11",456800,1,6,4,11,"chr11",1,0.0167604313173933
"15001","chr11.47425000.47430000","chr11.47580000.47585000",155000,13,0.008607758,47425000,47580000,47430000,47585000,"chr11",456807,7,14,16,37,"chr11",1,0.056375996249414
"15002","chr11.46650000.46655000","chr11.46695000.46700000",45000,23,0.007192356,46650000,46695000,46655000,46700000,"chr11",456836,0,6,4,10,"chr11",1,0.0269573370839194
"15003","chr11.116740000.116745000","chr11.117045000.117050000",305000,12,0.0004159643,116740000,117045000,116745000,117050000,"chr11",456843,5,17,13,35,"chr11",1,0.0492264416315049
"15004","chr11.85665000.85670000","chr11.85775000.85780000",110000,23,2.373591e-07,85665000,85775000,85670000,85780000,"chr11",456857,3,4,4,11,"chr11",1,0.0296530707923113
"15005","chr11.85665000.85670000","chr11.85965000.85970000",300000,10,0.007625651,85665000,85965000,85670000,85970000,"chr11",456865,4,12,12,28,"chr11",1,0.0328176277543366
"15006","chr11.124960000.124965000","chr11.125250000.125255000",290000,10,0.009090773,124960000,125250000,124965000,125255000,"chr11",456894,4,5,5,14,"chr11",1,0.0164088138771683
"15007","chr11.4065000.4070000","chr11.4095000.4100000",30000,32,0.0009985604,4065000,4095000,4070000,4100000,"chr11",456908,3,1,5,9,"chr11",1,0.0337552742616034
"15008","chr11.131275000.131280000","chr11.131540000.131545000",265000,11,0.004049008,131275000,131540000,131280000,131545000,"chr11",456911,0,0,1,1,"chr11",1,0.0012892639474918
"15009","chr11.3800000.3805000","chr11.4095000.4100000",295000,15,3.725679e-06,3800000,4095000,3805000,4100000,"chr11",456923,4,14,18,36,"chr11",1,0.0632911392405063
"15010","chr11.3835000.3840000","chr11.4095000.4100000",260000,16,2.117696e-06,3835000,4095000,3840000,4100000,"chr11",456960,0,3,1,4,"chr11",1,0.00750117205813408
"15011","chr11.46900000.46905000","chr11.47155000.47160000",255000,14,6.911283e-05,46900000,47155000,46905000,47160000,"chr11",456968,1,5,1,7,"chr11",1,0.0114861697140178
"15012","chr11.78000000.78005000","chr11.78120000.78125000",120000,15,0.004027368,7.8e+07,78120000,78005000,78125000,"chr11",456977,8,20,15,43,"chr11",1,0.0755977496483826
"15013","chr11.75590000.75595000","chr11.75865000.75870000",275000,11,0.003252287,75590000,75865000,75595000,75870000,"chr11",456990,0,2,1,3,"chr11",1,0.00386779184247539
"15014","chr11.73335000.73340000","chr11.73575000.73580000",240000,11,0.007139806,73335000,73575000,73340000,73580000,"chr11",457016,0,5,1,6,"chr11",1,0.00773558368495077
"15015","chr11.83550000.83555000","chr11.83740000.83745000",190000,12,0.00838713,83550000,83740000,83555000,83745000,"chr11",457033,1,1,1,3,"chr11",1,0.00421940928270042
"15016","chr11.62505000.62510000","chr11.62610000.62615000",105000,18,0.0003452499,62505000,62610000,62510000,62615000,"chr11",457042,2,3,2,7,"chr11",1,0.0147679324894515
"15017","chr11.64585000.64590000","chr11.64775000.64780000",190000,13,0.002567712,64585000,64775000,64590000,64780000,"chr11",457043,0,2,0,2,"chr11",1,0.00304735114861697
"15018","chr11.46935000.46940000","chr11.47180000.47185000",245000,21,3.693426e-10,46935000,47180000,46940000,47185000,"chr11",457044,4,12,8,24,"chr11",1,0.0590717299578059
"15019","chr11.65025000.65030000","chr11.65090000.65095000",65000,27,1.297689e-06,65025000,65090000,65030000,65095000,"chr11",457046,13,16,26,55,"chr11",1,0.174050632911392
"15020","chr11.65830000.65835000","chr11.65890000.65895000",60000,20,0.006541073,65830000,65890000,65835000,65895000,"chr11",457086,1,5,3,9,"chr11",1,0.0210970464135021
"15021","chr11.120305000.120310000","chr11.120325000.120330000",20000,42,7.950065e-05,120305000,120325000,120310000,120330000,"chr11",457092,0,0,2,2,"chr11",1,0.00984528832630099
"15022","chr11.118650000.118655000","chr11.118755000.118760000",105000,22,1.760541e-06,118650000,118755000,118655000,118760000,"chr11",457096,0,9,3,12,"chr11",1,0.0309423347398031
"15023","chr11.120210000.120215000","chr11.120305000.120310000",95000,17,0.002376085,120210000,120305000,120215000,120310000,"chr11",457120,0,0,1,1,"chr11",1,0.00199249882794187
"15024","chr11.116740000.116745000","chr11.116965000.116970000",225000,26,4.327989e-14,116740000,116965000,116745000,116970000,"chr11",457170,7,23,18,48,"chr11",1,0.146272855133615
"15025","chr11.3835000.3840000","chr11.4070000.4075000",235000,12,0.002286979,3835000,4070000,3840000,4075000,"chr11",457176,0,2,1,3,"chr11",1,0.00421940928270042
"15026","chr11.120380000.120385000","chr11.120680000.120685000",300000,12,0.0004572997,120380000,120680000,120385000,120685000,"chr11",457192,0,0,2,2,"chr11",1,0.00281293952180028
"15027","chr11.113070000.113075000","chr11.113135000.113140000",65000,30,2.420168e-08,113070000,113135000,113075000,113140000,"chr11",457235,1,12,10,23,"chr11",1,0.0808720112517581
"15028","chr11.62500000.62505000","chr11.62620000.62625000",120000,25,3.374627e-09,62500000,62620000,62505000,62625000,"chr11",457240,3,12,4,19,"chr11",1,0.0556727613689639
"15029","chr11.78000000.78005000","chr11.78095000.78100000",95000,16,0.006541073,7.8e+07,78095000,78005000,78100000,"chr11",457255,2,10,14,26,"chr11",1,0.0487576183778715
"15030","chr11.35675000.35680000","chr11.36155000.36160000",480000,12,1.866393e-05,35675000,36155000,35680000,36160000,"chr11",457265,1,6,2,9,"chr11",1,0.0126582278481013
"15031","chr11.44595000.44600000","chr11.44630000.44635000",35000,28,0.002286979,44595000,44630000,44600000,44635000,"chr11",457270,0,8,5,13,"chr11",1,0.0426629160806376
"15032","chr11.36155000.36160000","chr11.36265000.36270000",110000,20,1.727155e-05,36155000,36265000,36160000,36270000,"chr11",457278,2,3,1,6,"chr11",1,0.0140646976090014
"15033","chr11.46550000.46555000","chr11.46615000.46620000",65000,19,0.007548068,46550000,46615000,46555000,46620000,"chr11",457361,4,19,19,42,"chr11",1,0.0935302390998594
"15034","chr11.75620000.75625000","chr11.75655000.75660000",35000,32,7.227617e-05,75620000,75655000,75625000,75660000,"chr11",457427,0,3,7,10,"chr11",1,0.0375058602906704
"15035","chr11.111985000.111990000","chr11.112020000.112025000",35000,31,0.0001815381,111985000,112020000,111990000,112025000,"chr11",457431,2,12,10,24,"chr11",1,0.0872011251758087
"15036","chr11.46885000.46890000","chr11.47150000.47155000",265000,13,0.0002376872,46885000,47150000,46890000,47155000,"chr11",457439,0,9,6,15,"chr11",1,0.0228551336146273
"15037","chr11.36015000.36020000","chr11.36145000.36150000",130000,17,0.0002241194,36015000,36145000,36020000,36150000,"chr11",457455,0,3,4,7,"chr11",1,0.0139474917955931
"15038","chr11.117105000.117110000","chr11.117180000.117185000",75000,24,7.487435e-06,117105000,117180000,117110000,117185000,"chr11",457457,0,11,4,15,"chr11",1,0.0421940928270042
"15039","chr11.57510000.57515000","chr11.57530000.57535000",20000,51,2.41668e-08,57510000,57530000,57515000,57535000,"chr11",457505,6,19,18,43,"chr11",1,0.257032348804501
"15040","chr11.117315000.117320000","chr11.117675000.117680000",360000,22,2.102954e-13,117315000,117675000,117320000,117680000,"chr11",457509,1,3,2,6,"chr11",1,0.0154711673699015
"15041","chr11.9185000.9190000","chr11.9230000.9235000",45000,28,7.968688e-05,9185000,9230000,9190000,9235000,"chr11",457518,0,7,2,9,"chr11",1,0.029535864978903
"15042","chr11.61695000.61700000","chr11.61850000.61855000",155000,24,7.835665e-10,61695000,61850000,61700000,61855000,"chr11",457519,0,0,2,2,"chr11",1,0.00562587904360056
"15043","chr11.47280000.47285000","chr11.47425000.47430000",145000,16,0.0003756276,47280000,47425000,47285000,47430000,"chr11",457523,7,14,17,38,"chr11",1,0.0712611345522738
"15044","chr11.65150000.65155000","chr11.65275000.65280000",125000,54,9.471295e-37,65150000,65275000,65155000,65280000,"chr11",457526,1,4,5,10,"chr11",1,0.0632911392405063
"15045","chr11.100555000.100560000","chr11.100720000.100725000",165000,24,3.394365e-10,100555000,100720000,100560000,100725000,"chr11",457527,1,3,4,8,"chr11",1,0.0225035161744023
"15046","chr11.61600000.61605000","chr11.62080000.62085000",480000,10,0.000655038,61600000,62080000,61605000,62085000,"chr11",457532,3,10,8,21,"chr11",1,0.0246132208157525
"15047","chr11.8705000.8710000","chr11.8830000.8835000",125000,28,1.05899e-11,8705000,8830000,8710000,8835000,"chr11",457581,1,4,3,8,"chr11",1,0.0262541022034693
"15048","chr11.124795000.124800000","chr11.125330000.125335000",535000,8,0.00838713,124795000,125330000,124800000,125335000,"chr11",457648,1,0,1,2,"chr11",1,0.00187529301453352
"15049","chr11.108965000.108970000","chr11.109730000.109735000",765000,7,0.007397049,108965000,109730000,108970000,109735000,"chr11",457649,0,3,1,4,"chr11",1,0.00328176277543366
"15050","chr11.83570000.83575000","chr11.83735000.83740000",165000,14,0.001886065,83570000,83735000,83575000,83740000,"chr11",457655,0,1,1,2,"chr11",1,0.00328176277543366
"15051","chr11.20030000.20035000","chr11.20110000.20115000",80000,18,0.003390837,20030000,20110000,20035000,20115000,"chr11",457664,0,2,0,2,"chr11",1,0.00421940928270042
"15052","chr11.35940000.35945000","chr11.36015000.36020000",75000,27,1.431277e-07,35940000,36015000,35945000,36020000,"chr11",457749,0,2,1,3,"chr11",1,0.00949367088607595
"15053","chr11.45840000.45845000","chr11.46345000.46350000",505000,9,0.002442518,45840000,46345000,45845000,46350000,"chr11",457752,2,1,1,4,"chr11",1,0.00421940928270042
"15054","chr11.131495000.131500000","chr11.131530000.131535000",35000,33,2.780765e-05,131495000,131530000,131500000,131535000,"chr11",457781,0,2,1,3,"chr11",1,0.0116033755274262
"15055","chr11.57510000.57515000","chr11.57525000.57530000",15000,40,0.0003756276,57510000,57525000,57515000,57530000,"chr11",457794,0,8,6,14,"chr11",1,0.0656352555086732
"15056","chr11.117440000.117445000","chr11.117535000.117540000",95000,19,0.0002530364,117440000,117535000,117445000,117540000,"chr11",457800,0,2,1,3,"chr11",1,0.00668073136427567
"15057","chr11.83555000.83560000","chr11.83580000.83585000",25000,37,0.0005101673,83555000,83580000,83560000,83585000,"chr11",457814,1,1,2,4,"chr11",1,0.0173464603844351
"15058","chr11.9200000.9205000","chr11.9260000.9265000",60000,28,1.335512e-06,9200000,9260000,9205000,9265000,"chr11",457824,2,5,8,15,"chr11",1,0.0492264416315049
"15059","chr11.85775000.85780000","chr11.85945000.85950000",170000,18,5.889818e-06,85775000,85945000,85780000,85950000,"chr11",457825,2,0,2,4,"chr11",1,0.00843881856540084
"15060","chr11.117765000.117770000","chr11.117835000.117840000",70000,23,5.939981e-05,117765000,117835000,117770000,117840000,"chr11",457836,1,2,1,4,"chr11",1,0.0107829348335677
"15061","chr11.117835000.117840000","chr11.117935000.117940000",100000,19,0.0001577547,117835000,117935000,117840000,117940000,"chr11",457854,2,5,1,8,"chr11",1,0.0178152836380684
"15062","chr11.78000000.78005000","chr11.78150000.78155000",150000,17,7.601346e-05,7.8e+07,78150000,78005000,78155000,"chr11",457859,6,10,8,24,"chr11",1,0.0478199718706048
"15063","chr11.63545000.63550000","chr11.63575000.63580000",30000,35,8.05065e-05,63545000,63575000,63550000,63580000,"chr11",457867,4,14,2,20,"chr11",1,0.0820440693858415
"15064","chr11.63610000.63615000","chr11.63680000.63685000",70000,18,0.0098191,63610000,63680000,63615000,63685000,"chr11",457936,7,15,15,37,"chr11",1,0.0780590717299578
"15065","chr11.111775000.111780000","chr11.111845000.111850000",70000,18,0.0098191,111775000,111845000,111780000,111850000,"chr11",457947,7,19,7,33,"chr11",1,0.069620253164557
"15066","chr11.77870000.77875000","chr11.78095000.78100000",225000,12,0.003005846,77870000,78095000,77875000,78100000,"chr11",457953,2,10,8,20,"chr11",1,0.0281293952180028
"15067","chr11.129880000.129885000","chr11.129930000.129935000",50000,35,4.198379e-09,129880000,129930000,129885000,129935000,"chr11",458015,2,1,4,7,"chr11",1,0.0287154242850445
"15068","chr11.123510000.123515000","chr11.123575000.123580000",65000,20,0.003068502,123510000,123575000,123515000,123580000,"chr11",458022,3,9,3,15,"chr11",1,0.0351617440225035
"15069","chr11.124735000.124740000","chr11.124800000.124805000",65000,19,0.007548068,124735000,124800000,124740000,124805000,"chr11",458023,0,3,2,5,"chr11",1,0.0111345522737928
"15070","chr11.35980000.35985000","chr11.36130000.36135000",150000,14,0.003390837,35980000,36130000,35985000,36135000,"chr11",458056,3,6,6,15,"chr11",1,0.0246132208157525
"15071","chr11.65490000.65495000","chr11.65645000.65650000",155000,13,0.008607758,65490000,65645000,65495000,65650000,"chr11",458098,1,9,2,12,"chr11",1,0.0182841068917018
"15072","chr11.45965000.45970000","chr11.46025000.46030000",60000,20,0.006541073,45965000,46025000,45970000,46030000,"chr11",458107,0,5,1,6,"chr11",1,0.0140646976090014
"15073","chr11.116895000.116900000","chr11.116955000.116960000",60000,30,1.04161e-07,116895000,116955000,116900000,116960000,"chr11",458112,0,4,2,6,"chr11",1,0.0210970464135021
"15074","chr11.62500000.62505000","chr11.62540000.62545000",40000,30,5.610646e-05,62500000,62540000,62505000,62545000,"chr11",458144,1,1,0,2,"chr11",1,0.0070323488045007
"15075","chr11.83010000.83015000","chr11.83530000.83535000",520000,13,1.320476e-06,83010000,83530000,83015000,83535000,"chr11",458198,0,3,2,5,"chr11",1,0.00761837787154243
"15076","chr11.77385000.77390000","chr11.77420000.77425000",35000,29,0.001027929,77385000,77420000,77390000,77425000,"chr11",458210,0,3,3,6,"chr11",1,0.020393811533052
"15077","chr11.95790000.95795000","chr11.96055000.96060000",265000,16,1.760541e-06,95790000,96055000,95795000,96060000,"chr11",458216,0,6,4,10,"chr11",1,0.0187529301453352
"15078","chr11.3020000.3025000","chr11.3040000.3045000",20000,46,2.736836e-06,3020000,3040000,3025000,3045000,"chr11",458218,1,3,7,11,"chr11",1,0.0593061415846226
"15079","chr11.118565000.118570000","chr11.118655000.118660000",90000,34,7.547693e-14,118565000,118655000,118570000,118660000,"chr11",458219,0,3,1,4,"chr11",1,0.0159399906235349
"15080","chr11.65480000.65485000","chr11.65605000.65610000",125000,15,0.003134986,65480000,65605000,65485000,65610000,"chr11",458258,0,2,3,5,"chr11",1,0.00879043600562588
"15081","chr11.126710000.126715000","chr11.126755000.126760000",45000,31,3.286126e-06,126710000,126755000,126715000,126760000,"chr11",458275,0,3,1,4,"chr11",1,0.0145335208626348
"15082","chr11.46615000.46620000","chr11.46695000.46700000",80000,17,0.008774219,46615000,46695000,46620000,46700000,"chr11",458314,0,6,4,10,"chr11",1,0.0199249882794187
"15083","chr11.27425000.27430000","chr11.27470000.27475000",45000,23,0.007192356,27425000,27470000,27430000,27475000,"chr11",458342,1,3,1,5,"chr11",1,0.0134786685419597
"15084","chr11.3850000.3855000","chr11.4090000.4095000",240000,20,3.460285e-09,3850000,4090000,3855000,4095000,"chr11",458380,1,5,5,11,"chr11",1,0.0257852789498359
"15085","chr11.9185000.9190000","chr11.9505000.9510000",320000,10,0.005623782,9185000,9505000,9190000,9510000,"chr11",458409,0,7,2,9,"chr11",1,0.0105485232067511
"15086","chr11.33195000.33200000","chr11.33350000.33355000",155000,14,0.002788217,33195000,33350000,33200000,33355000,"chr11",458434,2,8,6,16,"chr11",1,0.0262541022034693
"15087","chr11.12090000.12095000","chr11.12285000.12290000",195000,14,0.0005851188,12090000,12285000,12095000,12290000,"chr11",458445,3,10,3,16,"chr11",1,0.0262541022034693
"15088","chr11.46645000.46650000","chr11.46710000.46715000",65000,28,3.596447e-07,46645000,46710000,46650000,46715000,"chr11",458450,13,32,41,86,"chr11",1,0.282231598687295
"15089","chr11.118060000.118065000","chr11.118355000.118360000",295000,12,0.0005115795,118060000,118355000,118065000,118360000,"chr11",458500,5,11,4,20,"chr11",1,0.0281293952180028
"15090","chr11.47215000.47220000","chr11.47280000.47285000",65000,25,1.51749e-05,47215000,47280000,47220000,47285000,"chr11",458509,5,20,17,42,"chr11",1,0.123066104078762
"15091","chr11.62390000.62395000","chr11.62435000.62440000",45000,31,3.286126e-06,62390000,62435000,62395000,62440000,"chr11",458524,3,6,4,13,"chr11",1,0.0472339428035631
"15092","chr11.10970000.10975000","chr11.11785000.11790000",815000,10,1.611537e-05,10970000,11785000,10975000,11790000,"chr11",458539,0,2,0,2,"chr11",1,0.0023441162681669
"15093","chr11.61685000.61690000","chr11.61850000.61855000",165000,14,0.001886065,61685000,61850000,61690000,61855000,"chr11",458541,0,2,12,14,"chr11",1,0.0229723394280356
"15094","chr11.121535000.121540000","chr11.121965000.121970000",430000,10,0.001246533,121535000,121965000,121540000,121970000,"chr11",458576,0,4,1,5,"chr11",1,0.00586029067041725
"15095","chr11.118950000.118955000","chr11.118995000.119000000",45000,23,0.007192356,118950000,118995000,118955000,1.19e+08,"chr11",458619,10,27,30,67,"chr11",1,0.18061415846226
"15096","chr11.7570000.7575000","chr11.7670000.7675000",100000,19,0.0001577547,7570000,7670000,7575000,7675000,"chr11",458627,1,2,4,7,"chr11",1,0.0155883731833099
"15097","chr11.66315000.66320000","chr11.66605000.66610000",290000,14,2.398897e-05,66315000,66605000,66320000,66610000,"chr11",458647,2,8,13,23,"chr11",1,0.0377402719174871
"15098","chr11.116710000.116715000","chr11.116965000.116970000",255000,15,1.393979e-05,116710000,116965000,116715000,116970000,"chr11",458653,0,6,3,9,"chr11",1,0.0158227848101266
"15099","chr11.57220000.57225000","chr11.57275000.57280000",55000,26,4.976647e-05,57220000,57275000,57225000,57280000,"chr11",458675,1,2,3,6,"chr11",1,0.0182841068917018
"15100","chr11.46660000.46665000","chr11.47160000.47165000",500000,9,0.002590039,46660000,47160000,46665000,47165000,"chr11",458677,2,4,5,11,"chr11",1,0.0116033755274262
"15101","chr11.77385000.77390000","chr11.77430000.77435000",45000,24,0.003204564,77385000,77430000,77390000,77435000,"chr11",458682,0,16,9,25,"chr11",1,0.070323488045007
"15102","chr11.62550000.62555000","chr11.62620000.62625000",70000,26,1.50198e-06,62550000,62620000,62555000,62625000,"chr11",458776,4,18,12,34,"chr11",1,0.103609939052977
"15103","chr11.48040000.48045000","chr11.48095000.48100000",55000,23,0.001056029,48040000,48095000,48045000,48100000,"chr11",458781,1,5,5,11,"chr11",1,0.0296530707923113
"15104","chr11.47790000.47795000","chr11.48080000.48085000",290000,11,0.002403702,47790000,48080000,47795000,48085000,"chr11",458809,7,28,22,57,"chr11",1,0.0734880450070323
"15105","chr11.131460000.131465000","chr11.131540000.131545000",80000,18,0.003390837,131460000,131540000,131465000,131545000,"chr11",458812,0,1,1,2,"chr11",1,0.00421940928270042
"15106","chr11.66415000.66420000","chr11.66715000.66720000",300000,10,0.007625651,66415000,66715000,66420000,66720000,"chr11",458877,0,2,1,3,"chr11",1,0.00351617440225035
"15107","chr11.65025000.65030000","chr11.65115000.65120000",90000,18,0.00126728,65025000,65115000,65030000,65120000,"chr11",458895,3,5,2,10,"chr11",1,0.0210970464135021
"15108","chr11.77990000.77995000","chr11.78100000.78105000",110000,22,1.046613e-06,77990000,78100000,77995000,78105000,"chr11",458932,4,24,26,54,"chr11",1,0.139240506329114
"15109","chr11.8710000.8715000","chr11.8985000.8990000",275000,12,0.0008089154,8710000,8985000,8715000,8990000,"chr11",458961,0,5,1,6,"chr11",1,0.00843881856540084
"15110","chr11.7595000.7600000","chr11.7670000.7675000",75000,20,0.0007826491,7595000,7670000,7600000,7675000,"chr11",458981,0,0,4,4,"chr11",1,0.00937646507266761
"15111","chr11.36265000.36270000","chr11.36495000.36500000",230000,11,0.009090773,36265000,36495000,36270000,36500000,"chr11",458989,2,3,1,6,"chr11",1,0.00773558368495077
"15112","chr11.65225000.65230000","chr11.65275000.65280000",50000,43,3.902832e-14,65225000,65275000,65230000,65280000,"chr11",459004,1,4,5,10,"chr11",1,0.0503984997655884
"15113","chr11.47515000.47520000","chr11.47535000.47540000",20000,48,4.383315e-07,47515000,47535000,47520000,47540000,"chr11",459013,1,15,10,26,"chr11",1,0.146272855133615
"15114","chr11.12110000.12115000","chr11.12175000.12180000",65000,19,0.007548068,12110000,12175000,12115000,12180000,"chr11",459029,1,2,2,5,"chr11",1,0.0111345522737928
"15115","chr11.73950000.73955000","chr11.74010000.74015000",60000,22,0.001056029,73950000,74010000,73955000,74015000,"chr11",459048,1,1,1,3,"chr11",1,0.00773558368495077
"15116","chr11.62390000.62395000","chr11.62410000.62415000",20000,49,1.721009e-07,62390000,62410000,62395000,62415000,"chr11",459143,3,6,4,13,"chr11",1,0.0746601031411158
"15117","chr11.78075000.78080000","chr11.78105000.78110000",30000,33,0.0004447369,78075000,78105000,78080000,78110000,"chr11",459147,6,16,17,39,"chr11",1,0.15084388185654
"15118","chr11.119470000.119475000","chr11.119970000.119975000",500000,11,8.586531e-05,119470000,119970000,119475000,119975000,"chr11",459151,1,2,2,5,"chr11",1,0.00644631973745898
"15119","chr11.695000.700000","chr11.765000.770000",70000,24,1.834963e-05,695000,765000,7e+05,770000,"chr11",459156,6,18,18,42,"chr11",1,0.118143459915612
"15120","chr11.65540000.65545000","chr11.65830000.65835000",290000,12,0.0005709472,65540000,65830000,65545000,65835000,"chr11",459193,0,2,0,2,"chr11",1,0.00281293952180028
"15121","chr11.660000.665000","chr11.765000.770000",105000,17,0.001084652,660000,765000,665000,770000,"chr11",459197,4,20,18,42,"chr11",1,0.0836849507735584
"15122","chr11.119875000.119880000","chr11.119970000.119975000",95000,20,7.534125e-05,119875000,119970000,119880000,119975000,"chr11",459205,0,2,1,3,"chr11",1,0.0070323488045007
"15123","chr11.710000.715000","chr11.765000.770000",55000,27,1.661895e-05,710000,765000,715000,770000,"chr11",459235,6,22,18,46,"chr11",1,0.145569620253165
"15124","chr11.83580000.83585000","chr11.84140000.84145000",560000,11,3.710381e-05,83580000,84140000,83585000,84145000,"chr11",459240,0,1,2,3,"chr11",1,0.00386779184247539
"15125","chr11.6595000.6600000","chr11.6635000.6640000",40000,25,0.004759951,6595000,6635000,6600000,6640000,"chr11",459264,4,8,7,19,"chr11",1,0.0556727613689639
"15126","chr11.122110000.122115000","chr11.122320000.122325000",210000,15,7.835284e-05,122110000,122320000,122115000,122325000,"chr11",459277,4,1,2,7,"chr11",1,0.0123066104078762
"15127","chr11.83555000.83560000","chr11.83735000.83740000",180000,14,0.001049378,83555000,83735000,83560000,83740000,"chr11",459281,0,1,1,2,"chr11",1,0.00328176277543366
"15128","chr11.117490000.117495000","chr11.117620000.117625000",130000,17,0.0002241194,117490000,117620000,117495000,117625000,"chr11",459283,0,3,0,3,"chr11",1,0.0059774964838256
"15129","chr11.75550000.75555000","chr11.75865000.75870000",315000,11,0.001513469,75550000,75865000,75555000,75870000,"chr11",459297,5,5,6,16,"chr11",1,0.0206282231598687
"15130","chr11.47575000.47580000","chr11.47640000.47645000",65000,21,0.001170751,47575000,47640000,47580000,47645000,"chr11",459300,2,5,10,17,"chr11",1,0.0418424753867792
"15131","chr11.65490000.65495000","chr11.65610000.65615000",120000,25,3.374627e-09,65490000,65610000,65495000,65615000,"chr11",459311,0,2,0,2,"chr11",1,0.00586029067041725
"15132","chr11.10510000.10515000","chr11.10670000.10675000",160000,15,0.0006715136,10510000,10670000,10515000,10675000,"chr11",459404,0,2,2,4,"chr11",1,0.0070323488045007
"15133","chr11.30345000.30350000","chr11.30910000.30915000",565000,9,0.001279571,30345000,30910000,30350000,30915000,"chr11",459438,0,3,2,5,"chr11",1,0.00527426160337553
"15134","chr11.72645000.72650000","chr11.72845000.72850000",200000,14,0.0004860211,72645000,72845000,72650000,72850000,"chr11",459444,0,2,1,3,"chr11",1,0.00492264416315049
"15135","chr11.93895000.93900000","chr11.94140000.94145000",245000,12,0.001737179,93895000,94140000,93900000,94145000,"chr11",459451,0,1,2,3,"chr11",1,0.00421940928270042
"15136","chr11.57530000.57535000","chr11.57565000.57570000",35000,37,4.446715e-07,57530000,57565000,57535000,57570000,"chr11",459465,3,1,2,6,"chr11",1,0.0260196905766526
"15137","chr11.118240000.118245000","chr11.118415000.118420000",175000,16,8.595666e-05,118240000,118415000,118245000,118420000,"chr11",459469,0,1,0,1,"chr11",1,0.00187529301453352
"15138","chr11.27460000.27465000","chr11.27485000.27490000",25000,36,0.001061553,27460000,27485000,27465000,27490000,"chr11",459479,5,8,7,20,"chr11",1,0.0843881856540084
"15139","chr11.116810000.116815000","chr11.116875000.116880000",65000,24,4.783243e-05,116810000,116875000,116815000,116880000,"chr11",459489,1,3,2,6,"chr11",1,0.0168776371308017
"15140","chr11.117325000.117330000","chr11.117675000.117680000",350000,14,5.480764e-06,117325000,117675000,117330000,117680000,"chr11",459511,1,3,2,6,"chr11",1,0.00984528832630099
"15141","chr11.66255000.66260000","chr11.66430000.66435000",175000,13,0.004289421,66255000,66430000,66260000,66435000,"chr11",459597,9,15,21,45,"chr11",1,0.0685654008438819
"15142","chr11.10805000.10810000","chr11.11805000.11810000",1000000,14,7.746251e-11,10805000,11805000,10810000,11810000,"chr11",459619,5,3,6,14,"chr11",1,0.0229723394280356
"15143","chr11.117490000.117495000","chr11.117675000.117680000",185000,24,6.567819e-11,117490000,117675000,117495000,117680000,"chr11",459679,1,3,2,6,"chr11",1,0.0168776371308017
"15144","chr11.124835000.124840000","chr11.125240000.125245000",405000,9,0.007423365,124835000,125240000,124840000,125245000,"chr11",459708,0,5,9,14,"chr11",1,0.0147679324894515
"15145","chr11.35335000.35340000","chr11.35360000.35365000",25000,33,0.008119404,35335000,35360000,35340000,35365000,"chr11",459723,0,3,3,6,"chr11",1,0.0232067510548523
"15146","chr11.33170000.33175000","chr11.33360000.33365000",190000,12,0.00838713,33170000,33360000,33175000,33365000,"chr11",459740,6,16,11,33,"chr11",1,0.0464135021097046
"15147","chr11.46900000.46905000","chr11.46975000.46980000",75000,20,0.0007826491,46900000,46975000,46905000,46980000,"chr11",459745,1,8,4,13,"chr11",1,0.0304735114861697
"15148","chr11.36145000.36150000","chr11.36270000.36275000",125000,18,8.05065e-05,36145000,36270000,36150000,36275000,"chr11",459769,0,0,6,6,"chr11",1,0.0126582278481013
"15149","chr11.129920000.129925000","chr11.130000000.130005000",80000,20,0.0004232169,129920000,1.3e+08,129925000,130005000,"chr11",459780,0,2,0,2,"chr11",1,0.0046882325363338
"15150","chr11.117365000.117370000","chr11.117510000.117515000",145000,21,2.716593e-07,117365000,117510000,117370000,117515000,"chr11",459831,0,3,1,4,"chr11",1,0.00984528832630099
"15151","chr11.34265000.34270000","chr11.34315000.34320000",50000,24,0.001138728,34265000,34315000,34270000,34320000,"chr11",459843,2,8,3,13,"chr11",1,0.0365682137834037
"15152","chr11.36350000.36355000","chr11.36495000.36500000",145000,19,5.822505e-06,36350000,36495000,36355000,36500000,"chr11",459847,3,4,7,14,"chr11",1,0.0311767463666198
"15153","chr11.11975000.11980000","chr11.12050000.12055000",75000,30,1.843935e-09,11975000,12050000,11980000,12055000,"chr11",459853,2,2,2,6,"chr11",1,0.0210970464135021
"15154","chr11.62265000.62270000","chr11.62310000.62315000",45000,24,0.003204564,62265000,62310000,62270000,62315000,"chr11",459943,0,6,4,10,"chr11",1,0.0281293952180028
"15155","chr11.47845000.47850000","chr11.48135000.48140000",290000,10,0.009090773,47845000,48135000,47850000,48140000,"chr11",459952,0,5,2,7,"chr11",1,0.00820440693858415
"15156","chr11.66840000.66845000","chr11.67095000.67100000",255000,14,6.911283e-05,66840000,67095000,66845000,67100000,"chr11",459954,4,11,8,23,"chr11",1,0.0377402719174871
"15157","chr11.117105000.117110000","chr11.117205000.117210000",100000,19,0.0001577547,117105000,117205000,117110000,117210000,"chr11",459963,5,9,8,22,"chr11",1,0.0489920300046882
"15158","chr11.131940000.131945000","chr11.131980000.131985000",40000,27,0.000917774,131940000,131980000,131945000,131985000,"chr11",459985,0,2,0,2,"chr11",1,0.00632911392405063
"15159","chr11.36310000.36315000","chr11.36510000.36515000",200000,23,1.394681e-10,36310000,36510000,36315000,36515000,"chr11",460053,0,2,2,4,"chr11",1,0.0107829348335677
"15160","chr11.121935000.121940000","chr11.121965000.121970000",30000,36,3.32889e-05,121935000,121965000,121940000,121970000,"chr11",460061,0,2,1,3,"chr11",1,0.0126582278481013
"15161","chr11.117945000.117950000","chr11.117985000.117990000",40000,26,0.002147236,117945000,117985000,117950000,117990000,"chr11",460088,2,5,2,9,"chr11",1,0.0274261603375527
"15162","chr11.65100000.65105000","chr11.65275000.65280000",175000,17,2.039847e-05,65100000,65275000,65105000,65280000,"chr11",460110,1,4,5,10,"chr11",1,0.0199249882794187
"15163","chr11.9185000.9190000","chr11.9385000.9390000",200000,19,2.075414e-07,9185000,9385000,9190000,9390000,"chr11",460112,0,7,2,9,"chr11",1,0.020042194092827
"15164","chr11.119360000.119365000","chr11.119520000.119525000",160000,13,0.007192356,119360000,119520000,119365000,119525000,"chr11",460146,0,2,1,3,"chr11",1,0.00457102672292546
"15165","chr11.77870000.77875000","chr11.78100000.78105000",230000,14,0.0001619151,77870000,78100000,77875000,78105000,"chr11",460147,4,13,8,25,"chr11",1,0.0410220346929208
"15166","chr11.47425000.47430000","chr11.47575000.47580000",150000,14,0.003390837,47425000,47575000,47430000,47580000,"chr11",460166,2,5,10,17,"chr11",1,0.0278949835911861
"15167","chr11.116970000.116975000","chr11.117050000.117055000",80000,17,0.008774219,116970000,117050000,116975000,117055000,"chr11",460169,6,9,8,23,"chr11",1,0.0458274730426629
"15168","chr11.116710000.116715000","chr11.116990000.116995000",280000,12,0.0007246773,116710000,116990000,116715000,116995000,"chr11",460178,0,6,3,9,"chr11",1,0.0126582278481013
"15169","chr11.8705000.8710000","chr11.8985000.8990000",280000,15,5.910184e-06,8705000,8985000,8710000,8990000,"chr11",460186,2,6,3,11,"chr11",1,0.0193389592123769
"15170","chr11.95790000.95795000","chr11.96045000.96050000",255000,14,6.911283e-05,95790000,96045000,95795000,96050000,"chr11",460200,1,1,1,3,"chr11",1,0.00492264416315049
"15171","chr11.125340000.125345000","chr11.125360000.125365000",20000,60,1.285655e-12,125340000,125360000,125345000,125365000,"chr11",460222,0,4,1,5,"chr11",1,0.0351617440225035
"15172","chr11.65885000.65890000","chr11.65940000.65945000",55000,23,0.001056029,65885000,65940000,65890000,65945000,"chr11",460252,1,11,8,20,"chr11",1,0.0539146741678387
"15173","chr11.117465000.117470000","chr11.117620000.117625000",155000,13,0.008607758,117465000,117620000,117470000,117625000,"chr11",460253,0,2,0,2,"chr11",1,0.00304735114861697
"15174","chr11.111435000.111440000","chr11.111740000.111745000",305000,14,1.60443e-05,111435000,111740000,111440000,111745000,"chr11",460265,0,4,2,6,"chr11",1,0.00984528832630099
"15175","chr11.119090000.119095000","chr11.119110000.119115000",20000,49,1.721009e-07,119090000,119110000,119095000,119115000,"chr11",460283,0,0,1,1,"chr11",1,0.00574308485700891
"15176","chr11.33440000.33445000","chr11.33690000.33695000",250000,14,8.05065e-05,33440000,33690000,33445000,33695000,"chr11",460303,1,1,1,3,"chr11",1,0.00492264416315049
"15177","chr11.13235000.13240000","chr11.13365000.13370000",130000,27,3.728679e-11,13235000,13365000,13240000,13370000,"chr11",460313,0,3,0,3,"chr11",1,0.00949367088607595
"15178","chr11.65180000.65185000","chr11.65225000.65230000",45000,29,2.867545e-05,65180000,65225000,65185000,65230000,"chr11",460320,1,1,2,4,"chr11",1,0.013595874355368
"15179","chr11.61695000.61700000","chr11.61840000.61845000",145000,21,2.716593e-07,61695000,61840000,61700000,61845000,"chr11",460353,1,0,2,3,"chr11",1,0.00738396624472574
"15180","chr11.112165000.112170000","chr11.113135000.113140000",970000,9,3.270297e-05,112165000,113135000,112170000,113140000,"chr11",460357,0,3,1,4,"chr11",1,0.00421940928270042
"15181","chr11.118415000.118420000","chr11.118650000.118655000",235000,11,0.008057482,118415000,118650000,118420000,118655000,"chr11",460358,1,9,3,13,"chr11",1,0.0167604313173933
"15182","chr11.70800000.70805000","chr11.71140000.71145000",340000,10,0.004203973,70800000,71140000,70805000,71145000,"chr11",460363,0,0,3,3,"chr11",1,0.00351617440225035
"15183","chr11.117835000.117840000","chr11.117885000.117890000",50000,23,0.002788217,117835000,117885000,117840000,117890000,"chr11",460369,2,1,1,4,"chr11",1,0.0107829348335677
"15184","chr11.9745000.9750000","chr11.10310000.10315000",565000,11,3.478021e-05,9745000,10310000,9750000,10315000,"chr11",460377,0,0,3,3,"chr11",1,0.00386779184247539
"15185","chr11.64970000.64975000","chr11.65025000.65030000",55000,23,0.001056029,64970000,65025000,64975000,65030000,"chr11",460430,8,16,22,46,"chr11",1,0.124003750586029
"15186","chr11.92970000.92975000","chr11.93285000.93290000",315000,13,6.739097e-05,92970000,93285000,92975000,93290000,"chr11",460437,0,0,3,3,"chr11",1,0.00457102672292546
"15187","chr11.62435000.62440000","chr11.62470000.62475000",35000,32,7.227617e-05,62435000,62470000,62440000,62475000,"chr11",460462,3,24,21,48,"chr11",1,0.180028129395218
"15188","chr11.119780000.119785000","chr11.119800000.119805000",20000,36,0.005637993,119780000,119800000,119785000,119805000,"chr11",460484,0,2,2,4,"chr11",1,0.0168776371308017
"15189","chr11.118870000.118875000","chr11.118935000.118940000",65000,20,0.003068502,118870000,118935000,118875000,118940000,"chr11",460495,2,5,6,13,"chr11",1,0.0304735114861697
"15190","chr11.66385000.66390000","chr11.66435000.66440000",50000,26,0.0001688891,66385000,66435000,66390000,66440000,"chr11",460499,3,9,10,22,"chr11",1,0.0670417252695734
"15191","chr11.118095000.118100000","chr11.118220000.118225000",125000,18,8.05065e-05,118095000,118220000,118100000,118225000,"chr11",460538,1,1,3,5,"chr11",1,0.0105485232067511
"15192","chr11.102320000.102325000","chr11.102365000.102370000",45000,23,0.007192356,102320000,102365000,102325000,102370000,"chr11",460553,3,4,13,20,"chr11",1,0.0539146741678387
"15193","chr11.73185000.73190000","chr11.73335000.73340000",150000,14,0.003390837,73185000,73335000,73190000,73340000,"chr11",460592,1,5,5,11,"chr11",1,0.0180496952648851
"15194","chr11.11020000.11025000","chr11.11805000.11810000",785000,8,0.001133592,11020000,11805000,11025000,11810000,"chr11",460607,3,3,6,12,"chr11",1,0.0112517580872011
"15195","chr11.62670000.62675000","chr11.62790000.62795000",120000,72,4.587013e-57,62670000,62790000,62675000,62795000,"chr11",460610,4,18,10,32,"chr11",1,0.270042194092827
"15196","chr11.12075000.12080000","chr11.12285000.12290000",210000,20,1.988882e-08,12075000,12285000,12080000,12290000,"chr11",460659,0,4,1,5,"chr11",1,0.0117205813408345
"15197","chr11.126720000.126725000","chr11.126755000.126760000",35000,32,7.227617e-05,126720000,126755000,126725000,126760000,"chr11",460712,0,2,1,3,"chr11",1,0.0112517580872011
"15198","chr11.73670000.73675000","chr11.73755000.73760000",85000,22,2.055153e-05,73670000,73755000,73675000,73760000,"chr11",460714,6,19,16,41,"chr11",1,0.105719643694327
"15199","chr11.77870000.77875000","chr11.78145000.78150000",275000,11,0.003252287,77870000,78145000,77875000,78150000,"chr11",460725,4,13,8,25,"chr11",1,0.0322315986872949
"15200","chr11.9200000.9205000","chr11.9385000.9390000",185000,14,0.000862795,9200000,9385000,9205000,9390000,"chr11",460782,3,5,8,16,"chr11",1,0.0262541022034693
"15201","chr11.35980000.35985000","chr11.36265000.36270000",285000,12,0.0006446838,35980000,36265000,35985000,36270000,"chr11",460820,2,3,1,6,"chr11",1,0.00843881856540084
"15202","chr11.65475000.65480000","chr11.65610000.65615000",135000,17,0.0001702143,65475000,65610000,65480000,65615000,"chr11",460831,0,2,0,2,"chr11",1,0.00398499765588373
"15203","chr11.64685000.64690000","chr11.64885000.64890000",200000,16,2.682304e-05,64685000,64885000,64690000,64890000,"chr11",460896,2,1,1,4,"chr11",1,0.00750117205813408
"15204","chr11.131980000.131985000","chr11.132165000.132170000",185000,15,0.0002257865,131980000,132165000,131985000,132170000,"chr11",460906,0,2,3,5,"chr11",1,0.00879043600562588
"15205","chr11.72670000.72675000","chr11.72845000.72850000",175000,13,0.004289421,72670000,72845000,72675000,72850000,"chr11",460985,0,2,2,4,"chr11",1,0.00609470229723394
"15206","chr11.113770000.113775000","chr11.113895000.113900000",125000,14,0.00910339,113770000,113895000,113775000,113900000,"chr11",461016,3,1,1,5,"chr11",1,0.00820440693858415
"15207","chr11.116770000.116775000","chr11.116840000.116845000",70000,29,2.615657e-08,116770000,116840000,116775000,116845000,"chr11",461079,2,0,6,8,"chr11",1,0.0271917487107361
"15208","chr11.66855000.66860000","chr11.66920000.66925000",65000,25,1.51749e-05,66855000,66920000,66860000,66925000,"chr11",461094,0,4,0,4,"chr11",1,0.0117205813408345
"15209","chr11.111435000.111440000","chr11.111730000.111735000",295000,12,0.0005115795,111435000,111730000,111440000,111735000,"chr11",461096,0,4,0,4,"chr11",1,0.00562587904360056
"15210","chr11.119750000.119755000","chr11.119970000.119975000",220000,13,0.0009431827,119750000,119970000,119755000,119975000,"chr11",461103,0,2,1,3,"chr11",1,0.00457102672292546
"15211","chr11.117300000.117305000","chr11.118065000.118070000",765000,7,0.007397049,117300000,118065000,117305000,118070000,"chr11",461105,7,13,11,31,"chr11",1,0.0254336615096109
"15212","chr11.19595000.19600000","chr11.19730000.19735000",135000,23,2.345235e-08,19595000,19730000,19600000,19735000,"chr11",461110,1,1,0,2,"chr11",1,0.00539146741678387
"15213","chr11.65985000.65990000","chr11.66020000.66025000",35000,35,3.743886e-06,65985000,66020000,65990000,66025000,"chr11",461116,2,17,16,35,"chr11",1,0.143577121425223
"15214","chr11.118650000.118655000","chr11.118785000.118790000",135000,17,0.0001702143,118650000,118785000,118655000,118790000,"chr11",461158,1,9,3,13,"chr11",1,0.0259024847632443
"15215","chr11.66340000.66345000","chr11.66415000.66420000",75000,19,0.002175798,66340000,66415000,66345000,66420000,"chr11",461195,1,2,1,4,"chr11",1,0.00890764181903422
"15216","chr11.107660000.107665000","chr11.107700000.107705000",40000,26,0.002147236,107660000,107700000,107665000,107705000,"chr11",461217,2,7,3,12,"chr11",1,0.0365682137834037
"15217","chr11.46275000.46280000","chr11.46345000.46350000",70000,21,0.0005429726,46275000,46345000,46280000,46350000,"chr11",461241,0,1,1,2,"chr11",1,0.00492264416315049
"15218","chr11.116875000.116880000","chr11.116955000.116960000",80000,46,1.521061e-22,116875000,116955000,116880000,116960000,"chr11",461249,1,3,2,6,"chr11",1,0.0323488045007032
"15219","chr11.118655000.118660000","chr11.118755000.118760000",100000,16,0.004591244,118655000,118755000,118660000,118760000,"chr11",461305,0,3,1,4,"chr11",1,0.00750117205813408
"15220","chr11.117300000.117305000","chr11.117935000.117940000",635000,8,0.003553843,117300000,117935000,117305000,117940000,"chr11",461337,3,9,10,22,"chr11",1,0.0206282231598687
"15221","chr12.12645000.12650000","chr12.12810000.12815000",165000,13,0.008778126,12645000,12810000,12650000,12815000,"chr12",461354,5,9,11,25,"chr12",1,0.0380918893577121
"15222","chr12.125015000.125020000","chr12.125210000.125215000",195000,15,0.0002442368,125015000,125210000,125020000,125215000,"chr12",461385,7,12,10,29,"chr12",1,0.0509845288326301
"15223","chr12.6530000.6535000","chr12.6615000.6620000",85000,20,0.000371396,6530000,6615000,6535000,6620000,"chr12",461480,0,2,0,2,"chr12",1,0.0046882325363338
"15224","chr12.110540000.110545000","chr12.110840000.110845000",300000,16,1.022563e-06,110540000,110840000,110545000,110845000,"chr12",461505,2,10,5,17,"chr12",1,0.0318799812470699
"15225","chr12.110075000.110080000","chr12.110120000.110125000",45000,29,4.822255e-05,110075000,110120000,110080000,110125000,"chr12",461517,5,20,19,44,"chr12",1,0.149554617909048
"15226","chr12.124805000.124810000","chr12.125255000.125260000",450000,10,0.001586397,124805000,125255000,124810000,125260000,"chr12",461523,4,0,1,5,"chr12",1,0.00586029067041725
"15227","chr12.121095000.121100000","chr12.121150000.121155000",55000,21,0.00890833,121095000,121150000,121100000,121155000,"chr12",461526,1,9,4,14,"chr12",1,0.0344585091420534
"15228","chr12.49805000.49810000","chr12.49875000.49880000",70000,24,3.132484e-05,49805000,49875000,49810000,49880000,"chr12",461541,0,2,5,7,"chr12",1,0.019690576652602
"15229","chr12.109055000.109060000","chr12.109230000.109235000",175000,13,0.006302058,109055000,109230000,109060000,109235000,"chr12",461543,0,5,6,11,"chr12",1,0.0167604313173933
"15230","chr12.110610000.110615000","chr12.110695000.110700000",85000,17,0.007949728,110610000,110695000,110615000,110700000,"chr12",461562,9,33,19,61,"chr12",1,0.121542428504454
"15231","chr12.67825000.67830000","chr12.68040000.68045000",215000,12,0.005955114,67825000,68040000,67830000,68045000,"chr12",461566,0,2,0,2,"chr12",1,0.00281293952180028
"15232","chr12.11015000.11020000","chr12.11620000.11625000",605000,8,0.007151147,11015000,11620000,11020000,11625000,"chr12",461584,3,9,5,17,"chr12",1,0.0159399906235349
"15233","chr12.108665000.108670000","chr12.108685000.108690000",20000,37,0.006042922,108665000,108685000,108670000,108690000,"chr12",461588,2,3,2,7,"chr12",1,0.0303563056727614
"15234","chr12.57630000.57635000","chr12.57830000.57835000",200000,12,0.009019421,57630000,57830000,57635000,57835000,"chr12",461606,3,3,3,9,"chr12",1,0.0126582278481013
"15235","chr12.56125000.56130000","chr12.56220000.56225000",95000,19,0.0004056182,56125000,56220000,56130000,56225000,"chr12",461607,0,3,5,8,"chr12",1,0.0178152836380684
"15236","chr12.51210000.51215000","chr12.51385000.51390000",175000,19,1.723294e-06,51210000,51385000,51215000,51390000,"chr12",461612,4,7,6,17,"chr12",1,0.0378574777308955
"15237","chr12.121990000.121995000","chr12.122065000.122070000",75000,39,1.309079e-15,121990000,122065000,121995000,122070000,"chr12",461658,5,26,23,54,"chr12",1,0.246835443037975
"15238","chr12.14415000.14420000","chr12.14765000.14770000",350000,11,0.001336691,14415000,14765000,14420000,14770000,"chr12",461676,3,9,6,18,"chr12",1,0.0232067510548523
"15239","chr12.121230000.121235000","chr12.121295000.121300000",65000,22,0.0006692584,121230000,121295000,121235000,121300000,"chr12",461679,1,5,15,21,"chr12",1,0.0541490857946554
"15240","chr12.121130000.121135000","chr12.121345000.121350000",215000,13,0.001721248,121130000,121345000,121135000,121350000,"chr12",461685,2,6,5,13,"chr12",1,0.0198077824660103
"15241","chr12.50920000.50925000","chr12.50985000.50990000",65000,21,0.001771687,50920000,50985000,50925000,50990000,"chr12",461788,2,3,1,6,"chr12",1,0.0147679324894515
"15242","chr12.50925000.50930000","chr12.51005000.51010000",80000,30,1.170137e-09,50925000,51005000,50930000,51010000,"chr12",461801,6,8,5,19,"chr12",1,0.0668073136427567
"15243","chr12.121740000.121745000","chr12.121780000.121785000",40000,27,0.00142882,121740000,121780000,121745000,121785000,"chr12",461861,6,28,21,55,"chr12",1,0.174050632911392
"15244","chr12.44370000.44375000","chr12.45260000.45265000",890000,7,0.005666202,44370000,45260000,44375000,45265000,"chr12",461936,0,4,3,7,"chr12",1,0.00574308485700891
"15245","chr12.91770000.91775000","chr12.92540000.92545000",770000,11,6.177962e-06,91770000,92540000,91775000,92545000,"chr12",461952,0,4,4,8,"chr12",1,0.0103141115799344
"15246","chr12.53770000.53775000","chr12.53885000.53890000",115000,15,0.007443733,53770000,53885000,53775000,53890000,"chr12",461978,2,0,2,4,"chr12",1,0.0070323488045007
"15247","chr12.19330000.19335000","chr12.19440000.19445000",110000,22,1.90134e-06,19330000,19440000,19335000,19445000,"chr12",462009,5,21,28,54,"chr12",1,0.139240506329114
"15248","chr12.12510000.12515000","chr12.12900000.12905000",390000,10,0.003303312,12510000,12900000,12515000,12905000,"chr12",462059,2,1,3,6,"chr12",1,0.0070323488045007
"15249","chr12.50005000.50010000","chr12.50175000.50180000",170000,13,0.007443733,50005000,50175000,50010000,50180000,"chr12",462166,0,6,5,11,"chr12",1,0.0167604313173933
"15250","chr12.12240000.12245000","chr12.12330000.12335000",90000,23,4.979087e-06,12240000,12330000,12245000,12335000,"chr12",462171,8,7,8,23,"chr12",1,0.0620018752930145
"15251","chr12.76560000.76565000","chr12.76620000.76625000",60000,21,0.003969465,76560000,76620000,76565000,76625000,"chr12",462195,0,4,5,9,"chr12",1,0.0221518987341772
"15252","chr12.54170000.54175000","chr12.54360000.54365000",190000,14,0.001129618,54170000,54360000,54175000,54365000,"chr12",462224,2,4,2,8,"chr12",1,0.0131270511017346
"15253","chr12.106745000.106750000","chr12.107315000.107320000",570000,8,0.009314854,106745000,107315000,106750000,107320000,"chr12",462288,1,2,5,8,"chr12",1,0.00750117205813408
"15254","chr12.68745000.68750000","chr12.69070000.69075000",325000,10,0.007606148,68745000,69070000,68750000,69075000,"chr12",462300,1,0,2,3,"chr12",1,0.00351617440225035
"15255","chr12.121990000.121995000","chr12.122120000.122125000",130000,50,2.370734e-32,121990000,122120000,121995000,122125000,"chr12",462319,5,26,23,54,"chr12",1,0.316455696202532
"15256","chr12.123115000.123120000","chr12.123250000.123255000",135000,15,0.003044139,123115000,123250000,123120000,123255000,"chr12",462347,2,0,5,7,"chr12",1,0.0123066104078762
"15257","chr12.121785000.121790000","chr12.122295000.122300000",510000,9,0.003668414,121785000,122295000,121790000,122300000,"chr12",462376,2,16,22,40,"chr12",1,0.0421940928270042
"15258","chr12.11770000.11775000","chr12.12015000.12020000",245000,19,3.719591e-08,11770000,12015000,11775000,12020000,"chr12",462423,2,1,6,9,"chr12",1,0.020042194092827
"15259","chr12.39760000.39765000","chr12.39820000.39825000",60000,24,0.0002241502,39760000,39820000,39765000,39825000,"chr12",462429,2,5,3,10,"chr12",1,0.0281293952180028
"15260","chr12.64230000.64235000","chr12.64610000.64615000",380000,25,1.631324e-16,64230000,64610000,64235000,64615000,"chr12",462444,4,11,14,29,"chr12",1,0.0849742147210502
"15261","chr12.12560000.12565000","chr12.12655000.12660000",95000,18,0.00123649,12560000,12655000,12565000,12660000,"chr12",462467,0,2,3,5,"chr12",1,0.0105485232067511
"15262","chr12.11820000.11825000","chr12.12015000.12020000",195000,19,5.439593e-07,11820000,12015000,11825000,12020000,"chr12",462470,2,7,6,15,"chr12",1,0.0334036568213783
"15263","chr12.30795000.30800000","chr12.30820000.30825000",25000,38,0.0005015141,30795000,30820000,30800000,30825000,"chr12",462484,0,2,0,2,"chr12",1,0.00890764181903422
"15264","chr12.64230000.64235000","chr12.64475000.64480000",245000,11,0.009206307,64230000,64475000,64235000,64480000,"chr12",462519,0,1,5,6,"chr12",1,0.00773558368495077
"15265","chr12.75795000.75800000","chr12.76420000.76425000",625000,8,0.006053684,75795000,76420000,75800000,76425000,"chr12",462539,1,2,3,6,"chr12",1,0.00562587904360056
"15266","chr12.121110000.121115000","chr12.121150000.121155000",40000,25,0.006935851,121110000,121150000,121115000,121155000,"chr12",462557,9,23,25,57,"chr12",1,0.167018284106892
"15267","chr12.109110000.109115000","chr12.109150000.109155000",40000,28,0.0006059727,109110000,109150000,109115000,109155000,"chr12",462608,3,6,10,19,"chr12",1,0.0623534927332396
"15268","chr12.50175000.50180000","chr12.50610000.50615000",435000,10,0.001870666,50175000,50610000,50180000,50615000,"chr12",462646,6,19,24,49,"chr12",1,0.0574308485700891
"15269","chr12.77010000.77015000","chr12.77185000.77190000",175000,33,3.170675e-18,77010000,77185000,77015000,77190000,"chr12",462661,2,1,9,12,"chr12",1,0.0464135021097046
"15270","chr12.56150000.56155000","chr12.56315000.56320000",165000,13,0.008778126,56150000,56315000,56155000,56320000,"chr12",462667,1,3,3,7,"chr12",1,0.0106657290201594
"15271","chr12.69210000.69215000","chr12.69460000.69465000",250000,11,0.008224003,69210000,69460000,69215000,69465000,"chr12",462707,3,5,4,12,"chr12",1,0.0154711673699015
"15272","chr12.12265000.12270000","chr12.12710000.12715000",445000,9,0.007221198,12265000,12710000,12270000,12715000,"chr12",462739,1,4,6,11,"chr12",1,0.0116033755274262
"15273","chr12.75950000.75955000","chr12.76390000.76395000",440000,9,0.007545672,75950000,76390000,75955000,76395000,"chr12",462744,3,8,6,17,"chr12",1,0.0179324894514768
"15274","chr12.6700000.6705000","chr12.6760000.6765000",60000,20,0.009290085,6700000,6760000,6705000,6765000,"chr12",462807,2,12,6,20,"chr12",1,0.046882325363338
"15275","chr12.13070000.13075000","chr12.13360000.13365000",290000,20,6.417405e-10,13070000,13360000,13075000,13365000,"chr12",462812,0,3,2,5,"chr12",1,0.0117205813408345
"15276","chr12.110530000.110535000","chr12.110885000.110890000",355000,10,0.005092321,110530000,110885000,110535000,110890000,"chr12",462850,2,12,15,29,"chr12",1,0.0339896858884201
"15277","chr12.109080000.109085000","chr12.109110000.109115000",30000,47,7.313053e-10,109080000,109110000,109085000,109115000,"chr12",462891,4,9,12,25,"chr12",1,0.137716830754805
"15278","chr12.56625000.56630000","chr12.56875000.56880000",250000,11,0.008224003,56625000,56875000,56630000,56880000,"chr12",462932,4,9,10,23,"chr12",1,0.0296530707923113
"15279","chr12.51215000.51220000","chr12.51420000.51425000",205000,41,2.996891e-28,51215000,51420000,51220000,51425000,"chr12",462940,0,4,1,5,"chr12",1,0.0240271917487107
"15280","chr12.11770000.11775000","chr12.12030000.12035000",260000,11,0.006681317,11770000,12030000,11775000,12035000,"chr12",462972,1,1,4,6,"chr12",1,0.00773558368495077
"15281","chr12.75905000.75910000","chr12.76470000.76475000",565000,12,9.820627e-06,75905000,76470000,75910000,76475000,"chr12",462993,2,2,3,7,"chr12",1,0.00984528832630099
"15282","chr12.11825000.11830000","chr12.11965000.11970000",140000,16,0.0007509807,11825000,11965000,11830000,11970000,"chr12",463014,1,0,1,2,"chr12",1,0.00375058602906704
"15283","chr12.1770000.1775000","chr12.1895000.1900000",125000,37,4.68559e-19,1770000,1895000,1775000,1900000,"chr12",463093,3,5,4,12,"chr12",1,0.0520393811533052
"15284","chr12.12640000.12645000","chr12.12835000.12840000",195000,15,0.0002442368,12640000,12835000,12645000,12840000,"chr12",463097,0,3,3,6,"chr12",1,0.0105485232067511
"15285","chr12.51440000.51445000","chr12.51645000.51650000",205000,18,1.623071e-06,51440000,51645000,51445000,51650000,"chr12",463152,6,15,12,33,"chr12",1,0.069620253164557
"15286","chr12.121780000.121785000","chr12.122050000.122055000",270000,14,7.587204e-05,121780000,122050000,121785000,122055000,"chr12",463174,3,15,10,28,"chr12",1,0.0459446788560713
"15287","chr12.12520000.12525000","chr12.12745000.12750000",225000,14,0.000321142,12520000,12745000,12525000,12750000,"chr12",463230,1,1,3,5,"chr12",1,0.00820440693858415
"15288","chr12.95995000.96000000","chr12.96215000.96220000",220000,16,1.979571e-05,95995000,96215000,9.6e+07,96220000,"chr12",463303,4,4,4,12,"chr12",1,0.0225035161744023
"15289","chr12.19295000.19300000","chr12.19615000.19620000",320000,10,0.008148661,19295000,19615000,19300000,19620000,"chr12",463337,0,13,12,25,"chr12",1,0.0293014533520863
"15290","chr12.123230000.123235000","chr12.123455000.123460000",225000,12,0.00450886,123230000,123455000,123235000,123460000,"chr12",463359,9,18,16,43,"chr12",1,0.060478199718706
"15291","chr12.12655000.12660000","chr12.12695000.12700000",40000,34,1.508577e-06,12655000,12695000,12660000,12700000,"chr12",463384,5,16,10,31,"chr12",1,0.123534927332396
"15292","chr12.123710000.123715000","chr12.124045000.124050000",335000,12,0.0003778329,123710000,124045000,123715000,124050000,"chr12",463396,3,5,2,10,"chr12",1,0.0140646976090014
"15293","chr12.121150000.121155000","chr12.121400000.121405000",250000,18,1.832769e-07,121150000,121400000,121155000,121405000,"chr12",463412,5,8,6,19,"chr12",1,0.040084388185654
"15294","chr12.50945000.50950000","chr12.51020000.51025000",75000,23,4.372199e-05,50945000,51020000,50950000,51025000,"chr12",463458,2,13,4,19,"chr12",1,0.0512189404594468
"15295","chr12.64805000.64810000","chr12.64825000.64830000",20000,51,8.375267e-08,64805000,64825000,64810000,64830000,"chr12",463509,2,1,1,4,"chr12",1,0.0239099859353024
"15296","chr12.77010000.77015000","chr12.77210000.77215000",200000,27,9.909571e-14,77010000,77210000,77015000,77215000,"chr12",463544,2,9,5,16,"chr12",1,0.0506329113924051
"15297","chr12.15880000.15885000","chr12.15910000.15915000",30000,38,1.077427e-05,15880000,15910000,15885000,15915000,"chr12",463560,1,2,3,6,"chr12",1,0.0267229254571027
"15298","chr12.93220000.93225000","chr12.93810000.93815000",590000,8,0.007951205,93220000,93810000,93225000,93815000,"chr12",463581,2,0,0,2,"chr12",1,0.00187529301453352
"15299","chr12.12985000.12990000","chr12.13135000.13140000",150000,14,0.004987821,12985000,13135000,12990000,13140000,"chr12",463634,0,3,2,5,"chr12",1,0.00820440693858415
"15300","chr12.12610000.12615000","chr12.12710000.12715000",100000,21,2.084308e-05,12610000,12710000,12615000,12715000,"chr12",463638,10,14,18,42,"chr12",1,0.10337552742616
"15301","chr12.116735000.116740000","chr12.117025000.117030000",290000,11,0.003641477,116735000,117025000,116740000,117030000,"chr12",463691,0,5,2,7,"chr12",1,0.00902484763244257
"15302","chr12.108930000.108935000","chr12.109260000.109265000",330000,11,0.001807086,108930000,109260000,108935000,109265000,"chr12",463732,3,10,14,27,"chr12",1,0.0348101265822785
"15303","chr12.50035000.50040000","chr12.50070000.50075000",35000,34,1.963249e-05,50035000,50070000,50040000,50075000,"chr12",463753,1,5,7,13,"chr12",1,0.0518049695264885
"15304","chr12.124440000.124445000","chr12.124470000.124475000",30000,34,0.0003692794,124440000,124470000,124445000,124475000,"chr12",463807,1,1,0,2,"chr12",1,0.00796999531176746
"15305","chr12.56155000.56160000","chr12.56355000.56360000",200000,13,0.002799815,56155000,56355000,56160000,56360000,"chr12",463869,4,9,9,22,"chr12",1,0.0335208626347867
"15306","chr12.120200000.120205000","chr12.120235000.120240000",35000,31,0.000314028,120200000,120235000,120205000,120240000,"chr12",463905,2,11,16,29,"chr12",1,0.105368026254102
"15307","chr12.11785000.11790000","chr12.12120000.12125000",335000,10,0.006673431,11785000,12120000,11790000,12125000,"chr12",463930,1,3,4,8,"chr12",1,0.00937646507266761
"15308","chr12.112485000.112490000","chr12.112795000.112800000",310000,11,0.002540599,112485000,112795000,112490000,112800000,"chr12",463939,1,3,4,8,"chr12",1,0.0103141115799344
"15309","chr12.13135000.13140000","chr12.13360000.13365000",225000,20,1.682007e-08,13135000,13360000,13140000,13365000,"chr12",463974,0,3,2,5,"chr12",1,0.0117205813408345
"15310","chr12.6730000.6735000","chr12.6760000.6765000",30000,38,1.077427e-05,6730000,6760000,6735000,6765000,"chr12",464003,2,10,6,18,"chr12",1,0.080168776371308
"15311","chr12.111895000.111900000","chr12.112105000.112110000",210000,15,0.000133501,111895000,112105000,111900000,112110000,"chr12",464034,2,5,5,12,"chr12",1,0.0210970464135021
"15312","chr12.120465000.120470000","chr12.120495000.120500000",30000,42,1.973882e-07,120465000,120495000,120470000,120500000,"chr12",464048,4,8,4,16,"chr12",1,0.0787623066104079
"15313","chr12.57125000.57130000","chr12.57490000.57495000",365000,10,0.00450886,57125000,57490000,57130000,57495000,"chr12",464159,1,11,5,17,"chr12",1,0.0199249882794187
"15314","chr12.109055000.109060000","chr12.109115000.109120000",60000,24,0.0002241502,109055000,109115000,109060000,109120000,"chr12",464204,0,12,6,18,"chr12",1,0.0506329113924051
"15315","chr12.53325000.53330000","chr12.53345000.53350000",20000,62,5.549264e-13,53325000,53345000,53330000,53350000,"chr12",464209,0,3,1,4,"chr12",1,0.0290670417252696
"15316","chr12.1775000.1780000","chr12.1895000.1900000",120000,27,2.305693e-10,1775000,1895000,1780000,1900000,"chr12",464223,2,5,4,11,"chr12",1,0.0348101265822785
"15317","chr12.51215000.51220000","chr12.51645000.51650000",430000,9,0.008375162,51215000,51645000,51220000,51650000,"chr12",464235,0,6,6,12,"chr12",1,0.0126582278481013
"15318","chr12.64230000.64235000","chr12.64825000.64830000",595000,13,8.109188e-07,64230000,64825000,64235000,64830000,"chr12",464251,2,1,1,4,"chr12",1,0.00609470229723394
"15319","chr12.120435000.120440000","chr12.120465000.120470000",30000,31,0.003607369,120435000,120465000,120440000,120470000,"chr12",464264,7,28,24,59,"chr12",1,0.214369432723863
"15320","chr12.122075000.122080000","chr12.122105000.122110000",30000,32,0.001734574,122075000,122105000,122080000,122110000,"chr12",464271,1,12,9,22,"chr12",1,0.0825128926394749
"15321","chr12.53495000.53500000","chr12.53550000.53555000",55000,21,0.00890833,53495000,53550000,53500000,53555000,"chr12",464294,6,5,11,22,"chr12",1,0.0541490857946554
"15322","chr12.12645000.12650000","chr12.12695000.12700000",50000,22,0.009115651,12645000,12695000,12650000,12700000,"chr12",464328,5,9,10,24,"chr12",1,0.0618846694796062
"15323","chr12.122020000.122025000","chr12.122120000.122125000",100000,21,2.084308e-05,122020000,122120000,122025000,122125000,"chr12",464439,0,4,0,4,"chr12",1,0.00984528832630099
"15324","chr12.56315000.56320000","chr12.56360000.56365000",45000,25,0.002042459,56315000,56360000,56320000,56365000,"chr12",464482,1,3,3,7,"chr12",1,0.0205110173464604
"15325","chr12.125280000.125285000","chr12.125330000.125335000",50000,24,0.001727655,125280000,125330000,125285000,125335000,"chr12",464519,1,0,2,3,"chr12",1,0.00843881856540084
"15326","chr12.68730000.68735000","chr12.69170000.69175000",440000,10,0.001756819,68730000,69170000,68735000,69175000,"chr12",464560,1,6,10,17,"chr12",1,0.0199249882794187
"15327","chr12.12505000.12510000","chr12.12710000.12715000",205000,12,0.007809895,12505000,12710000,12510000,12715000,"chr12",464585,0,3,1,4,"chr12",1,0.00562587904360056
"15328","chr12.12655000.12660000","chr12.12700000.12705000",45000,29,4.822255e-05,12655000,12700000,12660000,12705000,"chr12",464620,5,13,16,34,"chr12",1,0.115564932020628
"15329","chr12.11825000.11830000","chr12.11860000.11865000",35000,37,8.971714e-07,11825000,11860000,11830000,11865000,"chr12",464638,1,0,1,2,"chr12",1,0.00867323019221753
"15330","chr12.64210000.64215000","chr12.64820000.64825000",610000,10,0.0002436365,64210000,64820000,64215000,64825000,"chr12",464646,6,10,10,26,"chr12",1,0.0304735114861697
"15331","chr12.121130000.121135000","chr12.121150000.121155000",20000,42,0.0002031934,121130000,121150000,121135000,121155000,"chr12",464650,2,6,5,13,"chr12",1,0.0639943741209564
"15332","chr12.4415000.4420000","chr12.4645000.4650000",230000,16,1.299988e-05,4415000,4645000,4420000,4650000,"chr12",464679,1,2,3,6,"chr12",1,0.0112517580872011
"15333","chr12.116605000.116610000","chr12.116705000.116710000",100000,22,5.544371e-06,116605000,116705000,116610000,116710000,"chr12",464738,0,10,13,23,"chr12",1,0.0593061415846226
"15334","chr12.123455000.123460000","chr12.123710000.123715000",255000,12,0.002051731,123455000,123710000,123460000,123715000,"chr12",464745,3,5,2,10,"chr12",1,0.0140646976090014
"15335","chr12.123360000.123365000","chr12.123435000.123440000",75000,31,7.952723e-10,123360000,123435000,123365000,123440000,"chr12",464818,4,18,19,41,"chr12",1,0.148968588842007
"15336","chr12.10150000.10155000","chr12.10190000.10195000",40000,52,3.501523e-17,10150000,10190000,10155000,10195000,"chr12",464840,1,13,10,24,"chr12",1,0.146272855133615
"15337","chr12.125135000.125140000","chr12.125210000.125215000",75000,23,4.372199e-05,125135000,125210000,125140000,125215000,"chr12",464862,2,11,8,21,"chr12",1,0.0566104078762307
"15338","chr12.109050000.109055000","chr12.109500000.109505000",450000,9,0.006863721,109050000,109500000,109055000,109505000,"chr12",464899,3,2,5,10,"chr12",1,0.0105485232067511
"15339","chr12.56610000.56615000","chr12.56750000.56755000",140000,16,0.0007509807,56610000,56750000,56615000,56755000,"chr12",464933,2,5,4,11,"chr12",1,0.0206282231598687
"15340","chr12.124515000.124520000","chr12.125280000.125285000",765000,8,0.00219931,124515000,125280000,124520000,125285000,"chr12",464949,1,0,2,3,"chr12",1,0.00281293952180028
"15341","chr12.99115000.99120000","chr12.99255000.99260000",140000,16,0.0007509807,99115000,99255000,99120000,99260000,"chr12",464957,0,2,0,2,"chr12",1,0.00375058602906704
"15342","chr12.122020000.122025000","chr12.122115000.122120000",95000,20,0.0001245672,122020000,122115000,122025000,122120000,"chr12",464960,0,4,0,4,"chr12",1,0.00937646507266761
"15343","chr12.6450000.6455000","chr12.6520000.6525000",70000,21,0.0008428889,6450000,6520000,6455000,6525000,"chr12",464964,1,4,3,8,"chr12",1,0.019690576652602
"15344","chr12.122130000.122135000","chr12.122280000.122285000",150000,17,0.0001288331,122130000,122280000,122135000,122285000,"chr12",464970,8,18,10,36,"chr12",1,0.0717299578059072
"15345","chr12.110025000.110030000","chr12.110135000.110140000",110000,16,0.00352132,110025000,110135000,110030000,110140000,"chr12",464998,1,11,6,18,"chr12",1,0.0337552742616034
"15346","chr12.109080000.109085000","chr12.109115000.109120000",35000,55,5.138849e-17,109080000,109115000,109085000,109120000,"chr12",465021,2,9,12,23,"chr12",1,0.148265353961556
"15347","chr12.69210000.69215000","chr12.69455000.69460000",245000,11,0.009206307,69210000,69455000,69215000,69460000,"chr12",465086,2,5,4,11,"chr12",1,0.0141819034224098
"15348","chr12.12640000.12645000","chr12.12890000.12895000",250000,11,0.008224003,12640000,12890000,12645000,12895000,"chr12",465104,0,3,3,6,"chr12",1,0.00773558368495077
"15349","chr12.122835000.122840000","chr12.122940000.122945000",105000,17,0.001672415,122835000,122940000,122840000,122945000,"chr12",465139,0,2,3,5,"chr12",1,0.00996249413970933
"15350","chr12.116520000.116525000","chr12.116655000.116660000",135000,17,0.0002773748,116520000,116655000,116525000,116660000,"chr12",465166,3,4,3,10,"chr12",1,0.0199249882794187
"15351","chr12.14390000.14395000","chr12.14785000.14790000",395000,13,2.495385e-05,14390000,14785000,14395000,14790000,"chr12",465188,0,2,1,3,"chr12",1,0.00457102672292546
"15352","chr12.32605000.32610000","chr12.32700000.32705000",95000,35,8.05099e-15,32605000,32700000,32610000,32705000,"chr12",465205,4,12,9,25,"chr12",1,0.102555086732302
"15353","chr12.75485000.75490000","chr12.75665000.75670000",180000,13,0.005332587,75485000,75665000,75490000,75670000,"chr12",465218,0,3,6,9,"chr12",1,0.0137130801687764
"15354","chr12.121990000.121995000","chr12.122110000.122115000",120000,36,8.603709e-18,121990000,122110000,121995000,122115000,"chr12",465242,5,19,23,47,"chr12",1,0.19831223628692
"15355","chr12.12240000.12245000","chr12.12900000.12905000",660000,8,0.004655867,12240000,12900000,12245000,12905000,"chr12",465255,5,7,6,18,"chr12",1,0.0168776371308017
"15356","chr12.124545000.124550000","chr12.125125000.125130000",580000,8,0.008688971,124545000,125125000,124550000,125130000,"chr12",465322,1,5,1,7,"chr12",1,0.00656352555086732
"15357","chr12.108930000.108935000","chr12.109540000.109545000",610000,8,0.006863721,108930000,109540000,108935000,109545000,"chr12",465406,1,2,4,7,"chr12",1,0.00656352555086732
"15358","chr12.1380000.1385000","chr12.1660000.1665000",280000,11,0.004440254,1380000,1660000,1385000,1665000,"chr12",465407,3,2,2,7,"chr12",1,0.00902484763244257
"15359","chr12.1815000.1820000","chr12.1895000.1900000",80000,26,4.096678e-07,1815000,1895000,1820000,1900000,"chr12",465455,3,5,4,12,"chr12",1,0.0365682137834037
"15360","chr12.123815000.123820000","chr12.124030000.124035000",215000,13,0.001721248,123815000,124030000,123820000,124035000,"chr12",465497,2,4,7,13,"chr12",1,0.0198077824660103
"15361","chr12.121745000.121750000","chr12.121765000.121770000",20000,37,0.006042922,121745000,121765000,121750000,121770000,"chr12",465536,3,5,6,14,"chr12",1,0.0607126113455227
"15362","chr12.855000.860000","chr12.1100000.1105000",245000,12,0.002675138,855000,1100000,860000,1105000,"chr12",465552,1,3,3,7,"chr12",1,0.00984528832630099
"15363","chr12.715000.720000","chr12.855000.860000",140000,15,0.002422368,715000,855000,720000,860000,"chr12",465653,1,13,7,21,"chr12",1,0.0369198312236287
"15364","chr12.121915000.121920000","chr12.122110000.122115000",195000,15,0.0002442368,121915000,122110000,121920000,122115000,"chr12",465658,2,4,3,9,"chr12",1,0.0158227848101266
"15365","chr12.52060000.52065000","chr12.52080000.52085000",20000,43,9.410475e-05,52060000,52080000,52065000,52085000,"chr12",465706,0,2,0,2,"chr12",1,0.0100796999531177
"15366","chr12.50825000.50830000","chr12.51440000.51445000",615000,8,0.006606883,50825000,51440000,50830000,51445000,"chr12",465782,4,9,14,27,"chr12",1,0.0253164556962025
"15367","chr12.92205000.92210000","chr12.92800000.92805000",595000,8,0.007669293,92205000,92800000,92210000,92805000,"chr12",465783,0,1,1,2,"chr12",1,0.00187529301453352
"15368","chr12.3040000.3045000","chr12.3075000.3080000",35000,27,0.007443733,3040000,3075000,3045000,3080000,"chr12",465787,0,2,1,3,"chr12",1,0.00949367088607595
"15369","chr12.8845000.8850000","chr12.9045000.9050000",200000,14,0.0007820664,8845000,9045000,8850000,9050000,"chr12",465798,3,1,1,5,"chr12",1,0.00820440693858415
"15370","chr12.51010000.51015000","chr12.51045000.51050000",35000,28,0.003578991,51010000,51045000,51015000,51050000,"chr12",465843,4,15,12,31,"chr12",1,0.101734646038444
"15371","chr12.6530000.6535000","chr12.6560000.6565000",30000,57,1.752796e-15,6530000,6560000,6535000,6565000,"chr12",465868,0,2,0,2,"chr12",1,0.0133614627285513
"15372","chr12.123055000.123060000","chr12.123205000.123210000",150000,14,0.004987821,123055000,123205000,123060000,123210000,"chr12",465883,0,2,3,5,"chr12",1,0.00820440693858415
"15373","chr12.51025000.51030000","chr12.51045000.51050000",20000,43,9.410475e-05,51025000,51045000,51030000,51050000,"chr12",465932,6,21,14,41,"chr12",1,0.206633849038912
"15374","chr12.121150000.121155000","chr12.121285000.121290000",135000,18,7.594638e-05,121150000,121285000,121155000,121290000,"chr12",465974,7,17,15,39,"chr12",1,0.0822784810126582
"15375","chr12.6530000.6535000","chr12.6640000.6645000",110000,19,0.0001078184,6530000,6640000,6535000,6645000,"chr12",465985,0,2,0,2,"chr12",1,0.00445382090951711
"15376","chr12.51215000.51220000","chr12.51440000.51445000",225000,23,5.162391e-11,51215000,51440000,51220000,51445000,"chr12",465993,0,6,6,12,"chr12",1,0.0323488045007032
"15377","chr12.13135000.13140000","chr12.13365000.13370000",230000,18,4.68839e-07,13135000,13365000,13140000,13370000,"chr12",466096,0,0,4,4,"chr12",1,0.00843881856540084
"15378","chr12.110955000.110960000","chr12.111275000.111280000",320000,15,3.491061e-06,110955000,111275000,110960000,111280000,"chr12",466098,6,15,9,30,"chr12",1,0.0527426160337553
"15379","chr12.11820000.11825000","chr12.11945000.11950000",125000,15,0.004621529,11820000,11945000,11825000,11950000,"chr12",466121,1,1,3,5,"chr12",1,0.00879043600562588
"15380","chr12.56330000.56335000","chr12.56360000.56365000",30000,49,6.543975e-11,56330000,56360000,56335000,56365000,"chr12",466160,5,6,6,17,"chr12",1,0.0976324425691514
"15381","chr12.94550000.94555000","chr12.94640000.94645000",90000,18,0.001918374,94550000,94640000,94555000,94645000,"chr12",466173,1,4,1,6,"chr12",1,0.0126582278481013
"15382","chr12.89360000.89365000","chr12.89380000.89385000",20000,38,0.003270744,89360000,89380000,89365000,89385000,"chr12",466185,0,4,1,5,"chr12",1,0.0222691045475856
"15383","chr12.116705000.116710000","chr12.117050000.117055000",345000,12,0.0003172014,116705000,117050000,116710000,117055000,"chr12",466205,6,8,10,24,"chr12",1,0.0337552742616034
"15384","chr12.14390000.14395000","chr12.14775000.14780000",385000,11,0.0008044501,14390000,14775000,14395000,14780000,"chr12",466208,0,0,1,1,"chr12",1,0.0012892639474918
"15385","chr12.116595000.116600000","chr12.116655000.116660000",60000,24,0.0002241502,116595000,116655000,116600000,116660000,"chr12",466210,0,4,3,7,"chr12",1,0.019690576652602
"15386","chr12.11790000.11795000","chr12.12150000.12155000",360000,10,0.004769614,11790000,12150000,11795000,12155000,"chr12",466251,0,4,1,5,"chr12",1,0.00586029067041725
"15387","chr12.110430000.110435000","chr12.110540000.110545000",110000,15,0.009597347,110430000,110540000,110435000,110545000,"chr12",466296,6,21,19,46,"chr12",1,0.0808720112517581
"15388","chr12.105820000.105825000","chr12.106100000.106105000",280000,11,0.004440254,105820000,106100000,105825000,106105000,"chr12",466343,2,8,5,15,"chr12",1,0.0193389592123769
"15389","chr12.94185000.94190000","chr12.94275000.94280000",90000,19,0.0006616707,94185000,94275000,94190000,94280000,"chr12",466507,0,2,3,5,"chr12",1,0.0111345522737928
"15390","chr12.94070000.94075000","chr12.94165000.94170000",95000,28,1.487888e-09,94070000,94165000,94075000,94170000,"chr12",466511,3,1,2,6,"chr12",1,0.019690576652602
"15391","chr12.93395000.93400000","chr12.93775000.93780000",380000,15,8.486354e-07,93395000,93775000,93400000,93780000,"chr12",466569,0,1,0,1,"chr12",1,0.00175808720112518
"15392","chr12.108930000.108935000","chr12.109475000.109480000",545000,9,0.002594031,108930000,109475000,108935000,109480000,"chr12",466605,1,3,5,9,"chr12",1,0.00949367088607595
"15393","chr12.89580000.89585000","chr12.89695000.89700000",115000,15,0.007443733,89580000,89695000,89585000,89700000,"chr12",466658,1,3,5,9,"chr12",1,0.0158227848101266
"15394","chr12.93180000.93185000","chr12.93810000.93815000",630000,8,0.005858816,93180000,93810000,93185000,93815000,"chr12",466678,1,2,0,3,"chr12",1,0.00281293952180028
"15395","chr12.1280000.1285000","chr12.1540000.1545000",260000,14,0.0001016917,1280000,1540000,1285000,1545000,"chr12",466694,4,5,1,10,"chr12",1,0.0164088138771683
"15396","chr12.42555000.42560000","chr12.42585000.42590000",30000,30,0.007221198,42555000,42585000,42560000,42590000,"chr12",466699,5,11,14,30,"chr12",1,0.105485232067511
"15397","chr12.54185000.54190000","chr12.54245000.54250000",60000,20,0.009290085,54185000,54245000,54190000,54250000,"chr12",466705,5,24,20,49,"chr12",1,0.114861697140178
"15398","chr12.11835000.11840000","chr12.11860000.11865000",25000,36,0.002074578,11835000,11860000,11840000,11865000,"chr12",466714,1,1,0,2,"chr12",1,0.00843881856540084
"15399","chr12.99040000.99045000","chr12.99110000.99115000",70000,21,0.0008428889,99040000,99110000,99045000,99115000,"chr12",466717,2,2,1,5,"chr12",1,0.0123066104078762
"15400","chr12.6735000.6740000","chr12.6760000.6765000",25000,49,2.605071e-08,6735000,6760000,6740000,6765000,"chr12",466721,2,12,6,20,"chr12",1,0.114861697140178
"15401","chr12.121770000.121775000","chr12.121870000.121875000",100000,23,1.380136e-06,121770000,121870000,121775000,121875000,"chr12",466765,0,8,5,13,"chr12",1,0.0350445382090952
"15402","chr12.93415000.93420000","chr12.93820000.93825000",405000,10,0.002744281,93415000,93820000,93420000,93825000,"chr12",466823,2,7,12,21,"chr12",1,0.0246132208157525
"15403","chr12.53765000.53770000","chr12.53885000.53890000",120000,19,5.082846e-05,53765000,53885000,53770000,53890000,"chr12",466864,0,0,2,2,"chr12",1,0.00445382090951711
"15404","chr12.99150000.99155000","chr12.99380000.99385000",230000,12,0.003952237,99150000,99380000,99155000,99385000,"chr12",466901,0,2,0,2,"chr12",1,0.00281293952180028
"15405","chr12.21880000.21885000","chr12.22120000.22125000",240000,12,0.003069305,21880000,22120000,21885000,22125000,"chr12",466968,2,0,4,6,"chr12",1,0.00843881856540084
"15406","chr12.67825000.67830000","chr12.68320000.68325000",495000,9,0.004272864,67825000,68320000,67830000,68325000,"chr12",466972,0,2,0,2,"chr12",1,0.00210970464135021
"15407","chr12.124535000.124540000","chr12.125330000.125335000",795000,12,5.177838e-07,124535000,125330000,124540000,125335000,"chr12",467000,1,1,2,4,"chr12",1,0.00562587904360056
"15408","chr12.8235000.8240000","chr12.8395000.8400000",160000,18,1.888555e-05,8235000,8395000,8240000,8400000,"chr12",467010,2,6,5,13,"chr12",1,0.0274261603375527
"15409","chr12.125050000.125055000","chr12.125205000.125210000",155000,14,0.004138021,125050000,125205000,125055000,125210000,"chr12",467051,0,2,2,4,"chr12",1,0.00656352555086732
"15410","chr12.64775000.64780000","chr12.64820000.64825000",45000,25,0.002042459,64775000,64820000,64780000,64825000,"chr12",467057,1,4,1,6,"chr12",1,0.0175808720112518
"15411","chr12.124185000.124190000","chr12.124440000.124445000",255000,11,0.007443733,124185000,124440000,124190000,124445000,"chr12",467062,2,3,4,9,"chr12",1,0.0116033755274262
"15412","chr12.52980000.52985000","chr12.53265000.53270000",285000,11,0.004010278,52980000,53265000,52985000,53270000,"chr12",467085,5,31,28,64,"chr12",1,0.0825128926394749
"15413","chr12.51210000.51215000","chr12.51360000.51365000",150000,15,0.001624672,51210000,51360000,51215000,51365000,"chr12",467123,4,4,14,22,"chr12",1,0.0386779184247539
"15414","chr12.116620000.116625000","chr12.117065000.117070000",445000,10,0.001672415,116620000,117065000,116625000,117070000,"chr12",467153,7,11,14,32,"chr12",1,0.0375058602906704
"15415","chr12.50635000.50640000","chr12.50825000.50830000",190000,13,0.003862157,50635000,50825000,50640000,50830000,"chr12",467155,2,6,3,11,"chr12",1,0.0167604313173933
"15416","chr12.12505000.12510000","chr12.12810000.12815000",305000,12,0.0006692584,12505000,12810000,12510000,12815000,"chr12",467176,0,3,1,4,"chr12",1,0.00562587904360056
"15417","chr12.56590000.56595000","chr12.56685000.56690000",95000,19,0.0004056182,56590000,56685000,56595000,56690000,"chr12",467242,4,14,13,31,"chr12",1,0.0690342240975152
"15418","chr12.32605000.32610000","chr12.32755000.32760000",150000,24,2.494234e-09,32605000,32755000,32610000,32760000,"chr12",467247,2,5,6,13,"chr12",1,0.0365682137834037
"15419","chr12.121095000.121100000","chr12.121395000.121400000",300000,12,0.000743179,121095000,121395000,121100000,121400000,"chr12",467277,1,9,4,14,"chr12",1,0.019690576652602
"15420","chr12.106750000.106755000","chr12.107345000.107350000",595000,8,0.007669293,106750000,107345000,106755000,107350000,"chr12",467279,1,3,2,6,"chr12",1,0.00562587904360056
"15421","chr12.51210000.51215000","chr12.51720000.51725000",510000,11,0.0001371567,51210000,51720000,51215000,51725000,"chr12",467304,2,9,7,18,"chr12",1,0.0232067510548523
"15422","chr12.122130000.122135000","chr12.122200000.122205000",70000,34,2.906972e-11,122130000,122200000,122135000,122205000,"chr12",467332,0,10,9,19,"chr12",1,0.0757149554617909
"15423","chr12.121150000.121155000","chr12.121345000.121350000",195000,14,0.0009292903,121150000,121345000,121155000,121350000,"chr12",467398,10,12,12,34,"chr12",1,0.0557899671823722
"15424","chr12.123050000.123055000","chr12.123065000.123070000",15000,37,0.006042922,123050000,123065000,123055000,123070000,"chr12",467411,3,4,5,12,"chr12",1,0.0520393811533052
"15425","chr12.14395000.14400000","chr12.14765000.14770000",370000,11,0.0009923679,14395000,14765000,14400000,14770000,"chr12",467421,0,2,5,7,"chr12",1,0.00902484763244257
"15426","chr12.69280000.69285000","chr12.69455000.69460000",175000,20,3.482762e-07,69280000,69455000,69285000,69460000,"chr12",467481,2,3,4,9,"chr12",1,0.0210970464135021
"15427","chr12.56685000.56690000","chr12.56755000.56760000",70000,22,0.0002969304,56685000,56755000,56690000,56760000,"chr12",467518,4,8,13,25,"chr12",1,0.0644631973745898
"15428","chr12.57725000.57730000","chr12.57800000.57805000",75000,26,1.014084e-06,57725000,57800000,57730000,57805000,"chr12",467544,0,0,3,3,"chr12",1,0.00914205344585091
"15429","chr12.121915000.121920000","chr12.122065000.122070000",150000,18,3.298385e-05,121915000,122065000,121920000,122070000,"chr12",467563,2,4,3,9,"chr12",1,0.0189873417721519
"15430","chr12.110430000.110435000","chr12.110840000.110845000",410000,13,1.900473e-05,110430000,110840000,110435000,110845000,"chr12",467573,2,10,5,17,"chr12",1,0.0259024847632443
"15431","chr12.112675000.112680000","chr12.112795000.112800000",120000,15,0.005858816,112675000,112795000,112680000,112800000,"chr12",467622,3,3,6,12,"chr12",1,0.0210970464135021
"15432","chr12.93395000.93400000","chr12.93800000.93805000",405000,14,3.342699e-06,93395000,93800000,93400000,93805000,"chr12",467647,0,2,0,2,"chr12",1,0.00328176277543366
"15433","chr12.121990000.121995000","chr12.122200000.122205000",210000,13,0.002003822,121990000,122200000,121995000,122205000,"chr12",467696,0,10,9,19,"chr12",1,0.0289498359118612
"15434","chr12.11725000.11730000","chr12.12150000.12155000",425000,11,0.0004518397,11725000,12150000,11730000,12155000,"chr12",467708,3,3,6,12,"chr12",1,0.0154711673699015
"15435","chr12.120645000.120650000","chr12.120685000.120690000",40000,31,3.582247e-05,120645000,120685000,120650000,120690000,"chr12",467721,0,3,2,5,"chr12",1,0.0181669010782935
"15436","chr12.121770000.121775000","chr12.122125000.122130000",355000,11,0.001238238,121770000,122125000,121775000,122130000,"chr12",467780,0,6,5,11,"chr12",1,0.0141819034224098
"15437","chr12.64230000.64235000","chr12.64625000.64630000",395000,21,1.525759e-12,64230000,64625000,64235000,64630000,"chr12",467788,6,11,17,34,"chr12",1,0.0836849507735584
"15438","chr12.50945000.50950000","chr12.51025000.51030000",80000,22,6.941121e-05,50945000,51025000,50950000,51030000,"chr12",467831,2,13,4,19,"chr12",1,0.0489920300046882
"15439","chr12.48115000.48120000","chr12.48155000.48160000",40000,27,0.00142882,48115000,48155000,48120000,48160000,"chr12",467841,1,2,1,4,"chr12",1,0.0126582278481013
"15440","chr12.109090000.109095000","chr12.109130000.109135000",40000,31,3.582247e-05,109090000,109130000,109095000,109135000,"chr12",467900,6,13,14,33,"chr12",1,0.119901547116737
"15441","chr12.92645000.92650000","chr12.92925000.92930000",280000,12,0.001152152,92645000,92925000,92650000,92930000,"chr12",467903,0,5,4,9,"chr12",1,0.0126582278481013
"15442","chr12.121110000.121115000","chr12.121345000.121350000",235000,14,0.0002300535,121110000,121345000,121115000,121350000,"chr12",467995,9,12,12,33,"chr12",1,0.0541490857946554
"15443","chr12.27710000.27715000","chr12.27745000.27750000",35000,40,3.173984e-08,27710000,27745000,27715000,27750000,"chr12",468071,2,7,8,17,"chr12",1,0.0796999531176746
"15444","chr12.64820000.64825000","chr12.65120000.65125000",300000,11,0.003069305,64820000,65120000,64825000,65125000,"chr12",468082,0,3,0,3,"chr12",1,0.00386779184247539
"15445","chr12.56590000.56595000","chr12.56750000.56755000",160000,14,0.003472662,56590000,56750000,56595000,56755000,"chr12",468095,4,14,14,32,"chr12",1,0.0525082044069386
"15446","chr12.57460000.57465000","chr12.57490000.57495000",30000,43,6.888276e-08,57460000,57490000,57465000,57495000,"chr12",468156,0,5,3,8,"chr12",1,0.0403187998124707
"15447","chr12.121130000.121135000","chr12.121465000.121470000",335000,11,0.001682615,121130000,121465000,121135000,121470000,"chr12",468158,2,6,4,12,"chr12",1,0.0154711673699015
"15448","chr12.116655000.116660000","chr12.117145000.117150000",490000,9,0.00450886,116655000,117145000,116660000,117150000,"chr12",468204,3,4,3,10,"chr12",1,0.0105485232067511
"15449","chr12.52135000.52140000","chr12.52160000.52165000",25000,45,1.338776e-06,52135000,52160000,52140000,52165000,"chr12",468213,1,11,9,21,"chr12",1,0.110759493670886
"15450","chr12.116555000.116560000","chr12.116700000.116705000",145000,14,0.006042922,116555000,116700000,116560000,116705000,"chr12",468276,2,5,6,13,"chr12",1,0.0213314580403188
"15451","chr12.121915000.121920000","chr12.122080000.122085000",165000,18,1.415256e-05,121915000,122080000,121920000,122085000,"chr12",468301,2,4,3,9,"chr12",1,0.0189873417721519
"15452","chr12.93195000.93200000","chr12.93765000.93770000",570000,8,0.009314854,93195000,93765000,93200000,93770000,"chr12",468361,2,2,4,8,"chr12",1,0.00750117205813408
"15453","chr12.121915000.121920000","chr12.122050000.122055000",135000,16,0.0009413351,121915000,122050000,121920000,122055000,"chr12",468374,2,4,3,9,"chr12",1,0.0168776371308017
"15454","chr12.64235000.64240000","chr12.64450000.64455000",215000,23,1.038761e-10,64235000,64450000,64240000,64455000,"chr12",468424,1,2,1,4,"chr12",1,0.0107829348335677
"15455","chr12.105820000.105825000","chr12.106670000.106675000",850000,8,0.00124368,105820000,106670000,105825000,106675000,"chr12",468510,1,5,0,6,"chr12",1,0.00562587904360056
"15456","chr12.750000.755000","chr12.855000.860000",105000,19,0.0001648608,750000,855000,755000,860000,"chr12",468516,1,4,3,8,"chr12",1,0.0178152836380684
"15457","chr12.48980000.48985000","chr12.49000000.49005000",20000,37,0.006042922,48980000,4.9e+07,48985000,49005000,"chr12",468519,2,1,3,6,"chr12",1,0.0260196905766526
"15458","chr12.12680000.12685000","chr12.12710000.12715000",30000,73,3.906929e-26,12680000,12710000,12685000,12715000,"chr12",468530,5,13,13,31,"chr12",1,0.265236755743085
"15459","chr12.93165000.93170000","chr12.93800000.93805000",635000,9,0.001102717,93165000,93800000,93170000,93805000,"chr12",468582,0,2,0,2,"chr12",1,0.00210970464135021
"15460","chr12.8845000.8850000","chr12.8930000.8935000",85000,20,0.000371396,8845000,8930000,8850000,8935000,"chr12",468602,0,2,1,3,"chr12",1,0.0070323488045007
"15461","chr12.121235000.121240000","chr12.121345000.121350000",110000,16,0.00352132,121235000,121345000,121240000,121350000,"chr12",468612,10,12,12,34,"chr12",1,0.0637599624941397
"15462","chr12.51080000.51085000","chr12.51420000.51425000",340000,10,0.006200093,51080000,51420000,51085000,51425000,"chr12",468637,1,4,1,6,"chr12",1,0.0070323488045007
"15463","chr12.32550000.32555000","chr12.32580000.32585000",30000,35,0.000160824,32550000,32580000,32555000,32585000,"chr12",468677,1,1,7,9,"chr12",1,0.0369198312236287
"15464","chr12.700000.705000","chr12.965000.970000",265000,15,1.798477e-05,7e+05,965000,705000,970000,"chr12",468690,3,12,7,22,"chr12",1,0.0386779184247539
"15465","chr12.50055000.50060000","chr12.50110000.50115000",55000,21,0.00890833,50055000,50110000,50060000,50115000,"chr12",468697,2,4,2,8,"chr12",1,0.019690576652602
"15466","chr12.120445000.120450000","chr12.120465000.120470000",20000,45,1.888555e-05,120445000,120465000,120450000,120470000,"chr12",468705,7,28,24,59,"chr12",1,0.311181434599156
"15467","chr12.51205000.51210000","chr12.51340000.51345000",135000,14,0.008778126,51205000,51340000,51210000,51345000,"chr12",468720,11,28,27,66,"chr12",1,0.108298171589311
"15468","chr12.64235000.64240000","chr12.64460000.64465000",225000,22,3.746358e-10,64235000,64460000,64240000,64465000,"chr12",468726,1,2,1,4,"chr12",1,0.0103141115799344
"15469","chr12.1315000.1320000","chr12.1595000.1600000",280000,11,0.004440254,1315000,1595000,1320000,1600000,"chr12",468784,2,8,8,18,"chr12",1,0.0232067510548523
"15470","chr12.57060000.57065000","chr12.57890000.57895000",830000,7,0.007917341,57060000,57890000,57065000,57895000,"chr12",468870,0,5,3,8,"chr12",1,0.00656352555086732
"15471","chr12.14390000.14395000","chr12.14765000.14770000",375000,12,0.0001941104,14390000,14765000,14395000,14770000,"chr12",468880,0,2,1,3,"chr12",1,0.00421940928270042
"15472","chr12.27710000.27715000","chr12.27775000.27780000",65000,21,0.001771687,27710000,27775000,27715000,27780000,"chr12",468889,2,7,8,17,"chr12",1,0.0418424753867792
"15473","chr12.121585000.121590000","chr12.121610000.121615000",25000,41,4.656593e-05,121585000,121610000,121590000,121615000,"chr12",468903,4,24,18,46,"chr12",1,0.221050164088139
"15474","chr12.12240000.12245000","chr12.12485000.12490000",245000,19,3.719591e-08,12240000,12485000,12245000,12490000,"chr12",468979,6,11,8,25,"chr12",1,0.0556727613689639
"15475","chr12.110465000.110470000","chr12.110510000.110515000",45000,28,0.0001317231,110465000,110510000,110470000,110515000,"chr12",469026,3,5,5,13,"chr12",1,0.0426629160806376
"15476","chr12.51205000.51210000","chr12.51390000.51395000",185000,14,0.001359188,51205000,51390000,51210000,51395000,"chr12",469052,6,19,19,44,"chr12",1,0.0721987810595406
"15477","chr12.12640000.12645000","chr12.12680000.12685000",40000,28,0.0006059727,12640000,12680000,12645000,12685000,"chr12",469055,0,3,3,6,"chr12",1,0.019690576652602
"15478","chr12.116390000.116395000","chr12.116955000.116960000",565000,8,0.009745148,116390000,116955000,116395000,116960000,"chr12",469064,1,10,16,27,"chr12",1,0.0253164556962025
"15479","chr12.51440000.51445000","chr12.51720000.51725000",280000,11,0.004440254,51440000,51720000,51445000,51725000,"chr12",469091,2,9,7,18,"chr12",1,0.0232067510548523
"15480","chr12.49565000.49570000","chr12.50070000.50075000",505000,9,0.003873423,49565000,50070000,49570000,50075000,"chr12",469113,0,5,6,11,"chr12",1,0.0116033755274262
"15481","chr12.93195000.93200000","chr12.93800000.93805000",605000,11,4.014189e-05,93195000,93800000,93200000,93805000,"chr12",469159,0,2,0,2,"chr12",1,0.00257852789498359
"15482","chr12.93180000.93185000","chr12.93800000.93805000",620000,10,0.000220941,93180000,93800000,93185000,93805000,"chr12",469170,0,2,0,2,"chr12",1,0.0023441162681669
"15483","chr12.51045000.51050000","chr12.51075000.51080000",30000,40,1.538957e-06,51045000,51075000,51050000,51080000,"chr12",469237,6,25,14,45,"chr12",1,0.210970464135021
"15484","chr12.57135000.57140000","chr12.57455000.57460000",320000,11,0.002118006,57135000,57455000,57140000,57460000,"chr12",469242,0,6,10,16,"chr12",1,0.0206282231598687
"15485","chr12.56125000.56130000","chr12.56185000.56190000",60000,24,0.0002241502,56125000,56185000,56130000,56190000,"chr12",469297,0,3,1,4,"chr12",1,0.0112517580872011
"15486","chr12.121990000.121995000","chr12.122060000.122065000",70000,36,1.172799e-12,121990000,122060000,121995000,122065000,"chr12",469300,0,2,1,3,"chr12",1,0.0126582278481013
"15487","chr12.112005000.112010000","chr12.112105000.112110000",100000,16,0.006653592,112005000,112105000,112010000,112110000,"chr12",469376,2,5,5,12,"chr12",1,0.0225035161744023
"15488","chr12.101790000.101795000","chr12.102245000.102250000",455000,10,0.001487189,101790000,102245000,101795000,102250000,"chr12",469494,1,7,11,19,"chr12",1,0.0222691045475856
"15489","chr12.112615000.112620000","chr12.112795000.112800000",180000,13,0.005332587,112615000,112795000,112620000,112800000,"chr12",469497,3,3,6,12,"chr12",1,0.0182841068917018
"15490","chr12.124990000.124995000","chr12.125210000.125215000",220000,13,0.001487189,124990000,125210000,124995000,125215000,"chr12",469510,7,12,10,29,"chr12",1,0.0441865916549461
"15491","chr12.93175000.93180000","chr12.93780000.93785000",605000,12,5.585367e-06,93175000,93780000,93180000,93785000,"chr12",469535,0,2,1,3,"chr12",1,0.00421940928270042
"15492","chr12.52135000.52140000","chr12.52155000.52160000",20000,50,2.174504e-07,52135000,52155000,52140000,52160000,"chr12",469541,2,11,8,21,"chr12",1,0.123066104078762
"15493","chr12.27010000.27015000","chr12.27140000.27145000",130000,15,0.003709005,27010000,27140000,27015000,27145000,"chr12",469551,0,2,1,3,"chr12",1,0.00527426160337553
"15494","chr12.122065000.122070000","chr12.122105000.122110000",40000,27,0.00142882,122065000,122105000,122070000,122110000,"chr12",469556,1,25,19,45,"chr12",1,0.142405063291139
"15495","chr12.122620000.122625000","chr12.122835000.122840000",215000,12,0.005955114,122620000,122835000,122625000,122840000,"chr12",469812,0,2,3,5,"chr12",1,0.0070323488045007
"15496","chr12.15555000.15560000","chr12.15580000.15585000",25000,40,0.0001053516,15555000,15580000,15560000,15585000,"chr12",469838,2,3,7,12,"chr12",1,0.0562587904360056
"15497","chr12.109080000.109085000","chr12.109130000.109135000",50000,24,0.001727655,109080000,109130000,109085000,109135000,"chr12",469845,4,9,12,25,"chr12",1,0.070323488045007
"15498","chr12.110530000.110535000","chr12.110695000.110700000",165000,13,0.008778126,110530000,110695000,110535000,110700000,"chr12",469897,3,12,16,31,"chr12",1,0.0472339428035631
"15499","chr12.96445000.96450000","chr12.96880000.96885000",435000,10,0.001870666,96445000,96880000,96450000,96885000,"chr12",469930,1,2,1,4,"chr12",1,0.0046882325363338
"15500","chr12.125070000.125075000","chr12.125205000.125210000",135000,20,4.631446e-06,125070000,125205000,125075000,125210000,"chr12",469954,0,2,2,4,"chr12",1,0.00937646507266761
"15501","chr12.50945000.50950000","chr12.51005000.51010000",60000,34,8.044346e-10,50945000,51005000,50950000,51010000,"chr12",469971,2,13,4,19,"chr12",1,0.0757149554617909
"15502","chr12.98995000.99000000","chr12.99040000.99045000",45000,30,1.733209e-05,98995000,99040000,9.9e+07,99045000,"chr12",470028,0,2,1,3,"chr12",1,0.0105485232067511
"15503","chr12.122050000.122055000","chr12.122110000.122115000",60000,23,0.0006155153,122050000,122110000,122055000,122115000,"chr12",470041,3,15,10,28,"chr12",1,0.0754805438349742
"15504","chr12.64230000.64235000","chr12.64795000.64800000",565000,11,6.682199e-05,64230000,64795000,64235000,64800000,"chr12",470165,1,0,4,5,"chr12",1,0.00644631973745898
"15505","chr12.6590000.6595000","chr12.6615000.6620000",25000,35,0.004075805,6590000,6615000,6595000,6620000,"chr12",470186,1,5,5,11,"chr12",1,0.0451242381622128
"15506","chr12.6450000.6455000","chr12.6560000.6565000",110000,17,0.001187183,6450000,6560000,6455000,6565000,"chr12",470201,0,4,3,7,"chr12",1,0.0139474917955931
"15507","chr12.125135000.125140000","chr12.125205000.125210000",70000,22,0.0002969304,125135000,125205000,125140000,125210000,"chr12",470225,0,2,2,4,"chr12",1,0.0103141115799344
"15508","chr12.69280000.69285000","chr12.69435000.69440000",155000,18,2.484334e-05,69280000,69435000,69285000,69440000,"chr12",470253,4,3,11,18,"chr12",1,0.0379746835443038
"15509","chr12.51215000.51220000","chr12.51375000.51380000",160000,28,5.862708e-13,51215000,51375000,51220000,51380000,"chr12",470283,0,6,6,12,"chr12",1,0.0393811533052039
"15510","chr12.110025000.110030000","chr12.110170000.110175000",145000,19,1.050948e-05,110025000,110170000,110030000,110175000,"chr12",470342,1,11,6,18,"chr12",1,0.040084388185654
"15511","chr12.19615000.19620000","chr12.19640000.19645000",25000,41,4.656593e-05,19615000,19640000,19620000,19645000,"chr12",470393,3,10,4,17,"chr12",1,0.0816924519456165
"15512","chr12.76035000.76040000","chr12.76330000.76335000",295000,11,0.003338333,76035000,76330000,76040000,76335000,"chr12",470416,0,3,2,5,"chr12",1,0.00644631973745898
"15513","chr12.125255000.125260000","chr12.125330000.125335000",75000,27,2.634433e-07,125255000,125330000,125260000,125335000,"chr12",470431,4,0,1,5,"chr12",1,0.0158227848101266
"15514","chr12.12520000.12525000","chr12.12700000.12705000",180000,15,0.0004549036,12520000,12700000,12525000,12705000,"chr12",470465,1,1,3,5,"chr12",1,0.00879043600562588
"15515","chr12.41930000.41935000","chr12.42295000.42300000",365000,11,0.001070874,41930000,42295000,41935000,42300000,"chr12",470479,1,10,9,20,"chr12",1,0.0257852789498359
"15516","chr12.130535000.130540000","chr12.130805000.130810000",270000,17,4.82197e-07,130535000,130805000,130540000,130810000,"chr12",470491,1,5,1,7,"chr12",1,0.0139474917955931
"15517","chr12.121235000.121240000","chr12.121285000.121290000",50000,24,0.001727655,121235000,121285000,121240000,121290000,"chr12",470502,7,17,13,37,"chr12",1,0.10407876230661
"15518","chr12.125065000.125070000","chr12.125130000.125135000",65000,21,0.001771687,125065000,125130000,125070000,125135000,"chr12",470559,3,8,3,14,"chr12",1,0.0344585091420534
"15519","chr12.14390000.14395000","chr12.14545000.14550000",155000,35,4.840104e-19,14390000,14545000,14395000,14550000,"chr12",470598,0,2,1,3,"chr12",1,0.0123066104078762
"15520","chr12.57710000.57715000","chr12.57800000.57805000",90000,20,0.0002139501,57710000,57800000,57715000,57805000,"chr12",470637,0,9,4,13,"chr12",1,0.0304735114861697
"15521","chr12.116520000.116525000","chr12.117115000.117120000",595000,8,0.007669293,116520000,117115000,116525000,117120000,"chr12",470678,4,11,12,27,"chr12",1,0.0253164556962025
"15522","chr12.69280000.69285000","chr12.69470000.69475000",190000,14,0.001129618,69280000,69470000,69285000,69475000,"chr12",470743,2,3,2,7,"chr12",1,0.0114861697140178
"15523","chr12.96605000.96610000","chr12.96905000.96910000",300000,17,1.639439e-07,96605000,96905000,96610000,96910000,"chr12",470754,0,1,1,2,"chr12",1,0.00398499765588373
"15524","chr12.116705000.116710000","chr12.117030000.117035000",325000,18,1.01018e-08,116705000,117030000,116710000,117035000,"chr12",470770,0,8,3,11,"chr12",1,0.0232067510548523
"15525","chr12.109095000.109100000","chr12.109115000.109120000",20000,91,1.172487e-30,109095000,109115000,109100000,109120000,"chr12",470811,2,13,12,27,"chr12",1,0.287974683544304
"15526","chr12.860000.865000","chr12.1050000.1055000",190000,13,0.003862157,860000,1050000,865000,1055000,"chr12",470856,1,5,1,7,"chr12",1,0.0106657290201594
"15527","chr12.131790000.131795000","chr12.132135000.132140000",345000,47,9.041183e-43,131790000,132135000,131795000,132140000,"chr12",470877,0,10,4,14,"chr12",1,0.077121425222691
"15528","chr12.124400000.124405000","chr12.124440000.124445000",40000,31,3.582247e-05,124400000,124440000,124405000,124445000,"chr12",470883,2,0,2,4,"chr12",1,0.0145335208626348
"15529","chr12.11810000.11815000","chr12.11965000.11970000",155000,25,2.72434e-10,11810000,11965000,11815000,11970000,"chr12",470897,0,1,2,3,"chr12",1,0.00879043600562588
"15530","chr12.31025000.31030000","chr12.31390000.31395000",365000,10,0.00450886,31025000,31390000,31030000,31395000,"chr12",470914,2,6,22,30,"chr12",1,0.0351617440225035
"15531","chr12.49760000.49765000","chr12.50005000.50010000",245000,15,3.579617e-05,49760000,50005000,49765000,50010000,"chr12",470976,0,3,2,5,"chr12",1,0.00879043600562588
"15532","chr12.750000.755000","chr12.860000.865000",110000,26,4.130068e-09,750000,860000,755000,865000,"chr12",471003,1,4,1,6,"chr12",1,0.0182841068917018
"15533","chr12.121785000.121790000","chr12.121840000.121845000",55000,25,0.0002355347,121785000,121840000,121790000,121845000,"chr12",471018,13,32,39,84,"chr12",1,0.246132208157525
"15534","chr12.26095000.26100000","chr12.26885000.26890000",790000,7,0.009868343,26095000,26885000,26100000,26890000,"chr12",471125,2,1,3,6,"chr12",1,0.00492264416315049
"15535","chr12.110540000.110545000","chr12.110640000.110645000",100000,18,0.0008093402,110540000,110640000,110545000,110645000,"chr12",471134,6,19,18,43,"chr12",1,0.0907172995780591
"15536","chr12.56755000.56760000","chr12.56835000.56840000",80000,45,2.781778e-21,56755000,56835000,56760000,56840000,"chr12",471152,3,3,0,6,"chr12",1,0.0316455696202532
"15537","chr12.51350000.51355000","chr12.51675000.51680000",325000,10,0.007606148,51350000,51675000,51355000,51680000,"chr12",471156,2,8,13,23,"chr12",1,0.0269573370839194
"15538","chr12.116705000.116710000","chr12.117065000.117070000",360000,16,1.968861e-07,116705000,117065000,116710000,117070000,"chr12",471166,11,20,14,45,"chr12",1,0.0843881856540084
"15539","chr12.123115000.123120000","chr12.123220000.123225000",105000,18,0.0005441941,123115000,123220000,123120000,123225000,"chr12",471167,2,0,5,7,"chr12",1,0.0147679324894515
"15540","chr12.41930000.41935000","chr12.41950000.41955000",20000,43,9.410475e-05,41930000,41950000,41935000,41955000,"chr12",471184,1,1,0,2,"chr12",1,0.0100796999531177
"15541","chr12.56445000.56450000","chr12.56485000.56490000",40000,28,0.0006059727,56445000,56485000,56450000,56490000,"chr12",471247,5,18,3,26,"chr12",1,0.0853258321612752
"15542","chr12.49810000.49815000","chr12.49875000.49880000",65000,23,0.0002377345,49810000,49875000,49815000,49880000,"chr12",471261,0,2,5,7,"chr12",1,0.0188701359587436
"15543","chr12.94760000.94765000","chr12.94780000.94785000",20000,37,0.006042922,94760000,94780000,94765000,94785000,"chr12",471274,1,2,2,5,"chr12",1,0.0216830754805438
"15544","chr12.545000.550000","chr12.645000.650000",100000,22,5.544371e-06,545000,645000,550000,650000,"chr12",471377,0,1,1,2,"chr12",1,0.00515705578996718
"15545","chr12.116620000.116625000","chr12.117070000.117075000",450000,10,0.001586397,116620000,117070000,116625000,117075000,"chr12",471381,7,11,14,32,"chr12",1,0.0375058602906704
"15546","chr12.64230000.64235000","chr12.64450000.64455000",220000,18,7.530589e-07,64230000,64450000,64235000,64455000,"chr12",471397,2,8,9,19,"chr12",1,0.040084388185654
"15547","chr12.11770000.11775000","chr12.12080000.12085000",310000,10,0.00941307,11770000,12080000,11775000,12085000,"chr12",471446,2,1,10,13,"chr12",1,0.0152367557430849
"15548","chr12.110005000.110010000","chr12.110180000.110185000",175000,17,3.591227e-05,110005000,110180000,110010000,110185000,"chr12",471457,0,0,6,6,"chr12",1,0.0119549929676512
"15549","chr12.116520000.116525000","chr12.116555000.116560000",35000,29,0.001663392,116520000,116555000,116525000,116560000,"chr12",471489,2,5,6,13,"chr12",1,0.0441865916549461
"15550","chr12.106770000.106775000","chr12.107315000.107320000",545000,12,1.310771e-05,106770000,107315000,106775000,107320000,"chr12",471644,0,2,2,4,"chr12",1,0.00562587904360056
"15551","chr12.121770000.121775000","chr12.122115000.122120000",345000,12,0.0003172014,121770000,122115000,121775000,122120000,"chr12",471683,0,8,5,13,"chr12",1,0.0182841068917018
"15552","chr12.109595000.109600000","chr12.109615000.109620000",20000,38,0.003270744,109595000,109615000,109600000,109620000,"chr12",471702,2,2,7,11,"chr12",1,0.0489920300046882
"15553","chr12.123130000.123135000","chr12.123230000.123235000",100000,16,0.006653592,123130000,123230000,123135000,123235000,"chr12",471722,5,9,16,30,"chr12",1,0.0562587904360056
"15554","chr12.39990000.39995000","chr12.40010000.40015000",20000,39,0.001689966,39990000,40010000,39995000,40015000,"chr12",471725,1,1,1,3,"chr12",1,0.0137130801687764
"15555","chr12.99520000.99525000","chr12.99540000.99545000",20000,41,0.0004214119,99520000,99540000,99525000,99545000,"chr12",471760,0,2,5,7,"chr12",1,0.033638068448195
"15556","chr12.8170000.8175000","chr12.8225000.8230000",55000,26,8.379703e-05,8170000,8225000,8175000,8230000,"chr12",471764,0,2,1,3,"chr12",1,0.00914205344585091
"15557","chr12.50540000.50545000","chr12.50595000.50600000",55000,24,0.0006335958,50540000,50595000,50545000,50600000,"chr12",471862,4,5,6,15,"chr12",1,0.0421940928270042
"15558","chr12.108950000.108955000","chr12.109020000.109025000",70000,20,0.002260466,108950000,109020000,108955000,109025000,"chr12",471954,2,8,3,13,"chr12",1,0.0304735114861697
"15559","chr12.121990000.121995000","chr12.122115000.122120000",125000,42,8.721112e-24,121990000,122115000,121995000,122120000,"chr12",471991,2,11,16,29,"chr12",1,0.142756680731364
"15560","chr12.106640000.106645000","chr12.106745000.106750000",105000,17,0.001672415,106640000,106745000,106645000,106750000,"chr12",472013,2,12,10,24,"chr12",1,0.0478199718706048
"15561","chr12.56720000.56725000","chr12.56755000.56760000",35000,28,0.003578991,56720000,56755000,56725000,56760000,"chr12",472104,0,4,7,11,"chr12",1,0.0360993905297703
"15562","chr12.116705000.116710000","chr12.117145000.117150000",440000,10,0.001756819,116705000,117145000,116710000,117150000,"chr12",472119,3,10,7,20,"chr12",1,0.023441162681669
"15563","chr12.121150000.121155000","chr12.121780000.121785000",630000,8,0.005858816,121150000,121780000,121155000,121785000,"chr12",472177,6,28,21,55,"chr12",1,0.0515705578996718
"15564","chr12.6540000.6545000","chr12.6565000.6570000",25000,47,1.954999e-07,6540000,6565000,6545000,6570000,"chr12",472250,1,8,10,19,"chr12",1,0.104664791373652
"15565","chr12.92205000.92210000","chr12.92505000.92510000",300000,12,0.000743179,92205000,92505000,92210000,92510000,"chr12",472267,2,1,4,7,"chr12",1,0.00984528832630099
"15566","chr12.92205000.92210000","chr12.92465000.92470000",260000,16,4.011362e-06,92205000,92465000,92210000,92470000,"chr12",472297,2,1,4,7,"chr12",1,0.0131270511017346
"15567","chr12.120815000.120820000","chr12.120840000.120845000",25000,40,0.0001053516,120815000,120840000,120820000,120845000,"chr12",472345,2,5,4,11,"chr12",1,0.0515705578996718
"15568","chr12.110035000.110040000","chr12.110155000.110160000",120000,15,0.005858816,110035000,110155000,110040000,110160000,"chr12",472347,5,4,8,17,"chr12",1,0.029887482419128
"15569","chr12.120525000.120530000","chr12.120550000.120555000",25000,54,1.106288e-10,120525000,120550000,120530000,120555000,"chr12",472397,5,16,20,41,"chr12",1,0.259493670886076
"15570","chr12.57745000.57750000","chr12.57800000.57805000",55000,27,2.855257e-05,57745000,57800000,57750000,57805000,"chr12",472404,0,9,4,13,"chr12",1,0.0411392405063291
"15571","chr12.123380000.123385000","chr12.123435000.123440000",55000,22,0.003885138,123380000,123435000,123385000,123440000,"chr12",472446,4,18,36,58,"chr12",1,0.149554617909048
"15572","chr12.122065000.122070000","chr12.122115000.122120000",50000,34,3.040735e-08,122065000,122115000,122070000,122120000,"chr12",472460,2,11,16,29,"chr12",1,0.115564932020628
"15573","chr12.104360000.104365000","chr12.104450000.104455000",90000,18,0.001918374,104360000,104450000,104365000,104455000,"chr12",472462,1,6,1,8,"chr12",1,0.0168776371308017
"15574","chr12.19615000.19620000","chr12.19685000.19690000",70000,19,0.005751671,19615000,19685000,19620000,19690000,"chr12",472475,5,6,6,17,"chr12",1,0.0378574777308955
"15575","chr12.4645000.4650000","chr12.4755000.4760000",110000,30,4.489577e-12,4645000,4755000,4650000,4760000,"chr12",472489,0,2,1,3,"chr12",1,0.0105485232067511
"15576","chr12.49515000.49520000","chr12.49620000.49625000",105000,17,0.001672415,49515000,49620000,49520000,49625000,"chr12",472534,2,14,10,26,"chr12",1,0.0518049695264885
"15577","chr12.121785000.121790000","chr12.121835000.121840000",50000,24,0.001727655,121785000,121835000,121790000,121840000,"chr12",472544,13,32,38,83,"chr12",1,0.233473980309423
"15578","chr12.50035000.50040000","chr12.50110000.50115000",75000,23,4.372199e-05,50035000,50110000,50040000,50115000,"chr12",472558,4,17,15,36,"chr12",1,0.0970464135021097
"15579","chr12.12680000.12685000","chr12.12700000.12705000",20000,74,1.092479e-19,12680000,12700000,12685000,12705000,"chr12",472563,5,13,13,31,"chr12",1,0.268870135958744
"15580","chr12.610000.615000","chr12.645000.650000",35000,31,0.000314028,610000,645000,615000,650000,"chr12",472600,0,4,1,5,"chr12",1,0.0181669010782935
"15581","chr12.6565000.6570000","chr12.6615000.6620000",50000,26,0.0002698523,6565000,6615000,6570000,6620000,"chr12",472608,1,7,5,13,"chr12",1,0.0396155649320206
"15582","chr12.116530000.116535000","chr12.116555000.116560000",25000,41,4.656593e-05,116530000,116555000,116535000,116560000,"chr12",472664,2,5,6,13,"chr12",1,0.0624706985466479
"15583","chr12.51825000.51830000","chr12.52135000.52140000",310000,15,4.565919e-06,51825000,52135000,51830000,52140000,"chr12",472713,0,7,3,10,"chr12",1,0.0175808720112518
"15584","chr12.92045000.92050000","chr12.93015000.93020000",970000,9,6.64835e-05,92045000,93015000,92050000,93020000,"chr12",472727,6,14,14,34,"chr12",1,0.0358649789029536
"15585","chr12.117835000.117840000","chr12.118035000.118040000",200000,13,0.002799815,117835000,118035000,117840000,118040000,"chr12",472740,1,3,6,10,"chr12",1,0.0152367557430849
"15586","chr12.125485000.125490000","chr12.125505000.125510000",20000,45,1.888555e-05,125485000,125505000,125490000,125510000,"chr12",472795,1,1,3,5,"chr12",1,0.0263713080168776
"15587","chr12.18410000.18415000","chr12.19285000.19290000",875000,11,2.071203e-06,18410000,19285000,18415000,19290000,"chr12",472805,0,2,2,4,"chr12",1,0.00515705578996718
"15588","chr12.56750000.56755000","chr12.56835000.56840000",85000,27,4.058292e-08,56750000,56835000,56755000,56840000,"chr12",472869,3,3,0,6,"chr12",1,0.0189873417721519
"15589","chr12.700000.705000","chr12.855000.860000",155000,14,0.004138021,7e+05,855000,705000,860000,"chr12",472881,1,12,7,20,"chr12",1,0.0328176277543366
"15590","chr12.96310000.96315000","chr12.96605000.96610000",295000,11,0.003338333,96310000,96605000,96315000,96610000,"chr12",472947,0,1,1,2,"chr12",1,0.00257852789498359
"15591","chr12.12330000.12335000","chr12.12380000.12385000",50000,23,0.004075805,12330000,12380000,12335000,12385000,"chr12",472958,4,7,5,16,"chr12",1,0.043131739334271
"15592","chr12.57065000.57070000","chr12.57135000.57140000",70000,20,0.002260466,57065000,57135000,57070000,57140000,"chr12",473004,0,6,10,16,"chr12",1,0.0375058602906704
"15593","chr12.56330000.56335000","chr12.56750000.56755000",420000,9,0.009290085,56330000,56750000,56335000,56755000,"chr12",473033,4,6,6,16,"chr12",1,0.0168776371308017
"15594","chr12.51990000.51995000","chr12.52265000.52270000",275000,11,0.00487472,51990000,52265000,51995000,52270000,"chr12",473036,3,12,13,28,"chr12",1,0.0360993905297703
"15595","chr12.124515000.124520000","chr12.125330000.125335000",815000,8,0.001596261,124515000,125330000,124520000,125335000,"chr12",473045,2,2,2,6,"chr12",1,0.00562587904360056
"15596","chr12.92240000.92245000","chr12.92540000.92545000",300000,11,0.003069305,92240000,92540000,92245000,92545000,"chr12",473053,1,6,8,15,"chr12",1,0.0193389592123769
"15597","chr12.96515000.96520000","chr12.96575000.96580000",60000,24,0.0002241502,96515000,96575000,96520000,96580000,"chr12",473088,0,3,4,7,"chr12",1,0.019690576652602
"15598","chr12.56520000.56525000","chr12.56610000.56615000",90000,18,0.001918374,56520000,56610000,56525000,56615000,"chr12",473097,1,5,4,10,"chr12",1,0.0210970464135021
"15599","chr12.14400000.14405000","chr12.14565000.14570000",165000,14,0.002884344,14400000,14565000,14405000,14570000,"chr12",473110,3,16,18,37,"chr12",1,0.0607126113455227
"15600","chr12.124535000.124540000","chr12.125255000.125260000",720000,16,9.548228e-11,124535000,125255000,124540000,125260000,"chr12",473134,1,0,1,2,"chr12",1,0.00375058602906704
"15601","chr12.123265000.123270000","chr12.123425000.123430000",160000,18,1.888555e-05,123265000,123425000,123270000,123430000,"chr12",473145,0,3,0,3,"chr12",1,0.00632911392405063
"15602","chr12.7140000.7145000","chr12.7160000.7165000",20000,51,8.375267e-08,7140000,7160000,7145000,7165000,"chr12",473151,2,5,1,8,"chr12",1,0.0478199718706048
"15603","chr12.109055000.109060000","chr12.109525000.109530000",470000,10,0.00122966,109055000,109525000,109060000,109530000,"chr12",473235,0,9,5,14,"chr12",1,0.0164088138771683
"15604","chr12.50985000.50990000","chr12.51025000.51030000",40000,33,4.508113e-06,50985000,51025000,50990000,51030000,"chr12",473249,2,3,1,6,"chr12",1,0.0232067510548523
"15605","chr12.11785000.11790000","chr12.12425000.12430000",640000,8,0.005407378,11785000,12425000,11790000,12430000,"chr12",473250,4,3,3,10,"chr12",1,0.00937646507266761
"15606","chr12.122125000.122130000","chr12.122280000.122285000",155000,16,0.0003727337,122125000,122280000,122130000,122285000,"chr12",473267,2,6,10,18,"chr12",1,0.0337552742616034
"15607","chr12.110080000.110085000","chr12.110120000.110125000",40000,26,0.003245211,110080000,110120000,110085000,110125000,"chr12",473278,9,18,19,46,"chr12",1,0.140178152836381
"15608","chr12.122890000.122895000","chr12.122945000.122950000",55000,21,0.00890833,122890000,122945000,122895000,122950000,"chr12",473298,3,3,3,9,"chr12",1,0.0221518987341772
"15609","chr12.64220000.64225000","chr12.64570000.64575000",350000,10,0.005431479,64220000,64570000,64225000,64575000,"chr12",473301,2,10,7,19,"chr12",1,0.0222691045475856
"15610","chr12.12015000.12020000","chr12.12150000.12155000",135000,15,0.003044139,12015000,12150000,12020000,12155000,"chr12",473305,3,10,6,19,"chr12",1,0.0334036568213783
"15611","chr12.96310000.96315000","chr12.96905000.96910000",595000,8,0.007669293,96310000,96905000,96315000,96910000,"chr12",473321,2,3,1,6,"chr12",1,0.00562587904360056
"15612","chr12.50015000.50020000","chr12.50100000.50105000",85000,26,1.734411e-07,50015000,50100000,50020000,50105000,"chr12",473332,0,7,9,16,"chr12",1,0.0487576183778715
"15613","chr12.52390000.52395000","chr12.53370000.53375000",980000,7,0.003245211,52390000,53370000,52395000,53375000,"chr12",473395,4,7,6,17,"chr12",1,0.0139474917955931
"15614","chr12.57770000.57775000","chr12.57800000.57805000",30000,30,0.007221198,57770000,57800000,57775000,57805000,"chr12",473401,0,8,3,11,"chr12",1,0.0386779184247539
"15615","chr12.124535000.124540000","chr12.125260000.125265000",725000,10,7.587204e-05,124535000,125260000,124540000,125265000,"chr12",473437,1,1,2,4,"chr12",1,0.0046882325363338
"15616","chr12.12980000.12985000","chr12.13040000.13045000",60000,20,0.009290085,12980000,13040000,12985000,13045000,"chr12",473460,4,3,9,16,"chr12",1,0.0375058602906704
"15617","chr12.50920000.50925000","chr12.51045000.51050000",125000,21,2.190178e-06,50920000,51045000,50925000,51050000,"chr12",473463,5,9,7,21,"chr12",1,0.0516877637130802
"15618","chr12.12640000.12645000","chr12.12695000.12700000",55000,31,2.539377e-07,12640000,12695000,12645000,12700000,"chr12",473464,0,3,3,6,"chr12",1,0.0218002812939522
"15619","chr12.56115000.56120000","chr12.56360000.56365000",245000,13,0.000691547,56115000,56360000,56120000,56365000,"chr12",473500,5,11,6,22,"chr12",1,0.0335208626347867
"15620","chr12.62655000.62660000","chr12.62860000.62865000",205000,17,8.132959e-06,62655000,62860000,62660000,62865000,"chr12",473553,1,0,2,3,"chr12",1,0.0059774964838256
"15621","chr12.32535000.32540000","chr12.32605000.32610000",70000,19,0.005751671,32535000,32605000,32540000,32610000,"chr12",473571,2,9,11,22,"chr12",1,0.0489920300046882
"15622","chr12.27600000.27605000","chr12.27650000.27655000",50000,22,0.009115651,27600000,27650000,27605000,27655000,"chr12",473601,0,4,2,6,"chr12",1,0.0154711673699015
"15623","chr12.93395000.93400000","chr12.93765000.93770000",370000,15,1.060981e-06,93395000,93765000,93400000,93770000,"chr12",473608,2,2,4,8,"chr12",1,0.0140646976090014
"15624","chr12.75950000.75955000","chr12.76445000.76450000",495000,10,0.0009019394,75950000,76445000,75955000,76450000,"chr12",473623,3,5,6,14,"chr12",1,0.0164088138771683
"15625","chr12.109085000.109090000","chr12.109115000.109120000",30000,84,2.289506e-34,109085000,109115000,109090000,109120000,"chr12",473632,2,6,11,19,"chr12",1,0.187060478199719
"15626","chr12.51170000.51175000","chr12.51360000.51365000",190000,15,0.0003016,51170000,51360000,51175000,51365000,"chr12",473640,2,4,8,14,"chr12",1,0.0246132208157525
"15627","chr12.92240000.92245000","chr12.93015000.93020000",775000,9,0.0003383224,92240000,93015000,92245000,93020000,"chr12",473857,4,7,8,19,"chr12",1,0.020042194092827
"15628","chr12.121745000.121750000","chr12.121840000.121845000",95000,16,0.009290085,121745000,121840000,121750000,121845000,"chr12",473894,8,21,17,46,"chr12",1,0.086263478668542
"15629","chr12.12510000.12515000","chr12.12835000.12840000",325000,15,3.096897e-06,12510000,12835000,12515000,12840000,"chr12",473900,2,1,3,6,"chr12",1,0.0105485232067511
"15630","chr12.13075000.13080000","chr12.13125000.13130000",50000,30,3.867967e-06,13075000,13125000,13080000,13130000,"chr12",473935,0,3,1,4,"chr12",1,0.0140646976090014
"15631","chr12.49760000.49765000","chr12.50015000.50020000",255000,11,0.007443733,49760000,50015000,49765000,50020000,"chr12",473942,3,3,2,8,"chr12",1,0.0103141115799344
"15632","chr12.100200000.100205000","chr12.100525000.100530000",325000,14,1.798356e-05,100200000,100525000,100205000,100530000,"chr12",473950,3,4,3,10,"chr12",1,0.0164088138771683
"15633","chr12.12645000.12650000","chr12.12700000.12705000",55000,26,8.379703e-05,12645000,12700000,12650000,12705000,"chr12",473955,6,9,11,26,"chr12",1,0.0792311298640413
"15634","chr12.48750000.48755000","chr12.48775000.48780000",25000,37,0.001043084,48750000,48775000,48755000,48780000,"chr12",473970,0,2,0,2,"chr12",1,0.00867323019221753
"15635","chr12.19895000.19900000","chr12.20585000.20590000",690000,8,0.00373082,19895000,20585000,19900000,20590000,"chr12",473972,2,0,1,3,"chr12",1,0.00281293952180028
"15636","chr12.123385000.123390000","chr12.123425000.123430000",40000,36,1.587154e-07,123385000,123425000,123390000,123430000,"chr12",474044,1,9,3,13,"chr12",1,0.0548523206751055
"15637","chr12.92205000.92210000","chr12.92540000.92545000",335000,20,1.103232e-10,92205000,92540000,92210000,92545000,"chr12",474073,1,1,9,11,"chr12",1,0.0257852789498359
"15638","chr12.50540000.50545000","chr12.50760000.50765000",220000,16,1.979571e-05,50540000,50760000,50545000,50765000,"chr12",474136,4,29,17,50,"chr12",1,0.093764650726676
"15639","chr12.50945000.50950000","chr12.51080000.51085000",135000,18,7.594638e-05,50945000,51080000,50950000,51085000,"chr12",474169,2,13,4,19,"chr12",1,0.040084388185654
"15640","chr12.125485000.125490000","chr12.125525000.125530000",40000,35,4.975061e-07,125485000,125525000,125490000,125530000,"chr12",474176,2,1,0,3,"chr12",1,0.0123066104078762
"15641","chr12.99110000.99115000","chr12.99295000.99300000",185000,14,0.001359188,99110000,99295000,99115000,99300000,"chr12",474218,2,0,2,4,"chr12",1,0.00656352555086732
"15642","chr12.51675000.51680000","chr12.51720000.51725000",45000,29,4.822255e-05,51675000,51720000,51680000,51725000,"chr12",474241,2,8,7,17,"chr12",1,0.0577824660103141
"15643","chr12.116530000.116535000","chr12.117115000.117120000",585000,9,0.001741286,116530000,117115000,116535000,117120000,"chr12",474322,4,11,10,25,"chr12",1,0.0263713080168776
"15644","chr12.104860000.104865000","chr12.104960000.104965000",100000,16,0.006653592,104860000,104960000,104865000,104965000,"chr12",474333,1,9,5,15,"chr12",1,0.0281293952180028
"15645","chr12.109050000.109055000","chr12.109095000.109100000",45000,27,0.0003482007,109050000,109095000,109055000,109100000,"chr12",474406,7,18,17,42,"chr12",1,0.132911392405063
"15646","chr12.110170000.110175000","chr12.110335000.110340000",165000,13,0.008778126,110170000,110335000,110175000,110340000,"chr12",474536,4,25,27,56,"chr12",1,0.0853258321612752
"15647","chr12.108960000.108965000","chr12.109020000.109025000",60000,27,8.051557e-06,108960000,109020000,108965000,109025000,"chr12",474595,2,8,12,22,"chr12",1,0.069620253164557
"15648","chr12.106100000.106105000","chr12.106690000.106695000",590000,9,0.001678115,106100000,106690000,106105000,106695000,"chr12",474607,0,4,3,7,"chr12",1,0.00738396624472574
"15649","chr12.76470000.76475000","chr12.76635000.76640000",165000,14,0.002884344,76470000,76635000,76475000,76640000,"chr12",474610,2,2,3,7,"chr12",1,0.0114861697140178
"15650","chr12.49070000.49075000","chr12.49090000.49095000",20000,40,0.0008520859,49070000,49090000,49075000,49095000,"chr12",474618,1,6,9,16,"chr12",1,0.0750117205813408
"15651","chr12.125070000.125075000","chr12.125255000.125260000",185000,16,9.410247e-05,125070000,125255000,125075000,125260000,"chr12",474725,4,0,1,5,"chr12",1,0.00937646507266761
"15652","chr12.116520000.116525000","chr12.116595000.116600000",75000,21,0.0004214119,116520000,116595000,116525000,116600000,"chr12",474748,0,8,6,14,"chr12",1,0.0344585091420534
"15653","chr12.1090000.1095000","chr12.1630000.1635000",540000,13,1.964082e-06,1090000,1630000,1095000,1635000,"chr12",474750,2,4,4,10,"chr12",1,0.0152367557430849
"15654","chr12.64255000.64260000","chr12.64460000.64465000",205000,12,0.007809895,64255000,64460000,64260000,64465000,"chr12",474875,4,16,15,35,"chr12",1,0.0492264416315049
"15655","chr12.1780000.1785000","chr12.1895000.1900000",115000,34,1.087186e-15,1780000,1895000,1785000,1900000,"chr12",474898,1,5,4,10,"chr12",1,0.0398499765588373
"15656","chr12.64230000.64235000","chr12.64605000.64610000",375000,10,0.003969465,64230000,64605000,64235000,64610000,"chr12",474947,6,11,17,34,"chr12",1,0.0398499765588373
"15657","chr12.51215000.51220000","chr12.51385000.51390000",170000,29,2.857576e-14,51215000,51385000,51220000,51390000,"chr12",474962,0,6,6,12,"chr12",1,0.0407876230661041
"15658","chr12.51420000.51425000","chr12.51465000.51470000",45000,24,0.004672633,51420000,51465000,51425000,51470000,"chr12",475024,1,0,1,2,"chr12",1,0.00562587904360056
"15659","chr12.121745000.121750000","chr12.121770000.121775000",25000,36,0.002074578,121745000,121770000,121750000,121775000,"chr12",475029,0,8,5,13,"chr12",1,0.0548523206751055
"15660","chr12.109090000.109095000","chr12.109150000.109155000",60000,22,0.001624672,109090000,109150000,109095000,109155000,"chr12",475059,3,6,10,19,"chr12",1,0.0489920300046882
"15661","chr12.110885000.110890000","chr12.111020000.111025000",135000,20,4.631446e-06,110885000,111020000,110890000,111025000,"chr12",475061,2,8,7,17,"chr12",1,0.0398499765588373
"15662","chr12.54245000.54250000","chr12.54290000.54295000",45000,24,0.004672633,54245000,54290000,54250000,54295000,"chr12",475093,2,16,14,32,"chr12",1,0.090014064697609
"15663","chr12.51420000.51425000","chr12.51440000.51445000",20000,54,4.087665e-09,51420000,51440000,51425000,51445000,"chr12",475104,1,4,1,6,"chr12",1,0.0379746835443038
"15664","chr12.49535000.49540000","chr12.49565000.49570000",30000,60,2.463644e-17,49535000,49565000,49540000,49570000,"chr12",475136,0,10,6,16,"chr12",1,0.112517580872011
"15665","chr12.116390000.116395000","chr12.117145000.117150000",755000,8,0.002367268,116390000,117145000,116395000,117150000,"chr12",475199,3,10,7,20,"chr12",1,0.0187529301453352
"15666","chr12.93375000.93380000","chr12.93780000.93785000",405000,12,0.0001170106,93375000,93780000,93380000,93785000,"chr12",475214,1,7,4,12,"chr12",1,0.0168776371308017
"15667","chr12.56220000.56225000","chr12.56360000.56365000",140000,19,1.419541e-05,56220000,56360000,56225000,56365000,"chr12",475274,5,11,11,27,"chr12",1,0.060126582278481
"15668","chr12.123385000.123390000","chr12.123455000.123460000",70000,19,0.005751671,123385000,123455000,123390000,123460000,"chr12",475281,1,9,3,13,"chr12",1,0.0289498359118612
"15669","chr12.51010000.51015000","chr12.51025000.51030000",15000,39,0.001689966,51010000,51025000,51015000,51030000,"chr12",475334,4,15,12,31,"chr12",1,0.141701828410689
"15670","chr12.124925000.124930000","chr12.125255000.125260000",330000,14,1.593204e-05,124925000,125255000,124930000,125260000,"chr12",475358,2,0,1,3,"chr12",1,0.00492264416315049
"15671","chr12.50540000.50545000","chr12.50825000.50830000",285000,14,4.873665e-05,50540000,50825000,50545000,50830000,"chr12",475385,4,9,14,27,"chr12",1,0.0443037974683544
"15672","chr12.93440000.93445000","chr12.93780000.93785000",340000,12,0.0003483697,93440000,93780000,93445000,93785000,"chr12",475403,1,1,3,5,"chr12",1,0.0070323488045007
"15673","chr12.11825000.11830000","chr12.12015000.12020000",190000,14,0.001129618,11825000,12015000,11830000,12020000,"chr12",475443,1,0,1,2,"chr12",1,0.00328176277543366
"15674","chr12.56590000.56595000","chr12.56610000.56615000",20000,45,1.888555e-05,56590000,56610000,56595000,56615000,"chr12",475458,2,5,4,11,"chr12",1,0.0580168776371308
"15675","chr12.50035000.50040000","chr12.50075000.50080000",40000,26,0.003245211,50035000,50075000,50040000,50080000,"chr12",475460,2,4,5,11,"chr12",1,0.0335208626347867
"15676","chr12.76055000.76060000","chr12.76155000.76160000",100000,16,0.006653592,76055000,76155000,76060000,76160000,"chr12",475548,6,7,6,19,"chr12",1,0.0356305672761369
"15677","chr12.15855000.15860000","chr12.15930000.15935000",75000,21,0.0004214119,15855000,15930000,15860000,15935000,"chr12",475594,1,3,0,4,"chr12",1,0.00984528832630099
"15678","chr12.116520000.116525000","chr12.117190000.117195000",670000,9,0.0008093402,116520000,117190000,116525000,117195000,"chr12",475611,3,16,13,32,"chr12",1,0.0337552742616034
"15679","chr12.116620000.116625000","chr12.116655000.116660000",35000,29,0.001663392,116620000,116655000,116625000,116660000,"chr12",475660,3,4,3,10,"chr12",1,0.0339896858884201
"15680","chr12.64235000.64240000","chr12.64610000.64615000",375000,15,9.48061e-07,64235000,64610000,64240000,64615000,"chr12",475667,1,2,1,4,"chr12",1,0.0070323488045007
"15681","chr12.123385000.123390000","chr12.123710000.123715000",325000,11,0.00196439,123385000,123710000,123390000,123715000,"chr12",475714,1,5,2,8,"chr12",1,0.0103141115799344
"15682","chr12.99050000.99055000","chr12.99110000.99115000",60000,22,0.001624672,99050000,99110000,99055000,99115000,"chr12",475732,1,3,6,10,"chr12",1,0.0257852789498359
"15683","chr12.124535000.124540000","chr12.125230000.125235000",695000,8,0.003607369,124535000,125230000,124540000,125235000,"chr12",475826,0,0,2,2,"chr12",1,0.00187529301453352
"15684","chr12.50925000.50930000","chr12.50945000.50950000",20000,48,1.3808e-06,50925000,50945000,50930000,50950000,"chr12",476021,2,8,4,14,"chr12",1,0.0787623066104079
"15685","chr12.109085000.109090000","chr12.109155000.109160000",70000,31,2.831059e-09,109085000,109155000,109090000,109160000,"chr12",476033,3,6,7,16,"chr12",1,0.0581340834505391
"15686","chr12.93990000.93995000","chr12.94165000.94170000",175000,17,3.591227e-05,93990000,94165000,93995000,94170000,"chr12",476052,3,1,2,6,"chr12",1,0.0119549929676512
"15687","chr12.116700000.116705000","chr12.117025000.117030000",325000,10,0.007606148,116700000,117025000,116705000,117030000,"chr12",476115,2,5,8,15,"chr12",1,0.0175808720112518
"15688","chr12.49760000.49765000","chr12.49875000.49880000",115000,20,1.970212e-05,49760000,49875000,49765000,49880000,"chr12",476117,0,2,2,4,"chr12",1,0.00937646507266761
"15689","chr12.122850000.122855000","chr12.122870000.122875000",20000,39,0.001689966,122850000,122870000,122855000,122875000,"chr12",476217,0,2,2,4,"chr12",1,0.0182841068917018
"15690","chr12.98955000.98960000","chr12.99050000.99055000",95000,18,0.00123649,98955000,99050000,98960000,99055000,"chr12",476237,0,1,1,2,"chr12",1,0.00421940928270042
"15691","chr12.110955000.110960000","chr12.111010000.111015000",55000,21,0.00890833,110955000,111010000,110960000,111015000,"chr12",476260,0,8,1,9,"chr12",1,0.0221518987341772
"15692","chr12.94560000.94565000","chr12.94650000.94655000",90000,18,0.001918374,94560000,94650000,94565000,94655000,"chr12",476269,6,16,15,37,"chr12",1,0.0780590717299578
"15693","chr12.7635000.7640000","chr12.7805000.7810000",170000,15,0.0006903827,7635000,7805000,7640000,7810000,"chr12",476283,1,10,5,16,"chr12",1,0.0281293952180028
"15694","chr12.110695000.110700000","chr12.110840000.110845000",145000,16,0.00060261,110695000,110840000,110700000,110845000,"chr12",476363,2,10,5,17,"chr12",1,0.0318799812470699
"15695","chr12.125070000.125075000","chr12.125195000.125200000",125000,17,0.0004739813,125070000,125195000,125075000,125200000,"chr12",476444,0,3,4,7,"chr12",1,0.0139474917955931
"15696","chr12.68610000.68615000","chr12.68700000.68705000",90000,28,3.58205e-09,68610000,68700000,68615000,68705000,"chr12",476446,0,9,5,14,"chr12",1,0.0459446788560713
"15697","chr12.110565000.110570000","chr12.110840000.110845000",275000,16,2.343292e-06,110565000,110840000,110570000,110845000,"chr12",476535,2,10,5,17,"chr12",1,0.0318799812470699
"15698","chr12.116705000.116710000","chr12.117115000.117120000",410000,11,0.0005617405,116705000,117115000,116710000,117120000,"chr12",476607,6,11,12,29,"chr12",1,0.0373886544772621
"15699","chr12.56725000.56730000","chr12.56750000.56755000",25000,81,7.71068e-27,56725000,56750000,56730000,56755000,"chr12",476618,4,16,18,38,"chr12",1,0.360759493670886
"15700","chr12.11820000.11825000","chr12.11860000.11865000",40000,26,0.003245211,11820000,11860000,11825000,11865000,"chr12",476647,1,2,7,10,"chr12",1,0.0304735114861697
"15701","chr12.110375000.110380000","chr12.110430000.110435000",55000,24,0.0006335958,110375000,110430000,110380000,110435000,"chr12",476653,2,11,11,24,"chr12",1,0.0675105485232067
"15702","chr12.56185000.56190000","chr12.56330000.56335000",145000,21,5.218886e-07,56185000,56330000,56190000,56335000,"chr12",476673,0,4,1,5,"chr12",1,0.0123066104078762
"15703","chr12.121550000.121555000","chr12.121915000.121920000",365000,10,0.00450886,121550000,121915000,121555000,121920000,"chr12",476701,2,4,3,9,"chr12",1,0.0105485232067511
"15704","chr12.6870000.6875000","chr12.6925000.6930000",55000,23,0.001624672,6870000,6925000,6875000,6930000,"chr12",476707,0,4,2,6,"chr12",1,0.0161744022503516
"15705","chr12.64230000.64235000","chr12.64805000.64810000",575000,12,8.468874e-06,64230000,64805000,64235000,64810000,"chr12",476744,2,3,2,7,"chr12",1,0.00984528832630099
"15706","chr12.12505000.12510000","chr12.12835000.12840000",330000,11,0.001807086,12505000,12835000,12510000,12840000,"chr12",476803,0,3,1,4,"chr12",1,0.00515705578996718
"15707","chr12.124755000.124760000","chr12.125330000.125335000",575000,8,0.009019421,124755000,125330000,124760000,125335000,"chr12",476887,5,2,3,10,"chr12",1,0.00937646507266761
"15708","chr12.54435000.54440000","chr12.54460000.54465000",25000,37,0.001043084,54435000,54460000,54440000,54465000,"chr12",476900,3,6,18,27,"chr12",1,0.117088607594937
"15709","chr12.109110000.109115000","chr12.109155000.109160000",45000,27,0.0003482007,109110000,109155000,109115000,109160000,"chr12",476901,6,10,7,23,"chr12",1,0.0727848101265823
"15710","chr12.112485000.112490000","chr12.112515000.112520000",30000,35,0.000160824,112485000,112515000,112490000,112520000,"chr12",476913,1,10,4,15,"chr12",1,0.0615330520393812
"15711","chr12.56125000.56130000","chr12.56360000.56365000",235000,14,0.0002300535,56125000,56360000,56130000,56365000,"chr12",476997,0,3,5,8,"chr12",1,0.0131270511017346
"15712","chr12.76055000.76060000","chr12.76420000.76425000",365000,11,0.001070874,76055000,76420000,76060000,76425000,"chr12",477037,1,2,3,6,"chr12",1,0.00773558368495077
"15713","chr12.11820000.11825000","chr12.11965000.11970000",145000,14,0.006042922,11820000,11965000,11825000,11970000,"chr12",477041,2,7,6,15,"chr12",1,0.0246132208157525
"15714","chr12.39820000.39825000","chr12.40010000.40015000",190000,17,1.715689e-05,39820000,40010000,39825000,40015000,"chr12",477061,1,3,1,5,"chr12",1,0.00996249413970933
"15715","chr12.124925000.124930000","chr12.125205000.125210000",280000,11,0.004440254,124925000,125205000,124930000,125210000,"chr12",477071,0,2,2,4,"chr12",1,0.00515705578996718
"15716","chr12.130535000.130540000","chr12.130825000.130830000",290000,18,3.44992e-08,130535000,130825000,130540000,130830000,"chr12",477087,7,5,6,18,"chr12",1,0.0379746835443038
"15717","chr12.69250000.69255000","chr12.69460000.69465000",210000,14,0.0005467192,69250000,69460000,69255000,69465000,"chr12",477124,6,4,11,21,"chr12",1,0.0344585091420534
"15718","chr12.121990000.121995000","chr12.122105000.122110000",115000,37,2.592503e-18,121990000,122105000,121995000,122110000,"chr12",477128,1,25,19,45,"chr12",1,0.195147679324895
"15719","chr12.20795000.20800000","chr12.21655000.21660000",860000,7,0.006731739,20795000,21655000,20800000,21660000,"chr12",477132,0,0,3,3,"chr12",1,0.00246132208157525
"15720","chr12.121500000.121505000","chr12.121520000.121525000",20000,40,0.0008520859,121500000,121520000,121505000,121525000,"chr12",477174,3,11,7,21,"chr12",1,0.0984528832630098
"15721","chr12.6730000.6735000","chr12.6750000.6755000",20000,39,0.001689966,6730000,6750000,6735000,6755000,"chr12",477266,0,3,4,7,"chr12",1,0.0319971870604782
"15722","chr12.75720000.75725000","chr12.75905000.75910000",185000,13,0.004514648,75720000,75905000,75725000,75910000,"chr12",477275,0,5,3,8,"chr12",1,0.0121894045944679
"15723","chr12.12265000.12270000","chr12.12425000.12430000",160000,15,0.001053547,12265000,12425000,12270000,12430000,"chr12",477281,1,4,3,8,"chr12",1,0.0140646976090014
"15724","chr12.51465000.51470000","chr12.51645000.51650000",180000,21,4.720466e-08,51465000,51645000,51470000,51650000,"chr12",477308,1,0,3,4,"chr12",1,0.00984528832630099
"15725","chr12.4880000.4885000","chr12.4905000.4910000",25000,35,0.004075805,4880000,4905000,4885000,4910000,"chr12",477309,3,2,9,14,"chr12",1,0.0574308485700891
"15726","chr12.56445000.56450000","chr12.56465000.56470000",20000,52,3.159029e-08,56445000,56465000,56450000,56470000,"chr12",477337,4,19,3,26,"chr12",1,0.158462259728083
"15727","chr12.12240000.12245000","chr12.12465000.12470000",225000,12,0.00450886,12240000,12465000,12245000,12470000,"chr12",477375,6,15,8,29,"chr12",1,0.0407876230661041
"15728","chr12.1460000.1465000","chr12.1540000.1545000",80000,20,0.0006616707,1460000,1540000,1465000,1545000,"chr12",477393,1,4,4,9,"chr12",1,0.0210970464135021
"15729","chr12.12655000.12660000","chr12.12710000.12715000",55000,47,8.155758e-18,12655000,12710000,12660000,12715000,"chr12",477425,5,16,18,39,"chr12",1,0.214838255977496
"15730","chr12.51810000.51815000","chr12.52220000.52225000",410000,10,0.002567691,51810000,52220000,51815000,52225000,"chr12",477442,0,3,3,6,"chr12",1,0.0070323488045007
"15731","chr12.1790000.1795000","chr12.1895000.1900000",105000,21,1.256495e-05,1790000,1895000,1795000,1900000,"chr12",477514,0,1,0,1,"chr12",1,0.00246132208157525
"15732","chr12.92205000.92210000","chr12.93025000.93030000",820000,10,3.133168e-05,92205000,93025000,92210000,93030000,"chr12",477540,2,1,3,6,"chr12",1,0.0070323488045007
"15733","chr12.50760000.50765000","chr12.50825000.50830000",65000,30,4.63173e-08,50760000,50825000,50765000,50830000,"chr12",477564,4,9,14,27,"chr12",1,0.0949367088607595
"15734","chr12.31360000.31365000","chr12.31390000.31395000",30000,32,0.001734574,31360000,31390000,31365000,31395000,"chr12",477569,4,20,13,37,"chr12",1,0.138771683075481
"15735","chr12.15415000.15420000","chr12.15995000.16000000",580000,8,0.008688971,15415000,15995000,15420000,1.6e+07,"chr12",477581,0,1,1,2,"chr12",1,0.00187529301453352
"15736","chr12.112385000.112390000","chr12.112745000.112750000",360000,10,0.004769614,112385000,112745000,112390000,112750000,"chr12",477608,1,1,1,3,"chr12",1,0.00351617440225035
"15737","chr12.124990000.124995000","chr12.125230000.125235000",240000,12,0.003069305,124990000,125230000,124995000,125235000,"chr12",477615,0,0,6,6,"chr12",1,0.00843881856540084
"15738","chr12.8230000.8235000","chr12.8395000.8400000",165000,23,4.228458e-09,8230000,8395000,8235000,8400000,"chr12",477622,2,0,5,7,"chr12",1,0.0188701359587436
"15739","chr12.122060000.122065000","chr12.122110000.122115000",50000,22,0.009115651,122060000,122110000,122065000,122115000,"chr12",477623,0,2,1,3,"chr12",1,0.00773558368495077
"15740","chr12.50760000.50765000","chr12.51360000.51365000",600000,9,0.001542747,50760000,51360000,50765000,51365000,"chr12",477624,4,4,14,22,"chr12",1,0.0232067510548523
"15741","chr12.11770000.11775000","chr12.12520000.12525000",750000,8,0.00243635,11770000,12520000,11775000,12525000,"chr12",477633,1,1,3,5,"chr12",1,0.0046882325363338
"15742","chr12.26200000.26205000","chr12.26830000.26835000",630000,8,0.005858816,26200000,26830000,26205000,26835000,"chr12",477636,1,1,1,3,"chr12",1,0.00281293952180028
"15743","chr12.122850000.122855000","chr12.122890000.122895000",40000,28,0.0006059727,122850000,122890000,122855000,122895000,"chr12",477637,0,2,2,4,"chr12",1,0.0131270511017346
"15744","chr12.49510000.49515000","chr12.49620000.49625000",110000,16,0.00352132,49510000,49620000,49515000,49625000,"chr12",477736,2,3,7,12,"chr12",1,0.0225035161744023
"15745","chr12.122890000.122895000","chr12.122965000.122970000",75000,22,0.0001389838,122890000,122965000,122895000,122970000,"chr12",477775,2,6,6,14,"chr12",1,0.0360993905297703
"15746","chr12.49260000.49265000","chr12.49330000.49335000",70000,20,0.002260466,49260000,49330000,49265000,49335000,"chr12",477820,0,4,1,5,"chr12",1,0.0117205813408345
"15747","chr12.67080000.67085000","chr12.67265000.67270000",185000,13,0.004514648,67080000,67265000,67085000,67270000,"chr12",477884,4,4,7,15,"chr12",1,0.0228551336146273
"15748","chr12.56205000.56210000","chr12.56355000.56360000",150000,18,3.298385e-05,56205000,56355000,56210000,56360000,"chr12",477916,3,15,23,41,"chr12",1,0.0864978902953586
"15749","chr12.50055000.50060000","chr12.50100000.50105000",45000,31,5.853223e-06,50055000,50100000,50060000,50105000,"chr12",477918,0,4,2,6,"chr12",1,0.0218002812939522
"15750","chr12.41930000.41935000","chr12.42480000.42485000",550000,9,0.002453181,41930000,42480000,41935000,42485000,"chr12",478007,1,8,4,13,"chr12",1,0.0137130801687764
"15751","chr12.123780000.123785000","chr12.123805000.123810000",25000,39,0.0002355347,123780000,123805000,123785000,123810000,"chr12",478020,4,8,15,27,"chr12",1,0.123417721518987
"15752","chr12.14390000.14395000","chr12.14955000.14960000",565000,10,0.0004019376,14390000,14955000,14395000,14960000,"chr12",478078,0,2,1,3,"chr12",1,0.00351617440225035
"15753","chr12.122020000.122025000","chr12.122050000.122055000",30000,33,0.0008141503,122020000,122050000,122025000,122055000,"chr12",478130,0,4,0,4,"chr12",1,0.0154711673699015
"15754","chr12.122020000.122025000","chr12.122110000.122115000",90000,21,6.441507e-05,122020000,122110000,122025000,122115000,"chr12",478142,0,4,0,4,"chr12",1,0.00984528832630099
"15755","chr12.50985000.50990000","chr12.51045000.51050000",60000,20,0.009290085,50985000,51045000,50990000,51050000,"chr12",478162,2,3,1,6,"chr12",1,0.0140646976090014
"15756","chr12.93800000.93805000","chr12.93820000.93825000",20000,46,8.095311e-06,93800000,93820000,93805000,93825000,"chr12",478193,0,2,0,2,"chr12",1,0.0107829348335677
"15757","chr12.121770000.121775000","chr12.121915000.121920000",145000,17,0.0001664395,121770000,121915000,121775000,121920000,"chr12",478196,0,4,3,7,"chr12",1,0.0139474917955931
"15758","chr12.122000000.122005000","chr12.122300000.122305000",300000,13,0.0001648608,1.22e+08,122300000,122005000,122305000,"chr12",478239,4,19,13,36,"chr12",1,0.0548523206751055
"15759","chr12.56115000.56120000","chr12.56330000.56335000",215000,14,0.0004549036,56115000,56330000,56120000,56335000,"chr12",478248,5,6,6,17,"chr12",1,0.0278949835911861
"15760","chr12.122000000.122005000","chr12.122120000.122125000",120000,21,3.262999e-06,1.22e+08,122120000,122005000,122125000,"chr12",478304,11,20,24,55,"chr12",1,0.135372714486639
"15761","chr12.109110000.109115000","chr12.109540000.109545000",430000,9,0.008375162,109110000,109540000,109115000,109545000,"chr12",478358,1,2,4,7,"chr12",1,0.00738396624472574
"15762","chr12.11810000.11815000","chr12.11835000.11840000",25000,45,1.338776e-06,11810000,11835000,11815000,11840000,"chr12",478369,0,1,0,1,"chr12",1,0.00527426160337553
"15763","chr12.122945000.122950000","chr12.122965000.122970000",20000,43,9.410475e-05,122945000,122965000,122950000,122970000,"chr12",478450,2,3,3,8,"chr12",1,0.0403187998124707
"15764","chr12.26340000.26345000","chr12.26375000.26380000",35000,28,0.003578991,26340000,26375000,26345000,26380000,"chr12",478491,0,3,1,4,"chr12",1,0.0131270511017346
"15765","chr12.715000.720000","chr12.965000.970000",250000,13,0.0006059727,715000,965000,720000,970000,"chr12",478565,10,33,30,73,"chr12",1,0.111228316924519
"15766","chr12.122890000.122895000","chr12.122950000.122955000",60000,20,0.009290085,122890000,122950000,122895000,122955000,"chr12",478603,5,7,9,21,"chr12",1,0.0492264416315049
"15767","chr12.76620000.76625000","chr12.76700000.76705000",80000,20,0.0006616707,76620000,76700000,76625000,76705000,"chr12",478621,1,4,6,11,"chr12",1,0.0257852789498359
"15768","chr12.109555000.109560000","chr12.109845000.109850000",290000,11,0.003641477,109555000,109845000,109560000,109850000,"chr12",478723,0,4,1,5,"chr12",1,0.00644631973745898
"15769","chr12.109055000.109060000","chr12.109085000.109090000",30000,34,0.0003692794,109055000,109085000,109060000,109090000,"chr12",478749,0,6,6,12,"chr12",1,0.0478199718706048
"15770","chr12.124400000.124405000","chr12.124470000.124475000",70000,19,0.005751671,124400000,124470000,124405000,124475000,"chr12",478764,1,0,0,1,"chr12",1,0.00222691045475856
"15771","chr12.124535000.124540000","chr12.124815000.124820000",280000,11,0.004440254,124535000,124815000,124540000,124820000,"chr12",478766,1,1,2,4,"chr12",1,0.00515705578996718
"15772","chr12.69290000.69295000","chr12.69560000.69565000",270000,12,0.001453261,69290000,69560000,69295000,69565000,"chr12",478787,5,4,3,12,"chr12",1,0.0168776371308017
"15773","chr12.570000.575000","chr12.640000.645000",70000,23,9.887272e-05,570000,640000,575000,645000,"chr12",478789,1,13,8,22,"chr12",1,0.0593061415846226
"15774","chr12.14415000.14420000","chr12.14565000.14570000",150000,17,0.0001288331,14415000,14565000,14420000,14570000,"chr12",478799,3,9,6,18,"chr12",1,0.0358649789029536
"15775","chr12.123380000.123385000","chr12.123425000.123430000",45000,33,6.032229e-07,123380000,123425000,123385000,123430000,"chr12",478800,4,31,36,71,"chr12",1,0.274613220815752
"15776","chr12.122000000.122005000","chr12.122080000.122085000",80000,18,0.004919131,1.22e+08,122080000,122005000,122085000,"chr12",478808,4,11,6,21,"chr12",1,0.0443037974683544
"15777","chr12.122355000.122360000","chr12.122405000.122410000",50000,27,9.956267e-05,122355000,122405000,122360000,122410000,"chr12",478873,6,23,26,55,"chr12",1,0.174050632911392
"15778","chr12.121350000.121355000","chr12.121395000.121400000",45000,30,1.733209e-05,121350000,121395000,121355000,121400000,"chr12",478877,5,26,29,60,"chr12",1,0.210970464135021
"15779","chr12.116555000.116560000","chr12.116655000.116660000",100000,19,0.0002539577,116555000,116655000,116560000,116660000,"chr12",478881,2,4,3,9,"chr12",1,0.020042194092827
"15780","chr12.121790000.121795000","chr12.121885000.121890000",95000,18,0.00123649,121790000,121885000,121795000,121890000,"chr12",478884,0,5,4,9,"chr12",1,0.0189873417721519
"15781","chr12.92205000.92210000","chr12.92240000.92245000",35000,34,1.963249e-05,92205000,92240000,92210000,92245000,"chr12",478895,4,1,8,13,"chr12",1,0.0518049695264885
"15782","chr12.123655000.123660000","chr12.124105000.124110000",450000,9,0.006863721,123655000,124105000,123660000,124110000,"chr12",478901,2,4,8,14,"chr12",1,0.0147679324894515
"15783","chr12.66690000.66695000","chr12.67080000.67085000",390000,10,0.003303312,66690000,67080000,66695000,67085000,"chr12",478906,7,4,7,18,"chr12",1,0.0210970464135021
"15784","chr12.116605000.116610000","chr12.117020000.117025000",415000,9,0.009807336,116605000,117020000,116610000,117025000,"chr12",478913,0,0,1,1,"chr12",1,0.00105485232067511
"15785","chr12.124860000.124865000","chr12.125260000.125265000",400000,10,0.00293435,124860000,125260000,124865000,125265000,"chr12",478916,0,6,3,9,"chr12",1,0.0105485232067511
"15786","chr12.124555000.124560000","chr12.124790000.124795000",235000,13,0.0009269778,124555000,124790000,124560000,124795000,"chr12",478920,0,7,1,8,"chr12",1,0.0121894045944679
"15787","chr12.124470000.124475000","chr12.125260000.125265000",790000,7,0.009868343,124470000,125260000,124475000,125265000,"chr12",478948,1,1,0,2,"chr12",1,0.00164088138771683
"15788","chr12.121770000.121775000","chr12.121885000.121890000",115000,19,7.45768e-05,121770000,121885000,121775000,121890000,"chr12",479021,0,8,5,13,"chr12",1,0.0289498359118612
"15789","chr12.6735000.6740000","chr12.6890000.6895000",155000,15,0.001300684,6735000,6890000,6740000,6895000,"chr12",479026,6,27,38,71,"chr12",1,0.124824191279887
"15790","chr12.720000.725000","chr12.855000.860000",135000,16,0.0009413351,720000,855000,725000,860000,"chr12",479068,1,13,7,21,"chr12",1,0.0393811533052039
"15791","chr12.76605000.76610000","chr12.76620000.76625000",15000,37,0.006042922,76605000,76620000,76610000,76625000,"chr12",479077,0,2,5,7,"chr12",1,0.0303563056727614
"15792","chr12.112645000.112650000","chr12.112795000.112800000",150000,20,1.723294e-06,112645000,112795000,112650000,112800000,"chr12",479081,2,3,4,9,"chr12",1,0.0210970464135021
"15793","chr12.19285000.19290000","chr12.19440000.19445000",155000,16,0.0003727337,19285000,19440000,19290000,19445000,"chr12",479106,0,8,5,13,"chr12",1,0.0243788091889358
"15794","chr12.12345000.12350000","chr12.12380000.12385000",35000,33,5.076944e-05,12345000,12380000,12350000,12385000,"chr12",479124,0,5,5,10,"chr12",1,0.0386779184247539
"15795","chr12.125470000.125475000","chr12.125530000.125535000",60000,34,8.044346e-10,125470000,125530000,125475000,125535000,"chr12",479154,3,2,2,7,"chr12",1,0.0278949835911861
"15796","chr12.6540000.6545000","chr12.6555000.6560000",15000,45,1.888555e-05,6540000,6555000,6545000,6560000,"chr12",479169,1,8,10,19,"chr12",1,0.100210970464135
"15797","chr12.89580000.89585000","chr12.89665000.89670000",85000,20,0.000371396,89580000,89665000,89585000,89670000,"chr12",479271,0,4,2,6,"chr12",1,0.0140646976090014
"15798","chr12.1460000.1465000","chr12.1595000.1600000",135000,14,0.008778126,1460000,1595000,1465000,1600000,"chr12",479343,1,4,4,9,"chr12",1,0.0147679324894515
"15799","chr12.49260000.49265000","chr12.49320000.49325000",60000,20,0.009290085,49260000,49320000,49265000,49325000,"chr12",479383,7,19,26,52,"chr12",1,0.121894045944679
"15800","chr12.123065000.123070000","chr12.123115000.123120000",50000,22,0.009115651,123065000,123115000,123070000,123120000,"chr12",479430,2,0,5,7,"chr12",1,0.0180496952648851
"15801","chr12.56125000.56130000","chr12.56315000.56320000",190000,14,0.001129618,56125000,56315000,56130000,56320000,"chr12",479450,0,3,3,6,"chr12",1,0.00984528832630099
"15802","chr12.12685000.12690000","chr12.12710000.12715000",25000,47,1.954999e-07,12685000,12710000,12690000,12715000,"chr12",479461,4,7,5,16,"chr12",1,0.0881387716830755
"15803","chr12.110005000.110010000","chr12.110170000.110175000",165000,18,1.415256e-05,110005000,110170000,110010000,110175000,"chr12",479537,3,16,10,29,"chr12",1,0.0611814345991561
"15804","chr12.18410000.18415000","chr12.19330000.19335000",920000,9,0.0001033916,18410000,19330000,18415000,19335000,"chr12",479539,0,2,2,4,"chr12",1,0.00421940928270042
"15805","chr12.93375000.93380000","chr12.93765000.93770000",390000,10,0.003303312,93375000,93765000,93380000,93770000,"chr12",479558,1,2,4,7,"chr12",1,0.00820440693858415
"15806","chr12.122130000.122135000","chr12.122225000.122230000",95000,34,5.085673e-14,122130000,122225000,122135000,122230000,"chr12",479582,3,8,16,27,"chr12",1,0.107594936708861
"15807","chr12.93175000.93180000","chr12.93765000.93770000",590000,12,6.927573e-06,93175000,93765000,93180000,93770000,"chr12",479595,0,2,1,3,"chr12",1,0.00421940928270042
"15808","chr12.11725000.11730000","chr12.12160000.12165000",435000,9,0.007949728,11725000,12160000,11730000,12165000,"chr12",479598,0,3,2,5,"chr12",1,0.00527426160337553
"15809","chr12.56685000.56690000","chr12.56750000.56755000",65000,29,1.780772e-07,56685000,56750000,56690000,56755000,"chr12",479645,4,14,13,31,"chr12",1,0.105368026254102
"15810","chr12.12520000.12525000","chr12.12710000.12715000",190000,30,4.308587e-16,12520000,12710000,12525000,12715000,"chr12",479681,1,1,3,5,"chr12",1,0.0175808720112518
"15811","chr12.122120000.122125000","chr12.122225000.122230000",105000,19,0.0001648608,122120000,122225000,122125000,122230000,"chr12",479715,3,8,16,27,"chr12",1,0.060126582278481
"15812","chr12.6760000.6765000","chr12.6790000.6795000",30000,41,5.623927e-07,6760000,6790000,6765000,6795000,"chr12",479865,2,12,6,20,"chr12",1,0.0961087669948429
"15813","chr12.121155000.121160000","chr12.121295000.121300000",140000,14,0.007287567,121155000,121295000,121160000,121300000,"chr12",479869,1,5,9,15,"chr12",1,0.0246132208157525
"15814","chr12.122405000.122410000","chr12.123050000.123055000",645000,8,0.005212515,122405000,123050000,122410000,123055000,"chr12",479875,8,13,9,30,"chr12",1,0.0281293952180028
"15815","chr12.6735000.6740000","chr12.6905000.6910000",170000,13,0.007443733,6735000,6905000,6740000,6910000,"chr12",479881,2,4,4,10,"chr12",1,0.0152367557430849
"15816","chr12.49510000.49515000","chr12.49625000.49630000",115000,23,2.649724e-07,49510000,49625000,49515000,49630000,"chr12",479909,0,3,6,9,"chr12",1,0.0242616033755274
"15817","chr12.121750000.121755000","chr12.121780000.121785000",30000,35,0.000160824,121750000,121780000,121755000,121785000,"chr12",479913,4,8,10,22,"chr12",1,0.0902484763244257
"15818","chr12.125505000.125510000","chr12.125530000.125535000",25000,38,0.0005015141,125505000,125530000,125510000,125535000,"chr12",479946,1,4,2,7,"chr12",1,0.0311767463666198
"15819","chr12.12610000.12615000","chr12.12655000.12660000",45000,31,5.853223e-06,12610000,12655000,12615000,12660000,"chr12",479959,5,14,18,37,"chr12",1,0.134435067979372
"15820","chr12.56125000.56130000","chr12.56355000.56360000",230000,23,3.678619e-11,56125000,56355000,56130000,56360000,"chr12",479960,0,3,5,8,"chr12",1,0.0215658696671355
"15821","chr12.56155000.56160000","chr12.56185000.56190000",30000,31,0.003607369,56155000,56185000,56160000,56190000,"chr12",479961,0,4,1,5,"chr12",1,0.0181669010782935
"15822","chr12.99150000.99155000","chr12.99255000.99260000",105000,21,1.256495e-05,99150000,99255000,99155000,99260000,"chr12",479986,0,2,0,2,"chr12",1,0.00492264416315049
"15823","chr12.122480000.122485000","chr12.123220000.123225000",740000,8,0.002631479,122480000,123220000,122485000,123225000,"chr12",479988,7,14,8,29,"chr12",1,0.0271917487107361
"15824","chr12.76035000.76040000","chr12.76055000.76060000",20000,37,0.006042922,76035000,76055000,76040000,76060000,"chr12",479992,0,3,2,5,"chr12",1,0.0216830754805438
"15825","chr12.56190000.56195000","chr12.56330000.56335000",140000,16,0.0007509807,56190000,56330000,56195000,56335000,"chr12",480015,1,6,6,13,"chr12",1,0.0243788091889358
"15826","chr12.121780000.121785000","chr12.121885000.121890000",105000,32,2.692718e-13,121780000,121885000,121785000,121890000,"chr12",480020,6,28,21,55,"chr12",1,0.206282231598687
"15827","chr12.57755000.57760000","chr12.57790000.57795000",35000,37,8.971714e-07,57755000,57790000,57760000,57795000,"chr12",480051,0,1,1,2,"chr12",1,0.00867323019221753
"15828","chr12.49070000.49075000","chr12.49190000.49195000",120000,16,0.001982068,49070000,49190000,49075000,49195000,"chr12",480087,4,20,23,47,"chr12",1,0.0881387716830755
"15829","chr12.125065000.125070000","chr12.125125000.125130000",60000,30,1.954999e-07,125065000,125125000,125070000,125130000,"chr12",480101,3,10,3,16,"chr12",1,0.0562587904360056
"15830","chr12.116705000.116710000","chr12.117040000.117045000",335000,16,3.750721e-07,116705000,117040000,116710000,117045000,"chr12",480144,4,9,13,26,"chr12",1,0.0487576183778715
"15831","chr12.116700000.116705000","chr12.117115000.117120000",415000,10,0.002398359,116700000,117115000,116705000,117120000,"chr12",480149,6,11,12,29,"chr12",1,0.0339896858884201
"15832","chr12.64235000.64240000","chr12.64795000.64800000",560000,12,1.05274e-05,64235000,64795000,64240000,64800000,"chr12",480170,1,0,1,2,"chr12",1,0.00281293952180028
"15833","chr12.14400000.14405000","chr12.14765000.14770000",365000,12,0.0002275751,14400000,14765000,14405000,14770000,"chr12",480188,3,15,20,38,"chr12",1,0.0534458509142053
"15834","chr12.112385000.112390000","chr12.112480000.112485000",95000,17,0.00352132,112385000,112480000,112390000,112485000,"chr12",480242,4,10,15,29,"chr12",1,0.0577824660103141
"15835","chr12.11810000.11815000","chr12.11945000.11950000",135000,16,0.0009413351,11810000,11945000,11815000,11950000,"chr12",480246,0,1,2,3,"chr12",1,0.00562587904360056
"15836","chr12.50925000.50930000","chr12.51080000.51085000",155000,15,0.001300684,50925000,51080000,50930000,51085000,"chr12",480253,6,8,5,19,"chr12",1,0.0334036568213783
"15837","chr12.13070000.13075000","chr12.13365000.13370000",295000,33,2.039334e-23,13070000,13365000,13075000,13370000,"chr12",480285,0,0,4,4,"chr12",1,0.0154711673699015
"15838","chr12.121785000.121790000","chr12.122120000.122125000",335000,16,3.750721e-07,121785000,122120000,121790000,122125000,"chr12",480310,11,32,43,86,"chr12",1,0.161275199249883
"15839","chr12.122355000.122360000","chr12.122830000.122835000",475000,9,0.005244664,122355000,122830000,122360000,122835000,"chr12",480337,6,16,20,42,"chr12",1,0.0443037974683544
"15840","chr12.51425000.51430000","chr12.51720000.51725000",295000,12,0.0008241946,51425000,51720000,51430000,51725000,"chr12",480338,2,4,7,13,"chr12",1,0.0182841068917018
"15841","chr12.12330000.12335000","chr12.12375000.12380000",45000,25,0.002042459,12330000,12375000,12335000,12380000,"chr12",480353,4,7,24,35,"chr12",1,0.102555086732302
"15842","chr12.13070000.13075000","chr12.13125000.13130000",55000,45,2.429094e-16,13070000,13125000,13075000,13130000,"chr12",480383,1,3,4,8,"chr12",1,0.0421940928270042
"15843","chr12.50920000.50925000","chr12.51010000.51015000",90000,22,1.861616e-05,50920000,51010000,50925000,51015000,"chr12",480431,4,9,7,20,"chr12",1,0.0515705578996718
"15844","chr12.11785000.11790000","chr12.12045000.12050000",260000,11,0.006681317,11785000,12045000,11790000,12050000,"chr12",480469,2,3,4,9,"chr12",1,0.0116033755274262
"15845","chr12.93375000.93380000","chr12.93810000.93815000",435000,13,1.204126e-05,93375000,93810000,93380000,93815000,"chr12",480478,1,4,0,5,"chr12",1,0.00761837787154243
"15846","chr12.109090000.109095000","chr12.109110000.109115000",20000,61,1.803254e-12,109090000,109110000,109095000,109115000,"chr12",480510,6,13,14,33,"chr12",1,0.235935302390999
"15847","chr12.116700000.116705000","chr12.117145000.117150000",445000,12,6.175849e-05,116700000,117145000,116705000,117150000,"chr12",480563,3,10,7,20,"chr12",1,0.0281293952180028
"15848","chr12.110530000.110535000","chr12.110840000.110845000",310000,10,0.00941307,110530000,110840000,110535000,110845000,"chr12",480578,2,10,5,17,"chr12",1,0.0199249882794187
"15849","chr12.121135000.121140000","chr12.121345000.121350000",210000,12,0.006863721,121135000,121345000,121140000,121350000,"chr12",480655,4,11,12,27,"chr12",1,0.0379746835443038
"15850","chr12.111840000.111845000","chr12.111895000.111900000",55000,25,0.0002355347,111840000,111895000,111845000,111900000,"chr12",480709,2,9,10,21,"chr12",1,0.0615330520393812
"15851","chr12.49130000.49135000","chr12.49200000.49205000",70000,19,0.005751671,49130000,49200000,49135000,49205000,"chr12",480748,3,13,5,21,"chr12",1,0.0467651195499297
"15852","chr12.99540000.99545000","chr12.99985000.99990000",445000,9,0.007221198,99540000,99985000,99545000,99990000,"chr12",480784,0,2,4,6,"chr12",1,0.00632911392405063
"15853","chr12.116530000.116535000","chr12.117185000.117190000",655000,8,0.004824998,116530000,117185000,116535000,117190000,"chr12",480805,0,8,2,10,"chr12",1,0.00937646507266761
"15854","chr12.122885000.122890000","chr12.122945000.122950000",60000,22,0.001624672,122885000,122945000,122890000,122950000,"chr12",480810,3,3,3,9,"chr12",1,0.0232067510548523
"15855","chr12.116815000.116820000","chr12.116955000.116960000",140000,14,0.007287567,116815000,116955000,116820000,116960000,"chr12",480835,1,10,8,19,"chr12",1,0.0311767463666198
"15856","chr12.121500000.121505000","chr12.121550000.121555000",50000,24,0.001727655,121500000,121550000,121505000,121555000,"chr12",480858,6,21,22,49,"chr12",1,0.137834036568214
"15857","chr12.56150000.56155000","chr12.56190000.56195000",40000,35,4.975061e-07,56150000,56190000,56155000,56195000,"chr12",480888,1,5,8,14,"chr12",1,0.0574308485700891
"15858","chr12.56495000.56500000","chr12.56685000.56690000",190000,14,0.001129618,56495000,56685000,56500000,56690000,"chr12",480922,1,14,9,24,"chr12",1,0.0393811533052039
"15859","chr12.121915000.121920000","chr12.122115000.122120000",200000,14,0.0007820664,121915000,122115000,121920000,122120000,"chr12",480957,2,4,3,9,"chr12",1,0.0147679324894515
"15860","chr12.123395000.123400000","chr12.123425000.123430000",30000,43,6.888276e-08,123395000,123425000,123400000,123430000,"chr12",480975,2,9,11,22,"chr12",1,0.110876699484294
"15861","chr12.49810000.49815000","chr12.49880000.49885000",70000,21,0.0008428889,49810000,49880000,49815000,49885000,"chr12",480999,0,4,7,11,"chr12",1,0.0270745428973277
"15862","chr12.54185000.54190000","chr12.54365000.54370000",180000,14,0.001640208,54185000,54365000,54190000,54370000,"chr12",481009,4,8,6,18,"chr12",1,0.029535864978903
"15863","chr12.18410000.18415000","chr12.19310000.19315000",900000,9,0.0001228064,18410000,19310000,18415000,19315000,"chr12",481036,0,2,2,4,"chr12",1,0.00421940928270042
"15864","chr12.49535000.49540000","chr12.49555000.49560000",20000,47,3.380234e-06,49535000,49555000,49540000,49560000,"chr12",481056,0,0,4,4,"chr12",1,0.0220346929207689
"15865","chr12.108930000.108935000","chr12.109525000.109530000",595000,9,0.001621904,108930000,109525000,108935000,109530000,"chr12",481090,0,9,5,14,"chr12",1,0.0147679324894515
"15866","chr12.56125000.56130000","chr12.56190000.56195000",65000,20,0.00450886,56125000,56190000,56130000,56195000,"chr12",481094,0,3,5,8,"chr12",1,0.0187529301453352
"15867","chr12.26340000.26345000","chr12.26430000.26435000",90000,19,0.0006616707,26340000,26430000,26345000,26435000,"chr12",481111,0,3,2,5,"chr12",1,0.0111345522737928
"15868","chr12.98990000.98995000","chr12.99040000.99045000",50000,25,0.0006979354,98990000,99040000,98995000,99045000,"chr12",481158,0,2,1,3,"chr12",1,0.00879043600562588
"15869","chr12.50635000.50640000","chr12.51520000.51525000",885000,7,0.005848603,50635000,51520000,50640000,51525000,"chr12",481165,1,4,2,7,"chr12",1,0.00574308485700891
"15870","chr12.500000.505000","chr12.965000.970000",465000,9,0.005858816,5e+05,965000,505000,970000,"chr12",481262,11,37,36,84,"chr12",1,0.0886075949367089
"15871","chr12.120435000.120440000","chr12.120515000.120520000",80000,18,0.004919131,120435000,120515000,120440000,120520000,"chr12",481266,11,38,29,78,"chr12",1,0.164556962025316
"15872","chr12.1760000.1765000","chr12.1895000.1900000",135000,88,3.60019e-79,1760000,1895000,1765000,1900000,"chr12",481280,2,1,3,6,"chr12",1,0.0618846694796062
"15873","chr12.117485000.117490000","chr12.117510000.117515000",25000,36,0.002074578,117485000,117510000,117490000,117515000,"chr12",481316,4,1,4,9,"chr12",1,0.0379746835443038
"15874","chr12.27510000.27515000","chr12.27530000.27535000",20000,39,0.001689966,27510000,27530000,27515000,27535000,"chr12",481328,3,11,9,23,"chr12",1,0.105133614627286
"15875","chr12.67795000.67800000","chr12.68220000.68225000",425000,11,0.0004518397,67795000,68220000,67800000,68225000,"chr12",481332,1,5,2,8,"chr12",1,0.0103141115799344
"15876","chr12.108930000.108935000","chr12.109860000.109865000",930000,7,0.004464512,108930000,109860000,108935000,109865000,"chr12",481339,8,24,18,50,"chr12",1,0.0410220346929208
"15877","chr12.123125000.123130000","chr12.123230000.123235000",105000,26,8.050227e-09,123125000,123230000,123130000,123235000,"chr12",481404,10,18,16,44,"chr12",1,0.134083450539147
"15878","chr12.121790000.121795000","chr12.121915000.121920000",125000,16,0.001560541,121790000,121915000,121795000,121920000,"chr12",481439,0,4,3,7,"chr12",1,0.0131270511017346
"15879","chr12.51375000.51380000","chr12.51420000.51425000",45000,25,0.002042459,51375000,51420000,51380000,51425000,"chr12",481452,1,4,1,6,"chr12",1,0.0175808720112518
"15880","chr12.62655000.62660000","chr12.62680000.62685000",25000,35,0.004075805,62655000,62680000,62660000,62685000,"chr12",481471,3,0,2,5,"chr12",1,0.0205110173464604
"15881","chr12.116705000.116710000","chr12.117125000.117130000",420000,11,0.0004837481,116705000,117125000,116710000,117130000,"chr12",481473,0,5,3,8,"chr12",1,0.0103141115799344
"15882","chr12.12610000.12615000","chr12.12680000.12685000",70000,26,2.706382e-06,12610000,12680000,12615000,12685000,"chr12",481481,5,13,13,31,"chr12",1,0.0944678856071261
"15883","chr12.6540000.6545000","chr12.6560000.6565000",20000,73,4.252076e-19,6540000,6560000,6545000,6565000,"chr12",481544,0,8,9,17,"chr12",1,0.145452414439756
"15884","chr12.121610000.121615000","chr12.122295000.122300000",685000,8,0.00388511,121610000,122295000,121615000,122300000,"chr12",481570,2,16,22,40,"chr12",1,0.0375058602906704
"15885","chr12.56150000.56155000","chr12.56185000.56190000",35000,31,0.000314028,56150000,56185000,56155000,56190000,"chr12",481575,0,4,1,5,"chr12",1,0.0181669010782935
"15886","chr12.121915000.121920000","chr12.122130000.122135000",215000,14,0.0004549036,121915000,122130000,121920000,122135000,"chr12",481589,2,4,3,9,"chr12",1,0.0147679324894515
"15887","chr12.56720000.56725000","chr12.56750000.56755000",30000,42,1.973882e-07,56720000,56750000,56725000,56755000,"chr12",481687,0,4,7,11,"chr12",1,0.0541490857946554
"15888","chr12.94565000.94570000","chr12.94760000.94765000",195000,13,0.003286875,94565000,94760000,94570000,94765000,"chr12",481694,0,2,2,4,"chr12",1,0.00609470229723394
"15889","chr12.51385000.51390000","chr12.51420000.51425000",35000,34,1.963249e-05,51385000,51420000,51390000,51425000,"chr12",481724,1,4,1,6,"chr12",1,0.0239099859353024
"15890","chr12.68730000.68735000","chr12.69070000.69075000",340000,15,2.125942e-06,68730000,69070000,68735000,69075000,"chr12",481756,1,0,2,3,"chr12",1,0.00527426160337553
"15891","chr12.1055000.1060000","chr12.1100000.1105000",45000,24,0.004672633,1055000,1100000,1060000,1105000,"chr12",481763,1,3,3,7,"chr12",1,0.019690576652602
"15892","chr12.49760000.49765000","chr12.49975000.49980000",215000,13,0.001721248,49760000,49975000,49765000,49980000,"chr12",481776,3,3,2,8,"chr12",1,0.0121894045944679
"15893","chr12.50945000.50950000","chr12.51010000.51015000",65000,24,8.022832e-05,50945000,51010000,50950000,51015000,"chr12",481797,2,13,4,19,"chr12",1,0.0534458509142053
"15894","chr12.49515000.49520000","chr12.49625000.49630000",110000,26,4.130068e-09,49515000,49625000,49520000,49630000,"chr12",481844,0,3,6,9,"chr12",1,0.0274261603375527
"15895","chr12.116595000.116600000","chr12.116620000.116625000",25000,46,5.204899e-07,116595000,116620000,116600000,116625000,"chr12",481862,0,8,6,14,"chr12",1,0.0754805438349742
"15896","chr12.92045000.92050000","chr12.92645000.92650000",600000,8,0.007426256,92045000,92645000,92050000,92650000,"chr12",481960,4,7,6,17,"chr12",1,0.0159399906235349
"15897","chr12.12520000.12525000","chr12.12835000.12840000",315000,14,2.247521e-05,12520000,12835000,12525000,12840000,"chr12",481962,1,1,3,5,"chr12",1,0.00820440693858415
"15898","chr12.50920000.50925000","chr12.50945000.50950000",25000,36,0.002074578,50920000,50945000,50925000,50950000,"chr12",481986,2,9,4,15,"chr12",1,0.0632911392405063
"15899","chr12.31270000.31275000","chr12.31390000.31395000",120000,15,0.005858816,31270000,31390000,31275000,31395000,"chr12",481991,3,8,5,16,"chr12",1,0.0281293952180028
"15900","chr12.110840000.110845000","chr12.110885000.110890000",45000,33,6.032229e-07,110840000,110885000,110845000,110890000,"chr12",482028,2,10,5,17,"chr12",1,0.0657524613220816
"15901","chr12.95995000.96000000","chr12.96205000.96210000",210000,12,0.006863721,95995000,96205000,9.6e+07,96210000,"chr12",482096,6,5,8,19,"chr12",1,0.0267229254571027
"15902","chr12.51020000.51025000","chr12.51045000.51050000",25000,39,0.0002355347,51020000,51045000,51025000,51050000,"chr12",482114,6,19,14,39,"chr12",1,0.178270042194093
"15903","chr12.6065000.6070000","chr12.6465000.6470000",400000,10,0.00293435,6065000,6465000,6070000,6470000,"chr12",482146,5,11,6,22,"chr12",1,0.0257852789498359
"15904","chr12.750000.755000","chr12.1055000.1060000",305000,14,2.897758e-05,750000,1055000,755000,1060000,"chr12",482222,2,4,3,9,"chr12",1,0.0147679324894515
"15905","chr12.109055000.109060000","chr12.109130000.109135000",75000,20,0.001202934,109055000,109130000,109060000,109135000,"chr12",482262,0,12,6,18,"chr12",1,0.0421940928270042
"15906","chr12.11785000.11790000","chr12.12015000.12020000",230000,12,0.003952237,11785000,12015000,11790000,12020000,"chr12",482267,3,3,4,10,"chr12",1,0.0140646976090014
"15907","chr12.93175000.93180000","chr12.93820000.93825000",645000,8,0.005212515,93175000,93820000,93180000,93825000,"chr12",482270,0,2,1,3,"chr12",1,0.00281293952180028
"15908","chr12.25240000.25245000","chr12.25265000.25270000",25000,43,8.280586e-06,25240000,25265000,25245000,25270000,"chr12",482329,0,0,1,1,"chr12",1,0.00503984997655884
"15909","chr12.26095000.26100000","chr12.26810000.26815000",715000,8,0.003162759,26095000,26810000,26100000,26815000,"chr12",482345,4,1,3,8,"chr12",1,0.00750117205813408
"15910","chr12.26810000.26815000","chr12.26830000.26835000",20000,37,0.006042922,26810000,26830000,26815000,26835000,"chr12",482390,1,6,4,11,"chr12",1,0.0477027660571964
"15911","chr12.123115000.123120000","chr12.123230000.123235000",115000,18,0.0002591224,123115000,123230000,123120000,123235000,"chr12",482395,2,0,5,7,"chr12",1,0.0147679324894515
"15912","chr12.108960000.108965000","chr12.109540000.109545000",580000,8,0.008688971,108960000,109540000,108965000,109545000,"chr12",482464,1,2,4,7,"chr12",1,0.00656352555086732
"15913","chr12.14545000.14550000","chr12.14610000.14615000",65000,21,0.001771687,14545000,14610000,14550000,14615000,"chr12",482497,1,5,3,9,"chr12",1,0.0221518987341772
"15914","chr12.11785000.11790000","chr12.12160000.12165000",375000,12,0.0001941104,11785000,12160000,11790000,12165000,"chr12",482508,0,3,2,5,"chr12",1,0.0070323488045007
"15915","chr12.118350000.118355000","chr12.118370000.118375000",20000,44,4.265078e-05,118350000,118370000,118355000,118375000,"chr12",482513,0,6,7,13,"chr12",1,0.0670417252695734
"15916","chr12.121625000.121630000","chr12.121670000.121675000",45000,24,0.004672633,121625000,121670000,121630000,121675000,"chr12",482517,1,7,7,15,"chr12",1,0.0421940928270042
"15917","chr12.13075000.13080000","chr12.13360000.13365000",285000,13,0.0002355347,13075000,13360000,13080000,13365000,"chr12",482520,0,3,1,4,"chr12",1,0.00609470229723394
"15918","chr12.116595000.116600000","chr12.117040000.117045000",445000,12,6.175849e-05,116595000,117040000,116600000,117045000,"chr12",482545,0,8,6,14,"chr12",1,0.019690576652602
"15919","chr12.93175000.93180000","chr12.93810000.93815000",635000,10,0.0001881974,93175000,93810000,93180000,93815000,"chr12",482570,0,2,0,2,"chr12",1,0.0023441162681669
"15920","chr12.12655000.12660000","chr12.12680000.12685000",25000,39,0.0002355347,12655000,12680000,12660000,12685000,"chr12",482579,5,13,13,31,"chr12",1,0.141701828410689
"15921","chr12.111840000.111845000","chr12.111870000.111875000",30000,33,0.0008141503,111840000,111870000,111845000,111875000,"chr12",482589,0,9,9,18,"chr12",1,0.069620253164557
"15922","chr12.11860000.11865000","chr12.12010000.12015000",150000,16,0.0004715157,11860000,12010000,11865000,12015000,"chr12",482605,1,2,7,10,"chr12",1,0.0187529301453352
"15923","chr12.121125000.121130000","chr12.121340000.121345000",215000,15,0.0001092713,121125000,121340000,121130000,121345000,"chr12",482642,2,17,15,34,"chr12",1,0.059774964838256
"15924","chr12.53740000.53745000","chr12.53770000.53775000",30000,32,0.001734574,53740000,53770000,53745000,53775000,"chr12",482670,0,3,2,5,"chr12",1,0.0187529301453352
"15925","chr12.122885000.122890000","chr12.122940000.122945000",55000,23,0.001624672,122885000,122940000,122890000,122945000,"chr12",482685,6,16,8,30,"chr12",1,0.0808720112517581
"15926","chr12.116655000.116660000","chr12.116705000.116710000",50000,23,0.004075805,116655000,116705000,116660000,116710000,"chr12",482692,3,4,3,10,"chr12",1,0.0269573370839194
"15927","chr12.50110000.50115000","chr12.50175000.50180000",65000,20,0.00450886,50110000,50175000,50115000,50180000,"chr12",482753,6,19,23,48,"chr12",1,0.112517580872011
"15928","chr12.109050000.109055000","chr12.109615000.109620000",565000,8,0.009745148,109050000,109615000,109055000,109620000,"chr12",482781,6,6,7,19,"chr12",1,0.0178152836380684
"15929","chr12.77030000.77035000","chr12.77210000.77215000",180000,18,6.21255e-06,77030000,77210000,77035000,77215000,"chr12",482784,3,10,5,18,"chr12",1,0.0379746835443038
"15930","chr12.104355000.104360000","chr12.104450000.104455000",95000,17,0.00352132,104355000,104450000,104360000,104455000,"chr12",482817,0,2,2,4,"chr12",1,0.00796999531176746
"15931","chr12.12640000.12645000","chr12.12810000.12815000",170000,16,0.0001881303,12640000,12810000,12645000,12815000,"chr12",482818,0,3,3,6,"chr12",1,0.0112517580872011
"15932","chr12.120900000.120905000","chr12.121015000.121020000",115000,16,0.002631479,120900000,121015000,120905000,121020000,"chr12",482819,0,7,2,9,"chr12",1,0.0168776371308017
"15933","chr12.75950000.75955000","chr12.76420000.76425000",470000,26,2.934652e-19,75950000,76420000,75955000,76425000,"chr12",482826,1,2,3,6,"chr12",1,0.0182841068917018
"15934","chr12.8025000.8030000","chr12.8140000.8145000",115000,15,0.007443733,8025000,8140000,8030000,8145000,"chr12",482830,0,3,1,4,"chr12",1,0.0070323488045007
"15935","chr12.51390000.51395000","chr12.51420000.51425000",30000,31,0.003607369,51390000,51420000,51395000,51425000,"chr12",482833,1,4,1,6,"chr12",1,0.0218002812939522
"15936","chr12.50920000.50925000","chr12.51025000.51030000",105000,22,3.205892e-06,50920000,51025000,50925000,51030000,"chr12",482836,5,9,7,21,"chr12",1,0.0541490857946554
"15937","chr12.12015000.12020000","chr12.12160000.12165000",145000,16,0.00060261,12015000,12160000,12020000,12165000,"chr12",482844,0,6,2,8,"chr12",1,0.0150023441162682
"15938","chr12.860000.865000","chr12.1055000.1060000",195000,25,8.996534e-12,860000,1055000,865000,1060000,"chr12",482861,1,5,1,7,"chr12",1,0.0205110173464604
"15939","chr12.8080000.8085000","chr12.8140000.8145000",60000,25,7.684099e-05,8080000,8140000,8085000,8145000,"chr12",482864,0,3,0,3,"chr12",1,0.00879043600562588
"15940","chr12.110740000.110745000","chr12.110840000.110845000",100000,18,0.0008093402,110740000,110840000,110745000,110845000,"chr12",482889,2,1,5,8,"chr12",1,0.0168776371308017
"15941","chr12.50920000.50925000","chr12.51020000.51025000",100000,19,0.0002539577,50920000,51020000,50925000,51025000,"chr12",482947,5,9,7,21,"chr12",1,0.0467651195499297
"15942","chr12.113095000.113100000","chr12.113125000.113130000",30000,38,1.077427e-05,113095000,113125000,113100000,113130000,"chr12",482970,5,7,7,19,"chr12",1,0.0846225972808251
"15943","chr12.71835000.71840000","chr12.71935000.71940000",100000,16,0.006653592,71835000,71935000,71840000,71940000,"chr12",482972,1,5,7,13,"chr12",1,0.0243788091889358
"15944","chr12.49585000.49590000","chr12.49620000.49625000",35000,69,5.648758e-27,49585000,49620000,49590000,49625000,"chr12",482998,0,1,2,3,"chr12",1,0.0242616033755274
"15945","chr12.18410000.18415000","chr12.19315000.19320000",905000,7,0.005168804,18410000,19315000,18415000,19320000,"chr12",483068,0,2,2,4,"chr12",1,0.00328176277543366
"15946","chr12.109130000.109135000","chr12.109155000.109160000",25000,36,0.002074578,109130000,109155000,109135000,109160000,"chr12",483075,6,10,7,23,"chr12",1,0.0970464135021097
"15947","chr12.51025000.51030000","chr12.51080000.51085000",55000,28,9.257987e-06,51025000,51080000,51030000,51085000,"chr12",483079,6,14,19,39,"chr12",1,0.127988748241913
"15948","chr12.106100000.106105000","chr12.106480000.106485000",380000,18,1.976925e-09,106100000,106480000,106105000,106485000,"chr12",483144,5,12,9,26,"chr12",1,0.0548523206751055
"15949","chr12.125050000.125055000","chr12.125135000.125140000",85000,17,0.007949728,125050000,125135000,125055000,125140000,"chr12",483225,2,11,8,21,"chr12",1,0.0418424753867792
"15950","chr12.46125000.46130000","chr12.46380000.46385000",255000,11,0.007443733,46125000,46380000,46130000,46385000,"chr12",483246,1,1,2,4,"chr12",1,0.00515705578996718
"15951","chr12.116705000.116710000","chr12.117025000.117030000",320000,13,0.0001045123,116705000,117025000,116710000,117030000,"chr12",483261,2,5,8,15,"chr12",1,0.0228551336146273
"15952","chr12.49535000.49540000","chr12.49705000.49710000",170000,14,0.002367268,49535000,49705000,49540000,49710000,"chr12",483279,1,0,1,2,"chr12",1,0.00328176277543366
"15953","chr12.50920000.50925000","chr12.51075000.51080000",155000,14,0.004138021,50920000,51075000,50925000,51080000,"chr12",483281,5,9,7,21,"chr12",1,0.0344585091420534
"15954","chr12.57635000.57640000","chr12.57845000.57850000",210000,13,0.002003822,57635000,57845000,57640000,57850000,"chr12",483293,0,7,7,14,"chr12",1,0.0213314580403188
"15955","chr12.32520000.32525000","chr12.32605000.32610000",85000,21,0.0001170106,32520000,32605000,32525000,32610000,"chr12",483306,3,5,10,18,"chr12",1,0.0443037974683544
"15956","chr12.69820000.69825000","chr12.69925000.69930000",105000,23,7.590854e-07,69820000,69925000,69825000,69930000,"chr12",483341,0,3,4,7,"chr12",1,0.0188701359587436
"15957","chr12.121770000.121775000","chr12.122120000.122125000",350000,10,0.005431479,121770000,122120000,121775000,122125000,"chr12",483363,0,8,5,13,"chr12",1,0.0152367557430849
"15958","chr12.120165000.120170000","chr12.120235000.120240000",70000,22,0.0002969304,120165000,120235000,120170000,120240000,"chr12",483372,4,27,28,59,"chr12",1,0.152133145804032
"15959","chr12.122725000.122730000","chr12.123710000.123715000",985000,9,5.710601e-05,122725000,123710000,122730000,123715000,"chr12",483458,3,5,2,10,"chr12",1,0.0105485232067511
"15960","chr12.1955000.1960000","chr12.2000000.2005000",45000,26,0.0008520859,1955000,2e+06,1960000,2005000,"chr12",483490,0,0,3,3,"chr12",1,0.00914205344585091
"15961","chr12.92465000.92470000","chr12.92505000.92510000",40000,25,0.006935851,92465000,92505000,92470000,92510000,"chr12",483559,2,7,4,13,"chr12",1,0.0380918893577121
"15962","chr12.124555000.124560000","chr12.125255000.125260000",700000,8,0.003503296,124555000,125255000,124560000,125260000,"chr12",483580,0,0,1,1,"chr12",1,0.00093764650726676
"15963","chr12.93165000.93170000","chr12.93195000.93200000",30000,30,0.007221198,93165000,93195000,93170000,93200000,"chr12",483632,4,18,17,39,"chr12",1,0.137130801687764
"15964","chr12.12265000.12270000","chr12.12735000.12740000",470000,9,0.005532592,12265000,12735000,12270000,12740000,"chr12",483650,1,4,6,11,"chr12",1,0.0116033755274262
"15965","chr12.124215000.124220000","chr12.124440000.124445000",225000,14,0.000321142,124215000,124440000,124220000,124445000,"chr12",483656,2,4,4,10,"chr12",1,0.0164088138771683
"15966","chr12.11835000.11840000","chr12.12150000.12155000",315000,13,0.0001169014,11835000,12150000,11840000,12155000,"chr12",483669,1,1,0,2,"chr12",1,0.00304735114861697
"15967","chr12.57085000.57090000","chr12.57135000.57140000",50000,22,0.009115651,57085000,57135000,57090000,57140000,"chr12",483717,0,6,10,16,"chr12",1,0.0412564463197375
"15968","chr12.6790000.6795000","chr12.6940000.6945000",150000,21,3.671012e-07,6790000,6940000,6795000,6945000,"chr12",483739,1,14,8,23,"chr12",1,0.0566104078762307
"15969","chr12.120760000.120765000","chr12.120900000.120905000",140000,26,1.743347e-10,120760000,120900000,120765000,120905000,"chr12",483783,0,5,1,6,"chr12",1,0.0182841068917018
"15970","chr12.121990000.121995000","chr12.122020000.122025000",30000,42,1.973882e-07,121990000,122020000,121995000,122025000,"chr12",483788,0,4,0,4,"chr12",1,0.019690576652602
"15971","chr12.122000000.122005000","chr12.122105000.122110000",105000,24,1.780772e-07,1.22e+08,122105000,122005000,122110000,"chr12",483790,1,20,19,40,"chr12",1,0.112517580872011
"15972","chr12.710000.715000","chr12.965000.970000",255000,12,0.002051731,710000,965000,715000,970000,"chr12",483805,4,22,17,43,"chr12",1,0.060478199718706
"15973","chr12.51385000.51390000","chr12.51425000.51430000",40000,26,0.003245211,51385000,51425000,51390000,51430000,"chr12",483855,4,4,6,14,"chr12",1,0.0426629160806376
"15974","chr12.92205000.92210000","chr12.92985000.92990000",780000,14,5.479081e-09,92205000,92985000,92210000,92990000,"chr12",483929,7,1,9,17,"chr12",1,0.0278949835911861
"15975","chr12.125075000.125080000","chr12.125210000.125215000",135000,17,0.0002773748,125075000,125210000,125080000,125215000,"chr12",483992,5,12,10,27,"chr12",1,0.0537974683544304
"15976","chr12.121500000.121505000","chr12.121535000.121540000",35000,38,3.046196e-07,121500000,121535000,121505000,121540000,"chr12",484009,2,5,13,20,"chr12",1,0.0890764181903422
"15977","chr12.11770000.11775000","chr12.12045000.12050000",275000,14,6.554734e-05,11770000,12045000,11775000,12050000,"chr12",484080,2,1,5,8,"chr12",1,0.0131270511017346
"15978","chr12.64210000.64215000","chr12.64730000.64735000",520000,10,0.0006718892,64210000,64730000,64215000,64735000,"chr12",484096,6,10,10,26,"chr12",1,0.0304735114861697
"15979","chr12.6865000.6870000","chr12.6940000.6945000",75000,18,0.008040947,6865000,6940000,6870000,6945000,"chr12",484145,1,2,0,3,"chr12",1,0.00632911392405063
"15980","chr12.123360000.123365000","chr12.123425000.123430000",65000,34,1.425451e-10,123360000,123425000,123365000,123430000,"chr12",484158,4,19,19,42,"chr12",1,0.167369901547117
"15981","chr12.94560000.94565000","chr12.94640000.94645000",80000,20,0.0006616707,94560000,94640000,94565000,94645000,"chr12",484165,2,6,8,16,"chr12",1,0.0375058602906704
"15982","chr12.53505000.53510000","chr12.53535000.53540000",30000,35,0.000160824,53505000,53535000,53510000,53540000,"chr12",484230,4,13,12,29,"chr12",1,0.11896390060947
"15983","chr12.710000.715000","chr12.945000.950000",235000,19,6.178042e-08,710000,945000,715000,950000,"chr12",484249,4,22,17,43,"chr12",1,0.0957571495546179
"15984","chr12.53600000.53605000","chr12.53675000.53680000",75000,32,1.678511e-10,53600000,53675000,53605000,53680000,"chr12",484264,0,1,0,1,"chr12",1,0.00375058602906704
"15985","chr12.11770000.11775000","chr12.12405000.12410000",635000,8,0.005646098,11770000,12405000,11775000,12410000,"chr12",484274,2,1,4,7,"chr12",1,0.00656352555086732
"15986","chr12.122000000.122005000","chr12.122065000.122070000",65000,21,0.001771687,1.22e+08,122065000,122005000,122070000,"chr12",484281,12,20,24,56,"chr12",1,0.137834036568214
"15987","chr12.112480000.112485000","chr12.112795000.112800000",315000,10,0.008808239,112480000,112795000,112485000,112800000,"chr12",484290,3,3,6,12,"chr12",1,0.0140646976090014
"15988","chr12.96605000.96610000","chr12.96850000.96855000",245000,11,0.009206307,96605000,96850000,96610000,96855000,"chr12",484322,0,1,1,2,"chr12",1,0.00257852789498359
"15989","chr12.110465000.110470000","chr12.110840000.110845000",375000,10,0.003969465,110465000,110840000,110470000,110845000,"chr12",484382,2,5,5,12,"chr12",1,0.0140646976090014
"15990","chr12.12520000.12525000","chr12.12655000.12660000",135000,17,0.0002773748,12520000,12655000,12525000,12660000,"chr12",484385,1,1,3,5,"chr12",1,0.00996249413970933
"15991","chr12.22255000.22260000","chr12.22620000.22625000",365000,10,0.00450886,22255000,22620000,22260000,22625000,"chr12",484397,0,3,4,7,"chr12",1,0.00820440693858415
"15992","chr12.123065000.123070000","chr12.123205000.123210000",140000,14,0.007287567,123065000,123205000,123070000,123210000,"chr12",484420,3,4,5,12,"chr12",1,0.019690576652602
"15993","chr12.122125000.122130000","chr12.122330000.122335000",205000,15,0.0001648608,122125000,122330000,122130000,122335000,"chr12",484499,0,6,12,18,"chr12",1,0.0316455696202532
"15994","chr12.116705000.116710000","chr12.117150000.117155000",445000,12,6.175849e-05,116705000,117150000,116710000,117155000,"chr12",484522,6,8,14,28,"chr12",1,0.0393811533052039
"15995","chr12.64230000.64235000","chr12.64585000.64590000",355000,13,5.139158e-05,64230000,64585000,64235000,64590000,"chr12",484534,6,11,17,34,"chr12",1,0.0518049695264885
"15996","chr12.122020000.122025000","chr12.122065000.122070000",45000,24,0.004672633,122020000,122065000,122025000,122070000,"chr12",484535,0,4,0,4,"chr12",1,0.0112517580872011
"15997","chr12.122890000.122895000","chr12.122935000.122940000",45000,29,4.822255e-05,122890000,122935000,122895000,122940000,"chr12",484575,5,7,9,21,"chr12",1,0.0713783403656821
"15998","chr12.76560000.76565000","chr12.76700000.76705000",140000,16,0.0007509807,76560000,76700000,76565000,76705000,"chr12",484577,0,6,5,11,"chr12",1,0.0206282231598687
"15999","chr12.121610000.121615000","chr12.121625000.121630000",15000,45,1.888555e-05,121610000,121625000,121615000,121630000,"chr12",484599,1,7,7,15,"chr12",1,0.0791139240506329
"16000","chr12.76035000.76040000","chr12.76255000.76260000",220000,12,0.005168804,76035000,76255000,76040000,76260000,"chr12",484675,0,3,2,5,"chr12",1,0.0070323488045007
"16001","chr12.1315000.1320000","chr12.1530000.1535000",215000,13,0.001721248,1315000,1530000,1320000,1535000,"chr12",484677,2,1,0,3,"chr12",1,0.00457102672292546
"16002","chr12.11860000.11865000","chr12.12015000.12020000",155000,17,9.956267e-05,11860000,12015000,11865000,12020000,"chr12",484733,1,2,6,9,"chr12",1,0.0179324894514768
"16003","chr12.121670000.121675000","chr12.121915000.121920000",245000,11,0.009206307,121670000,121915000,121675000,121920000,"chr12",484735,2,4,3,9,"chr12",1,0.0116033755274262
"16004","chr12.116715000.116720000","chr12.117030000.117035000",315000,11,0.002332131,116715000,117030000,116720000,117035000,"chr12",484842,0,5,0,5,"chr12",1,0.00644631973745898
"16005","chr12.50035000.50040000","chr12.50100000.50105000",65000,85,9.239645e-57,50035000,50100000,50040000,50105000,"chr12",484887,0,7,9,16,"chr12",1,0.159399906235349
"16006","chr12.50925000.50930000","chr12.51010000.51015000",85000,27,4.058292e-08,50925000,51010000,50930000,51015000,"chr12",484913,4,8,5,17,"chr12",1,0.0537974683544304
"16007","chr12.124535000.124540000","chr12.125135000.125140000",600000,11,4.270603e-05,124535000,125135000,124540000,125140000,"chr12",484981,1,1,2,4,"chr12",1,0.00515705578996718
"16008","chr12.26295000.26300000","chr12.26340000.26345000",45000,28,0.0001317231,26295000,26340000,26300000,26345000,"chr12",485026,0,2,1,3,"chr12",1,0.00984528832630099
"16009","chr12.121610000.121615000","chr12.121780000.121785000",170000,13,0.007443733,121610000,121780000,121615000,121785000,"chr12",485031,6,28,21,55,"chr12",1,0.0838021565869667
"16010","chr12.121230000.121235000","chr12.121395000.121400000",165000,14,0.002884344,121230000,121395000,121235000,121400000,"chr12",485049,5,21,21,47,"chr12",1,0.077121425222691
"16011","chr12.6870000.6875000","chr12.6890000.6895000",20000,39,0.001689966,6870000,6890000,6875000,6895000,"chr12",485056,4,7,8,19,"chr12",1,0.0868495077355837
"16012","chr12.50825000.50830000","chr12.51080000.51085000",255000,11,0.007443733,50825000,51080000,50830000,51085000,"chr12",485064,4,9,14,27,"chr12",1,0.0348101265822785
"16013","chr12.26340000.26345000","chr12.26810000.26815000",470000,11,0.0002382194,26340000,26810000,26345000,26815000,"chr12",485101,0,3,2,5,"chr12",1,0.00644631973745898
"16014","chr12.124535000.124540000","chr12.125210000.125215000",675000,10,0.0001235799,124535000,125210000,124540000,125215000,"chr12",485102,1,1,2,4,"chr12",1,0.0046882325363338
"16015","chr12.109085000.109090000","chr12.109130000.109135000",45000,34,1.852345e-07,109085000,109130000,109090000,109135000,"chr12",485131,3,6,11,20,"chr12",1,0.0796999531176746
"16016","chr12.56220000.56225000","chr12.56315000.56320000",95000,28,1.487888e-09,56220000,56315000,56225000,56320000,"chr12",485138,1,3,3,7,"chr12",1,0.0229723394280356
"16017","chr12.14395000.14400000","chr12.14545000.14550000",150000,17,0.0001288331,14395000,14545000,14400000,14550000,"chr12",485164,0,2,3,5,"chr12",1,0.00996249413970933
"16018","chr12.124510000.124515000","chr12.125255000.125260000",745000,8,0.002539844,124510000,125255000,124515000,125260000,"chr12",485228,2,0,1,3,"chr12",1,0.00281293952180028
"16019","chr12.92645000.92650000","chr12.92720000.92725000",75000,20,0.001202934,92645000,92720000,92650000,92725000,"chr12",485268,0,3,2,5,"chr12",1,0.0117205813408345
"16020","chr12.64235000.64240000","chr12.64585000.64590000",350000,18,4.634034e-09,64235000,64585000,64240000,64590000,"chr12",485301,1,2,1,4,"chr12",1,0.00843881856540084
"16021","chr12.121750000.121755000","chr12.121840000.121845000",90000,22,1.861616e-05,121750000,121840000,121755000,121845000,"chr12",485307,4,8,10,22,"chr12",1,0.056727613689639
"16022","chr12.88500000.88505000","chr12.89380000.89385000",880000,8,0.001013418,88500000,89380000,88505000,89385000,"chr12",485346,2,0,1,3,"chr12",1,0.00281293952180028
"16023","chr12.1380000.1385000","chr12.1650000.1655000",270000,11,0.005402026,1380000,1650000,1385000,1655000,"chr12",485352,6,13,17,36,"chr12",1,0.0464135021097046
"16024","chr12.56150000.56155000","chr12.56205000.56210000",55000,23,0.001624672,56150000,56205000,56155000,56210000,"chr12",485409,3,5,8,16,"chr12",1,0.043131739334271
"16025","chr12.53600000.53605000","chr12.53695000.53700000",95000,17,0.00352132,53600000,53695000,53605000,53700000,"chr12",485504,0,2,1,3,"chr12",1,0.0059774964838256
"16026","chr12.51170000.51175000","chr12.51720000.51725000",550000,9,0.002453181,51170000,51720000,51175000,51725000,"chr12",485505,2,7,7,16,"chr12",1,0.0168776371308017
"16027","chr12.13075000.13080000","chr12.13135000.13140000",60000,30,1.954999e-07,13075000,13135000,13080000,13140000,"chr12",485510,0,3,1,4,"chr12",1,0.0140646976090014
"16028","chr12.124990000.124995000","chr12.125255000.125260000",265000,13,0.0003960999,124990000,125255000,124995000,125260000,"chr12",485515,4,0,1,5,"chr12",1,0.00761837787154243
"16029","chr12.109085000.109090000","chr12.109110000.109115000",25000,73,1.549798e-21,109085000,109110000,109090000,109115000,"chr12",485590,3,6,11,20,"chr12",1,0.171120487576184
"16030","chr12.88535000.88540000","chr12.89360000.89365000",825000,7,0.008117236,88535000,89360000,88540000,89365000,"chr12",485629,0,2,1,3,"chr12",1,0.00246132208157525
"16031","chr12.64210000.64215000","chr12.64805000.64810000",595000,9,0.001621904,64210000,64805000,64215000,64810000,"chr12",485632,2,3,2,7,"chr12",1,0.00738396624472574
"16032","chr12.21645000.21650000","chr12.21820000.21825000",175000,13,0.006302058,21645000,21820000,21650000,21825000,"chr12",485651,0,1,1,2,"chr12",1,0.00304735114861697
"16033","chr12.12645000.12650000","chr12.12710000.12715000",65000,38,2.596713e-13,12645000,12710000,12650000,12715000,"chr12",485658,6,9,11,26,"chr12",1,0.115799343647445
"16034","chr12.121780000.121785000","chr12.121870000.121875000",90000,24,1.291838e-06,121780000,121870000,121785000,121875000,"chr12",485668,6,26,21,53,"chr12",1,0.149085794655415
"16035","chr12.121150000.121155000","chr12.121340000.121345000",190000,20,1.370741e-07,121150000,121340000,121155000,121345000,"chr12",485727,2,29,21,52,"chr12",1,0.121894045944679
"16036","chr12.120465000.120470000","chr12.120485000.120490000",20000,57,1.669786e-10,120465000,120485000,120470000,120490000,"chr12",485776,7,28,24,59,"chr12",1,0.394163150492264
"16037","chr12.39760000.39765000","chr12.40010000.40015000",250000,21,6.112791e-10,39760000,40010000,39765000,40015000,"chr12",485799,1,3,1,5,"chr12",1,0.0123066104078762
"16038","chr12.75950000.75955000","chr12.76470000.76475000",520000,10,0.0006718892,75950000,76470000,75955000,76475000,"chr12",485801,2,2,3,7,"chr12",1,0.00820440693858415
"16039","chr12.56590000.56595000","chr12.56835000.56840000",245000,12,0.002675138,56590000,56835000,56595000,56840000,"chr12",485846,3,3,0,6,"chr12",1,0.00843881856540084
"16040","chr12.123125000.123130000","chr12.123220000.123225000",95000,20,0.0001245672,123125000,123220000,123130000,123225000,"chr12",485858,7,27,35,69,"chr12",1,0.161744022503516
"16041","chr12.121990000.121995000","chr12.122130000.122135000",140000,23,3.089841e-08,121990000,122130000,121995000,122135000,"chr12",485859,5,20,20,45,"chr12",1,0.121308016877637
"16042","chr12.57630000.57635000","chr12.57840000.57845000",210000,13,0.002003822,57630000,57840000,57635000,57845000,"chr12",485885,0,2,3,5,"chr12",1,0.00761837787154243
"16043","chr12.92205000.92210000","chr12.93060000.93065000",855000,7,0.006931212,92205000,93060000,92210000,93065000,"chr12",485896,3,1,6,10,"chr12",1,0.00820440693858415
"16044","chr12.11085000.11090000","chr12.11620000.11625000",535000,10,0.0005682123,11085000,11620000,11090000,11625000,"chr12",485910,4,9,5,18,"chr12",1,0.0210970464135021
"16045","chr12.4415000.4420000","chr12.4755000.4760000",340000,10,0.006200093,4415000,4755000,4420000,4760000,"chr12",485927,0,2,1,3,"chr12",1,0.00351617440225035
"16046","chr12.50825000.50830000","chr12.51675000.51680000",850000,7,0.007148363,50825000,51675000,50830000,51680000,"chr12",485939,4,8,13,25,"chr12",1,0.0205110173464604
"16047","chr12.121125000.121130000","chr12.121150000.121155000",25000,59,2.815598e-13,121125000,121150000,121130000,121155000,"chr12",485978,7,17,15,39,"chr12",1,0.269690576652602
"16048","chr12.12640000.12645000","chr12.12700000.12705000",60000,23,0.0006155153,12640000,12700000,12645000,12705000,"chr12",485987,0,3,3,6,"chr12",1,0.0161744022503516
"16049","chr12.110345000.110350000","chr12.110365000.110370000",20000,37,0.006042922,110345000,110365000,110350000,110370000,"chr12",485993,3,5,10,18,"chr12",1,0.0780590717299578
"16050","chr12.76055000.76060000","chr12.76085000.76090000",30000,32,0.001734574,76055000,76085000,76060000,76090000,"chr12",486060,4,7,6,17,"chr12",1,0.0637599624941397
"16051","chr12.116605000.116610000","chr12.116700000.116705000",95000,19,0.0004056182,116605000,116700000,116610000,116705000,"chr12",486175,0,10,12,22,"chr12",1,0.0489920300046882
"16052","chr12.51005000.51010000","chr12.51045000.51050000",40000,34,1.508577e-06,51005000,51045000,51010000,51050000,"chr12",486189,6,25,14,45,"chr12",1,0.179324894514768
"16053","chr12.76340000.76345000","chr12.76420000.76425000",80000,19,0.001849757,76340000,76420000,76345000,76425000,"chr12",486265,1,2,3,6,"chr12",1,0.0133614627285513
"16054","chr12.49260000.49265000","chr12.49340000.49345000",80000,18,0.004919131,49260000,49340000,49265000,49345000,"chr12",486357,0,4,0,4,"chr12",1,0.00843881856540084
"16055","chr12.76325000.76330000","chr12.76420000.76425000",95000,16,0.009290085,76325000,76420000,76330000,76425000,"chr12",486389,1,2,3,6,"chr12",1,0.0112517580872011
"16056","chr12.121990000.121995000","chr12.122125000.122130000",135000,27,4.67899e-11,121990000,122125000,121995000,122130000,"chr12",486397,2,6,12,20,"chr12",1,0.0632911392405063
"16057","chr12.123130000.123135000","chr12.123205000.123210000",75000,25,3.728455e-06,123130000,123205000,123135000,123210000,"chr12",486439,5,9,17,31,"chr12",1,0.0908345053914674
"16058","chr12.109095000.109100000","chr12.109110000.109115000",15000,43,9.410475e-05,109095000,109110000,109100000,109115000,"chr12",486458,6,16,14,36,"chr12",1,0.181434599156118
"16059","chr12.50760000.50765000","chr12.51675000.51680000",915000,9,0.000107677,50760000,51675000,50765000,51680000,"chr12",486464,5,8,13,26,"chr12",1,0.0274261603375527
"16060","chr12.53285000.53290000","chr12.53370000.53375000",85000,26,1.734411e-07,53285000,53370000,53290000,53375000,"chr12",486527,0,2,9,11,"chr12",1,0.0335208626347867
"16061","chr12.49520000.49525000","chr12.49620000.49625000",100000,21,2.084308e-05,49520000,49620000,49525000,49625000,"chr12",486553,2,14,9,25,"chr12",1,0.0615330520393812
"16062","chr12.130535000.130540000","chr12.130815000.130820000",280000,20,1.0008e-09,130535000,130815000,130540000,130820000,"chr12",486607,3,5,3,11,"chr12",1,0.0257852789498359
"16063","chr12.110430000.110435000","chr12.110640000.110645000",210000,12,0.006863721,110430000,110640000,110435000,110645000,"chr12",486620,14,19,18,51,"chr12",1,0.0717299578059072
"16064","chr12.123050000.123055000","chr12.123205000.123210000",155000,15,0.001300684,123050000,123205000,123055000,123210000,"chr12",486625,8,13,9,30,"chr12",1,0.0527426160337553
"16065","chr12.21655000.21660000","chr12.21820000.21825000",165000,16,0.0002355347,21655000,21820000,21660000,21825000,"chr12",486635,0,0,1,1,"chr12",1,0.00187529301453352
"16066","chr12.94565000.94570000","chr12.94650000.94655000",85000,17,0.007949728,94565000,94650000,94570000,94655000,"chr12",486717,0,3,3,6,"chr12",1,0.0119549929676512
"16067","chr12.117510000.117515000","chr12.118300000.118305000",790000,8,0.001850134,117510000,118300000,117515000,118305000,"chr12",486755,1,1,4,6,"chr12",1,0.00562587904360056
"16068","chr12.122000000.122005000","chr12.122095000.122100000",95000,17,0.00352132,1.22e+08,122095000,122005000,122100000,"chr12",486800,12,18,22,52,"chr12",1,0.103609939052977
"16069","chr12.109055000.109060000","chr12.109110000.109115000",55000,26,8.379703e-05,109055000,109110000,109060000,109115000,"chr12",486842,0,12,6,18,"chr12",1,0.0548523206751055
"16070","chr12.19895000.19900000","chr12.20795000.20800000",900000,8,0.0008692824,19895000,20795000,19900000,20800000,"chr12",486861,0,0,1,1,"chr12",1,0.00093764650726676
"16071","chr12.64225000.64230000","chr12.64545000.64550000",320000,10,0.008148661,64225000,64545000,64230000,64550000,"chr12",486888,10,6,20,36,"chr12",1,0.0421940928270042
"16072","chr12.8170000.8175000","chr12.8395000.8400000",225000,12,0.00450886,8170000,8395000,8175000,8400000,"chr12",486890,0,2,1,3,"chr12",1,0.00421940928270042
"16073","chr12.23895000.23900000","chr12.24705000.24710000",810000,7,0.008863337,23895000,24705000,23900000,24710000,"chr12",486892,0,1,1,2,"chr12",1,0.00164088138771683
"16074","chr12.67825000.67830000","chr12.68275000.68280000",450000,13,9.222815e-06,67825000,68275000,67830000,68280000,"chr12",486909,1,5,5,11,"chr12",1,0.0167604313173933
"16075","chr12.49535000.49540000","chr12.49775000.49780000",240000,12,0.003069305,49535000,49775000,49540000,49780000,"chr12",486918,1,11,7,19,"chr12",1,0.0267229254571027
"16076","chr12.49565000.49570000","chr12.49625000.49630000",60000,24,0.0002241502,49565000,49625000,49570000,49630000,"chr12",487051,0,3,6,9,"chr12",1,0.0253164556962025
"16077","chr12.56315000.56320000","chr12.56355000.56360000",40000,25,0.006935851,56315000,56355000,56320000,56360000,"chr12",487055,1,3,3,7,"chr12",1,0.0205110173464604
"16078","chr12.12330000.12335000","chr12.12405000.12410000",75000,20,0.001202934,12330000,12405000,12335000,12410000,"chr12",487076,2,7,4,13,"chr12",1,0.0304735114861697
"16079","chr12.57750000.57755000","chr12.57800000.57805000",50000,24,0.001727655,57750000,57800000,57755000,57805000,"chr12",487087,0,3,4,7,"chr12",1,0.019690576652602
"16080","chr12.64225000.64230000","chr12.64610000.64615000",385000,13,2.997019e-05,64225000,64610000,64230000,64615000,"chr12",487123,4,6,14,24,"chr12",1,0.0365682137834037
"16081","chr12.51990000.51995000","chr12.52200000.52205000",210000,13,0.002003822,51990000,52200000,51995000,52205000,"chr12",487174,0,2,1,3,"chr12",1,0.00457102672292546
"16082","chr12.121750000.121755000","chr12.121770000.121775000",20000,42,0.0002031934,121750000,121770000,121755000,121775000,"chr12",487242,0,8,5,13,"chr12",1,0.0639943741209564
"16083","chr12.122280000.122285000","chr12.122300000.122305000",20000,54,4.087665e-09,122280000,122300000,122285000,122305000,"chr12",487246,4,18,10,32,"chr12",1,0.20253164556962
"16084","chr12.14415000.14420000","chr12.14775000.14780000",360000,11,0.001154404,14415000,14775000,14420000,14780000,"chr12",487251,2,0,3,5,"chr12",1,0.00644631973745898
"16085","chr12.122870000.122875000","chr12.122965000.122970000",95000,17,0.00352132,122870000,122965000,122875000,122970000,"chr12",487259,2,4,6,12,"chr12",1,0.0239099859353024
"16086","chr12.125485000.125490000","chr12.125530000.125535000",45000,31,5.853223e-06,125485000,125530000,125490000,125535000,"chr12",487261,2,1,2,5,"chr12",1,0.0181669010782935
"16087","chr12.51170000.51175000","chr12.51420000.51425000",250000,11,0.008224003,51170000,51420000,51175000,51425000,"chr12",487281,1,4,1,6,"chr12",1,0.00773558368495077
"16088","chr12.123220000.123225000","chr12.124030000.124035000",810000,8,0.001640208,123220000,124030000,123225000,124035000,"chr12",487282,2,4,7,13,"chr12",1,0.0121894045944679
"16089","chr12.121230000.121235000","chr12.121990000.121995000",760000,8,0.002280937,121230000,121990000,121235000,121995000,"chr12",487283,5,21,21,47,"chr12",1,0.0440693858415377
"16090","chr12.125505000.125510000","chr12.125525000.125530000",20000,40,0.0008520859,125505000,125525000,125510000,125530000,"chr12",487306,1,3,0,4,"chr12",1,0.0187529301453352
"16091","chr12.96425000.96430000","chr12.96605000.96610000",180000,22,8.185508e-09,96425000,96605000,96430000,96610000,"chr12",487310,0,1,1,2,"chr12",1,0.00515705578996718
"16092","chr12.116705000.116710000","chr12.117020000.117025000",315000,12,0.0005520247,116705000,117020000,116710000,117025000,"chr12",487316,1,0,1,2,"chr12",1,0.00281293952180028
"16093","chr12.110580000.110585000","chr12.110740000.110745000",160000,14,0.003472662,110580000,110740000,110585000,110745000,"chr12",487349,2,1,3,6,"chr12",1,0.00984528832630099
"16094","chr12.121790000.121795000","chr12.121835000.121840000",45000,27,0.0003482007,121790000,121835000,121795000,121840000,"chr12",487368,0,5,4,9,"chr12",1,0.0284810126582278
"16095","chr12.110005000.110010000","chr12.110195000.110200000",190000,13,0.003862157,110005000,110195000,110010000,110200000,"chr12",487380,3,16,10,29,"chr12",1,0.0441865916549461
"16096","chr12.64230000.64235000","chr12.64775000.64780000",545000,12,1.310771e-05,64230000,64775000,64235000,64780000,"chr12",487388,1,4,1,6,"chr12",1,0.00843881856540084
"16097","chr12.93175000.93180000","chr12.93430000.93435000",255000,11,0.007443733,93175000,93430000,93180000,93435000,"chr12",487390,0,2,1,3,"chr12",1,0.00386779184247539
"16098","chr12.64210000.64215000","chr12.64795000.64800000",585000,8,0.008285684,64210000,64795000,64215000,64800000,"chr12",487396,1,0,4,5,"chr12",1,0.0046882325363338
"16099","chr12.111460000.111465000","chr12.111750000.111755000",290000,18,3.44992e-08,111460000,111750000,111465000,111755000,"chr12",487441,0,16,6,22,"chr12",1,0.0464135021097046
"16100","chr12.116520000.116525000","chr12.116700000.116705000",180000,13,0.005332587,116520000,116700000,116525000,116705000,"chr12",487516,4,16,12,32,"chr12",1,0.0487576183778715
"16101","chr12.121110000.121115000","chr12.121395000.121400000",285000,14,4.873665e-05,121110000,121395000,121115000,121400000,"chr12",487535,5,23,29,57,"chr12",1,0.0935302390998594
"16102","chr12.56590000.56595000","chr12.56625000.56630000",35000,28,0.003578991,56590000,56625000,56595000,56630000,"chr12",487556,4,9,10,23,"chr12",1,0.0754805438349742
"16103","chr12.12265000.12270000","chr12.12485000.12490000",220000,13,0.001487189,12265000,12485000,12270000,12490000,"chr12",487557,1,4,6,11,"chr12",1,0.0167604313173933
"16104","chr12.32545000.32550000","chr12.32605000.32610000",60000,20,0.009290085,32545000,32605000,32550000,32610000,"chr12",487584,6,12,11,29,"chr12",1,0.0679793717768401
"16105","chr12.116735000.116740000","chr12.117030000.117035000",295000,12,0.0008241946,116735000,117030000,116740000,117035000,"chr12",487595,0,6,2,8,"chr12",1,0.0112517580872011
"16106","chr12.116605000.116610000","chr12.117145000.117150000",540000,13,1.964082e-06,116605000,117145000,116610000,117150000,"chr12",487603,0,10,7,17,"chr12",1,0.0259024847632443
"16107","chr12.94165000.94170000","chr12.94460000.94465000",295000,11,0.003338333,94165000,94460000,94170000,94465000,"chr12",487620,1,1,2,4,"chr12",1,0.00515705578996718
"16108","chr12.12680000.12685000","chr12.12835000.12840000",155000,14,0.004138021,12680000,12835000,12685000,12840000,"chr12",487640,2,7,5,14,"chr12",1,0.0229723394280356
"16109","chr12.94560000.94565000","chr12.94660000.94665000",100000,18,0.0008093402,94560000,94660000,94565000,94665000,"chr12",487690,2,19,15,36,"chr12",1,0.0759493670886076
"16110","chr12.121590000.121595000","chr12.121625000.121630000",35000,28,0.003578991,121590000,121625000,121595000,121630000,"chr12",487700,1,7,7,15,"chr12",1,0.0492264416315049
"16111","chr12.121780000.121785000","chr12.122120000.122125000",340000,13,6.969851e-05,121780000,122120000,121785000,122125000,"chr12",487748,6,28,21,55,"chr12",1,0.0838021565869667
"16112","chr12.51210000.51215000","chr12.51390000.51395000",180000,17,2.800994e-05,51210000,51390000,51215000,51395000,"chr12",487750,6,19,19,44,"chr12",1,0.0876699484294421
"16113","chr12.69275000.69280000","chr12.69455000.69460000",180000,23,1.337702e-09,69275000,69455000,69280000,69460000,"chr12",487786,2,12,4,18,"chr12",1,0.0485232067510548
"16114","chr12.51205000.51210000","chr12.51675000.51680000",470000,9,0.005532592,51205000,51675000,51210000,51680000,"chr12",487817,5,8,13,26,"chr12",1,0.0274261603375527
"16115","chr12.69250000.69255000","chr12.69280000.69285000",30000,30,0.007221198,69250000,69280000,69255000,69285000,"chr12",487859,4,3,11,18,"chr12",1,0.0632911392405063
"16116","chr12.69250000.69255000","chr12.69535000.69540000",285000,11,0.004010278,69250000,69535000,69255000,69540000,"chr12",487879,3,4,2,9,"chr12",1,0.0116033755274262
"16117","chr12.124515000.124520000","chr12.125255000.125260000",740000,15,8.386471e-10,124515000,125255000,124520000,125260000,"chr12",487905,2,0,1,3,"chr12",1,0.00527426160337553
"16118","chr12.50925000.50930000","chr12.51020000.51025000",95000,16,0.009290085,50925000,51020000,50930000,51025000,"chr12",487913,6,8,5,19,"chr12",1,0.0356305672761369
"16119","chr12.96465000.96470000","chr12.96605000.96610000",140000,23,3.089841e-08,96465000,96605000,96470000,96610000,"chr12",487955,0,1,1,2,"chr12",1,0.00539146741678387
"16120","chr12.122060000.122065000","chr12.122115000.122120000",55000,22,0.003885138,122060000,122115000,122065000,122120000,"chr12",488017,0,2,1,3,"chr12",1,0.00773558368495077
"16121","chr12.20795000.20800000","chr12.21320000.21325000",525000,10,0.0006377825,20795000,21320000,20800000,21325000,"chr12",488044,0,4,3,7,"chr12",1,0.00820440693858415
"16122","chr12.116530000.116535000","chr12.116595000.116600000",65000,20,0.00450886,116530000,116595000,116535000,116600000,"chr12",488048,0,8,6,14,"chr12",1,0.0328176277543366
"16123","chr12.121765000.121770000","chr12.121785000.121790000",20000,39,0.001689966,121765000,121785000,121770000,121790000,"chr12",488074,3,5,6,14,"chr12",1,0.0639943741209564
"16124","chr12.122130000.122135000","chr12.122295000.122300000",165000,15,0.0008516665,122130000,122295000,122135000,122300000,"chr12",488075,2,16,20,38,"chr12",1,0.0668073136427567
"16125","chr12.76420000.76425000","chr12.76470000.76475000",50000,22,0.009115651,76420000,76470000,76425000,76475000,"chr12",488166,1,2,3,6,"chr12",1,0.0154711673699015
"16126","chr12.76035000.76040000","chr12.76645000.76650000",610000,8,0.006863721,76035000,76645000,76040000,76650000,"chr12",488195,0,3,2,5,"chr12",1,0.0046882325363338
"16127","chr12.14415000.14420000","chr12.14545000.14550000",130000,36,1.774909e-18,14415000,14545000,14420000,14550000,"chr12",488199,1,9,3,13,"chr12",1,0.0548523206751055
"16128","chr12.92240000.92245000","chr12.92285000.92290000",45000,24,0.004672633,92240000,92285000,92245000,92290000,"chr12",488227,3,4,7,14,"chr12",1,0.0393811533052039
"16129","chr12.110640000.110645000","chr12.110840000.110845000",200000,14,0.0007820664,110640000,110840000,110645000,110845000,"chr12",488273,2,10,5,17,"chr12",1,0.0278949835911861
"16130","chr12.111840000.111845000","chr12.111885000.111890000",45000,54,2.40806e-20,111840000,111885000,111845000,111890000,"chr12",488293,0,3,0,3,"chr12",1,0.0189873417721519
"16131","chr12.121785000.121790000","chr12.121870000.121875000",85000,25,6.948767e-07,121785000,121870000,121790000,121875000,"chr12",488335,10,26,41,77,"chr12",1,0.225621190811064
"16132","chr12.125065000.125070000","chr12.125205000.125210000",140000,16,0.0007509807,125065000,125205000,125070000,125210000,"chr12",488407,0,2,2,4,"chr12",1,0.00750117205813408
"16133","chr12.92205000.92210000","chr12.92695000.92700000",490000,10,0.0009569384,92205000,92695000,92210000,92700000,"chr12",488438,0,1,7,8,"chr12",1,0.00937646507266761
"16134","chr12.52875000.52880000","chr12.53345000.53350000",470000,11,0.0002382194,52875000,53345000,52880000,53350000,"chr12",488468,3,4,7,14,"chr12",1,0.0180496952648851
"16135","chr12.57085000.57090000","chr12.57460000.57465000",375000,11,0.0009184904,57085000,57460000,57090000,57465000,"chr12",488484,0,5,3,8,"chr12",1,0.0103141115799344
"16136","chr12.50025000.50030000","chr12.50100000.50105000",75000,20,0.001202934,50025000,50100000,50030000,50105000,"chr12",488503,0,7,9,16,"chr12",1,0.0375058602906704
"16137","chr12.56100000.56105000","chr12.56315000.56320000",215000,14,0.0004549036,56100000,56315000,56105000,56320000,"chr12",488507,1,3,3,7,"chr12",1,0.0114861697140178
"16138","chr12.96435000.96440000","chr12.96605000.96610000",170000,14,0.002367268,96435000,96605000,96440000,96610000,"chr12",488533,0,1,1,2,"chr12",1,0.00328176277543366
"16139","chr12.50635000.50640000","chr12.50690000.50695000",55000,27,2.855257e-05,50635000,50690000,50640000,50695000,"chr12",488592,2,6,3,11,"chr12",1,0.0348101265822785
"16140","chr12.123055000.123060000","chr12.123670000.123675000",615000,8,0.006606883,123055000,123670000,123060000,123675000,"chr12",488629,0,2,3,5,"chr12",1,0.0046882325363338
"16141","chr12.64230000.64235000","chr12.64460000.64465000",230000,15,6.188943e-05,64230000,64460000,64235000,64465000,"chr12",488676,4,11,15,30,"chr12",1,0.0527426160337553
"16142","chr12.51025000.51030000","chr12.51075000.51080000",50000,26,0.0002698523,51025000,51075000,51030000,51080000,"chr12",488728,7,21,18,46,"chr12",1,0.140178152836381
"16143","chr12.6540000.6545000","chr12.6615000.6620000",75000,20,0.001202934,6540000,6615000,6545000,6620000,"chr12",488785,1,7,5,13,"chr12",1,0.0304735114861697
"16144","chr12.110335000.110340000","chr12.110430000.110435000",95000,23,2.583942e-06,110335000,110430000,110340000,110435000,"chr12",488787,4,25,32,61,"chr12",1,0.164439756211908
"16145","chr12.121585000.121590000","chr12.121625000.121630000",40000,25,0.006935851,121585000,121625000,121590000,121630000,"chr12",488842,1,7,7,15,"chr12",1,0.0439521800281294
"16146","chr12.51005000.51010000","chr12.51025000.51030000",20000,65,1.46312e-14,51005000,51025000,51010000,51030000,"chr12",488930,8,21,22,51,"chr12",1,0.388537271448664
"16147","chr12.122880000.122885000","chr12.122965000.122970000",85000,18,0.003090006,122880000,122965000,122885000,122970000,"chr12",488933,2,6,6,14,"chr12",1,0.029535864978903
"16148","chr12.121345000.121350000","chr12.121400000.121405000",55000,22,0.003885138,121345000,121400000,121350000,121405000,"chr12",488945,5,8,6,19,"chr12",1,0.0489920300046882
"16149","chr12.110040000.110045000","chr12.110180000.110185000",140000,17,0.0002167233,110040000,110180000,110045000,110185000,"chr12",488990,0,0,5,5,"chr12",1,0.00996249413970933
"16150","chr12.125485000.125490000","chr12.125545000.125550000",60000,21,0.003969465,125485000,125545000,125490000,125550000,"chr12",489035,1,0,4,5,"chr12",1,0.0123066104078762
"16151","chr12.110510000.110515000","chr12.110840000.110845000",330000,18,8.627113e-09,110510000,110840000,110515000,110845000,"chr12",489065,2,10,5,17,"chr12",1,0.0358649789029536
"16152","chr12.64270000.64275000","chr12.64570000.64575000",300000,11,0.003069305,64270000,64570000,64275000,64575000,"chr12",489070,3,11,7,21,"chr12",1,0.0270745428973277
"16153","chr12.76470000.76475000","chr12.76780000.76785000",310000,12,0.0006089869,76470000,76780000,76475000,76785000,"chr12",489150,0,1,3,4,"chr12",1,0.00562587904360056
"16154","chr12.68610000.68615000","chr12.69070000.69075000",460000,11,0.0002739569,68610000,69070000,68615000,69075000,"chr12",489161,0,0,2,2,"chr12",1,0.00257852789498359
"16155","chr12.12510000.12515000","chr12.12890000.12895000",380000,10,0.003719672,12510000,12890000,12515000,12895000,"chr12",489230,2,1,3,6,"chr12",1,0.0070323488045007
"16156","chr12.51215000.51220000","chr12.51425000.51430000",210000,20,4.058292e-08,51215000,51425000,51220000,51430000,"chr12",489240,0,4,6,10,"chr12",1,0.023441162681669
"16157","chr12.108950000.108955000","chr12.109115000.109120000",165000,13,0.008778126,108950000,109115000,108955000,109120000,"chr12",489251,2,8,3,13,"chr12",1,0.0198077824660103
"16158","chr12.51210000.51215000","chr12.51425000.51430000",215000,16,2.46815e-05,51210000,51425000,51215000,51430000,"chr12",489255,4,4,7,15,"chr12",1,0.0281293952180028
"16159","chr12.123710000.123715000","chr12.124030000.124035000",320000,10,0.008148661,123710000,124030000,123715000,124035000,"chr12",489277,2,4,2,8,"chr12",1,0.00937646507266761
"16160","chr12.122065000.122070000","chr12.122110000.122115000",45000,34,1.852345e-07,122065000,122110000,122070000,122115000,"chr12",489284,6,19,34,59,"chr12",1,0.23511486169714
"16161","chr12.12655000.12660000","chr12.12810000.12815000",155000,16,0.0003727337,12655000,12810000,12660000,12815000,"chr12",489292,5,16,18,39,"chr12",1,0.0731364275668073
"16162","chr12.51425000.51430000","chr12.51675000.51680000",250000,16,5.856367e-06,51425000,51675000,51430000,51680000,"chr12",489325,4,4,7,15,"chr12",1,0.0281293952180028
"16163","chr12.116735000.116740000","chr12.117050000.117055000",315000,12,0.0005520247,116735000,117050000,116740000,117055000,"chr12",489342,0,6,2,8,"chr12",1,0.0112517580872011
"16164","chr12.57755000.57760000","chr12.57800000.57805000",45000,32,1.90134e-06,57755000,57800000,57760000,57805000,"chr12",489356,0,1,1,2,"chr12",1,0.00750117205813408
"16165","chr12.11770000.11775000","chr12.12160000.12165000",390000,13,2.73533e-05,11770000,12160000,11775000,12165000,"chr12",489360,0,1,2,3,"chr12",1,0.00457102672292546
"16166","chr12.57895000.57900000","chr12.57935000.57940000",40000,26,0.003245211,57895000,57935000,57900000,57940000,"chr12",489374,4,2,4,10,"chr12",1,0.0304735114861697
"16167","chr12.2790000.2795000","chr12.2850000.2855000",60000,20,0.009290085,2790000,2850000,2795000,2855000,"chr12",489381,5,9,22,36,"chr12",1,0.0843881856540084
"16168","chr12.49825000.49830000","chr12.49875000.49880000",50000,23,0.004075805,49825000,49875000,49830000,49880000,"chr12",489388,0,2,1,3,"chr12",1,0.00808720112517581
"16169","chr12.121670000.121675000","chr12.121750000.121755000",80000,21,0.0002211656,121670000,121750000,121675000,121755000,"chr12",489390,4,8,10,22,"chr12",1,0.0541490857946554
"16170","chr12.56205000.56210000","chr12.56315000.56320000",110000,23,4.467528e-07,56205000,56315000,56210000,56320000,"chr12",489396,1,3,3,7,"chr12",1,0.0188701359587436
"16171","chr12.92650000.92655000","chr12.93015000.93020000",365000,10,0.00450886,92650000,93015000,92655000,93020000,"chr12",489403,1,8,12,21,"chr12",1,0.0246132208157525
"16172","chr12.51170000.51175000","chr12.51425000.51430000",255000,17,8.663093e-07,51170000,51425000,51175000,51430000,"chr12",489438,2,4,7,13,"chr12",1,0.0259024847632443
"16173","chr12.123710000.123715000","chr12.124105000.124110000",395000,16,8.469244e-08,123710000,124105000,123715000,124110000,"chr12",489460,2,4,2,8,"chr12",1,0.0150023441162682
"16174","chr12.96310000.96315000","chr12.96400000.96405000",90000,20,0.0002139501,96310000,96400000,96315000,96405000,"chr12",489461,5,15,23,43,"chr12",1,0.100796999531177
"16175","chr12.121155000.121160000","chr12.121345000.121350000",190000,13,0.003862157,121155000,121345000,121160000,121350000,"chr12",489467,2,6,9,17,"chr12",1,0.0259024847632443
"16176","chr12.122860000.122865000","chr12.122945000.122950000",85000,22,3.550843e-05,122860000,122945000,122865000,122950000,"chr12",489494,0,2,1,3,"chr12",1,0.00773558368495077
"16177","chr12.116595000.116600000","chr12.116705000.116710000",110000,16,0.00352132,116595000,116705000,116600000,116710000,"chr12",489497,0,8,6,14,"chr12",1,0.0262541022034693
"16178","chr12.6530000.6535000","chr12.6565000.6570000",35000,28,0.003578991,6530000,6565000,6535000,6570000,"chr12",489536,0,2,0,2,"chr12",1,0.00656352555086732
"16179","chr12.122065000.122070000","chr12.122120000.122125000",55000,40,7.81085e-13,122065000,122120000,122070000,122125000,"chr12",489538,11,34,42,87,"chr12",1,0.407876230661041
"16180","chr12.12405000.12410000","chr12.12425000.12430000",20000,39,0.001689966,12405000,12425000,12410000,12430000,"chr12",489552,2,6,3,11,"chr12",1,0.05028129395218
"16181","chr12.123780000.123785000","chr12.123815000.123820000",35000,28,0.003578991,123780000,123815000,123785000,123820000,"chr12",489555,2,11,12,25,"chr12",1,0.0820440693858415
"16182","chr12.57710000.57715000","chr12.57830000.57835000",120000,15,0.005858816,57710000,57830000,57715000,57835000,"chr12",489668,7,11,14,32,"chr12",1,0.0562587904360056
"16183","chr12.11810000.11815000","chr12.12160000.12165000",350000,10,0.005431479,11810000,12160000,11815000,12165000,"chr12",489671,0,1,2,3,"chr12",1,0.00351617440225035
"16184","chr12.122020000.122025000","chr12.122060000.122065000",40000,34,1.508577e-06,122020000,122060000,122025000,122065000,"chr12",489674,0,2,0,2,"chr12",1,0.00796999531176746
"16185","chr12.12330000.12335000","chr12.12350000.12355000",20000,37,0.006042922,12330000,12350000,12335000,12355000,"chr12",489675,5,7,21,33,"chr12",1,0.143108298171589
"16186","chr12.12520000.12525000","chr12.12810000.12815000",290000,24,1.119007e-13,12520000,12810000,12525000,12815000,"chr12",489709,1,1,3,5,"chr12",1,0.0140646976090014
"16187","chr12.69235000.69240000","chr12.69560000.69565000",325000,12,0.0004548585,69235000,69560000,69240000,69565000,"chr12",489736,5,4,3,12,"chr12",1,0.0168776371308017
"16188","chr12.122295000.122300000","chr12.122725000.122730000",430000,10,0.001985269,122295000,122725000,122300000,122730000,"chr12",489741,2,6,16,24,"chr12",1,0.0281293952180028
"16189","chr12.121230000.121235000","chr12.121285000.121290000",55000,23,0.001624672,121230000,121285000,121235000,121290000,"chr12",489853,5,17,15,37,"chr12",1,0.0997421472105016
"16190","chr12.66730000.66735000","chr12.67080000.67085000",350000,10,0.005431479,66730000,67080000,66735000,67085000,"chr12",489885,4,4,7,15,"chr12",1,0.0175808720112518
"16191","chr12.92205000.92210000","chr12.92645000.92650000",440000,10,0.001756819,92205000,92645000,92210000,92650000,"chr12",489886,4,1,6,11,"chr12",1,0.012892639474918
"16192","chr12.120900000.120905000","chr12.120970000.120975000",70000,19,0.005751671,120900000,120970000,120905000,120975000,"chr12",489893,2,7,7,16,"chr12",1,0.0356305672761369
"16193","chr12.69290000.69295000","chr12.69470000.69475000",180000,16,0.0001170106,69290000,69470000,69295000,69475000,"chr12",489895,2,4,2,8,"chr12",1,0.0150023441162682
"16194","chr12.49025000.49030000","chr12.49045000.49050000",20000,41,0.0004214119,49025000,49045000,49030000,49050000,"chr12",489956,0,5,3,8,"chr12",1,0.0384435067979372
"16195","chr12.121780000.121785000","chr12.122105000.122110000",325000,13,9.443082e-05,121780000,122105000,121785000,122110000,"chr12",490003,1,25,19,45,"chr12",1,0.0685654008438819
"16196","chr12.121795000.121800000","chr12.121885000.121890000",90000,19,0.0006616707,121795000,121885000,121800000,121890000,"chr12",490008,0,2,2,4,"chr12",1,0.00890764181903422
"16197","chr12.56220000.56225000","chr12.56330000.56335000",110000,16,0.00352132,56220000,56330000,56225000,56335000,"chr12",490028,6,6,6,18,"chr12",1,0.0337552742616034
"16198","chr12.94990000.94995000","chr12.95385000.95390000",395000,16,8.469244e-08,94990000,95385000,94995000,95390000,"chr12",490037,0,8,11,19,"chr12",1,0.0356305672761369
"16199","chr12.51980000.51985000","chr12.52135000.52140000",155000,17,9.956267e-05,51980000,52135000,51985000,52140000,"chr12",490095,0,9,3,12,"chr12",1,0.0239099859353024
"16200","chr12.121585000.121590000","chr12.121750000.121755000",165000,15,0.0008516665,121585000,121750000,121590000,121755000,"chr12",490138,4,8,10,22,"chr12",1,0.0386779184247539
"16201","chr12.12485000.12490000","chr12.12710000.12715000",225000,13,0.001267021,12485000,12710000,12490000,12715000,"chr12",490161,6,11,15,32,"chr12",1,0.0487576183778715
"16202","chr12.104340000.104345000","chr12.104360000.104365000",20000,48,1.3808e-06,104340000,104360000,104345000,104365000,"chr12",490178,1,4,1,6,"chr12",1,0.0337552742616034
"16203","chr12.26340000.26345000","chr12.26700000.26705000",360000,10,0.004769614,26340000,26700000,26345000,26705000,"chr12",490210,0,3,2,5,"chr12",1,0.00586029067041725
"16204","chr12.56125000.56130000","chr12.56330000.56335000",205000,17,8.132959e-06,56125000,56330000,56130000,56335000,"chr12",490271,0,3,5,8,"chr12",1,0.0159399906235349
"16205","chr12.49705000.49710000","chr12.50005000.50010000",300000,15,6.044558e-06,49705000,50005000,49710000,50010000,"chr12",490283,0,0,1,1,"chr12",1,0.00175808720112518
"16206","chr12.109050000.109055000","chr12.109130000.109135000",80000,18,0.004919131,109050000,109130000,109055000,109135000,"chr12",490301,6,15,17,38,"chr12",1,0.080168776371308
"16207","chr12.95000000.95005000","chr12.95385000.95390000",385000,11,0.0008044501,9.5e+07,95385000,95005000,95390000,"chr12",490303,0,8,8,16,"chr12",1,0.0206282231598687
"16208","chr12.14365000.14370000","chr12.14765000.14770000",400000,10,0.00293435,14365000,14765000,14370000,14770000,"chr12",490328,1,9,8,18,"chr12",1,0.0210970464135021
"16209","chr12.565000.570000","chr12.645000.650000",80000,35,3.338436e-13,565000,645000,570000,650000,"chr12",490350,0,2,1,3,"chr12",1,0.0123066104078762
"16210","chr12.32545000.32550000","chr12.32580000.32585000",35000,27,0.007443733,32545000,32580000,32550000,32585000,"chr12",490372,1,1,8,10,"chr12",1,0.0316455696202532
"16211","chr12.124470000.124475000","chr12.124510000.124515000",40000,31,3.582247e-05,124470000,124510000,124475000,124515000,"chr12",490394,1,1,0,2,"chr12",1,0.00726676043131739
"16212","chr12.110500000.110505000","chr12.110840000.110845000",340000,13,6.969851e-05,110500000,110840000,110505000,110845000,"chr12",490405,1,10,2,13,"chr12",1,0.0198077824660103
"16213","chr12.12510000.12515000","chr12.12710000.12715000",200000,19,4.096678e-07,12510000,12710000,12515000,12715000,"chr12",490422,2,1,3,6,"chr12",1,0.0133614627285513
"16214","chr12.96605000.96610000","chr12.96880000.96885000",275000,13,0.0003037717,96605000,96880000,96610000,96885000,"chr12",490466,0,1,1,2,"chr12",1,0.00304735114861697
"16215","chr12.12695000.12700000","chr12.12835000.12840000",140000,17,0.0002167233,12695000,12835000,12700000,12840000,"chr12",490476,2,7,5,14,"chr12",1,0.0278949835911861
"16216","chr12.12380000.12385000","chr12.12405000.12410000",25000,36,0.002074578,12380000,12405000,12385000,12410000,"chr12",490491,2,7,4,13,"chr12",1,0.0548523206751055
"16217","chr12.121915000.121920000","chr12.122125000.122130000",210000,12,0.006863721,121915000,122125000,121920000,122130000,"chr12",490519,2,4,3,9,"chr12",1,0.0126582278481013
"16218","chr12.116520000.116525000","chr12.117200000.117205000",680000,9,0.0007396781,116520000,117200000,116525000,117205000,"chr12",490541,3,16,13,32,"chr12",1,0.0337552742616034
"16219","chr12.122280000.122285000","chr12.122305000.122310000",25000,37,0.001043084,122280000,122305000,122285000,122310000,"chr12",490552,5,11,10,26,"chr12",1,0.112751992498828
"16220","chr12.130535000.130540000","chr12.130835000.130840000",300000,11,0.003069305,130535000,130835000,130540000,130840000,"chr12",490562,7,5,6,18,"chr12",1,0.0232067510548523
"16221","chr12.108615000.108620000","chr12.108635000.108640000",20000,43,9.410475e-05,108615000,108635000,108620000,108640000,"chr12",490609,4,7,6,17,"chr12",1,0.0856774496015002
"16222","chr12.121915000.121920000","chr12.122120000.122125000",205000,12,0.007809895,121915000,122120000,121920000,122125000,"chr12",490657,2,4,3,9,"chr12",1,0.0126582278481013
"16223","chr12.50685000.50690000","chr12.51385000.51390000",700000,8,0.003503296,50685000,51385000,50690000,51390000,"chr12",490706,4,6,6,16,"chr12",1,0.0150023441162682
"16224","chr12.12520000.12525000","chr12.12640000.12645000",120000,24,3.447354e-08,12520000,12640000,12525000,12645000,"chr12",490710,0,1,3,4,"chr12",1,0.0112517580872011
"16225","chr12.101755000.101760000","chr12.101775000.101780000",20000,41,0.0004214119,101755000,101775000,101760000,101780000,"chr12",490742,0,6,5,11,"chr12",1,0.0528598218471636
"16226","chr12.121785000.121790000","chr12.121915000.121920000",130000,18,0.0001006252,121785000,121915000,121790000,121920000,"chr12",490747,2,4,3,9,"chr12",1,0.0189873417721519
"16227","chr12.93515000.93520000","chr12.93780000.93785000",265000,11,0.006016121,93515000,93780000,93520000,93785000,"chr12",490752,1,8,7,16,"chr12",1,0.0206282231598687
"16228","chr12.124515000.124520000","chr12.125125000.125130000",610000,9,0.001395062,124515000,125125000,124520000,125130000,"chr12",490779,2,8,2,12,"chr12",1,0.0126582278481013
"16229","chr12.124825000.124830000","chr12.125255000.125260000",430000,11,0.0004214119,124825000,125255000,124830000,125260000,"chr12",490792,4,0,1,5,"chr12",1,0.00644631973745898
"16230","chr12.32605000.32610000","chr12.32670000.32675000",65000,25,2.584704e-05,32605000,32670000,32610000,32675000,"chr12",490797,5,12,11,28,"chr12",1,0.0820440693858415
"16231","chr12.27710000.27715000","chr12.27730000.27735000",20000,55,1.438703e-09,27710000,27730000,27715000,27735000,"chr12",490815,2,7,6,15,"chr12",1,0.0966947960618847
"16232","chr12.110550000.110555000","chr12.110885000.110890000",335000,10,0.006673431,110550000,110885000,110555000,110890000,"chr12",490834,2,16,15,33,"chr12",1,0.0386779184247539
"16233","chr12.76155000.76160000","chr12.76390000.76395000",235000,14,0.0002300535,76155000,76390000,76160000,76395000,"chr12",490890,3,8,22,33,"chr12",1,0.0541490857946554
"16234","chr12.122280000.122285000","chr12.122310000.122315000",30000,39,4.152256e-06,122280000,122310000,122285000,122315000,"chr12",490961,5,18,10,33,"chr12",1,0.15084388185654
"16235","chr12.121130000.121135000","chr12.121765000.121770000",635000,8,0.005646098,121130000,121765000,121135000,121770000,"chr12",490968,2,5,5,12,"chr12",1,0.0112517580872011
"16236","chr12.110335000.110340000","chr12.110840000.110845000",505000,10,0.0008082193,110335000,110840000,110340000,110845000,"chr12",490979,2,10,5,17,"chr12",1,0.0199249882794187
"16237","chr12.94070000.94075000","chr12.94290000.94295000",220000,12,0.005168804,94070000,94290000,94075000,94295000,"chr12",490997,4,6,4,14,"chr12",1,0.019690576652602
"16238","chr12.51210000.51215000","chr12.51420000.51425000",210000,20,4.058292e-08,51210000,51420000,51215000,51425000,"chr12",490998,1,4,1,6,"chr12",1,0.0140646976090014
"16239","chr12.11810000.11815000","chr12.12010000.12015000",200000,17,1.036822e-05,11810000,12010000,11815000,12015000,"chr12",491016,0,1,2,3,"chr12",1,0.0059774964838256
"16240","chr12.124470000.124475000","chr12.125255000.125260000",785000,12,5.764126e-07,124470000,125255000,124475000,125260000,"chr12",491137,1,0,0,1,"chr12",1,0.00140646976090014
"16241","chr12.11965000.11970000","chr12.12160000.12165000",195000,14,0.0009292903,11965000,12160000,11970000,12165000,"chr12",491149,0,6,2,8,"chr12",1,0.0131270511017346
"16242","chr12.11810000.11815000","chr12.12265000.12270000",455000,9,0.006493903,11810000,12265000,11815000,12270000,"chr12",491173,0,1,2,3,"chr12",1,0.00316455696202532
"16243","chr12.123285000.123290000","chr12.123710000.123715000",425000,9,0.008863337,123285000,123710000,123290000,123715000,"chr12",491209,3,5,2,10,"chr12",1,0.0105485232067511
"16244","chr12.57090000.57095000","chr12.57125000.57130000",35000,27,0.007443733,57090000,57125000,57095000,57130000,"chr12",491373,0,4,4,8,"chr12",1,0.0253164556962025
"16245","chr12.122750000.122755000","chr12.123455000.123460000",705000,10,9.268002e-05,122750000,123455000,122755000,123460000,"chr12",491401,2,0,3,5,"chr12",1,0.00586029067041725
"16246","chr12.112685000.112690000","chr12.112790000.112795000",105000,18,0.0005441941,112685000,112790000,112690000,112795000,"chr12",491423,0,3,1,4,"chr12",1,0.00843881856540084
"16247","chr12.51990000.51995000","chr12.52160000.52165000",170000,13,0.007443733,51990000,52160000,51995000,52165000,"chr12",491445,1,14,9,24,"chr12",1,0.0365682137834037
"16248","chr12.106100000.106105000","chr12.106670000.106675000",570000,11,6.245331e-05,106100000,106670000,106105000,106675000,"chr12",491450,1,5,0,6,"chr12",1,0.00773558368495077
"16249","chr12.11815000.11820000","chr12.11965000.11970000",150000,15,0.001624672,11815000,11965000,11820000,11970000,"chr12",491459,1,3,3,7,"chr12",1,0.0123066104078762
"16250","chr12.116605000.116610000","chr12.116735000.116740000",130000,15,0.003709005,116605000,116735000,116610000,116740000,"chr12",491487,0,6,2,8,"chr12",1,0.0140646976090014
"16251","chr12.123360000.123365000","chr12.123710000.123715000",350000,10,0.005431479,123360000,123710000,123365000,123715000,"chr12",491506,3,5,2,10,"chr12",1,0.0117205813408345
"16252","chr12.112685000.112690000","chr12.112795000.112800000",110000,25,2.083948e-08,112685000,112795000,112690000,112800000,"chr12",491525,3,3,3,9,"chr12",1,0.0263713080168776
"16253","chr12.56590000.56595000","chr12.56755000.56760000",165000,14,0.002884344,56590000,56755000,56595000,56760000,"chr12",491556,5,8,13,26,"chr12",1,0.0426629160806376
"16254","chr12.122280000.122285000","chr12.122315000.122320000",35000,32,0.0001288331,122280000,122315000,122285000,122320000,"chr12",491561,2,5,9,16,"chr12",1,0.0600093764650727
"16255","chr12.93175000.93180000","chr12.93800000.93805000",625000,12,4.225301e-06,93175000,93800000,93180000,93805000,"chr12",491586,0,2,0,2,"chr12",1,0.00281293952180028
"16256","chr12.64225000.64230000","chr12.64570000.64575000",345000,10,0.005848603,64225000,64570000,64230000,64575000,"chr12",491674,3,6,7,16,"chr12",1,0.0187529301453352
"16257","chr12.120445000.120450000","chr12.120470000.120475000",25000,39,0.0002355347,120445000,120470000,120450000,120475000,"chr12",491694,10,36,35,81,"chr12",1,0.370253164556962
"16258","chr12.122060000.122065000","chr12.122120000.122125000",60000,30,1.954999e-07,122060000,122120000,122065000,122125000,"chr12",491705,0,2,1,3,"chr12",1,0.0105485232067511
"16259","chr12.27600000.27605000","chr12.27795000.27800000",195000,14,0.0009292903,27600000,27795000,27605000,27800000,"chr12",491721,0,2,2,4,"chr12",1,0.00656352555086732
"16260","chr12.49775000.49780000","chr12.49875000.49880000",100000,20,7.564209e-05,49775000,49875000,49780000,49880000,"chr12",491775,0,2,5,7,"chr12",1,0.0164088138771683
"16261","chr12.121990000.121995000","chr12.122050000.122055000",60000,21,0.003969465,121990000,122050000,121995000,122055000,"chr12",491801,3,15,10,28,"chr12",1,0.0689170182841069
"16262","chr12.75975000.75980000","chr12.76420000.76425000",445000,9,0.007221198,75975000,76420000,75980000,76425000,"chr12",491814,1,2,3,6,"chr12",1,0.00632911392405063
"16263","chr12.125135000.125140000","chr12.125255000.125260000",120000,16,0.001982068,125135000,125255000,125140000,125260000,"chr12",491830,2,0,1,3,"chr12",1,0.00562587904360056
"16264","chr12.116880000.116885000","chr12.116955000.116960000",75000,19,0.003245211,116880000,116955000,116885000,116960000,"chr12",491917,1,10,11,22,"chr12",1,0.0489920300046882
"16265","chr12.100505000.100510000","chr12.100525000.100530000",20000,45,1.888555e-05,100505000,100525000,100510000,100530000,"chr12",491925,0,4,3,7,"chr12",1,0.0369198312236287
"16266","chr12.116605000.116610000","chr12.116620000.116625000",15000,47,3.380234e-06,116605000,116620000,116610000,116625000,"chr12",491936,0,10,13,23,"chr12",1,0.126699484294421
"16267","chr12.116605000.116610000","chr12.117115000.117120000",510000,11,0.0001371567,116605000,117115000,116610000,117120000,"chr12",491945,0,10,12,22,"chr12",1,0.0283638068448195
"16268","chr12.15855000.15860000","chr12.15910000.15915000",55000,26,8.379703e-05,15855000,15910000,15860000,15915000,"chr12",491989,1,2,0,3,"chr12",1,0.00914205344585091
"16269","chr12.53655000.53660000","chr12.53675000.53680000",20000,61,1.803254e-12,53655000,53675000,53660000,53680000,"chr12",492043,2,1,0,3,"chr12",1,0.0214486638537271
"16270","chr12.50920000.50925000","chr12.51005000.51010000",85000,30,4.04347e-10,50920000,51005000,50925000,51010000,"chr12",492061,5,9,7,21,"chr12",1,0.0738396624472574
"16271","chr12.26340000.26345000","chr12.26830000.26835000",490000,13,4.577268e-06,26340000,26830000,26345000,26835000,"chr12",492076,0,3,2,5,"chr12",1,0.00761837787154243
"16272","chr12.6890000.6895000","chr12.6925000.6930000",35000,30,0.0007344653,6890000,6925000,6895000,6930000,"chr12",492114,0,4,2,6,"chr12",1,0.0210970464135021
"16273","chr12.11810000.11815000","chr12.12150000.12155000",340000,15,2.125942e-06,11810000,12150000,11815000,12155000,"chr12",492131,0,1,2,3,"chr12",1,0.00527426160337553
"16274","chr12.112385000.112390000","chr12.112485000.112490000",100000,20,7.564209e-05,112385000,112485000,112390000,112490000,"chr12",492134,1,10,4,15,"chr12",1,0.0351617440225035
"16275","chr12.108930000.108935000","chr12.108950000.108955000",20000,46,8.095311e-06,108930000,108950000,108935000,108955000,"chr12",492179,6,8,3,17,"chr12",1,0.0916549460853258
"16276","chr12.113125000.113130000","chr12.113145000.113150000",20000,46,8.095311e-06,113125000,113145000,113130000,113150000,"chr12",492189,5,7,7,19,"chr12",1,0.102437880918894
"16277","chr12.124535000.124540000","chr12.124805000.124810000",270000,23,3.148121e-12,124535000,124805000,124540000,124810000,"chr12",492222,1,1,2,4,"chr12",1,0.0107829348335677
"16278","chr12.101750000.101755000","chr12.101775000.101780000",25000,34,0.00767932,101750000,101775000,101755000,101780000,"chr12",492260,0,6,5,11,"chr12",1,0.0438349742147211
"16279","chr12.120235000.120240000","chr12.120315000.120320000",80000,20,0.0006616707,120235000,120315000,120240000,120320000,"chr12",492268,9,27,28,64,"chr12",1,0.150023441162682
"16280","chr12.50985000.50990000","chr12.51005000.51010000",20000,46,8.095311e-06,50985000,51005000,50990000,51010000,"chr12",492292,2,3,1,6,"chr12",1,0.0323488045007032
"16281","chr12.121775000.121780000","chr12.121870000.121875000",95000,18,0.00123649,121775000,121870000,121780000,121875000,"chr12",492301,3,10,13,26,"chr12",1,0.0548523206751055
"16282","chr12.62860000.62865000","chr12.62975000.62980000",115000,18,0.0002591224,62860000,62975000,62865000,62980000,"chr12",492316,1,0,2,3,"chr12",1,0.00632911392405063
"16283","chr12.69275000.69280000","chr12.69470000.69475000",195000,18,2.763511e-06,69275000,69470000,69280000,69475000,"chr12",492353,2,4,2,8,"chr12",1,0.0168776371308017
"16284","chr12.69290000.69295000","chr12.69460000.69465000",170000,25,7.387305e-11,69290000,69460000,69295000,69465000,"chr12",492355,8,17,12,37,"chr12",1,0.108415377402719
"16285","chr12.116520000.116525000","chr12.116605000.116610000",85000,24,2.706382e-06,116520000,116605000,116525000,116610000,"chr12",492371,0,10,13,23,"chr12",1,0.0646976090014065
"16286","chr12.124455000.124460000","chr12.125255000.125260000",800000,8,0.001733755,124455000,125255000,124460000,125260000,"chr12",492420,2,0,1,3,"chr12",1,0.00281293952180028
"16287","chr12.109055000.109060000","chr12.109080000.109085000",25000,46,5.204899e-07,109055000,109080000,109060000,109085000,"chr12",492426,0,9,6,15,"chr12",1,0.0808720112517581
"16288","chr12.120165000.120170000","chr12.120200000.120205000",35000,35,7.309473e-06,120165000,120200000,120170000,120205000,"chr12",492432,2,11,16,29,"chr12",1,0.11896390060947
"16289","chr12.94560000.94565000","chr12.94685000.94690000",125000,18,0.0001355009,94560000,94685000,94565000,94690000,"chr12",492499,6,16,15,37,"chr12",1,0.0780590717299578
"16290","chr12.121750000.121755000","chr12.121785000.121790000",35000,38,3.046196e-07,121750000,121785000,121755000,121790000,"chr12",492546,4,8,10,22,"chr12",1,0.0979840600093765
"16291","chr12.54415000.54420000","chr12.54590000.54595000",175000,17,3.591227e-05,54415000,54590000,54420000,54595000,"chr12",492553,0,2,1,3,"chr12",1,0.0059774964838256
"16292","chr12.108950000.108955000","chr12.109540000.109545000",590000,8,0.007951205,108950000,109540000,108955000,109545000,"chr12",492591,1,2,3,6,"chr12",1,0.00562587904360056
"16293","chr12.76445000.76450000","chr12.76790000.76795000",345000,11,0.001450845,76445000,76790000,76450000,76795000,"chr12",492611,1,5,5,11,"chr12",1,0.0141819034224098
"16294","chr12.109090000.109095000","chr12.109115000.109120000",25000,70,1.15034e-19,109090000,109115000,109095000,109120000,"chr12",492615,2,13,12,27,"chr12",1,0.221518987341772
"16295","chr12.12520000.12525000","chr12.12900000.12905000",380000,11,0.0008520859,12520000,12900000,12525000,12905000,"chr12",492621,1,1,3,5,"chr12",1,0.00644631973745898
"16296","chr12.123980000.123985000","chr12.124025000.124030000",45000,24,0.004672633,123980000,124025000,123985000,124030000,"chr12",492646,2,0,2,4,"chr12",1,0.0112517580872011
"16297","chr12.106100000.106105000","chr12.106490000.106495000",390000,11,0.0007436355,106100000,106490000,106105000,106495000,"chr12",492663,2,2,3,7,"chr12",1,0.00902484763244257
"16298","chr12.124615000.124620000","chr12.124650000.124655000",35000,28,0.003578991,124615000,124650000,124620000,124655000,"chr12",492677,1,3,1,5,"chr12",1,0.0164088138771683
"16299","chr12.51045000.51050000","chr12.51080000.51085000",35000,39,9.994752e-08,51045000,51080000,51050000,51085000,"chr12",492698,6,14,14,34,"chr12",1,0.155414908579466
"16300","chr12.121580000.121585000","chr12.121610000.121615000",30000,37,2.748527e-05,121580000,121610000,121585000,121615000,"chr12",492710,1,4,3,8,"chr12",1,0.0346929207688701
"16301","chr12.120485000.120490000","chr12.120515000.120520000",30000,31,0.003607369,120485000,120515000,120490000,120520000,"chr12",492737,9,38,29,76,"chr12",1,0.276136896390061
"16302","chr12.120645000.120650000","chr12.120710000.120715000",65000,25,2.584704e-05,120645000,120710000,120650000,120715000,"chr12",492739,0,2,1,3,"chr12",1,0.00879043600562588
"16303","chr12.116520000.116525000","chr12.116705000.116710000",185000,14,0.001359188,116520000,116705000,116525000,116710000,"chr12",492749,4,16,13,33,"chr12",1,0.0541490857946554
"16304","chr12.545000.550000","chr12.660000.665000",115000,16,0.002631479,545000,660000,550000,665000,"chr12",492782,1,1,1,3,"chr12",1,0.00562587904360056
"16305","chr12.11835000.11840000","chr12.12045000.12050000",210000,14,0.0005467192,11835000,12045000,11840000,12050000,"chr12",492783,1,1,0,2,"chr12",1,0.00328176277543366
"16306","chr12.53300000.53305000","chr12.53345000.53350000",45000,26,0.0008520859,53300000,53345000,53305000,53350000,"chr12",492794,4,17,27,48,"chr12",1,0.146272855133615
"16307","chr12.51440000.51445000","chr12.51630000.51635000",190000,19,7.191149e-07,51440000,51630000,51445000,51635000,"chr12",492802,0,4,4,8,"chr12",1,0.0178152836380684
"16308","chr12.56520000.56525000","chr12.56750000.56755000",230000,13,0.001088482,56520000,56750000,56525000,56755000,"chr12",492813,1,12,14,27,"chr12",1,0.0411392405063291
"16309","chr12.53325000.53330000","chr12.53350000.53355000",25000,40,0.0001053516,53325000,53350000,53330000,53355000,"chr12",492823,0,3,1,4,"chr12",1,0.0187529301453352
"16310","chr12.93440000.93445000","chr12.93765000.93770000",325000,12,0.0004548585,93440000,93765000,93445000,93770000,"chr12",492839,2,1,3,6,"chr12",1,0.00843881856540084
"16311","chr12.51025000.51030000","chr12.51125000.51130000",100000,17,0.002386462,51025000,51125000,51030000,51130000,"chr12",492851,1,14,10,25,"chr12",1,0.0498124706985466
"16312","chr12.94100000.94105000","chr12.94950000.94955000",850000,7,0.007148363,94100000,94950000,94105000,94955000,"chr12",492863,1,6,8,15,"chr12",1,0.0123066104078762
"16313","chr12.110465000.110470000","chr12.110500000.110505000",35000,32,0.0001288331,110465000,110500000,110470000,110505000,"chr12",492886,1,5,2,8,"chr12",1,0.0300046882325363
"16314","chr12.49565000.49570000","chr12.50005000.50010000",440000,9,0.007545672,49565000,50005000,49570000,50010000,"chr12",492931,0,6,5,11,"chr12",1,0.0116033755274262
"16315","chr12.51205000.51210000","chr12.51465000.51470000",260000,14,0.0001016917,51205000,51465000,51210000,51470000,"chr12",492950,1,0,3,4,"chr12",1,0.00656352555086732
"16316","chr12.121785000.121790000","chr12.122115000.122120000",330000,14,1.593204e-05,121785000,122115000,121790000,122120000,"chr12",492952,2,11,16,29,"chr12",1,0.0475855602437881
"16317","chr12.69250000.69255000","chr12.69455000.69460000",205000,20,5.457936e-08,69250000,69455000,69255000,69460000,"chr12",492968,2,4,4,10,"chr12",1,0.023441162681669
"16318","chr12.51440000.51445000","chr12.51465000.51470000",25000,49,2.605071e-08,51440000,51465000,51445000,51470000,"chr12",493043,1,0,3,4,"chr12",1,0.0229723394280356
"16319","chr12.120640000.120645000","chr12.120725000.120730000",85000,27,4.058292e-08,120640000,120725000,120645000,120730000,"chr12",493092,2,4,3,9,"chr12",1,0.0284810126582278
"16320","chr12.123050000.123055000","chr12.123115000.123120000",65000,23,0.0002377345,123050000,123115000,123055000,123120000,"chr12",493098,2,0,5,7,"chr12",1,0.0188701359587436
"16321","chr12.14415000.14420000","chr12.14615000.14620000",200000,14,0.0007820664,14415000,14615000,14420000,14620000,"chr12",493132,3,3,2,8,"chr12",1,0.0131270511017346
"16322","chr12.69820000.69825000","chr12.69845000.69850000",25000,39,0.0002355347,69820000,69845000,69825000,69850000,"chr12",493137,0,2,1,3,"chr12",1,0.0137130801687764
"16323","chr12.49580000.49585000","chr12.49625000.49630000",45000,78,2.376265e-40,49580000,49625000,49585000,49630000,"chr12",493142,0,2,5,7,"chr12",1,0.0639943741209564
"16324","chr12.48750000.48755000","chr12.49015000.49020000",265000,11,0.006016121,48750000,49015000,48755000,49020000,"chr12",493170,5,5,6,16,"chr12",1,0.0206282231598687
"16325","chr12.111320000.111325000","chr12.111750000.111755000",430000,10,0.001985269,111320000,111750000,111325000,111755000,"chr12",493178,9,23,19,51,"chr12",1,0.059774964838256
"16326","chr12.11770000.11775000","chr12.11965000.11970000",195000,18,2.763511e-06,11770000,11965000,11775000,11970000,"chr12",493192,2,1,6,9,"chr12",1,0.0189873417721519
"16327","chr12.11820000.11825000","chr12.12150000.12155000",330000,14,1.593204e-05,11820000,12150000,11825000,12155000,"chr12",493253,2,7,7,16,"chr12",1,0.0262541022034693
"16328","chr12.64270000.64275000","chr12.64610000.64615000",340000,10,0.006200093,64270000,64610000,64275000,64615000,"chr12",493270,4,11,14,29,"chr12",1,0.0339896858884201
"16329","chr12.64230000.64235000","chr12.64570000.64575000",340000,20,9.218539e-11,64230000,64570000,64235000,64575000,"chr12",493279,3,11,7,21,"chr12",1,0.0492264416315049
"16330","chr12.124515000.124520000","chr12.124790000.124795000",275000,11,0.00487472,124515000,124790000,124520000,124795000,"chr12",493285,2,8,2,12,"chr12",1,0.0154711673699015
"16331","chr12.121785000.121790000","chr12.121885000.121890000",100000,16,0.006653592,121785000,121885000,121790000,121890000,"chr12",493350,13,32,48,93,"chr12",1,0.174402250351617
"16332","chr12.720000.725000","chr12.860000.865000",140000,19,1.419541e-05,720000,860000,725000,865000,"chr12",493459,1,5,1,7,"chr12",1,0.0155883731833099
"16333","chr12.77030000.77035000","chr12.77065000.77070000",35000,27,0.007443733,77030000,77065000,77035000,77070000,"chr12",493504,0,2,0,2,"chr12",1,0.00632911392405063
"16334","chr12.110075000.110080000","chr12.110135000.110140000",60000,37,9.249506e-12,110075000,110135000,110080000,110140000,"chr12",493509,2,16,19,37,"chr12",1,0.160454758556024
"16335","chr12.64235000.64240000","chr12.64570000.64575000",335000,28,6.563258e-19,64235000,64570000,64240000,64575000,"chr12",493534,1,2,1,4,"chr12",1,0.0131270511017346
"16336","chr12.124790000.124795000","chr12.125255000.125260000",465000,9,0.005858816,124790000,125255000,124795000,125260000,"chr12",493593,4,0,1,5,"chr12",1,0.00527426160337553
"16337","chr12.106745000.106750000","chr12.107345000.107350000",600000,8,0.007426256,106745000,107345000,106750000,107350000,"chr12",493595,1,3,5,9,"chr12",1,0.00843881856540084
"16338","chr12.56265000.56270000","chr12.56315000.56320000",50000,27,9.956267e-05,56265000,56315000,56270000,56320000,"chr12",493618,0,3,3,6,"chr12",1,0.0189873417721519
"16339","chr12.121765000.121770000","chr12.122120000.122125000",355000,10,0.005092321,121765000,122120000,121770000,122125000,"chr12",493620,3,5,6,14,"chr12",1,0.0164088138771683
"16340","chr12.110040000.110045000","chr12.110075000.110080000",35000,27,0.007443733,110040000,110075000,110045000,110080000,"chr12",493622,0,11,5,16,"chr12",1,0.0506329113924051
"16341","chr12.14400000.14405000","chr12.14545000.14550000",145000,27,1.764648e-11,14400000,14545000,14405000,14550000,"chr12",493737,1,9,3,13,"chr12",1,0.0411392405063291
"16342","chr12.93395000.93400000","chr12.93780000.93785000",385000,10,0.00352132,93395000,93780000,93400000,93785000,"chr12",493750,1,10,7,18,"chr12",1,0.0210970464135021
"16343","chr12.12330000.12335000","chr12.12395000.12400000",65000,24,8.022832e-05,12330000,12395000,12335000,12400000,"chr12",493773,0,5,3,8,"chr12",1,0.0225035161744023
"16344","chr12.1280000.1285000","chr12.1580000.1585000",300000,11,0.003069305,1280000,1580000,1285000,1585000,"chr12",493799,3,5,1,9,"chr12",1,0.0116033755274262
"16345","chr12.92130000.92135000","chr12.92240000.92245000",110000,17,0.001187183,92130000,92240000,92135000,92245000,"chr12",493854,3,6,7,16,"chr12",1,0.0318799812470699
"16346","chr12.112645000.112650000","chr12.112685000.112690000",40000,32,1.290883e-05,112645000,112685000,112650000,112690000,"chr12",493885,2,3,3,8,"chr12",1,0.0300046882325363
"16347","chr12.124815000.124820000","chr12.125255000.125260000",440000,14,1.646203e-06,124815000,125255000,124820000,125260000,"chr12",493898,4,0,1,5,"chr12",1,0.00820440693858415
"16348","chr12.56760000.56765000","chr12.56835000.56840000",75000,21,0.0004214119,56760000,56835000,56765000,56840000,"chr12",493913,3,3,0,6,"chr12",1,0.0147679324894515
"16349","chr12.69275000.69280000","chr12.69435000.69440000",160000,14,0.003472662,69275000,69435000,69280000,69440000,"chr12",493933,10,12,13,35,"chr12",1,0.0574308485700891
"16350","chr12.121670000.121675000","chr12.121870000.121875000",200000,12,0.009019421,121670000,121870000,121675000,121875000,"chr12",493984,6,26,22,54,"chr12",1,0.0759493670886076
"16351","chr12.570000.575000","chr12.645000.650000",75000,21,0.0004214119,570000,645000,575000,650000,"chr12",494003,0,4,1,5,"chr12",1,0.0123066104078762
"16352","chr12.50040000.50045000","chr12.50100000.50105000",60000,32,1.361879e-08,50040000,50100000,50045000,50105000,"chr12",494042,0,6,1,7,"chr12",1,0.0262541022034693
"16353","chr12.57725000.57730000","chr12.57745000.57750000",20000,39,0.001689966,57725000,57745000,57730000,57750000,"chr12",494062,2,0,3,5,"chr12",1,0.0228551336146273
"16354","chr12.122355000.122360000","chr12.122480000.122485000",125000,19,3.636664e-05,122355000,122480000,122360000,122485000,"chr12",494087,6,14,8,28,"chr12",1,0.0623534927332396
"16355","chr12.57690000.57695000","chr12.57840000.57845000",150000,14,0.004987821,57690000,57840000,57695000,57845000,"chr12",494133,0,2,3,5,"chr12",1,0.00820440693858415
"16356","chr12.124535000.124540000","chr12.124800000.124805000",265000,19,1.427889e-08,124535000,124800000,124540000,124805000,"chr12",494134,1,1,2,4,"chr12",1,0.00890764181903422
"16357","chr12.109260000.109265000","chr12.109515000.109520000",255000,14,0.0001187788,109260000,109515000,109265000,109520000,"chr12",494207,1,3,6,10,"chr12",1,0.0164088138771683
"16358","chr12.69250000.69255000","chr12.69470000.69475000",220000,12,0.005168804,69250000,69470000,69255000,69475000,"chr12",494257,2,4,2,8,"chr12",1,0.0112517580872011
"16359","chr12.51215000.51220000","chr12.51390000.51395000",175000,27,9.874226e-13,51215000,51390000,51220000,51395000,"chr12",494265,0,6,6,12,"chr12",1,0.0379746835443038
"16360","chr12.53740000.53745000","chr12.53765000.53770000",25000,36,0.002074578,53740000,53765000,53745000,53770000,"chr12",494291,0,0,2,2,"chr12",1,0.00843881856540084
"16361","chr12.122000000.122005000","chr12.122130000.122135000",130000,19,2.645209e-05,1.22e+08,122130000,122005000,122135000,"chr12",494295,8,20,20,48,"chr12",1,0.106891701828411
"16362","chr12.13070000.13075000","chr12.13135000.13140000",65000,64,3.241332e-35,13070000,13135000,13075000,13140000,"chr12",494310,2,3,4,9,"chr12",1,0.0675105485232067
"16363","chr12.69235000.69240000","chr12.69470000.69475000",235000,18,3.671012e-07,69235000,69470000,69240000,69475000,"chr12",494311,2,4,2,8,"chr12",1,0.0168776371308017
"16364","chr12.56315000.56320000","chr12.56520000.56525000",205000,12,0.007809895,56315000,56520000,56320000,56525000,"chr12",494320,1,3,3,7,"chr12",1,0.00984528832630099
"16365","chr12.50635000.50640000","chr12.50660000.50665000",25000,55,3.451837e-11,50635000,50660000,50640000,50665000,"chr12",494322,2,6,3,11,"chr12",1,0.0709095171120488
"16366","chr12.106105000.106110000","chr12.106690000.106695000",585000,8,0.008285684,106105000,106690000,106110000,106695000,"chr12",494377,0,3,2,5,"chr12",1,0.0046882325363338
"16367","chr12.75905000.75910000","chr12.76420000.76425000",515000,21,3.270197e-14,75905000,76420000,75910000,76425000,"chr12",494412,1,2,3,6,"chr12",1,0.0147679324894515
"16368","chr12.123425000.123430000","chr12.123670000.123675000",245000,11,0.009206307,123425000,123670000,123430000,123675000,"chr12",494433,11,26,21,58,"chr12",1,0.0747773089545241
"16369","chr12.88535000.88540000","chr12.89380000.89385000",845000,12,2.885672e-07,88535000,89380000,88540000,89385000,"chr12",494443,2,2,1,5,"chr12",1,0.0070323488045007
"16370","chr12.12640000.12645000","chr12.12710000.12715000",70000,37,2.230189e-13,12640000,12710000,12645000,12715000,"chr12",494450,0,3,3,6,"chr12",1,0.0260196905766526
"16371","chr12.50925000.50930000","chr12.51025000.51030000",100000,23,1.380136e-06,50925000,51025000,50930000,51030000,"chr12",494473,6,8,5,19,"chr12",1,0.0512189404594468
"16372","chr12.76055000.76060000","chr12.76090000.76095000",35000,29,0.001663392,76055000,76090000,76060000,76095000,"chr12",494479,1,7,3,11,"chr12",1,0.0373886544772621
"16373","chr12.4285000.4290000","chr12.4320000.4325000",35000,29,0.001663392,4285000,4320000,4290000,4325000,"chr12",494554,1,2,0,3,"chr12",1,0.010196905766526
"16374","chr12.96445000.96450000","chr12.96605000.96610000",160000,26,2.745822e-11,96445000,96605000,96450000,96610000,"chr12",494559,0,1,1,2,"chr12",1,0.00609470229723394
"16375","chr12.98995000.99000000","chr12.99020000.99025000",25000,35,0.004075805,98995000,99020000,9.9e+07,99025000,"chr12",494562,0,2,4,6,"chr12",1,0.0246132208157525
"16376","chr12.77605000.77610000","chr12.77925000.77930000",320000,10,0.008148661,77605000,77925000,77610000,77930000,"chr12",494641,0,3,5,8,"chr12",1,0.00937646507266761
"16377","chr12.124025000.124030000","chr12.124045000.124050000",20000,50,2.174504e-07,124025000,124045000,124030000,124050000,"chr12",494651,2,4,7,13,"chr12",1,0.0761837787154243
"16378","chr12.98835000.98840000","chr12.98915000.98920000",80000,23,2.055084e-05,98835000,98915000,98840000,98920000,"chr12",494660,0,2,2,4,"chr12",1,0.0107829348335677
"16379","chr12.69290000.69295000","chr12.69455000.69460000",165000,13,0.008778126,69290000,69455000,69295000,69460000,"chr12",494698,2,12,4,18,"chr12",1,0.0274261603375527
"16380","chr12.104555000.104560000","chr12.105420000.105425000",865000,10,2.05769e-05,104555000,105420000,104560000,105425000,"chr12",494714,0,2,2,4,"chr12",1,0.0046882325363338
"16381","chr12.14400000.14405000","chr12.14785000.14790000",385000,12,0.0001641518,14400000,14785000,14405000,14790000,"chr12",494801,2,8,5,15,"chr12",1,0.0210970464135021
"16382","chr12.22255000.22260000","chr12.22460000.22465000",205000,14,0.0006539792,22255000,22460000,22260000,22465000,"chr12",494819,0,3,3,6,"chr12",1,0.00984528832630099
"16383","chr12.121785000.121790000","chr12.122105000.122110000",320000,15,3.491061e-06,121785000,122105000,121790000,122110000,"chr12",494824,1,25,19,45,"chr12",1,0.0791139240506329
"16384","chr12.53505000.53510000","chr12.53530000.53535000",25000,37,0.001043084,53505000,53530000,53510000,53535000,"chr12",494834,0,5,10,15,"chr12",1,0.0650492264416315
"16385","chr12.6735000.6740000","chr12.6790000.6795000",55000,33,1.910847e-08,6735000,6790000,6740000,6795000,"chr12",494842,6,27,34,67,"chr12",1,0.259142053445851
"16386","chr12.545000.550000","chr12.640000.645000",95000,22,9.901382e-06,545000,640000,550000,645000,"chr12",494852,1,1,1,3,"chr12",1,0.00773558368495077
"16387","chr12.66930000.66935000","chr12.67080000.67085000",150000,14,0.004987821,66930000,67080000,66935000,67085000,"chr12",494856,0,2,0,2,"chr12",1,0.00328176277543366
"16388","chr12.123125000.123130000","chr12.123205000.123210000",80000,18,0.004919131,123125000,123205000,123130000,123210000,"chr12",494879,11,27,33,71,"chr12",1,0.149789029535865
"16389","chr12.109150000.109155000","chr12.109180000.109185000",30000,36,6.745676e-05,109150000,109180000,109155000,109185000,"chr12",494965,3,6,10,19,"chr12",1,0.080168776371308
"16390","chr12.57085000.57090000","chr12.57830000.57835000",745000,9,0.0004256654,57085000,57830000,57090000,57835000,"chr12",495000,3,12,19,34,"chr12",1,0.0358649789029536
"16391","chr12.122125000.122130000","chr12.122225000.122230000",100000,29,1.251792e-10,122125000,122225000,122130000,122230000,"chr12",495039,2,6,12,20,"chr12",1,0.0679793717768401
"16392","chr12.121770000.121775000","chr12.121790000.121795000",20000,43,9.410475e-05,121770000,121790000,121775000,121795000,"chr12",495064,0,5,4,9,"chr12",1,0.0453586497890295
"16393","chr12.121990000.121995000","chr12.122095000.122100000",105000,18,0.0005441941,121990000,122095000,121995000,122100000,"chr12",495067,5,18,22,45,"chr12",1,0.0949367088607595
"16394","chr12.116700000.116705000","chr12.117040000.117045000",340000,12,0.0003483697,116700000,117040000,116705000,117045000,"chr12",495068,4,9,12,25,"chr12",1,0.0351617440225035
"16395","chr12.49580000.49585000","chr12.49620000.49625000",40000,43,2.082212e-11,49580000,49620000,49585000,49625000,"chr12",495174,1,2,5,8,"chr12",1,0.0403187998124707
"16396","chr12.11810000.11815000","chr12.12015000.12020000",205000,23,2.096601e-10,11810000,12015000,11815000,12020000,"chr12",495329,0,1,2,3,"chr12",1,0.00808720112517581
"16397","chr12.93440000.93445000","chr12.93740000.93745000",300000,12,0.000743179,93440000,93740000,93445000,93745000,"chr12",495337,2,1,2,5,"chr12",1,0.0070323488045007
"16398","chr12.93165000.93170000","chr12.93765000.93770000",600000,10,0.0002707346,93165000,93765000,93170000,93770000,"chr12",495361,2,2,4,8,"chr12",1,0.00937646507266761
"16399","chr12.6730000.6735000","chr12.6790000.6795000",60000,20,0.009290085,6730000,6790000,6735000,6795000,"chr12",495362,2,10,10,22,"chr12",1,0.0515705578996718
"16400","chr12.11770000.11775000","chr12.12115000.12120000",345000,10,0.005848603,11770000,12115000,11775000,12120000,"chr12",495375,2,1,7,10,"chr12",1,0.0117205813408345
"16401","chr12.120760000.120765000","chr12.121520000.121525000",760000,8,0.002280937,120760000,121520000,120765000,121525000,"chr12",495410,0,5,1,6,"chr12",1,0.00562587904360056
"16402","chr12.98955000.98960000","chr12.99040000.99045000",85000,29,1.956214e-09,98955000,99040000,98960000,99045000,"chr12",495462,0,1,1,2,"chr12",1,0.00679793717768401
"16403","chr12.48925000.48930000","chr12.49025000.49030000",100000,16,0.006653592,48925000,49025000,48930000,49030000,"chr12",495489,3,6,3,12,"chr12",1,0.0225035161744023
"16404","chr12.8170000.8175000","chr12.8230000.8235000",60000,20,0.009290085,8170000,8230000,8175000,8235000,"chr12",495493,0,0,1,1,"chr12",1,0.0023441162681669
"16405","chr12.32530000.32535000","chr12.32565000.32570000",35000,31,0.000314028,32530000,32565000,32535000,32570000,"chr12",495510,0,1,1,2,"chr12",1,0.00726676043131739
"16406","chr12.56125000.56130000","chr12.56445000.56450000",320000,14,1.993578e-05,56125000,56445000,56130000,56450000,"chr12",495533,0,3,3,6,"chr12",1,0.00984528832630099
"16407","chr12.50730000.50735000","chr12.50760000.50765000",30000,33,0.0008141503,50730000,50760000,50735000,50765000,"chr12",495542,5,6,5,16,"chr12",1,0.0618846694796062
"16408","chr12.121110000.121115000","chr12.121135000.121140000",25000,42,1.993578e-05,121110000,121135000,121115000,121140000,"chr12",495562,4,11,12,27,"chr12",1,0.132911392405063
"16409","chr12.51425000.51430000","chr12.51440000.51445000",15000,41,0.0004214119,51425000,51440000,51430000,51445000,"chr12",495604,4,4,7,15,"chr12",1,0.0720815752461322
"16410","chr12.121110000.121115000","chr12.121130000.121135000",20000,39,0.001689966,121110000,121130000,121115000,121135000,"chr12",495674,2,6,5,13,"chr12",1,0.0594233473980309
"16411","chr12.49520000.49525000","chr12.49625000.49630000",105000,42,6.574371e-22,49520000,49625000,49525000,49630000,"chr12",495728,0,3,6,9,"chr12",1,0.0443037974683544
"16412","chr12.121285000.121290000","chr12.121340000.121345000",55000,21,0.00890833,121285000,121340000,121290000,121345000,"chr12",495736,2,17,15,34,"chr12",1,0.0836849507735584
"16413","chr12.121795000.121800000","chr12.121870000.121875000",75000,20,0.001202934,121795000,121870000,121800000,121875000,"chr12",495824,0,2,2,4,"chr12",1,0.00937646507266761
"16414","chr12.64235000.64240000","chr12.64625000.64630000",390000,21,1.803254e-12,64235000,64625000,64240000,64630000,"chr12",495913,1,2,1,4,"chr12",1,0.00984528832630099
"16415","chr12.51990000.51995000","chr12.52135000.52140000",145000,15,0.00196439,51990000,52135000,51995000,52140000,"chr12",495980,2,11,14,27,"chr12",1,0.0474683544303797
"16416","chr12.57065000.57070000","chr12.57095000.57100000",30000,35,0.000160824,57065000,57095000,57070000,57100000,"chr12",496005,3,4,4,11,"chr12",1,0.0451242381622128
"16417","chr12.123265000.123270000","chr12.123435000.123440000",170000,16,0.0001881303,123265000,123435000,123270000,123440000,"chr12",496112,0,3,0,3,"chr12",1,0.00562587904360056
"16418","chr12.11785000.11790000","chr12.12700000.12705000",915000,7,0.004867336,11785000,12700000,11790000,12705000,"chr12",496121,4,3,4,11,"chr12",1,0.00902484763244257
"16419","chr12.110170000.110175000","chr12.110200000.110205000",30000,38,1.077427e-05,110170000,110200000,110175000,110205000,"chr12",496128,5,17,14,36,"chr12",1,0.160337552742616
"16420","chr12.122880000.122885000","chr12.123230000.123235000",350000,10,0.005431479,122880000,123230000,122885000,123235000,"chr12",496158,8,12,10,30,"chr12",1,0.0351617440225035
"16421","chr12.62655000.62660000","chr12.62975000.62980000",320000,16,5.647163e-07,62655000,62975000,62660000,62980000,"chr12",496188,2,0,2,4,"chr12",1,0.00750117205813408
"16422","chr12.76470000.76475000","chr12.76700000.76705000",230000,12,0.003952237,76470000,76700000,76475000,76705000,"chr12",496192,1,2,3,6,"chr12",1,0.00843881856540084
"16423","chr12.125470000.125475000","chr12.125545000.125550000",75000,26,1.014084e-06,125470000,125545000,125475000,125550000,"chr12",496202,1,0,2,3,"chr12",1,0.00914205344585091
"16424","chr12.88495000.88500000","chr12.89380000.89385000",885000,7,0.005848603,88495000,89380000,88500000,89385000,"chr12",496220,2,4,1,7,"chr12",1,0.00574308485700891
"16425","chr12.92285000.92290000","chr12.92605000.92610000",320000,10,0.008148661,92285000,92605000,92290000,92610000,"chr12",496253,0,2,0,2,"chr12",1,0.0023441162681669
"16426","chr12.106095000.106100000","chr12.106480000.106485000",385000,15,7.536765e-07,106095000,106480000,106100000,106485000,"chr12",496280,1,6,7,14,"chr12",1,0.0246132208157525
"16427","chr12.26095000.26100000","chr12.26830000.26835000",735000,9,0.0004636185,26095000,26830000,26100000,26835000,"chr12",496304,1,1,3,5,"chr12",1,0.00527426160337553
"16428","chr12.116655000.116660000","chr12.117190000.117195000",535000,9,0.002884344,116655000,117190000,116660000,117195000,"chr12",496319,3,4,3,10,"chr12",1,0.0105485232067511
"16429","chr12.122000000.122005000","chr12.122110000.122115000",110000,29,2.605582e-11,1.22e+08,122110000,122005000,122115000,"chr12",496381,6,19,24,49,"chr12",1,0.166549460853258
"16430","chr12.52450000.52455000","chr12.53380000.53385000",930000,7,0.004464512,52450000,53380000,52455000,53385000,"chr12",496437,0,2,3,5,"chr12",1,0.00410220346929208
"16431","chr12.110430000.110435000","chr12.110510000.110515000",80000,26,4.096678e-07,110430000,110510000,110435000,110515000,"chr12",496446,3,14,14,31,"chr12",1,0.0944678856071261
"16432","chr12.121095000.121100000","chr12.121400000.121405000",305000,15,5.245575e-06,121095000,121400000,121100000,121405000,"chr12",496460,1,8,4,13,"chr12",1,0.0228551336146273
"16433","chr12.125485000.125490000","chr12.125510000.125515000",25000,39,0.0002355347,125485000,125510000,125490000,125515000,"chr12",496469,0,0,3,3,"chr12",1,0.0137130801687764
"16434","chr12.106100000.106105000","chr12.106460000.106465000",360000,13,4.701615e-05,106100000,106460000,106105000,106465000,"chr12",496492,0,6,3,9,"chr12",1,0.0137130801687764
"16435","chr12.124535000.124540000","chr12.124790000.124795000",255000,17,8.663093e-07,124535000,124790000,124540000,124795000,"chr12",496496,1,1,2,4,"chr12",1,0.00796999531176746
"16436","chr12.49585000.49590000","chr12.49625000.49630000",40000,74,4.017287e-34,49585000,49625000,49590000,49630000,"chr12",496572,0,1,2,3,"chr12",1,0.0260196905766526
"16437","chr12.51215000.51220000","chr12.51465000.51470000",250000,12,0.002349198,51215000,51465000,51220000,51470000,"chr12",496577,0,0,3,3,"chr12",1,0.00421940928270042
"16438","chr12.57135000.57140000","chr12.57430000.57435000",295000,12,0.0008241946,57135000,57430000,57140000,57435000,"chr12",496580,0,6,8,14,"chr12",1,0.019690576652602
"16439","chr12.123050000.123055000","chr12.123250000.123255000",200000,13,0.002799815,123050000,123250000,123055000,123255000,"chr12",496621,4,13,8,25,"chr12",1,0.0380918893577121
"16440","chr12.6850000.6855000","chr12.6920000.6925000",70000,19,0.005751671,6850000,6920000,6855000,6925000,"chr12",496684,4,8,4,16,"chr12",1,0.0356305672761369
"16441","chr13.30355000.30360000","chr13.30420000.30425000",65000,29,3.672398e-08,30355000,30420000,30360000,30425000,"chr13",496754,4,2,2,8,"chr13",1,0.0271917487107361
"16442","chr13.30350000.30355000","chr13.30405000.30410000",55000,26,2.694731e-05,30350000,30405000,30355000,30410000,"chr13",496790,1,8,7,16,"chr13",1,0.0487576183778715
"16443","chr13.52165000.52170000","chr13.52235000.52240000",70000,19,0.002710671,52165000,52235000,52170000,52240000,"chr13",496802,1,8,8,17,"chr13",1,0.0378574777308955
"16444","chr13.43730000.43735000","chr13.43805000.43810000",75000,21,0.0001578639,43730000,43805000,43735000,43810000,"chr13",496863,0,2,6,8,"chr13",1,0.019690576652602
"16445","chr13.21405000.21410000","chr13.21435000.21440000",30000,32,0.0006755212,21405000,21435000,21410000,21440000,"chr13",496902,0,2,3,5,"chr13",1,0.0187529301453352
"16446","chr13.41020000.41025000","chr13.41190000.41195000",170000,13,0.004673452,41020000,41190000,41025000,41195000,"chr13",497036,3,2,4,9,"chr13",1,0.0137130801687764
"16447","chr13.80000000.80005000","chr13.80105000.80110000",105000,50,1.867452e-31,8e+07,80105000,80005000,80110000,"chr13",497056,0,3,2,5,"chr13",1,0.0293014533520863
"16448","chr13.30865000.30870000","chr13.30905000.30910000",40000,25,0.003302617,30865000,30905000,30870000,30910000,"chr13",497057,1,0,1,2,"chr13",1,0.00586029067041725
"16449","chr13.30340000.30345000","chr13.30420000.30425000",80000,44,7.797441e-22,30340000,30420000,30345000,30425000,"chr13",497085,3,2,2,7,"chr13",1,0.0360993905297703
"16450","chr13.41665000.41670000","chr13.41780000.41785000",115000,22,3.171017e-07,41665000,41780000,41670000,41785000,"chr13",497138,2,2,3,7,"chr13",1,0.0180496952648851
"16451","chr13.51730000.51735000","chr13.51800000.51805000",70000,20,0.000977278,51730000,51800000,51735000,51805000,"chr13",497230,0,2,1,3,"chr13",1,0.0070323488045007
"16452","chr13.30970000.30975000","chr13.31245000.31250000",275000,14,4.457639e-05,30970000,31245000,30975000,31250000,"chr13",497254,0,3,2,5,"chr13",1,0.00820440693858415
"16453","chr13.23340000.23345000","chr13.23360000.23365000",20000,49,9.207649e-08,23340000,23360000,23345000,23365000,"chr13",497275,0,3,6,9,"chr13",1,0.0516877637130802
"16454","chr13.100750000.100755000","chr13.100785000.100790000",35000,30,0.0002747622,100750000,100785000,100755000,100790000,"chr13",497276,4,2,4,10,"chr13",1,0.0351617440225035
"16455","chr13.97800000.97805000","chr13.98005000.98010000",205000,12,0.00549287,97800000,98005000,97805000,98010000,"chr13",497444,0,2,1,3,"chr13",1,0.00421940928270042
"16456","chr13.31195000.31200000","chr13.31420000.31425000",225000,12,0.00328273,31195000,31420000,31200000,31425000,"chr13",497510,0,2,2,4,"chr13",1,0.00562587904360056
"16457","chr13.77280000.77285000","chr13.77455000.77460000",175000,15,0.0003034485,77280000,77455000,77285000,77460000,"chr13",497549,2,2,2,6,"chr13",1,0.0105485232067511
"16458","chr13.52595000.52600000","chr13.52695000.52700000",100000,16,0.003327734,52595000,52695000,52600000,52700000,"chr13",497573,0,3,2,5,"chr13",1,0.00937646507266761
"16459","chr13.51730000.51735000","chr13.51870000.51875000",140000,16,0.0003535582,51730000,51870000,51735000,51875000,"chr13",497642,0,0,4,4,"chr13",1,0.00750117205813408
"16460","chr13.31040000.31045000","chr13.31235000.31240000",195000,13,0.002146119,31040000,31235000,31045000,31240000,"chr13",497645,2,12,8,22,"chr13",1,0.0335208626347867
"16461","chr13.25660000.25665000","chr13.25870000.25875000",210000,17,3.196276e-06,25660000,25870000,25665000,25875000,"chr13",497684,0,0,5,5,"chr13",1,0.00996249413970933
"16462","chr13.23375000.23380000","chr13.23890000.23895000",515000,14,4.152515e-07,23375000,23890000,23380000,23895000,"chr13",497748,1,5,3,9,"chr13",1,0.0147679324894515
"16463","chr13.26755000.26760000","chr13.27500000.27505000",745000,8,0.003433873,26755000,27500000,26760000,27505000,"chr13",497798,0,2,4,6,"chr13",1,0.00562587904360056
"16464","chr13.34175000.34180000","chr13.34290000.34295000",115000,35,1.11076e-17,34175000,34290000,34180000,34295000,"chr13",497802,0,0,1,1,"chr13",1,0.00410220346929208
"16465","chr13.45140000.45145000","chr13.45525000.45530000",385000,15,5.79295e-07,45140000,45525000,45145000,45530000,"chr13",497823,1,1,0,2,"chr13",1,0.00351617440225035
"16466","chr13.99615000.99620000","chr13.99655000.99660000",40000,25,0.003302617,99615000,99655000,99620000,99660000,"chr13",497831,0,1,2,3,"chr13",1,0.00879043600562588
"16467","chr13.21430000.21435000","chr13.21455000.21460000",25000,37,0.0003423553,21430000,21455000,21435000,21460000,"chr13",497873,1,5,7,13,"chr13",1,0.056375996249414
"16468","chr13.45100000.45105000","chr13.45120000.45125000",20000,45,4.052298e-06,45100000,45120000,45105000,45125000,"chr13",498117,3,18,14,35,"chr13",1,0.184599156118143
"16469","chr13.30360000.30365000","chr13.30675000.30680000",315000,12,0.0004357697,30360000,30675000,30365000,30680000,"chr13",498121,1,4,2,7,"chr13",1,0.00984528832630099
"16470","chr13.30340000.30345000","chr13.30670000.30675000",330000,11,0.001529122,30340000,30670000,30345000,30675000,"chr13",498178,0,4,3,7,"chr13",1,0.00902484763244257
"16471","chr13.36430000.36435000","chr13.36460000.36465000",30000,30,0.003198946,36430000,36460000,36435000,36465000,"chr13",498181,0,2,4,6,"chr13",1,0.0210970464135021
"16472","chr13.99520000.99525000","chr13.99585000.99590000",65000,21,0.0007435594,99520000,99585000,99525000,99590000,"chr13",498188,6,17,10,33,"chr13",1,0.0812236286919831
"16473","chr13.45045000.45050000","chr13.45330000.45335000",285000,12,0.0007813087,45045000,45330000,45050000,45335000,"chr13",498282,3,15,15,33,"chr13",1,0.0464135021097046
"16474","chr13.23360000.23365000","chr13.23885000.23890000",525000,9,0.003558934,23360000,23885000,23365000,23890000,"chr13",498306,1,0,3,4,"chr13",1,0.00421940928270042
"16475","chr13.52735000.52740000","chr13.52765000.52770000",30000,43,1.178245e-08,52735000,52765000,52740000,52770000,"chr13",498406,1,8,9,18,"chr13",1,0.0907172995780591
"16476","chr13.51210000.51215000","chr13.51630000.51635000",420000,11,0.0004599435,51210000,51630000,51215000,51635000,"chr13",498531,0,7,5,12,"chr13",1,0.0154711673699015
"16477","chr13.105445000.105450000","chr13.106090000.106095000",645000,9,0.001297929,105445000,106090000,105450000,106095000,"chr13",498584,0,2,8,10,"chr13",1,0.0105485232067511
"16478","chr13.51790000.51795000","chr13.51860000.51865000",70000,19,0.002710671,51790000,51860000,51795000,51865000,"chr13",498590,0,3,2,5,"chr13",1,0.0111345522737928
"16479","chr13.45100000.45105000","chr13.45510000.45515000",410000,11,0.0005253948,45100000,45510000,45105000,45515000,"chr13",498624,3,4,14,21,"chr13",1,0.0270745428973277
"16480","chr13.52765000.52770000","chr13.53020000.53025000",255000,15,1.545231e-05,52765000,53020000,52770000,53025000,"chr13",498631,1,0,3,4,"chr13",1,0.0070323488045007
"16481","chr13.26755000.26760000","chr13.27130000.27135000",375000,11,0.0008047032,26755000,27130000,26760000,27135000,"chr13",498709,1,2,4,7,"chr13",1,0.00902484763244257
"16482","chr13.25945000.25950000","chr13.26615000.26620000",670000,8,0.005509245,25945000,26615000,25950000,26620000,"chr13",498785,0,2,1,3,"chr13",1,0.00281293952180028
"16483","chr13.36295000.36300000","chr13.36365000.36370000",70000,21,0.0003314908,36295000,36365000,36300000,36370000,"chr13",498806,0,3,1,4,"chr13",1,0.00984528832630099
"16484","chr13.40645000.40650000","chr13.40795000.40800000",150000,13,0.00883829,40645000,40795000,40650000,40800000,"chr13",498820,2,4,7,13,"chr13",1,0.0198077824660103
"16485","chr13.20635000.20640000","chr13.20660000.20665000",25000,42,4.569119e-06,20635000,20660000,20640000,20665000,"chr13",498849,0,3,2,5,"chr13",1,0.0246132208157525
"16486","chr13.27280000.27285000","chr13.27450000.27455000",170000,19,9.053298e-07,27280000,27450000,27285000,27455000,"chr13",498946,0,5,2,7,"chr13",1,0.0155883731833099
"16487","chr13.32895000.32900000","chr13.33155000.33160000",260000,11,0.005238999,32895000,33155000,32900000,33160000,"chr13",498997,0,2,1,3,"chr13",1,0.00386779184247539
"16488","chr13.48815000.48820000","chr13.48855000.48860000",40000,25,0.003302617,48815000,48855000,48820000,48860000,"chr13",499075,0,5,3,8,"chr13",1,0.023441162681669
"16489","chr13.80000000.80005000","chr13.80030000.80035000",30000,44,3.649763e-09,8e+07,80030000,80005000,80035000,"chr13",499091,0,3,2,5,"chr13",1,0.0257852789498359
"16490","chr13.31020000.31025000","chr13.31170000.31175000",150000,14,0.002888673,31020000,31170000,31025000,31175000,"chr13",499125,0,6,3,9,"chr13",1,0.0147679324894515
"16491","chr13.42035000.42040000","chr13.42135000.42140000",100000,34,1.534608e-15,42035000,42135000,42040000,42140000,"chr13",499142,2,0,1,3,"chr13",1,0.0119549929676512
"16492","chr13.30730000.30735000","chr13.30970000.30975000",240000,11,0.007967524,30730000,30970000,30735000,30975000,"chr13",499162,0,0,2,2,"chr13",1,0.00257852789498359
"16493","chr13.31040000.31045000","chr13.31195000.31200000",155000,13,0.007480853,31040000,31195000,31045000,31200000,"chr13",499212,0,4,2,6,"chr13",1,0.00914205344585091
"16494","chr13.101280000.101285000","chr13.101300000.101305000",20000,35,0.008327471,101280000,101300000,101285000,101305000,"chr13",499244,0,4,4,8,"chr13",1,0.0328176277543366
"16495","chr13.24040000.24045000","chr13.24300000.24305000",260000,11,0.005238999,24040000,24300000,24045000,24305000,"chr13",499274,0,4,3,7,"chr13",1,0.00902484763244257
"16496","chr13.30845000.30850000","chr13.30865000.30870000",20000,37,0.002343816,30845000,30865000,30850000,30870000,"chr13",499394,1,6,2,9,"chr13",1,0.0390295358649789
"16497","chr13.33155000.33160000","chr13.33215000.33220000",60000,25,2.466582e-05,33155000,33215000,33160000,33220000,"chr13",499401,0,2,1,3,"chr13",1,0.00879043600562588
"16498","chr13.48815000.48820000","chr13.48880000.48885000",65000,40,7.043084e-16,48815000,48880000,48820000,48885000,"chr13",499420,0,3,3,6,"chr13",1,0.0281293952180028
"16499","chr13.30905000.30910000","chr13.31190000.31195000",285000,13,0.0001723239,30905000,31190000,30910000,31195000,"chr13",499461,0,0,1,1,"chr13",1,0.00152367557430849
"16500","chr13.42270000.42275000","chr13.42595000.42600000",325000,11,0.00164697,42270000,42595000,42275000,42600000,"chr13",499463,0,1,1,2,"chr13",1,0.00257852789498359
"16501","chr13.80030000.80035000","chr13.80105000.80110000",75000,23,1.349252e-05,80030000,80105000,80035000,80110000,"chr13",499537,0,3,3,6,"chr13",1,0.0161744022503516
"16502","chr13.52010000.52015000","chr13.52345000.52350000",335000,11,0.001423887,52010000,52345000,52015000,52350000,"chr13",499628,3,3,3,9,"chr13",1,0.0116033755274262
"16503","chr13.80570000.80575000","chr13.80895000.80900000",325000,11,0.00164697,80570000,80895000,80575000,80900000,"chr13",499694,1,3,5,9,"chr13",1,0.0116033755274262
"16504","chr13.51475000.51480000","chr13.51630000.51635000",155000,13,0.007480853,51475000,51630000,51480000,51635000,"chr13",499718,4,4,8,16,"chr13",1,0.0243788091889358
"16505","chr13.39345000.39350000","chr13.39385000.39390000",40000,24,0.007199304,39345000,39385000,39350000,39390000,"chr13",499899,0,3,0,3,"chr13",1,0.00843881856540084
"16506","chr13.110885000.110890000","chr13.111065000.111070000",180000,15,0.0002544964,110885000,111065000,110890000,111070000,"chr13",499929,0,0,2,2,"chr13",1,0.00351617440225035
"16507","chr13.77385000.77390000","chr13.77455000.77460000",70000,24,9.416608e-06,77385000,77455000,77390000,77460000,"chr13",499930,1,2,2,5,"chr13",1,0.0140646976090014
"16508","chr13.44755000.44760000","chr13.44965000.44970000",210000,12,0.004799044,44755000,44965000,44760000,44970000,"chr13",500076,1,13,7,21,"chr13",1,0.029535864978903
"16509","chr13.80000000.80005000","chr13.80130000.80135000",130000,19,9.416608e-06,8e+07,80130000,80005000,80135000,"chr13",500182,0,1,2,3,"chr13",1,0.00668073136427567
"16510","chr13.52010000.52015000","chr13.52165000.52170000",155000,13,0.007480853,52010000,52165000,52015000,52170000,"chr13",500263,1,3,3,7,"chr13",1,0.0106657290201594
"16511","chr13.40985000.40990000","chr13.41015000.41020000",30000,31,0.001487628,40985000,41015000,40990000,41020000,"chr13",500304,0,2,1,3,"chr13",1,0.0109001406469761
"16512","chr13.26220000.26225000","chr13.26605000.26610000",385000,10,0.003257862,26220000,26605000,26225000,26610000,"chr13",500353,4,4,1,9,"chr13",1,0.0105485232067511
"16513","chr13.45055000.45060000","chr13.45510000.45515000",455000,13,8.00055e-06,45055000,45510000,45060000,45515000,"chr13",500454,4,4,14,22,"chr13",1,0.0335208626347867
"16514","chr13.45120000.45125000","chr13.45140000.45145000",20000,36,0.004498105,45120000,45140000,45125000,45145000,"chr13",500496,7,6,10,23,"chr13",1,0.0970464135021097
"16515","chr13.45100000.45105000","chr13.45280000.45285000",180000,13,0.003433873,45100000,45280000,45105000,45285000,"chr13",500514,0,7,2,9,"chr13",1,0.0137130801687764
"16516","chr13.41960000.41965000","chr13.42245000.42250000",285000,11,0.003273289,41960000,42245000,41965000,42250000,"chr13",500524,2,6,8,16,"chr13",1,0.0206282231598687
"16517","chr13.96210000.96215000","chr13.96495000.96500000",285000,14,3.360894e-05,96210000,96495000,96215000,96500000,"chr13",500575,0,3,2,5,"chr13",1,0.00820440693858415
"16518","chr13.52570000.52575000","chr13.52775000.52780000",205000,19,1.318447e-07,52570000,52775000,52575000,52780000,"chr13",500617,0,0,2,2,"chr13",1,0.00445382090951711
"16519","chr13.100785000.100790000","chr13.100805000.100810000",20000,40,0.0002696732,100785000,100805000,100790000,100810000,"chr13",500631,2,3,6,11,"chr13",1,0.0515705578996718
"16520","chr13.42040000.42045000","chr13.42135000.42140000",95000,29,4.475953e-11,42040000,42135000,42045000,42140000,"chr13",500727,3,0,2,5,"chr13",1,0.01699484294421
"16521","chr13.40645000.40650000","chr13.41260000.41265000",615000,13,7.542495e-07,40645000,41260000,40650000,41265000,"chr13",500760,2,13,7,22,"chr13",1,0.0335208626347867
"16522","chr13.99085000.99090000","chr13.99310000.99315000",225000,14,0.0002067683,99085000,99310000,99090000,99315000,"chr13",500771,0,1,0,1,"chr13",1,0.00164088138771683
"16523","chr13.31040000.31045000","chr13.31205000.31210000",165000,13,0.005480469,31040000,31205000,31045000,31210000,"chr13",500818,1,9,8,18,"chr13",1,0.0274261603375527
"16524","chr13.33165000.33170000","chr13.33205000.33210000",40000,30,3.105606e-05,33165000,33205000,33170000,33210000,"chr13",500828,1,1,4,6,"chr13",1,0.0210970464135021
"16525","chr13.20210000.20215000","chr13.20440000.20445000",230000,11,0.009973867,20210000,20440000,20215000,20445000,"chr13",500841,0,7,3,10,"chr13",1,0.012892639474918
"16526","chr13.44400000.44405000","chr13.45045000.45050000",645000,9,0.001297929,44400000,45045000,44405000,45050000,"chr13",500876,3,15,15,33,"chr13",1,0.0348101265822785
"16527","chr13.101450000.101455000","chr13.101470000.101475000",20000,50,3.410117e-08,101450000,101470000,101455000,101475000,"chr13",500901,2,5,2,9,"chr13",1,0.0527426160337553
"16528","chr13.43645000.43650000","chr13.44400000.44405000",755000,8,0.003257862,43645000,44400000,43650000,44405000,"chr13",500911,1,1,1,3,"chr13",1,0.00281293952180028
"16529","chr13.48820000.48825000","chr13.49110000.49115000",290000,12,0.0007114209,48820000,49110000,48825000,49115000,"chr13",501013,0,3,2,5,"chr13",1,0.0070323488045007
"16530","chr13.21145000.21150000","chr13.21405000.21410000",260000,12,0.001390094,21145000,21405000,21150000,21410000,"chr13",501018,0,5,3,8,"chr13",1,0.0112517580872011
"16531","chr13.26725000.26730000","chr13.27035000.27040000",310000,10,0.008105067,26725000,27035000,26730000,27040000,"chr13",501023,1,1,0,2,"chr13",1,0.0023441162681669
"16532","chr13.45340000.45345000","chr13.45465000.45470000",125000,16,0.0007269117,45340000,45465000,45345000,45470000,"chr13",501082,2,6,3,11,"chr13",1,0.0206282231598687
"16533","chr13.51210000.51215000","chr13.51395000.51400000",185000,14,0.0008047032,51210000,51395000,51215000,51400000,"chr13",501189,0,7,5,12,"chr13",1,0.019690576652602
"16534","chr13.43820000.43825000","chr13.44050000.44055000",230000,11,0.009973867,43820000,44050000,43825000,44055000,"chr13",501212,0,3,3,6,"chr13",1,0.00773558368495077
"16535","chr13.98670000.98675000","chr13.99305000.99310000",635000,8,0.006994897,98670000,99305000,98675000,99310000,"chr13",501265,3,5,7,15,"chr13",1,0.0140646976090014
"16536","chr13.30890000.30895000","chr13.30970000.30975000",80000,20,0.0002618107,30890000,30970000,30895000,30975000,"chr13",501395,0,3,2,5,"chr13",1,0.0117205813408345
"16537","chr13.30430000.30435000","chr13.30675000.30680000",245000,11,0.007162995,30430000,30675000,30435000,30680000,"chr13",501579,6,11,12,29,"chr13",1,0.0373886544772621
"16538","chr13.45055000.45060000","chr13.45475000.45480000",420000,15,2.919282e-07,45055000,45475000,45060000,45480000,"chr13",501598,5,5,9,19,"chr13",1,0.0334036568213783
"16539","chr13.97855000.97860000","chr13.98005000.98010000",150000,13,0.00883829,97855000,98005000,97860000,98010000,"chr13",501629,3,8,11,22,"chr13",1,0.0335208626347867
"16540","chr13.51260000.51265000","chr13.51330000.51335000",70000,19,0.002710671,51260000,51330000,51265000,51335000,"chr13",501689,4,10,4,18,"chr13",1,0.040084388185654
"16541","chr13.31020000.31025000","chr13.31210000.31215000",190000,12,0.008301911,31020000,31210000,31025000,31215000,"chr13",501745,0,12,11,23,"chr13",1,0.0323488045007032
"16542","chr13.21525000.21530000","chr13.21635000.21640000",110000,16,0.001693788,21525000,21635000,21530000,21640000,"chr13",501865,1,0,4,5,"chr13",1,0.00937646507266761
"16543","chr13.51730000.51735000","chr13.51785000.51790000",55000,21,0.004367354,51730000,51785000,51735000,51790000,"chr13",501872,0,2,0,2,"chr13",1,0.00492264416315049
"16544","chr13.80255000.80260000","chr13.80920000.80925000",665000,8,0.00572994,80255000,80920000,80260000,80925000,"chr13",501902,0,1,3,4,"chr13",1,0.00375058602906704
"16545","chr13.97910000.97915000","chr13.98005000.98010000",95000,23,6.788033e-07,97910000,98005000,97915000,98010000,"chr13",501933,0,2,5,7,"chr13",1,0.0188701359587436
"16546","chr13.21600000.21605000","chr13.21635000.21640000",35000,27,0.003451473,21600000,21635000,21605000,21640000,"chr13",502009,0,4,4,8,"chr13",1,0.0253164556962025
"16547","chr13.23360000.23365000","chr13.24075000.24080000",715000,8,0.004178475,23360000,24075000,23365000,24080000,"chr13",502134,0,2,8,10,"chr13",1,0.00937646507266761
"16548","chr13.52570000.52575000","chr13.52765000.52770000",195000,26,3.015383e-13,52570000,52765000,52575000,52770000,"chr13",502164,4,8,9,21,"chr13",1,0.0639943741209564
"16549","chr13.21060000.21065000","chr13.21405000.21410000",345000,12,0.0002614425,21060000,21405000,21065000,21410000,"chr13",502199,0,5,3,8,"chr13",1,0.0112517580872011
"16550","chr13.50765000.50770000","chr13.51630000.51635000",865000,7,0.008937232,50765000,51630000,50770000,51635000,"chr13",502235,0,3,2,5,"chr13",1,0.00410220346929208
"16551","chr13.30805000.30810000","chr13.30845000.30850000",40000,25,0.003302617,30805000,30845000,30810000,30850000,"chr13",502256,2,7,4,13,"chr13",1,0.0380918893577121
"16552","chr13.30340000.30345000","chr13.30675000.30680000",335000,11,0.001423887,30340000,30675000,30345000,30680000,"chr13",502342,3,5,3,11,"chr13",1,0.0141819034224098
"16553","chr13.26705000.26710000","chr13.27360000.27365000",655000,8,0.006150144,26705000,27360000,26710000,27365000,"chr13",502438,0,4,3,7,"chr13",1,0.00656352555086732
"16554","chr13.25660000.25665000","chr13.25945000.25950000",285000,11,0.003273289,25660000,25945000,25665000,25950000,"chr13",502463,0,4,2,6,"chr13",1,0.00773558368495077
"16555","chr13.77040000.77045000","chr13.77475000.77480000",435000,11,0.0003737283,77040000,77475000,77045000,77480000,"chr13",502536,2,4,4,10,"chr13",1,0.012892639474918
"16556","chr13.45595000.45600000","chr13.45860000.45865000",265000,16,1.968351e-06,45595000,45860000,45600000,45865000,"chr13",502548,2,4,1,7,"chr13",1,0.0131270511017346
"16557","chr13.44520000.44525000","chr13.45090000.45095000",570000,12,1.078668e-05,44520000,45090000,44525000,45095000,"chr13",502566,0,2,1,3,"chr13",1,0.00421940928270042
"16558","chr13.76610000.76615000","chr13.77025000.77030000",415000,9,0.009623856,76610000,77025000,76615000,77030000,"chr13",502651,0,3,3,6,"chr13",1,0.00632911392405063
"16559","chr13.21420000.21425000","chr13.21440000.21445000",20000,41,0.0001236192,21420000,21440000,21425000,21445000,"chr13",502722,0,6,5,11,"chr13",1,0.0528598218471636
"16560","chr13.99085000.99090000","chr13.99305000.99310000",220000,12,0.003738633,99085000,99305000,99090000,99310000,"chr13",502845,0,4,0,4,"chr13",1,0.00562587904360056
"16561","chr13.39260000.39265000","chr13.39450000.39455000",190000,16,3.857144e-05,39260000,39450000,39265000,39455000,"chr13",502881,0,0,2,2,"chr13",1,0.00375058602906704
"16562","chr13.99915000.99920000","chr13.100085000.100090000",170000,13,0.004673452,99915000,100085000,99920000,100090000,"chr13",502900,2,15,17,34,"chr13",1,0.0518049695264885
"16563","chr13.52405000.52410000","chr13.52765000.52770000",360000,14,6.237582e-06,52405000,52765000,52410000,52770000,"chr13",502913,6,8,10,24,"chr13",1,0.0393811533052039
"16564","chr13.40640000.40645000","chr13.41260000.41265000",620000,16,7.865452e-10,40640000,41260000,40645000,41265000,"chr13",502983,2,9,2,13,"chr13",1,0.0243788091889358
"16565","chr13.43805000.43810000","chr13.43830000.43835000",25000,34,0.003198946,43805000,43830000,43810000,43835000,"chr13",503047,0,2,3,5,"chr13",1,0.0199249882794187
"16566","chr13.20770000.20775000","chr13.21435000.21440000",665000,13,3.924827e-07,20770000,21435000,20775000,21440000,"chr13",503059,2,2,6,10,"chr13",1,0.0152367557430849
"16567","chr13.101300000.101305000","chr13.101765000.101770000",465000,9,0.006097803,101300000,101765000,101305000,101770000,"chr13",503144,0,2,1,3,"chr13",1,0.00316455696202532
"16568","chr13.110885000.110890000","chr13.111035000.111040000",150000,14,0.002888673,110885000,111035000,110890000,111040000,"chr13",503158,0,2,2,4,"chr13",1,0.00656352555086732
"16569","chr13.51725000.51730000","chr13.51790000.51795000",65000,27,5.76258e-07,51725000,51790000,51730000,51795000,"chr13",503237,0,3,2,5,"chr13",1,0.0158227848101266
"16570","chr13.80000000.80005000","chr13.80045000.80050000",45000,25,0.0008733208,8e+07,80045000,80005000,80050000,"chr13",503261,0,3,2,5,"chr13",1,0.0146507266760431
"16571","chr13.80570000.80575000","chr13.80920000.80925000",350000,10,0.004791123,80570000,80920000,80575000,80925000,"chr13",503270,0,1,3,4,"chr13",1,0.0046882325363338
"16572","chr13.45045000.45050000","chr13.45525000.45530000",480000,20,9.850547e-13,45045000,45525000,45050000,45530000,"chr13",503293,1,1,0,2,"chr13",1,0.0046882325363338
"16573","chr13.29140000.29145000","chr13.29160000.29165000",20000,39,0.0005749349,29140000,29160000,29145000,29165000,"chr13",503327,0,0,4,4,"chr13",1,0.0182841068917018
"16574","chr13.26550000.26555000","chr13.26610000.26615000",60000,27,2.112979e-06,26550000,26610000,26555000,26615000,"chr13",503390,2,0,7,9,"chr13",1,0.0284810126582278
"16575","chr13.52695000.52700000","chr13.52785000.52790000",90000,21,2.130287e-05,52695000,52785000,52700000,52790000,"chr13",503419,0,2,1,3,"chr13",1,0.00738396624472574
"16576","chr13.49975000.49980000","chr13.49995000.50000000",20000,41,0.0001236192,49975000,49995000,49980000,5e+07,"chr13",503472,3,8,4,15,"chr13",1,0.0720815752461322
"16577","chr13.26755000.26760000","chr13.27280000.27285000",525000,10,0.0007131859,26755000,27280000,26760000,27285000,"chr13",503478,0,2,4,6,"chr13",1,0.0070323488045007
"16578","chr13.99555000.99560000","chr13.99575000.99580000",20000,40,0.0002696732,99555000,99575000,99560000,99580000,"chr13",503527,4,9,6,19,"chr13",1,0.0890764181903422
"16579","chr13.33165000.33170000","chr13.33675000.33680000",510000,9,0.004076385,33165000,33675000,33170000,33680000,"chr13",503645,1,1,0,2,"chr13",1,0.00210970464135021
"16580","chr13.51210000.51215000","chr13.51310000.51315000",100000,15,0.009219608,51210000,51310000,51215000,51315000,"chr13",503743,0,7,5,12,"chr13",1,0.0210970464135021
"16581","chr13.30890000.30895000","chr13.30905000.30910000",15000,41,0.0001236192,30890000,30905000,30895000,30910000,"chr13",503781,1,0,1,2,"chr13",1,0.00961087669948429
"16582","chr13.40245000.40250000","chr13.40985000.40990000",740000,8,0.00355171,40245000,40985000,40250000,40990000,"chr13",503818,0,0,4,4,"chr13",1,0.00375058602906704
"16583","chr13.31195000.31200000","chr13.31235000.31240000",40000,34,3.686083e-07,31195000,31235000,31200000,31240000,"chr13",503891,0,4,2,6,"chr13",1,0.0239099859353024
"16584","chr13.27280000.27285000","chr13.27500000.27505000",220000,47,1.621367e-37,27280000,27500000,27285000,27505000,"chr13",503910,0,5,4,9,"chr13",1,0.04957805907173
"16585","chr13.41960000.41965000","chr13.42650000.42655000",690000,12,2.523038e-06,41960000,42650000,41965000,42655000,"chr13",504051,2,0,1,3,"chr13",1,0.00421940928270042
"16586","chr13.48750000.48755000","chr13.48815000.48820000",65000,23,8.404463e-05,48750000,48815000,48755000,48820000,"chr13",504052,0,2,2,4,"chr13",1,0.0107829348335677
"16587","chr13.30845000.30850000","chr13.30905000.30910000",60000,25,2.466582e-05,30845000,30905000,30850000,30910000,"chr13",504116,1,0,1,2,"chr13",1,0.00586029067041725
"16588","chr13.33155000.33160000","chr13.33590000.33595000",435000,11,0.0003737283,33155000,33590000,33160000,33595000,"chr13",504158,0,1,1,2,"chr13",1,0.00257852789498359
"16589","chr13.43640000.43645000","chr13.44380000.44385000",740000,8,0.00355171,43640000,44380000,43645000,44385000,"chr13",504192,1,0,7,8,"chr13",1,0.00750117205813408
"16590","chr13.26705000.26710000","chr13.26725000.26730000",20000,35,0.008327471,26705000,26725000,26710000,26730000,"chr13",504283,0,4,3,7,"chr13",1,0.0287154242850445
"16591","chr13.24175000.24180000","chr13.24205000.24210000",30000,32,0.0006755212,24175000,24205000,24180000,24210000,"chr13",504371,0,2,2,4,"chr13",1,0.0150023441162682
"16592","chr13.51790000.51795000","chr13.52775000.52780000",985000,7,0.004525834,51790000,52775000,51795000,52780000,"chr13",504432,0,0,2,2,"chr13",1,0.00164088138771683
"16593","chr13.21060000.21065000","chr13.21430000.21435000",370000,11,0.0008598866,21060000,21430000,21065000,21435000,"chr13",504515,4,13,8,25,"chr13",1,0.0322315986872949
"16594","chr13.20565000.20570000","chr13.20635000.20640000",70000,19,0.002710671,20565000,20635000,20570000,20640000,"chr13",504534,0,3,2,5,"chr13",1,0.0111345522737928
"16595","chr13.52785000.52790000","chr13.53020000.53025000",235000,15,3.094447e-05,52785000,53020000,52790000,53025000,"chr13",504555,0,0,1,1,"chr13",1,0.00175808720112518
"16596","chr13.30355000.30360000","chr13.30405000.30410000",50000,30,9.917777e-07,30355000,30405000,30360000,30410000,"chr13",504769,1,8,7,16,"chr13",1,0.0562587904360056
"16597","chr13.31040000.31045000","chr13.31190000.31195000",150000,25,9.431915e-11,31040000,31190000,31045000,31195000,"chr13",504907,0,4,4,8,"chr13",1,0.023441162681669
"16598","chr13.33165000.33170000","chr13.33200000.33205000",35000,36,6.307407e-07,33165000,33200000,33170000,33205000,"chr13",505069,1,0,4,5,"chr13",1,0.0210970464135021
"16599","chr13.30740000.30745000","chr13.30905000.30910000",165000,13,0.005480469,30740000,30905000,30745000,30910000,"chr13",505078,1,0,1,2,"chr13",1,0.00304735114861697
"16600","chr13.20590000.20595000","chr13.20660000.20665000",70000,19,0.002710671,20590000,20660000,20595000,20665000,"chr13",505084,0,3,2,5,"chr13",1,0.0111345522737928
"16601","chr13.51800000.51805000","chr13.51860000.51865000",60000,31,1.006948e-08,51800000,51860000,51805000,51865000,"chr13",505114,0,2,1,3,"chr13",1,0.0109001406469761
"16602","chr13.101365000.101370000","chr13.101755000.101760000",390000,12,0.0001299797,101365000,101755000,101370000,101760000,"chr13",505211,0,3,0,3,"chr13",1,0.00421940928270042
"16603","chr13.31190000.31195000","chr13.31245000.31250000",55000,22,0.001748236,31190000,31245000,31195000,31250000,"chr13",505258,0,3,2,5,"chr13",1,0.012892639474918
"16604","chr13.46720000.46725000","chr13.46890000.46895000",170000,18,4.495e-06,46720000,46890000,46725000,46895000,"chr13",505289,0,2,3,5,"chr13",1,0.0105485232067511
"16605","chr13.24005000.24010000","chr13.24040000.24045000",35000,32,4.184865e-05,24005000,24040000,24010000,24045000,"chr13",505336,0,2,0,2,"chr13",1,0.00750117205813408
"16606","chr13.31205000.31210000","chr13.31235000.31240000",30000,37,7.324602e-06,31205000,31235000,31210000,31240000,"chr13",505382,1,9,13,23,"chr13",1,0.0997421472105016
"16607","chr13.77570000.77575000","chr13.77595000.77600000",25000,40,2.826469e-05,77570000,77595000,77575000,77600000,"chr13",505443,1,8,13,22,"chr13",1,0.103141115799344
"16608","chr13.51730000.51735000","chr13.51860000.51865000",130000,19,9.416608e-06,51730000,51860000,51735000,51865000,"chr13",505464,0,3,4,7,"chr13",1,0.0155883731833099
"16609","chr13.31035000.31040000","chr13.31190000.31195000",155000,19,2.112979e-06,31035000,31190000,31040000,31195000,"chr13",505526,0,2,1,3,"chr13",1,0.00668073136427567
"16610","chr13.20355000.20360000","chr13.20435000.20440000",80000,21,7.884935e-05,20355000,20435000,20360000,20440000,"chr13",505617,2,5,4,11,"chr13",1,0.0270745428973277
"16611","chr13.100655000.100660000","chr13.101300000.101305000",645000,9,0.001297929,100655000,101300000,100660000,101305000,"chr13",505619,4,3,2,9,"chr13",1,0.00949367088607595
"16612","chr13.26755000.26760000","chr13.27425000.27430000",670000,8,0.005509245,26755000,27425000,26760000,27430000,"chr13",505749,1,2,3,6,"chr13",1,0.00562587904360056
"16613","chr13.80050000.80055000","chr13.80105000.80110000",55000,34,8.226485e-10,80050000,80105000,80055000,80110000,"chr13",505767,2,8,3,13,"chr13",1,0.0518049695264885
"16614","chr13.40665000.40670000","chr13.40790000.40795000",125000,15,0.002386702,40665000,40790000,40670000,40795000,"chr13",505837,0,0,3,3,"chr13",1,0.00527426160337553
"16615","chr13.27335000.27340000","chr13.27450000.27455000",115000,16,0.001259352,27335000,27450000,27340000,27455000,"chr13",505838,1,6,2,9,"chr13",1,0.0168776371308017
"16616","chr13.30355000.30360000","chr13.30640000.30645000",285000,11,0.003273289,30355000,30640000,30360000,30645000,"chr13",505906,1,8,12,21,"chr13",1,0.0270745428973277
"16617","chr13.45115000.45120000","chr13.45510000.45515000",395000,14,3.262021e-06,45115000,45510000,45120000,45515000,"chr13",505913,4,4,14,22,"chr13",1,0.0360993905297703
"16618","chr13.21145000.21150000","chr13.21175000.21180000",30000,36,1.919708e-05,21145000,21175000,21150000,21180000,"chr13",505944,0,12,6,18,"chr13",1,0.0759493670886076
"16619","chr13.100655000.100660000","chr13.100805000.100810000",150000,13,0.00883829,100655000,100805000,100660000,100810000,"chr13",506037,2,3,2,7,"chr13",1,0.0106657290201594
"16620","chr13.77570000.77575000","chr13.77590000.77595000",20000,38,0.001173859,77570000,77590000,77575000,77595000,"chr13",506150,1,3,1,5,"chr13",1,0.0222691045475856
"16621","chr13.40665000.40670000","chr13.40785000.40790000",120000,14,0.008856388,40665000,40785000,40670000,40790000,"chr13",506167,0,0,5,5,"chr13",1,0.00820440693858415
"16622","chr13.77565000.77570000","chr13.77595000.77600000",30000,49,7.343708e-12,77565000,77595000,77570000,77600000,"chr13",506209,0,3,4,7,"chr13",1,0.0402015939990624
"16623","chr13.76435000.76440000","chr13.77040000.77045000",605000,16,1.018818e-09,76435000,77040000,76440000,77045000,"chr13",506429,1,0,4,5,"chr13",1,0.00937646507266761
"16624","chr13.30420000.30425000","chr13.30640000.30645000",220000,14,0.0002450198,30420000,30640000,30425000,30645000,"chr13",506476,1,2,2,5,"chr13",1,0.00820440693858415
"16625","chr13.33105000.33110000","chr13.33155000.33160000",50000,26,9.70389e-05,33105000,33155000,33110000,33160000,"chr13",506542,0,1,1,2,"chr13",1,0.00609470229723394
"16626","chr13.50730000.50735000","chr13.51285000.51290000",555000,9,0.002745497,50730000,51285000,50735000,51290000,"chr13",506560,0,1,1,2,"chr13",1,0.00210970464135021
"16627","chr13.51800000.51805000","chr13.51895000.51900000",95000,16,0.004751805,51800000,51895000,51805000,51900000,"chr13",506594,0,2,1,3,"chr13",1,0.00562587904360056
"16628","chr13.46080000.46085000","chr13.46690000.46695000",610000,8,0.008301911,46080000,46690000,46085000,46695000,"chr13",506610,0,3,4,7,"chr13",1,0.00656352555086732
"16629","chr13.20770000.20775000","chr13.21475000.21480000",705000,9,0.0008018354,20770000,21475000,20775000,21480000,"chr13",506800,1,8,7,16,"chr13",1,0.0168776371308017
"16630","chr13.35870000.35875000","chr13.36345000.36350000",475000,10,0.001209969,35870000,36345000,35875000,36350000,"chr13",506817,1,8,7,16,"chr13",1,0.0187529301453352
"16631","chr13.77565000.77570000","chr13.77590000.77595000",25000,33,0.006163333,77565000,77590000,77570000,77595000,"chr13",506853,0,3,1,4,"chr13",1,0.0154711673699015
"16632","chr13.46080000.46085000","chr13.46890000.46895000",810000,8,0.002311547,46080000,46890000,46085000,46895000,"chr13",506936,0,2,3,5,"chr13",1,0.0046882325363338
"16633","chr13.77280000.77285000","chr13.77385000.77390000",105000,15,0.006800872,77280000,77385000,77285000,77390000,"chr13",506956,1,2,4,7,"chr13",1,0.0123066104078762
"16634","chr13.52570000.52575000","chr13.52695000.52700000",125000,22,1.31405e-07,52570000,52695000,52575000,52700000,"chr13",507166,4,9,9,22,"chr13",1,0.056727613689639
"16635","chr13.46890000.46895000","chr13.46910000.46915000",20000,38,0.001173859,46890000,46910000,46895000,46915000,"chr13",507214,0,2,3,5,"chr13",1,0.0222691045475856
"16636","chr13.40785000.40790000","chr13.41190000.41195000",405000,13,1.767017e-05,40785000,41190000,40790000,41195000,"chr13",507273,3,2,5,10,"chr13",1,0.0152367557430849
"16637","chr13.21060000.21065000","chr13.21440000.21445000",380000,14,4.240439e-06,21060000,21440000,21065000,21445000,"chr13",507320,1,9,8,18,"chr13",1,0.029535864978903
"16638","chr13.52570000.52575000","chr13.52785000.52790000",215000,19,7.823639e-08,52570000,52785000,52575000,52790000,"chr13",507332,0,2,1,3,"chr13",1,0.00668073136427567
"16639","chr13.99100000.99105000","chr13.99305000.99310000",205000,20,2.159223e-08,99100000,99305000,99105000,99310000,"chr13",507374,3,5,7,15,"chr13",1,0.0351617440225035
"16640","chr13.30165000.30170000","chr13.30420000.30425000",255000,11,0.005814558,30165000,30420000,30170000,30425000,"chr13",507456,0,2,2,4,"chr13",1,0.00515705578996718
"16641","chr13.47065000.47070000","chr13.47255000.47260000",190000,19,2.968726e-07,47065000,47255000,47070000,47260000,"chr13",507520,0,1,1,2,"chr13",1,0.00445382090951711
"16642","chr13.77385000.77390000","chr13.77475000.77480000",90000,22,5.509535e-06,77385000,77475000,77390000,77480000,"chr13",507545,1,4,4,9,"chr13",1,0.0232067510548523
"16643","chr13.52185000.52190000","chr13.52235000.52240000",50000,24,0.0007269117,52185000,52235000,52190000,52240000,"chr13",507560,3,8,8,19,"chr13",1,0.0534458509142053
"16644","chr13.33715000.33720000","chr13.34290000.34295000",575000,10,0.0004307257,33715000,34290000,33720000,34295000,"chr13",507615,0,0,1,1,"chr13",1,0.00117205813408345
"16645","chr13.73540000.73545000","chr13.74290000.74295000",750000,10,8.580449e-05,73540000,74290000,73545000,74295000,"chr13",507619,0,3,2,5,"chr13",1,0.00586029067041725
"16646","chr13.27445000.27450000","chr13.27500000.27505000",55000,23,0.0006755212,27445000,27500000,27450000,27505000,"chr13",507639,0,7,4,11,"chr13",1,0.0296530707923113
"16647","chr13.27335000.27340000","chr13.27500000.27505000",165000,15,0.0004606705,27335000,27500000,27340000,27505000,"chr13",507679,0,8,4,12,"chr13",1,0.0210970464135021
"16648","chr13.20355000.20360000","chr13.20440000.20445000",85000,21,4.031878e-05,20355000,20440000,20360000,20445000,"chr13",507921,1,5,3,9,"chr13",1,0.0221518987341772
"16649","chr13.99585000.99590000","chr13.99615000.99620000",30000,36,1.919708e-05,99585000,99615000,99590000,99620000,"chr13",507928,2,17,10,29,"chr13",1,0.122362869198312
"16650","chr13.110580000.110585000","chr13.110615000.110620000",35000,27,0.003451473,110580000,110615000,110585000,110620000,"chr13",507983,2,1,3,6,"chr13",1,0.0189873417721519
"16651","chr13.46890000.46895000","chr13.46950000.46955000",60000,20,0.004524474,46890000,46950000,46895000,46955000,"chr13",507987,0,2,2,4,"chr13",1,0.00937646507266761
"16652","chr13.51800000.51805000","chr13.51830000.51835000",30000,31,0.001487628,51800000,51830000,51805000,51835000,"chr13",508217,0,2,1,3,"chr13",1,0.0109001406469761
"16653","chr13.97910000.97915000","chr13.97930000.97935000",20000,46,1.644914e-06,97910000,97930000,97915000,97935000,"chr13",508219,0,2,1,3,"chr13",1,0.0161744022503516
"16654","chr13.47215000.47220000","chr13.47255000.47260000",40000,24,0.007199304,47215000,47255000,47220000,47260000,"chr13",508231,1,1,3,5,"chr13",1,0.0140646976090014
"16655","chr13.50765000.50770000","chr13.51675000.51680000",910000,7,0.007051853,50765000,51675000,50770000,51680000,"chr13",508235,0,3,2,5,"chr13",1,0.00410220346929208
"16656","chr13.100585000.100590000","chr13.101365000.101370000",780000,8,0.002773952,100585000,101365000,100590000,101370000,"chr13",508336,0,3,0,3,"chr13",1,0.00281293952180028
"16657","chr13.45100000.45105000","chr13.45140000.45145000",40000,30,3.105606e-05,45100000,45140000,45105000,45145000,"chr13",508388,3,6,10,19,"chr13",1,0.0668073136427567
"16658","chr13.52740000.52745000","chr13.52765000.52770000",25000,48,1.086967e-08,52740000,52765000,52745000,52770000,"chr13",508460,2,4,5,11,"chr13",1,0.0618846694796062
"16659","chr13.40640000.40645000","chr13.41220000.41225000",580000,11,6.652359e-05,40640000,41220000,40645000,41225000,"chr13",508521,0,3,2,5,"chr13",1,0.00644631973745898
"16660","chr13.51730000.51735000","chr13.51790000.51795000",60000,22,0.0006755212,51730000,51790000,51735000,51795000,"chr13",508558,0,3,2,5,"chr13",1,0.012892639474918
"16661","chr13.30165000.30170000","chr13.30340000.30345000",175000,17,1.653007e-05,30165000,30340000,30170000,30345000,"chr13",508603,0,2,2,4,"chr13",1,0.00796999531176746
"16662","chr13.30845000.30850000","chr13.31020000.31025000",175000,14,0.001168754,30845000,31020000,30850000,31025000,"chr13",508658,0,7,4,11,"chr13",1,0.0180496952648851
"16663","chr13.80235000.80240000","chr13.80895000.80900000",660000,9,0.00115571,80235000,80895000,80240000,80900000,"chr13",508719,1,6,4,11,"chr13",1,0.0116033755274262
"16664","chr13.21510000.21515000","chr13.21635000.21640000",125000,17,0.0002063554,21510000,21635000,21515000,21640000,"chr13",508736,1,3,4,8,"chr13",1,0.0159399906235349
"16665","chr13.45660000.45665000","chr13.45745000.45750000",85000,22,1.088549e-05,45660000,45745000,45665000,45750000,"chr13",508759,0,2,1,3,"chr13",1,0.00773558368495077
"16666","chr13.111245000.111250000","chr13.111460000.111465000",215000,12,0.004280643,111245000,111460000,111250000,111465000,"chr13",508795,1,3,2,6,"chr13",1,0.00843881856540084
"16667","chr13.40785000.40790000","chr13.41015000.41020000",230000,13,0.0007389143,40785000,41015000,40790000,41020000,"chr13",508814,1,2,1,4,"chr13",1,0.00609470229723394
"16668","chr13.25150000.25155000","chr13.25245000.25250000",95000,19,0.0001578639,25150000,25245000,25155000,25250000,"chr13",508822,1,0,0,1,"chr13",1,0.00222691045475856
"16669","chr13.77025000.77030000","chr13.77465000.77470000",440000,10,0.001758818,77025000,77465000,77030000,77470000,"chr13",508834,2,3,5,10,"chr13",1,0.0117205813408345
"16670","chr13.25660000.25665000","chr13.25755000.25760000",95000,23,6.788033e-07,25660000,25755000,25665000,25760000,"chr13",508882,1,4,8,13,"chr13",1,0.0350445382090952
"16671","chr13.51870000.51875000","chr13.52765000.52770000",895000,8,0.001350271,51870000,52765000,51875000,52770000,"chr13",508906,0,0,6,6,"chr13",1,0.00562587904360056
"16672","chr13.23375000.23380000","chr13.23885000.23890000",510000,9,0.004076385,23375000,23885000,23380000,23890000,"chr13",508942,1,0,3,4,"chr13",1,0.00421940928270042
"16673","chr13.80235000.80240000","chr13.80945000.80950000",710000,9,0.0007703221,80235000,80945000,80240000,80950000,"chr13",508944,0,3,2,5,"chr13",1,0.00527426160337553
"16674","chr13.97910000.97915000","chr13.98020000.98025000",110000,16,0.001693788,97910000,98020000,97915000,98025000,"chr13",509022,0,2,3,5,"chr13",1,0.00937646507266761
"16675","chr13.80620000.80625000","chr13.80920000.80925000",300000,15,3.961841e-06,80620000,80920000,80625000,80925000,"chr13",509080,0,1,3,4,"chr13",1,0.0070323488045007
"16676","chr13.28865000.28870000","chr13.29365000.29370000",500000,9,0.00446687,28865000,29365000,28870000,29370000,"chr13",509120,0,0,2,2,"chr13",1,0.00210970464135021
"16677","chr13.24050000.24055000","chr13.24075000.24080000",25000,33,0.006163333,24050000,24075000,24055000,24080000,"chr13",509126,0,2,4,6,"chr13",1,0.0232067510548523
"16678","chr13.51285000.51290000","chr13.51310000.51315000",25000,36,0.0007435594,51285000,51310000,51290000,51315000,"chr13",509162,0,7,8,15,"chr13",1,0.0632911392405063
"16679","chr13.20770000.20775000","chr13.21440000.21445000",670000,8,0.005509245,20770000,21440000,20775000,21445000,"chr13",509178,1,8,7,16,"chr13",1,0.0150023441162682
"16680","chr13.24185000.24190000","chr13.24215000.24220000",30000,33,0.0002869421,24185000,24215000,24190000,24220000,"chr13",509277,0,2,3,5,"chr13",1,0.0193389592123769
"16681","chr13.45090000.45095000","chr13.45115000.45120000",25000,49,3.614358e-09,45090000,45115000,45095000,45120000,"chr13",509300,4,13,12,29,"chr13",1,0.166549460853258
"16682","chr13.52165000.52170000","chr13.52185000.52190000",20000,55,1.600806e-10,52165000,52185000,52170000,52190000,"chr13",509351,1,8,9,18,"chr13",1,0.116033755274262
"16683","chr13.80045000.80050000","chr13.80105000.80110000",60000,21,0.001787903,80045000,80105000,80050000,80110000,"chr13",509378,4,12,17,33,"chr13",1,0.0812236286919831
"16684","chr13.31035000.31040000","chr13.31195000.31200000",160000,14,0.00199506,31035000,31195000,31040000,31200000,"chr13",509405,0,2,1,3,"chr13",1,0.00492264416315049
"16685","chr13.45045000.45050000","chr13.45460000.45465000",415000,18,5.515944e-10,45045000,45460000,45050000,45465000,"chr13",509413,3,7,11,21,"chr13",1,0.0443037974683544
"16686","chr13.31205000.31210000","chr13.31245000.31250000",40000,26,0.00142612,31205000,31245000,31210000,31250000,"chr13",509510,0,3,2,5,"chr13",1,0.0152367557430849
"16687","chr13.31050000.31055000","chr13.31170000.31175000",120000,15,0.003061984,31050000,31170000,31055000,31175000,"chr13",509599,2,1,1,4,"chr13",1,0.0070323488045007
"16688","chr13.33205000.33210000","chr13.34175000.34180000",970000,7,0.004992662,33205000,34175000,33210000,34180000,"chr13",509659,2,0,1,3,"chr13",1,0.00246132208157525
"16689","chr13.97930000.97935000","chr13.98005000.98010000",75000,25,9.591664e-07,97930000,98005000,97935000,98010000,"chr13",509669,0,3,1,4,"chr13",1,0.0117205813408345
"16690","chr13.110005000.110010000","chr13.110440000.110445000",435000,13,1.086904e-05,110005000,110440000,110010000,110445000,"chr13",509689,0,3,1,4,"chr13",1,0.00609470229723394
"16691","chr13.40770000.40775000","chr13.41220000.41225000",450000,11,0.0003098994,40770000,41220000,40775000,41225000,"chr13",509792,0,3,7,10,"chr13",1,0.012892639474918
"16692","chr13.80010000.80015000","chr13.80105000.80110000",95000,28,2.512984e-10,80010000,80105000,80015000,80110000,"chr13",509826,1,1,0,2,"chr13",1,0.00656352555086732
"16693","chr13.51790000.51795000","chr13.51830000.51835000",40000,26,0.00142612,51790000,51830000,51795000,51835000,"chr13",509886,0,3,2,5,"chr13",1,0.0152367557430849
"16694","chr13.43555000.43560000","chr13.43575000.43580000",20000,39,0.0005749349,43555000,43575000,43560000,43580000,"chr13",509924,1,1,2,4,"chr13",1,0.0182841068917018
"16695","chr13.42035000.42040000","chr13.42130000.42135000",95000,17,0.001649295,42035000,42130000,42040000,42135000,"chr13",509930,2,2,1,5,"chr13",1,0.00996249413970933
"16696","chr13.45045000.45050000","chr13.45835000.45840000",790000,8,0.002595338,45045000,45835000,45050000,45840000,"chr13",509945,0,2,2,4,"chr13",1,0.00375058602906704
"16697","chr13.20770000.20775000","chr13.21060000.21065000",290000,13,0.000153479,20770000,21060000,20775000,21065000,"chr13",510038,4,8,7,19,"chr13",1,0.0289498359118612
"16698","chr13.23960000.23965000","chr13.24005000.24010000",45000,29,1.517236e-05,23960000,24005000,23965000,24010000,"chr13",510051,0,2,0,2,"chr13",1,0.00679793717768401
"16699","chr13.26550000.26555000","chr13.26615000.26620000",65000,20,0.002062159,26550000,26615000,26555000,26620000,"chr13",510085,0,0,1,1,"chr13",1,0.0023441162681669
"16700","chr13.45045000.45050000","chr13.45465000.45470000",420000,12,8.416952e-05,45045000,45465000,45050000,45470000,"chr13",510149,2,6,3,11,"chr13",1,0.0154711673699015
"16701","chr13.45140000.45145000","chr13.45475000.45480000",335000,10,0.005813995,45140000,45475000,45145000,45480000,"chr13",510172,5,5,9,19,"chr13",1,0.0222691045475856
"16702","chr13.51725000.51730000","chr13.51860000.51865000",135000,23,1.117298e-08,51725000,51860000,51730000,51865000,"chr13",510178,4,3,3,10,"chr13",1,0.0269573370839194
"16703","chr13.106090000.106095000","chr13.106150000.106155000",60000,23,0.0002375925,106090000,106150000,106095000,106155000,"chr13",510281,1,3,1,5,"chr13",1,0.0134786685419597
"16704","chr13.40770000.40775000","chr13.40920000.40925000",150000,14,0.002888673,40770000,40920000,40775000,40925000,"chr13",510305,1,6,1,8,"chr13",1,0.0131270511017346
"16705","chr13.43875000.43880000","chr13.44380000.44385000",505000,9,0.004280643,43875000,44380000,43880000,44385000,"chr13",510307,0,5,2,7,"chr13",1,0.00738396624472574
"16706","chr13.49665000.49670000","chr13.49845000.49850000",180000,14,0.0009722793,49665000,49845000,49670000,49850000,"chr13",510368,5,20,18,43,"chr13",1,0.0705578996718237
"16707","chr13.24175000.24180000","chr13.24225000.24230000",50000,24,0.0007269117,24175000,24225000,24180000,24230000,"chr13",510392,2,7,2,11,"chr13",1,0.0309423347398031
"16708","chr13.20210000.20215000","chr13.20435000.20440000",225000,13,0.0008515941,20210000,20435000,20215000,20440000,"chr13",510617,0,7,8,15,"chr13",1,0.0228551336146273
"16709","chr13.39615000.39620000","chr13.40245000.40250000",630000,17,5.791436e-11,39615000,40245000,39620000,40250000,"chr13",510694,1,0,4,5,"chr13",1,0.00996249413970933
"16710","chr13.30430000.30435000","chr13.30670000.30675000",240000,14,0.0001261405,30430000,30670000,30435000,30675000,"chr13",510695,0,4,4,8,"chr13",1,0.0131270511017346
"16711","chr13.80255000.80260000","chr13.80945000.80950000",690000,9,0.0009011683,80255000,80945000,80260000,80950000,"chr13",510740,0,3,2,5,"chr13",1,0.00527426160337553
"16712","chr13.26840000.26845000","chr13.26910000.26915000",70000,18,0.006939498,26840000,26910000,26845000,26915000,"chr13",510754,0,3,2,5,"chr13",1,0.0105485232067511
"16713","chr13.31195000.31200000","chr13.31245000.31250000",50000,28,1.060181e-05,31195000,31245000,31200000,31250000,"chr13",510760,0,3,2,5,"chr13",1,0.0164088138771683
"16714","chr13.38705000.38710000","chr13.38800000.38805000",95000,17,0.001649295,38705000,38800000,38710000,38805000,"chr13",510838,0,4,6,10,"chr13",1,0.0199249882794187
"16715","chr13.52695000.52700000","chr13.52765000.52770000",70000,19,0.002710671,52695000,52765000,52700000,52770000,"chr13",510854,6,8,10,24,"chr13",1,0.0534458509142053
"16716","chr13.27280000.27285000","chr13.27445000.27450000",165000,33,1.183076e-18,27280000,27445000,27285000,27450000,"chr13",510944,0,5,4,9,"chr13",1,0.0348101265822785
"16717","chr13.21145000.21150000","chr13.21435000.21440000",290000,13,0.000153479,21145000,21435000,21150000,21440000,"chr13",510961,0,2,6,8,"chr13",1,0.0121894045944679
"16718","chr13.30970000.30975000","chr13.31035000.31040000",65000,30,8.732125e-09,30970000,31035000,30975000,31040000,"chr13",511037,0,2,1,3,"chr13",1,0.0105485232067511
"16719","chr13.84915000.84920000","chr13.84995000.85000000",80000,17,0.006291129,84915000,84995000,84920000,8.5e+07,"chr13",511069,0,0,3,3,"chr13",1,0.0059774964838256
"16720","chr13.30355000.30360000","chr13.30670000.30675000",315000,12,0.0004357697,30355000,30670000,30360000,30675000,"chr13",511085,0,4,4,8,"chr13",1,0.0112517580872011
"16721","chr13.30350000.30355000","chr13.30420000.30425000",70000,31,4.523787e-10,30350000,30420000,30355000,30425000,"chr13",511098,3,2,2,7,"chr13",1,0.0254336615096109
"16722","chr13.20440000.20445000","chr13.20525000.20530000",85000,25,1.648888e-07,20440000,20525000,20445000,20530000,"chr13",511144,1,7,3,11,"chr13",1,0.0322315986872949
"16723","chr13.76435000.76440000","chr13.77080000.77085000",645000,8,0.006510633,76435000,77080000,76440000,77085000,"chr13",511216,1,0,0,1,"chr13",1,0.00093764650726676
"16724","chr13.76435000.76440000","chr13.77025000.77030000",590000,9,0.002035765,76435000,77025000,76440000,77030000,"chr13",511333,1,0,4,5,"chr13",1,0.00527426160337553
"16725","chr13.40270000.40275000","chr13.41260000.41265000",990000,10,9.929824e-06,40270000,41260000,40275000,41265000,"chr13",511353,4,1,8,13,"chr13",1,0.0152367557430849
"16726","chr13.25660000.25665000","chr13.25810000.25815000",150000,17,5.653956e-05,25660000,25810000,25665000,25815000,"chr13",511669,1,1,1,3,"chr13",1,0.0059774964838256
"16727","chr13.101470000.101475000","chr13.101765000.101770000",295000,12,0.0006483967,101470000,101765000,101475000,101770000,"chr13",511713,0,2,1,3,"chr13",1,0.00421940928270042
"16728","chr13.26840000.26845000","chr13.26860000.26865000",20000,36,0.004498105,26840000,26860000,26845000,26865000,"chr13",511763,0,1,0,1,"chr13",1,0.00421940928270042
"16729","chr13.45100000.45105000","chr13.45460000.45465000",360000,12,0.000206245,45100000,45460000,45105000,45465000,"chr13",511835,3,7,11,21,"chr13",1,0.029535864978903
"16730","chr13.51310000.51315000","chr13.51330000.51335000",20000,42,5.480763e-05,51310000,51330000,51315000,51335000,"chr13",511905,0,9,12,21,"chr13",1,0.10337552742616
"16731","chr13.110130000.110135000","chr13.110615000.110620000",485000,9,0.00504111,110130000,110615000,110135000,110620000,"chr13",511975,2,4,3,9,"chr13",1,0.00949367088607595
"16732","chr13.74795000.74800000","chr13.75685000.75690000",890000,9,0.0002062894,74795000,75685000,74800000,75690000,"chr13",512074,1,0,1,2,"chr13",1,0.00210970464135021
"16733","chr13.51260000.51265000","chr13.51285000.51290000",25000,46,9.034301e-08,51260000,51285000,51265000,51290000,"chr13",512092,4,7,4,15,"chr13",1,0.0808720112517581
"16734","chr13.110870000.110875000","chr13.111065000.111070000",195000,15,0.0001396542,110870000,111065000,110875000,111070000,"chr13",512203,0,0,2,2,"chr13",1,0.00351617440225035
"16735","chr13.40775000.40780000","chr13.41220000.41225000",445000,10,0.001661541,40775000,41220000,40780000,41225000,"chr13",512246,0,3,7,10,"chr13",1,0.0117205813408345
"16736","chr13.99185000.99190000","chr13.99305000.99310000",120000,15,0.003061984,99185000,99305000,99190000,99310000,"chr13",512287,0,5,7,12,"chr13",1,0.0210970464135021
"16737","chr13.80000000.80005000","chr13.80050000.80055000",50000,31,2.897949e-07,8e+07,80050000,80005000,80055000,"chr13",512423,0,3,2,5,"chr13",1,0.0181669010782935
"16738","chr13.26755000.26760000","chr13.27270000.27275000",515000,19,4.72025e-12,26755000,27270000,26760000,27275000,"chr13",512467,1,2,2,5,"chr13",1,0.0111345522737928
"16739","chr13.30350000.30355000","chr13.31205000.31210000",855000,8,0.001728827,30350000,31205000,30355000,31210000,"chr13",512524,1,9,13,23,"chr13",1,0.0215658696671355
"16740","chr13.76470000.76475000","chr13.77040000.77045000",570000,9,0.00239533,76470000,77040000,76475000,77045000,"chr13",512566,0,4,3,7,"chr13",1,0.00738396624472574
"16741","chr13.48880000.48885000","chr13.49110000.49115000",230000,14,0.0001742763,48880000,49110000,48885000,49115000,"chr13",512589,0,3,2,5,"chr13",1,0.00820440693858415
"16742","chr13.42040000.42045000","chr13.42130000.42135000",90000,16,0.006994897,42040000,42130000,42045000,42135000,"chr13",512640,5,6,10,21,"chr13",1,0.0393811533052039
"16743","chr13.52920000.52925000","chr13.53020000.53025000",100000,29,1.813516e-11,52920000,53020000,52925000,53025000,"chr13",512652,1,0,3,4,"chr13",1,0.013595874355368
"16744","chr13.31040000.31045000","chr13.31160000.31165000",120000,15,0.003061984,31040000,31160000,31045000,31165000,"chr13",512663,5,12,8,25,"chr13",1,0.0439521800281294
"16745","chr13.43645000.43650000","chr13.44405000.44410000",760000,9,0.0005404292,43645000,44405000,43650000,44410000,"chr13",512677,1,1,1,3,"chr13",1,0.00316455696202532
"16746","chr13.48820000.48825000","chr13.48880000.48885000",60000,23,0.0002375925,48820000,48880000,48825000,48885000,"chr13",512709,0,3,3,6,"chr13",1,0.0161744022503516
"16747","chr13.26705000.26710000","chr13.27040000.27045000",335000,11,0.001423887,26705000,27040000,26710000,27045000,"chr13",512763,0,4,3,7,"chr13",1,0.00902484763244257
"16748","chr13.98670000.98675000","chr13.99085000.99090000",415000,9,0.009623856,98670000,99085000,98675000,99090000,"chr13",512904,0,4,0,4,"chr13",1,0.00421940928270042
"16749","chr13.98020000.98025000","chr13.98460000.98465000",440000,12,6.333105e-05,98020000,98460000,98025000,98465000,"chr13",512906,2,6,3,11,"chr13",1,0.0154711673699015
"16750","chr13.39615000.39620000","chr13.39675000.39680000",60000,21,0.001787903,39615000,39675000,39620000,39680000,"chr13",512952,1,1,4,6,"chr13",1,0.0147679324894515
"16751","chr13.30970000.30975000","chr13.31040000.31045000",70000,26,6.773311e-07,30970000,31040000,30975000,31045000,"chr13",512983,0,8,2,10,"chr13",1,0.0304735114861697
"16752","chr13.30970000.30975000","chr13.31190000.31195000",220000,14,0.0002450198,30970000,31190000,30975000,31195000,"chr13",513037,0,4,2,6,"chr13",1,0.00984528832630099
"16753","chr13.100550000.100555000","chr13.100750000.100755000",200000,13,0.001826467,100550000,100750000,100555000,100755000,"chr13",513079,0,2,4,6,"chr13",1,0.00914205344585091
"16754","chr13.72040000.72045000","chr13.73035000.73040000",995000,8,0.0006646616,72040000,73035000,72045000,73040000,"chr13",513107,2,2,1,5,"chr13",1,0.0046882325363338
"16755","chr13.48880000.48885000","chr13.49145000.49150000",265000,15,1.11315e-05,48880000,49145000,48885000,49150000,"chr13",513124,0,2,3,5,"chr13",1,0.00879043600562588
"16756","chr13.26755000.26760000","chr13.27200000.27205000",445000,9,0.007225375,26755000,27200000,26760000,27205000,"chr13",513227,1,2,4,7,"chr13",1,0.00738396624472574
"16757","chr13.20920000.20925000","chr13.20940000.20945000",20000,37,0.002343816,20920000,20940000,20925000,20945000,"chr13",513305,3,20,18,41,"chr13",1,0.177801218940459
"16758","chr13.51725000.51730000","chr13.51800000.51805000",75000,18,0.003988638,51725000,51800000,51730000,51805000,"chr13",513315,0,2,1,3,"chr13",1,0.00632911392405063
"16759","chr13.45045000.45050000","chr13.45510000.45515000",465000,15,1.237287e-07,45045000,45510000,45050000,45515000,"chr13",513440,3,4,14,21,"chr13",1,0.0369198312236287
"16760","chr13.45090000.45095000","chr13.45525000.45530000",435000,10,0.001853046,45090000,45525000,45095000,45530000,"chr13",513514,1,1,0,2,"chr13",1,0.0023441162681669
"16761","chr13.41760000.41765000","chr13.41780000.41785000",20000,35,0.008327471,41760000,41780000,41765000,41785000,"chr13",513518,1,1,2,4,"chr13",1,0.0164088138771683
"16762","chr13.48855000.48860000","chr13.48880000.48885000",25000,33,0.006163333,48855000,48880000,48860000,48885000,"chr13",513527,0,3,3,6,"chr13",1,0.0232067510548523
"16763","chr13.52735000.52740000","chr13.53020000.53025000",285000,11,0.003273289,52735000,53020000,52740000,53025000,"chr13",513552,1,0,3,4,"chr13",1,0.00515705578996718
"16764","chr13.49845000.49850000","chr13.49975000.49980000",130000,19,9.416608e-06,49845000,49975000,49850000,49980000,"chr13",513572,3,8,4,15,"chr13",1,0.0334036568213783
"16765","chr13.110090000.110095000","chr13.110440000.110445000",350000,11,0.001146935,110090000,110440000,110095000,110445000,"chr13",513626,1,3,0,4,"chr13",1,0.00515705578996718
"16766","chr13.41190000.41195000","chr13.41220000.41225000",30000,29,0.006445437,41190000,41220000,41195000,41225000,"chr13",513645,0,2,5,7,"chr13",1,0.023792780121894
"16767","chr13.36395000.36400000","chr13.36460000.36465000",65000,19,0.00525891,36395000,36460000,36400000,36465000,"chr13",513715,2,3,4,9,"chr13",1,0.020042194092827
"16768","chr13.30730000.30735000","chr13.31040000.31045000",310000,10,0.008105067,30730000,31040000,30735000,31045000,"chr13",513798,2,0,6,8,"chr13",1,0.00937646507266761
"16769","chr14.64590000.64595000","chr14.64765000.64770000",175000,13,0.005050053,64590000,64765000,64595000,64770000,"chr14",513863,3,1,1,5,"chr14",1,0.00761837787154243
"16770","chr14.22515000.22520000","chr14.22550000.22555000",35000,30,0.0004969798,22515000,22550000,22520000,22555000,"chr14",513928,0,1,0,1,"chr14",1,0.00351617440225035
"16771","chr14.75650000.75655000","chr14.75695000.75700000",45000,33,3.747443e-07,75650000,75695000,75655000,75700000,"chr14",513933,0,6,3,9,"chr14",1,0.0348101265822785
"16772","chr14.102275000.102280000","chr14.102310000.102315000",35000,29,0.001160061,102275000,102310000,102280000,102315000,"chr14",513936,10,7,22,39,"chr14",1,0.132559774964838
"16773","chr14.22850000.22855000","chr14.23035000.23040000",185000,13,0.003596248,22850000,23035000,22855000,23040000,"chr14",513943,1,15,9,25,"chr14",1,0.0380918893577121
"16774","chr14.90575000.90580000","chr14.90595000.90600000",20000,39,0.0009125548,90575000,90595000,90580000,90600000,"chr14",513977,0,5,5,10,"chr14",1,0.0457102672292546
"16775","chr14.74145000.74150000","chr14.74465000.74470000",320000,10,0.006626174,74145000,74465000,74150000,74470000,"chr14",514004,1,1,0,2,"chr14",1,0.0023441162681669
"16776","chr14.74215000.74220000","chr14.74255000.74260000",40000,33,2.860897e-06,74215000,74255000,74220000,74260000,"chr14",514051,1,10,6,17,"chr14",1,0.0657524613220816
"16777","chr14.68935000.68940000","chr14.69065000.69070000",130000,15,0.002883085,68935000,69065000,68940000,69070000,"chr14",514102,0,4,2,6,"chr14",1,0.0105485232067511
"16778","chr14.91320000.91325000","chr14.91570000.91575000",250000,12,0.001869736,91320000,91570000,91325000,91575000,"chr14",514103,0,2,2,4,"chr14",1,0.00562587904360056
"16779","chr14.24710000.24715000","chr14.24910000.24915000",200000,15,0.0001528125,24710000,24910000,24715000,24915000,"chr14",514119,0,0,1,1,"chr14",1,0.00175808720112518
"16780","chr14.32675000.32680000","chr14.32985000.32990000",310000,10,0.007618584,32675000,32985000,32680000,32990000,"chr14",514120,0,0,2,2,"chr14",1,0.0023441162681669
"16781","chr14.96445000.96450000","chr14.96795000.96800000",350000,10,0.004346244,96445000,96795000,96450000,96800000,"chr14",514122,1,1,4,6,"chr14",1,0.0070323488045007
"16782","chr14.51250000.51255000","chr14.51270000.51275000",20000,40,0.0004516266,51250000,51270000,51255000,51275000,"chr14",514190,1,1,5,7,"chr14",1,0.0328176277543366
"16783","chr14.91380000.91385000","chr14.91575000.91580000",195000,12,0.008370895,91380000,91575000,91385000,91580000,"chr14",514224,1,3,3,7,"chr14",1,0.00984528832630099
"16784","chr14.69005000.69010000","chr14.69100000.69105000",95000,16,0.007111399,69005000,69100000,69010000,69105000,"chr14",514230,0,3,5,8,"chr14",1,0.0150023441162682
"16785","chr14.74270000.74275000","chr14.74290000.74295000",20000,46,3.482539e-06,74270000,74290000,74275000,74295000,"chr14",514236,0,2,1,3,"chr14",1,0.0161744022503516
"16786","chr14.35750000.35755000","chr14.35880000.35885000",130000,22,2.186541e-07,35750000,35880000,35755000,35885000,"chr14",514255,2,1,1,4,"chr14",1,0.0103141115799344
"16787","chr14.55070000.55075000","chr14.55135000.55140000",65000,23,0.0001620954,55070000,55135000,55075000,55140000,"chr14",514278,6,9,3,18,"chr14",1,0.0485232067510548
"16788","chr14.90820000.90825000","chr14.90840000.90845000",20000,39,0.0009125548,90820000,90840000,90825000,90845000,"chr14",514284,3,10,14,27,"chr14",1,0.123417721518987
"16789","chr14.50835000.50840000","chr14.50870000.50875000",35000,30,0.0004969798,50835000,50870000,50840000,50875000,"chr14",514355,4,8,5,17,"chr14",1,0.059774964838256
"16790","chr14.28750000.28755000","chr14.29060000.29065000",310000,14,1.906072e-05,28750000,29060000,28755000,29065000,"chr14",514371,1,0,2,3,"chr14",1,0.00492264416315049
"16791","chr14.91300000.91305000","chr14.91360000.91365000",60000,22,0.001160061,91300000,91360000,91305000,91365000,"chr14",514392,4,8,6,18,"chr14",1,0.0464135021097046
"16792","chr14.75665000.75670000","chr14.75995000.76000000",330000,10,0.005742303,75665000,75995000,75670000,7.6e+07,"chr14",514410,0,3,2,5,"chr14",1,0.00586029067041725
"16793","chr14.73750000.73755000","chr14.73950000.73955000",200000,14,0.0006054675,73750000,73950000,73755000,73955000,"chr14",514427,2,2,6,10,"chr14",1,0.0164088138771683
"16794","chr14.35155000.35160000","chr14.35470000.35475000",315000,11,0.001846312,35155000,35470000,35160000,35475000,"chr14",514488,2,6,2,10,"chr14",1,0.012892639474918
"16795","chr14.90840000.90845000","chr14.91310000.91315000",470000,13,4.555077e-06,90840000,91310000,90845000,91315000,"chr14",514542,3,11,13,27,"chr14",1,0.0411392405063291
"16796","chr14.23055000.23060000","chr14.23235000.23240000",180000,31,7.370203e-17,23055000,23235000,23060000,23240000,"chr14",514583,2,2,6,10,"chr14",1,0.036333802156587
"16797","chr14.35220000.35225000","chr14.35245000.35250000",25000,43,4.255905e-06,35220000,35245000,35225000,35250000,"chr14",514607,0,3,1,4,"chr14",1,0.0201593999062353
"16798","chr14.79565000.79570000","chr14.79585000.79590000",20000,38,0.001810636,79565000,79585000,79570000,79590000,"chr14",514686,0,3,1,4,"chr14",1,0.0178152836380684
"16799","chr14.50790000.50795000","chr14.50960000.50965000",170000,17,3.449042e-05,50790000,50960000,50795000,50965000,"chr14",514735,0,1,2,3,"chr14",1,0.0059774964838256
"16800","chr14.65140000.65145000","chr14.65230000.65235000",90000,21,4.50258e-05,65140000,65230000,65145000,65235000,"chr14",514740,0,9,11,20,"chr14",1,0.0492264416315049
"16801","chr14.73170000.73175000","chr14.73355000.73360000",185000,16,7.041606e-05,73170000,73355000,73175000,73360000,"chr14",514766,2,9,8,19,"chr14",1,0.0356305672761369
"16802","chr14.74415000.74420000","chr14.74550000.74555000",135000,15,0.002351642,74415000,74550000,74420000,74555000,"chr14",514776,1,1,0,2,"chr14",1,0.00351617440225035
"16803","chr14.102230000.102235000","chr14.102310000.102315000",80000,29,3.052523e-09,102230000,102310000,102235000,102315000,"chr14",514829,1,0,1,2,"chr14",1,0.00679793717768401
"16804","chr14.61935000.61940000","chr14.62175000.62180000",240000,25,1.614455e-13,61935000,62175000,61940000,62180000,"chr14",514873,0,1,0,1,"chr14",1,0.00293014533520863
"16805","chr14.69545000.69550000","chr14.69585000.69590000",40000,25,0.005099286,69545000,69585000,69550000,69590000,"chr14",514888,3,9,10,22,"chr14",1,0.0644631973745898
"16806","chr14.75275000.75280000","chr14.75295000.75300000",20000,37,0.003472832,75275000,75295000,75280000,75300000,"chr14",514920,1,5,1,7,"chr14",1,0.0303563056727614
"16807","chr14.91255000.91260000","chr14.91290000.91295000",35000,27,0.005372273,91255000,91290000,91260000,91295000,"chr14",514930,0,3,2,5,"chr14",1,0.0158227848101266
"16808","chr14.91395000.91400000","chr14.91505000.91510000",110000,25,1.275205e-08,91395000,91505000,91400000,91510000,"chr14",514939,5,6,13,24,"chr14",1,0.070323488045007
"16809","chr14.74270000.74275000","chr14.74295000.74300000",25000,38,0.0002904985,74270000,74295000,74275000,74300000,"chr14",514943,4,16,13,33,"chr14",1,0.146976090014065
"16810","chr14.62690000.62695000","chr14.63595000.63600000",905000,8,0.0006512996,62690000,63595000,62695000,63600000,"chr14",514946,0,2,1,3,"chr14",1,0.00281293952180028
"16811","chr14.73755000.73760000","chr14.73900000.73905000",145000,15,0.001523164,73755000,73900000,73760000,73905000,"chr14",514950,3,3,2,8,"chr14",1,0.0140646976090014
"16812","chr14.23035000.23040000","chr14.23325000.23330000",290000,40,5.842103e-32,23035000,23325000,23040000,23330000,"chr14",514982,6,13,18,37,"chr14",1,0.173464603844351
"16813","chr14.69110000.69115000","chr14.69190000.69195000",80000,19,0.0013419,69110000,69190000,69115000,69195000,"chr14",515008,6,12,9,27,"chr14",1,0.060126582278481
"16814","chr14.92120000.92125000","chr14.92400000.92405000",280000,12,0.0009078497,92120000,92400000,92125000,92405000,"chr14",515025,3,9,12,24,"chr14",1,0.0337552742616034
"16815","chr14.91365000.91370000","chr14.91635000.91640000",270000,64,5.416928e-63,91365000,91635000,91370000,91640000,"chr14",515111,0,6,2,8,"chr14",1,0.0600093764650727
"16816","chr14.92585000.92590000","chr14.93175000.93180000",590000,9,0.00129151,92585000,93175000,92590000,93180000,"chr14",515120,5,9,17,31,"chr14",1,0.0327004219409283
"16817","chr14.51440000.51445000","chr14.51555000.51560000",115000,18,0.0001900271,51440000,51555000,51445000,51560000,"chr14",515165,0,2,1,3,"chr14",1,0.00632911392405063
"16818","chr14.102200000.102205000","chr14.102445000.102450000",245000,14,0.0001257414,102200000,102445000,102205000,102450000,"chr14",515402,3,2,3,8,"chr14",1,0.0131270511017346
"16819","chr14.102265000.102270000","chr14.102315000.102320000",50000,23,0.003007492,102265000,102315000,102270000,102320000,"chr14",515416,1,5,10,16,"chr14",1,0.043131739334271
"16820","chr14.90770000.90775000","chr14.90840000.90845000",70000,40,5.503188e-16,90770000,90840000,90775000,90845000,"chr14",515438,4,5,6,15,"chr14",1,0.070323488045007
"16821","chr14.51450000.51455000","chr14.51480000.51485000",30000,72,5.036608e-26,51450000,51480000,51455000,51485000,"chr14",515456,0,2,3,5,"chr14",1,0.0421940928270042
"16822","chr14.77920000.77925000","chr14.78220000.78225000",300000,10,0.009006076,77920000,78220000,77925000,78225000,"chr14",515470,0,0,2,2,"chr14",1,0.0023441162681669
"16823","chr14.50795000.50800000","chr14.51025000.51030000",230000,14,0.0002092806,50795000,51025000,50800000,51030000,"chr14",515550,0,2,0,2,"chr14",1,0.00328176277543366
"16824","chr14.90840000.90845000","chr14.91635000.91640000",795000,7,0.007891718,90840000,91635000,90845000,91640000,"chr14",515569,5,9,9,23,"chr14",1,0.0188701359587436
"16825","chr14.68630000.68635000","chr14.69295000.69300000",665000,9,0.0006515927,68630000,69295000,68635000,69300000,"chr14",515575,1,6,3,10,"chr14",1,0.0105485232067511
"16826","chr14.91410000.91415000","chr14.91635000.91640000",225000,12,0.003600476,91410000,91635000,91415000,91640000,"chr14",515643,1,3,9,13,"chr14",1,0.0182841068917018
"16827","chr14.25345000.25350000","chr14.25515000.25520000",170000,22,1.105757e-08,25345000,25515000,25350000,25520000,"chr14",515650,0,0,3,3,"chr14",1,0.00773558368495077
"16828","chr14.67705000.67710000","chr14.67745000.67750000",40000,37,2.794921e-08,67705000,67745000,67710000,67750000,"chr14",515692,4,4,12,20,"chr14",1,0.0867323019221753
"16829","chr14.90000000.90005000","chr14.90395000.90400000",395000,9,0.009775897,9e+07,90395000,90005000,90400000,"chr14",515716,0,3,0,3,"chr14",1,0.00316455696202532
"16830","chr14.50860000.50865000","chr14.51235000.51240000",375000,12,0.000144153,50860000,51235000,50865000,51240000,"chr14",515726,0,5,9,14,"chr14",1,0.019690576652602
"16831","chr14.93265000.93270000","chr14.93975000.93980000",710000,8,0.002608249,93265000,93975000,93270000,93980000,"chr14",515731,0,3,1,4,"chr14",1,0.00375058602906704
"16832","chr14.96560000.96565000","chr14.96755000.96760000",195000,14,0.0007316646,96560000,96755000,96565000,96760000,"chr14",515760,0,4,2,6,"chr14",1,0.00984528832630099
"16833","chr14.74255000.74260000","chr14.74290000.74295000",35000,48,5.619634e-13,74255000,74290000,74260000,74295000,"chr14",515769,0,2,1,3,"chr14",1,0.0168776371308017
"16834","chr14.22995000.23000000","chr14.23325000.23330000",330000,12,0.0003191931,22995000,23325000,2.3e+07,23330000,"chr14",515770,0,2,1,3,"chr14",1,0.00421940928270042
"16835","chr14.74320000.74325000","chr14.74415000.74420000",95000,20,8.842614e-05,74320000,74415000,74325000,74420000,"chr14",515836,5,2,0,7,"chr14",1,0.0164088138771683
"16836","chr14.93750000.93755000","chr14.94000000.94005000",250000,15,2.249757e-05,93750000,9.4e+07,93755000,94005000,"chr14",515870,2,2,5,9,"chr14",1,0.0158227848101266
"16837","chr14.96040000.96045000","chr14.96445000.96450000",405000,9,0.00875539,96040000,96445000,96045000,96450000,"chr14",515874,1,2,1,4,"chr14",1,0.00421940928270042
"16838","chr14.50795000.50800000","chr14.50860000.50865000",65000,20,0.003279551,50795000,50860000,50800000,50865000,"chr14",515920,0,5,8,13,"chr14",1,0.0304735114861697
"16839","chr14.63850000.63855000","chr14.64010000.64015000",160000,15,0.000816505,63850000,64010000,63855000,64015000,"chr14",515923,0,3,3,6,"chr14",1,0.0105485232067511
"16840","chr14.50845000.50850000","chr14.51310000.51315000",465000,9,0.004631469,50845000,51310000,50850000,51315000,"chr14",515991,0,2,2,4,"chr14",1,0.00421940928270042
"16841","chr14.23965000.23970000","chr14.23985000.23990000",20000,48,5.60916e-07,23965000,23985000,23970000,23990000,"chr14",516031,1,0,2,3,"chr14",1,0.0168776371308017
"16842","chr14.69395000.69400000","chr14.69585000.69590000",190000,12,0.009775897,69395000,69585000,69400000,69590000,"chr14",516041,3,9,6,18,"chr14",1,0.0253164556962025
"16843","chr14.68860000.68865000","chr14.68935000.68940000",75000,21,0.000291988,68860000,68935000,68865000,68940000,"chr14",516067,0,4,2,6,"chr14",1,0.0147679324894515
"16844","chr14.23065000.23070000","chr14.23300000.23305000",235000,13,0.0007320306,23065000,23300000,23070000,23305000,"chr14",516073,0,6,3,9,"chr14",1,0.0137130801687764
"16845","chr14.50800000.50805000","chr14.50955000.50960000",155000,14,0.003279551,50800000,50955000,50805000,50960000,"chr14",516091,1,7,3,11,"chr14",1,0.0180496952648851
"16846","chr14.26865000.26870000","chr14.27430000.27435000",565000,9,0.001653099,26865000,27430000,26870000,27435000,"chr14",516159,1,0,3,4,"chr14",1,0.00421940928270042
"16847","chr14.102230000.102235000","chr14.102405000.102410000",175000,23,1.29149e-09,102230000,102405000,102235000,102410000,"chr14",516185,1,0,1,2,"chr14",1,0.00539146741678387
"16848","chr14.91290000.91295000","chr14.91360000.91365000",70000,20,0.001624697,91290000,91360000,91295000,91365000,"chr14",516191,0,3,2,5,"chr14",1,0.0117205813408345
"16849","chr14.93690000.93695000","chr14.94030000.94035000",340000,11,0.001215416,93690000,94030000,93695000,94035000,"chr14",516215,3,4,1,8,"chr14",1,0.0103141115799344
"16850","chr14.65040000.65045000","chr14.65060000.65065000",20000,38,0.001810636,65040000,65060000,65045000,65065000,"chr14",516276,2,12,5,19,"chr14",1,0.0846225972808251
"16851","chr14.50775000.50780000","chr14.50970000.50975000",195000,12,0.008370895,50775000,50970000,50780000,50975000,"chr14",516300,3,0,4,7,"chr14",1,0.00984528832630099
"16852","chr14.104050000.104055000","chr14.104115000.104120000",65000,19,0.007907143,104050000,104115000,104055000,104120000,"chr14",516305,2,1,1,4,"chr14",1,0.00890764181903422
"16853","chr14.102275000.102280000","chr14.102320000.102325000",45000,33,3.747443e-07,102275000,102320000,102280000,102325000,"chr14",516312,4,7,5,16,"chr14",1,0.0618846694796062
"16854","chr14.103070000.103075000","chr14.103150000.103155000",80000,18,0.003619781,103070000,103150000,103075000,103155000,"chr14",516319,0,4,1,5,"chr14",1,0.0105485232067511
"16855","chr14.90820000.90825000","chr14.91235000.91240000",415000,9,0.007821677,90820000,91235000,90825000,91240000,"chr14",516350,3,10,14,27,"chr14",1,0.0284810126582278
"16856","chr14.73160000.73165000","chr14.73355000.73360000",195000,14,0.0007316646,73160000,73355000,73165000,73360000,"chr14",516356,2,12,8,22,"chr14",1,0.0360993905297703
"16857","chr14.66425000.66430000","chr14.66530000.66535000",105000,16,0.003614085,66425000,66530000,66430000,66535000,"chr14",516371,1,1,3,5,"chr14",1,0.00937646507266761
"16858","chr14.55120000.55125000","chr14.55210000.55215000",90000,22,1.250617e-05,55120000,55210000,55125000,55215000,"chr14",516390,2,7,12,21,"chr14",1,0.0541490857946554
"16859","chr14.93025000.93030000","chr14.93045000.93050000",20000,36,0.006432007,93025000,93045000,93030000,93050000,"chr14",516397,2,1,0,3,"chr14",1,0.0126582278481013
"16860","chr14.89490000.89495000","chr14.90405000.90410000",915000,7,0.003859497,89490000,90405000,89495000,90410000,"chr14",516434,1,1,2,4,"chr14",1,0.00328176277543366
"16861","chr14.92120000.92125000","chr14.92360000.92365000",240000,18,2.028804e-07,92120000,92360000,92125000,92365000,"chr14",516454,4,10,12,26,"chr14",1,0.0548523206751055
"16862","chr14.55050000.55055000","chr14.55125000.55130000",75000,18,0.006029456,55050000,55125000,55055000,55130000,"chr14",516465,0,2,2,4,"chr14",1,0.00843881856540084
"16863","chr14.68395000.68400000","chr14.68795000.68800000",400000,9,0.00932719,68395000,68795000,68400000,68800000,"chr14",516521,0,0,2,2,"chr14",1,0.00210970464135021
"16864","chr14.77985000.77990000","chr14.78025000.78030000",40000,26,0.002351642,77985000,78025000,77990000,78030000,"chr14",516528,0,3,6,9,"chr14",1,0.0274261603375527
"16865","chr14.21260000.21265000","chr14.21305000.21310000",45000,30,1.138115e-05,21260000,21305000,21265000,21310000,"chr14",516557,4,15,19,38,"chr14",1,0.133614627285513
"16866","chr14.33955000.33960000","chr14.34785000.34790000",830000,7,0.006486874,33955000,34785000,33960000,34790000,"chr14",516559,2,13,10,25,"chr14",1,0.0205110173464604
"16867","chr14.50790000.50795000","chr14.51095000.51100000",305000,12,0.000518268,50790000,51095000,50795000,51100000,"chr14",516599,1,1,1,3,"chr14",1,0.00421940928270042
"16868","chr14.59125000.59130000","chr14.59490000.59495000",365000,10,0.003552204,59125000,59490000,59130000,59495000,"chr14",516617,1,2,6,9,"chr14",1,0.0105485232067511
"16869","chr14.70085000.70090000","chr14.70185000.70190000",100000,28,3.889376e-10,70085000,70185000,70090000,70190000,"chr14",516625,1,3,3,7,"chr14",1,0.0229723394280356
"16870","chr14.35465000.35470000","chr14.35880000.35885000",415000,11,0.000402483,35465000,35880000,35470000,35885000,"chr14",516633,2,5,5,12,"chr14",1,0.0154711673699015
"16871","chr14.75660000.75665000","chr14.75705000.75710000",45000,24,0.003472832,75660000,75705000,75665000,75710000,"chr14",516644,0,3,7,10,"chr14",1,0.0281293952180028
"16872","chr14.61170000.61175000","chr14.61485000.61490000",315000,11,0.001846312,61170000,61485000,61175000,61490000,"chr14",516654,0,0,3,3,"chr14",1,0.00386779184247539
"16873","chr14.33700000.33705000","chr14.33835000.33840000",135000,17,0.0002074511,33700000,33835000,33705000,33840000,"chr14",516675,2,2,0,4,"chr14",1,0.00796999531176746
"16874","chr14.23035000.23040000","chr14.23055000.23060000",20000,48,5.60916e-07,23035000,23055000,23040000,23060000,"chr14",516720,2,2,6,10,"chr14",1,0.0562587904360056
"16875","chr14.91365000.91370000","chr14.91455000.91460000",90000,21,4.50258e-05,91365000,91455000,91370000,91460000,"chr14",516742,0,6,2,8,"chr14",1,0.019690576652602
"16876","chr14.59125000.59130000","chr14.59320000.59325000",195000,16,4.503971e-05,59125000,59320000,59130000,59325000,"chr14",516765,1,8,7,16,"chr14",1,0.0300046882325363
"16877","chr14.68345000.68350000","chr14.68625000.68630000",280000,12,0.0009078497,68345000,68625000,68350000,68630000,"chr14",516771,2,1,3,6,"chr14",1,0.00843881856540084
"16878","chr14.23075000.23080000","chr14.23325000.23330000",250000,14,0.0001064003,23075000,23325000,23080000,23330000,"chr14",516778,0,2,1,3,"chr14",1,0.00492264416315049
"16879","chr14.51480000.51485000","chr14.51620000.51625000",140000,15,0.001875477,51480000,51620000,51485000,51625000,"chr14",516814,0,2,0,2,"chr14",1,0.00351617440225035
"16880","chr14.78185000.78190000","chr14.78205000.78210000",20000,48,5.60916e-07,78185000,78205000,78190000,78210000,"chr14",516871,0,2,0,2,"chr14",1,0.0112517580872011
"16881","chr14.50230000.50235000","chr14.50775000.50780000",545000,10,0.0003891405,50230000,50775000,50235000,50780000,"chr14",516945,3,0,4,7,"chr14",1,0.00820440693858415
"16882","chr14.89485000.89490000","chr14.90330000.90335000",845000,7,0.005973001,89485000,90330000,89490000,90335000,"chr14",516993,3,3,4,10,"chr14",1,0.00820440693858415
"16883","chr14.90770000.90775000","chr14.91225000.91230000",455000,15,1.087706e-07,90770000,91225000,90775000,91230000,"chr14",517018,3,5,2,10,"chr14",1,0.0175808720112518
"16884","chr14.102235000.102240000","chr14.102405000.102410000",170000,17,3.449042e-05,102235000,102405000,102240000,102410000,"chr14",517041,1,1,2,4,"chr14",1,0.00796999531176746
"16885","chr14.92600000.92605000","chr14.93290000.93295000",690000,11,1.091655e-05,92600000,93290000,92605000,93295000,"chr14",517048,1,0,0,1,"chr14",1,0.0012892639474918
"16886","chr14.77800000.77805000","chr14.77830000.77835000",30000,33,0.0005252989,77800000,77830000,77805000,77835000,"chr14",517087,3,8,14,25,"chr14",1,0.0966947960618847
"16887","chr14.70085000.70090000","chr14.70150000.70155000",65000,23,0.0001620954,70085000,70150000,70090000,70155000,"chr14",517089,1,3,2,6,"chr14",1,0.0161744022503516
"16888","chr14.69360000.69365000","chr14.69575000.69580000",215000,13,0.001353966,69360000,69575000,69365000,69580000,"chr14",517177,2,8,4,14,"chr14",1,0.0213314580403188
"16889","chr14.102235000.102240000","chr14.102340000.102345000",105000,18,0.0004036942,102235000,102340000,102240000,102345000,"chr14",517203,1,1,2,4,"chr14",1,0.00843881856540084
"16890","chr14.93180000.93185000","chr14.93205000.93210000",25000,33,0.00932719,93180000,93205000,93185000,93210000,"chr14",517253,2,13,16,31,"chr14",1,0.119901547116737
"16891","chr14.102275000.102280000","chr14.102300000.102305000",25000,58,3.187004e-13,102275000,102300000,102280000,102305000,"chr14",517283,7,7,22,36,"chr14",1,0.244725738396624
"16892","chr14.34330000.34335000","chr14.34535000.34540000",205000,12,0.006349867,34330000,34535000,34335000,34540000,"chr14",517307,5,10,20,35,"chr14",1,0.0492264416315049
"16893","chr14.102445000.102450000","chr14.102515000.102520000",70000,20,0.001624697,102445000,102515000,102450000,102520000,"chr14",517344,9,14,16,39,"chr14",1,0.0914205344585091
"16894","chr14.90770000.90775000","chr14.91290000.91295000",520000,11,8.924784e-05,90770000,91290000,90775000,91295000,"chr14",517350,0,3,2,5,"chr14",1,0.00644631973745898
"16895","chr14.69590000.69595000","chr14.69610000.69615000",20000,40,0.0004516266,69590000,69610000,69595000,69615000,"chr14",517355,0,2,1,3,"chr14",1,0.0140646976090014
"16896","chr14.68395000.68400000","chr14.69295000.69300000",900000,12,1.021231e-07,68395000,69295000,68400000,69300000,"chr14",517402,0,0,2,2,"chr14",1,0.00281293952180028
"16897","chr14.68395000.68400000","chr14.69310000.69315000",915000,13,6.750107e-09,68395000,69310000,68400000,69315000,"chr14",517421,0,0,2,2,"chr14",1,0.00304735114861697
"16898","chr14.35630000.35635000","chr14.36070000.36075000",440000,9,0.006029456,35630000,36070000,35635000,36075000,"chr14",517470,1,6,3,10,"chr14",1,0.0105485232067511
"16899","chr14.68395000.68400000","chr14.68965000.68970000",570000,8,0.00747829,68395000,68965000,68400000,68970000,"chr14",517530,0,0,2,2,"chr14",1,0.00187529301453352
"16900","chr14.35380000.35385000","chr14.35410000.35415000",30000,36,4.157914e-05,35380000,35410000,35385000,35415000,"chr14",517570,7,21,18,46,"chr14",1,0.194092827004219
"16901","chr14.90855000.90860000","chr14.91365000.91370000",510000,9,0.002883085,90855000,91365000,90860000,91370000,"chr14",517643,0,6,2,8,"chr14",1,0.00843881856540084
"16902","chr14.90840000.90845000","chr14.91255000.91260000",415000,9,0.007821677,90840000,91255000,90845000,91260000,"chr14",517659,4,13,14,31,"chr14",1,0.0327004219409283
"16903","chr14.90840000.90845000","chr14.91225000.91230000",385000,12,0.0001218958,90840000,91225000,90845000,91230000,"chr14",517662,3,5,2,10,"chr14",1,0.0140646976090014
"16904","chr14.77580000.77585000","chr14.77780000.77785000",200000,14,0.0006054675,77580000,77780000,77585000,77785000,"chr14",517715,7,29,30,66,"chr14",1,0.108298171589311
"16905","chr14.23070000.23075000","chr14.23325000.23330000",255000,13,0.0004149928,23070000,23325000,23075000,23330000,"chr14",517728,0,8,9,17,"chr14",1,0.0259024847632443
"16906","chr14.102235000.102240000","chr14.102320000.102325000",85000,17,0.006029456,102235000,102320000,102240000,102325000,"chr14",517729,1,1,2,4,"chr14",1,0.00796999531176746
"16907","chr14.50960000.50965000","chr14.50985000.50990000",25000,34,0.004999711,50960000,50985000,50965000,50990000,"chr14",517743,0,3,1,4,"chr14",1,0.0159399906235349
"16908","chr14.73165000.73170000","chr14.73355000.73360000",190000,13,0.003060019,73165000,73355000,73170000,73360000,"chr14",517784,2,16,8,26,"chr14",1,0.0396155649320206
"16909","chr14.23035000.23040000","chr14.23360000.23365000",325000,11,0.001545355,23035000,23360000,23040000,23365000,"chr14",517820,5,5,14,24,"chr14",1,0.0309423347398031
"16910","chr14.78185000.78190000","chr14.78220000.78225000",35000,30,0.0004969798,78185000,78220000,78190000,78225000,"chr14",517884,0,0,2,2,"chr14",1,0.0070323488045007
"16911","chr14.50790000.50795000","chr14.50955000.50960000",165000,17,4.50258e-05,50790000,50955000,50795000,50960000,"chr14",517935,1,1,2,4,"chr14",1,0.00796999531176746
"16912","chr14.74190000.74195000","chr14.74290000.74295000",100000,39,4.630666e-19,74190000,74290000,74195000,74295000,"chr14",517954,0,2,1,3,"chr14",1,0.0137130801687764
"16913","chr14.102300000.102305000","chr14.102320000.102325000",20000,40,0.0004516266,102300000,102320000,102305000,102325000,"chr14",517973,4,10,5,19,"chr14",1,0.0890764181903422
"16914","chr14.56340000.56345000","chr14.56545000.56550000",205000,17,6.010849e-06,56340000,56545000,56345000,56550000,"chr14",518065,0,1,1,2,"chr14",1,0.00398499765588373
"16915","chr14.65140000.65145000","chr14.65220000.65225000",80000,28,1.36953e-08,65140000,65220000,65145000,65225000,"chr14",518075,9,12,12,33,"chr14",1,0.108298171589311
"16916","chr14.74190000.74195000","chr14.74295000.74300000",105000,17,0.001246206,74190000,74295000,74195000,74300000,"chr14",518090,4,6,8,18,"chr14",1,0.0358649789029536
"16917","chr14.67635000.67640000","chr14.67750000.67755000",115000,19,5.356982e-05,67635000,67750000,67640000,67755000,"chr14",518114,1,11,6,18,"chr14",1,0.040084388185654
"16918","chr14.102435000.102440000","chr14.102460000.102465000",25000,35,0.002569474,102435000,102460000,102440000,102465000,"chr14",518155,3,2,9,14,"chr14",1,0.0574308485700891
"16919","chr14.77780000.77785000","chr14.77920000.77925000",140000,17,0.0001599041,77780000,77920000,77785000,77925000,"chr14",518198,3,3,5,11,"chr14",1,0.0219174871073605
"16920","chr14.30005000.30010000","chr14.30495000.30500000",490000,9,0.003532756,30005000,30495000,30010000,30500000,"chr14",518200,0,3,0,3,"chr14",1,0.00316455696202532
"16921","chr14.77990000.77995000","chr14.78025000.78030000",35000,30,0.0004969798,77990000,78025000,77995000,78030000,"chr14",518300,0,5,6,11,"chr14",1,0.0386779184247539
"16922","chr14.99915000.99920000","chr14.100375000.100380000",460000,10,0.001068994,99915000,100375000,99920000,100380000,"chr14",518332,3,6,3,12,"chr14",1,0.0140646976090014
"16923","chr14.65040000.65045000","chr14.65160000.65165000",120000,15,0.004559122,65040000,65160000,65045000,65165000,"chr14",518360,2,12,5,19,"chr14",1,0.0334036568213783
"16924","chr14.73590000.73595000","chr14.73660000.73665000",70000,20,0.001624697,73590000,73660000,73595000,73665000,"chr14",518374,3,9,5,17,"chr14",1,0.0398499765588373
"16925","chr14.64995000.65000000","chr14.65100000.65105000",105000,29,3.163797e-11,64995000,65100000,6.5e+07,65105000,"chr14",518436,1,7,3,11,"chr14",1,0.0373886544772621
"16926","chr14.31450000.31455000","chr14.31560000.31565000",110000,16,0.002676957,31450000,31560000,31455000,31565000,"chr14",518497,4,1,8,13,"chr14",1,0.0243788091889358
"16927","chr14.23480000.23485000","chr14.23535000.23540000",55000,23,0.001160061,23480000,23535000,23485000,23540000,"chr14",518518,0,2,5,7,"chr14",1,0.0188701359587436
"16928","chr14.102265000.102270000","chr14.102320000.102325000",55000,27,1.906072e-05,102265000,102320000,102270000,102325000,"chr14",518588,3,10,5,18,"chr14",1,0.0569620253164557
"16929","chr14.50860000.50865000","chr14.50995000.51000000",135000,28,4.352308e-12,50860000,50995000,50865000,5.1e+07,"chr14",518612,0,5,9,14,"chr14",1,0.0459446788560713
"16930","chr14.67675000.67680000","chr14.67695000.67700000",20000,44,1.968028e-05,67675000,67695000,67680000,67700000,"chr14",518616,6,7,11,24,"chr14",1,0.123769338959212
"16931","chr14.23055000.23060000","chr14.23300000.23305000",245000,26,1.226212e-14,23055000,23300000,23060000,23305000,"chr14",518759,2,2,6,10,"chr14",1,0.0304735114861697
"16932","chr14.91360000.91365000","chr14.91635000.91640000",275000,30,9.889597e-20,91360000,91635000,91365000,91640000,"chr14",518859,5,8,9,22,"chr14",1,0.0773558368495077
"16933","chr14.93265000.93270000","chr14.93290000.93295000",25000,35,0.002569474,93265000,93290000,93270000,93295000,"chr14",518918,0,4,1,5,"chr14",1,0.0205110173464604
"16934","chr14.89485000.89490000","chr14.90405000.90410000",920000,13,6.283692e-09,89485000,90405000,89490000,90410000,"chr14",518929,1,1,2,4,"chr14",1,0.00609470229723394
"16935","chr14.77565000.77570000","chr14.77780000.77785000",215000,27,1.488317e-14,77565000,77780000,77570000,77785000,"chr14",518931,3,11,20,34,"chr14",1,0.107594936708861
"16936","chr14.90850000.90855000","chr14.91635000.91640000",785000,9,0.0002406318,90850000,91635000,90855000,91640000,"chr14",518955,0,5,7,12,"chr14",1,0.0126582278481013
"16937","chr14.94165000.94170000","chr14.94265000.94270000",100000,16,0.005072834,94165000,94265000,94170000,94270000,"chr14",519037,0,0,1,1,"chr14",1,0.00187529301453352
"16938","chr14.24680000.24685000","chr14.24710000.24715000",30000,38,6.328392e-06,24680000,24710000,24685000,24715000,"chr14",519098,0,0,3,3,"chr14",1,0.0133614627285513
"16939","chr14.23065000.23070000","chr14.23235000.23240000",170000,19,1.658466e-06,23065000,23235000,23070000,23240000,"chr14",519186,0,6,3,9,"chr14",1,0.020042194092827
"16940","chr14.74605000.74610000","chr14.74945000.74950000",340000,11,0.001215416,74605000,74945000,74610000,74950000,"chr14",519188,1,3,2,6,"chr14",1,0.00773558368495077
"16941","chr14.102235000.102240000","chr14.102445000.102450000",210000,15,0.0001011165,102235000,102445000,102240000,102450000,"chr14",519210,1,1,2,4,"chr14",1,0.0070323488045007
"16942","chr14.35630000.35635000","chr14.35825000.35830000",195000,13,0.002608249,35630000,35825000,35635000,35830000,"chr14",519330,1,6,5,12,"chr14",1,0.0182841068917018
"16943","chr14.102235000.102240000","chr14.102265000.102270000",30000,45,3.663786e-09,102235000,102265000,102240000,102270000,"chr14",519384,1,1,2,4,"chr14",1,0.0210970464135021
"16944","chr14.91455000.91460000","chr14.91505000.91510000",50000,28,2.370386e-05,91455000,91505000,91460000,91510000,"chr14",519409,3,8,5,16,"chr14",1,0.0525082044069386
"16945","chr14.50935000.50940000","chr14.50985000.50990000",50000,23,0.003007492,50935000,50985000,50940000,50990000,"chr14",519457,0,3,1,4,"chr14",1,0.0107829348335677
"16946","chr14.77550000.77555000","chr14.77800000.77805000",250000,12,0.001869736,77550000,77800000,77555000,77805000,"chr14",519478,3,8,8,19,"chr14",1,0.0267229254571027
"16947","chr14.90795000.90800000","chr14.90850000.90855000",55000,25,0.0001620049,90795000,90850000,90800000,90855000,"chr14",519525,0,5,6,11,"chr14",1,0.0322315986872949
"16948","chr14.90805000.90810000","chr14.90825000.90830000",20000,63,4.026298e-14,90805000,90825000,90810000,90830000,"chr14",519534,3,7,3,13,"chr14",1,0.0959915611814346
"16949","chr14.31950000.31955000","chr14.32720000.32725000",770000,8,0.001719053,31950000,32720000,31955000,32725000,"chr14",519535,1,2,0,3,"chr14",1,0.00281293952180028
"16950","chr14.77375000.77380000","chr14.77540000.77545000",165000,17,4.50258e-05,77375000,77540000,77380000,77545000,"chr14",519536,0,0,4,4,"chr14",1,0.00796999531176746
"16951","chr14.81505000.81510000","chr14.81590000.81595000",85000,18,0.002290551,81505000,81590000,81510000,81595000,"chr14",519600,1,8,4,13,"chr14",1,0.0274261603375527
"16952","chr14.89895000.89900000","chr14.89950000.89955000",55000,21,0.006689366,89895000,89950000,89900000,89955000,"chr14",519662,4,6,5,15,"chr14",1,0.0369198312236287
"16953","chr14.50770000.50775000","chr14.51250000.51255000",480000,9,0.003922175,50770000,51250000,50775000,51255000,"chr14",519667,1,1,2,4,"chr14",1,0.00421940928270042
"16954","chr14.91235000.91240000","chr14.91270000.91275000",35000,30,0.0004969798,91235000,91270000,91240000,91275000,"chr14",519672,3,10,12,25,"chr14",1,0.0879043600562588
"16955","chr14.90795000.90800000","chr14.90840000.90845000",45000,27,0.0002398135,90795000,90840000,90800000,90845000,"chr14",519695,1,11,6,18,"chr14",1,0.0569620253164557
"16956","chr14.22850000.22855000","chr14.23325000.23330000",475000,9,0.004136778,22850000,23325000,22855000,23330000,"chr14",519709,1,13,9,23,"chr14",1,0.0242616033755274
"16957","chr14.90725000.90730000","chr14.91360000.91365000",635000,9,0.0008664074,90725000,91360000,90730000,91365000,"chr14",519754,5,8,17,30,"chr14",1,0.0316455696202532
"16958","chr14.50795000.50800000","chr14.51000000.51005000",205000,22,9.382116e-10,50795000,5.1e+07,50800000,51005000,"chr14",519762,0,0,8,8,"chr14",1,0.0206282231598687
"16959","chr14.51450000.51455000","chr14.51505000.51510000",55000,24,0.0004493798,51450000,51505000,51455000,51510000,"chr14",519766,1,5,9,15,"chr14",1,0.0421940928270042
"16960","chr14.77310000.77315000","chr14.77550000.77555000",240000,12,0.002441612,77310000,77550000,77315000,77555000,"chr14",519772,0,8,3,11,"chr14",1,0.0154711673699015
"16961","chr14.90855000.90860000","chr14.91235000.91240000",380000,11,0.0006535428,90855000,91235000,90860000,91240000,"chr14",519808,2,7,14,23,"chr14",1,0.0296530707923113
"16962","chr14.50955000.50960000","chr14.50985000.50990000",30000,35,9.875529e-05,50955000,50985000,50960000,50990000,"chr14",519822,0,3,1,4,"chr14",1,0.0164088138771683
"16963","chr14.24275000.24280000","chr14.24330000.24335000",55000,21,0.006689366,24275000,24330000,24280000,24335000,"chr14",519827,1,5,3,9,"chr14",1,0.0221518987341772
"16964","chr14.90825000.90830000","chr14.91310000.91315000",485000,10,0.0007869971,90825000,91310000,90830000,91315000,"chr14",519874,3,11,13,27,"chr14",1,0.0316455696202532
"16965","chr14.103445000.103450000","chr14.103505000.103510000",60000,21,0.002898357,103445000,103505000,103450000,103510000,"chr14",519917,4,6,12,22,"chr14",1,0.0541490857946554
"16966","chr14.67705000.67710000","chr14.67750000.67755000",45000,62,4.700974e-27,67705000,67750000,67710000,67755000,"chr14",519952,4,11,18,33,"chr14",1,0.239803094233474
"16967","chr14.68475000.68480000","chr14.69310000.69315000",835000,9,0.0001613823,68475000,69310000,68480000,69315000,"chr14",519995,1,1,1,3,"chr14",1,0.00316455696202532
"16968","chr14.100295000.100300000","chr14.100315000.100320000",20000,38,0.001810636,100295000,100315000,100300000,100320000,"chr14",520095,5,8,14,27,"chr14",1,0.120253164556962
"16969","chr14.73790000.73795000","chr14.73895000.73900000",105000,18,0.0004036942,73790000,73895000,73795000,73900000,"chr14",520096,1,11,5,17,"chr14",1,0.0358649789029536
"16970","chr14.77425000.77430000","chr14.77495000.77500000",70000,35,2.909262e-12,77425000,77495000,77430000,77500000,"chr14",520119,3,17,4,24,"chr14",1,0.0984528832630098
"16971","chr14.89935000.89940000","chr14.90330000.90335000",395000,9,0.009775897,89935000,90330000,89940000,90335000,"chr14",520173,4,18,17,39,"chr14",1,0.0411392405063291
"16972","chr14.102235000.102240000","chr14.102415000.102420000",180000,27,3.503839e-13,102235000,102415000,102240000,102420000,"chr14",520182,0,1,2,3,"chr14",1,0.00949367088607595
"16973","chr14.65140000.65145000","chr14.65160000.65165000",20000,40,0.0004516266,65140000,65160000,65145000,65165000,"chr14",520239,3,13,10,26,"chr14",1,0.121894045944679
"16974","chr14.60185000.60190000","chr14.60325000.60330000",140000,15,0.001875477,60185000,60325000,60190000,60330000,"chr14",520243,2,4,4,10,"chr14",1,0.0175808720112518
"16975","chr14.23065000.23070000","chr14.23360000.23365000",295000,10,0.009775897,23065000,23360000,23070000,23365000,"chr14",520285,0,5,3,8,"chr14",1,0.00937646507266761
"16976","chr14.69360000.69365000","chr14.69545000.69550000",185000,18,3.420176e-06,69360000,69545000,69365000,69550000,"chr14",520309,2,8,4,14,"chr14",1,0.029535864978903
"16977","chr14.59125000.59130000","chr14.59505000.59510000",380000,11,0.0006535428,59125000,59505000,59130000,59510000,"chr14",520320,1,8,7,16,"chr14",1,0.0206282231598687
"16978","chr14.73140000.73145000","chr14.73355000.73360000",215000,13,0.001353966,73140000,73355000,73145000,73360000,"chr14",520363,2,10,7,19,"chr14",1,0.0289498359118612
"16979","chr14.50950000.50955000","chr14.50995000.51000000",45000,23,0.007600586,50950000,50995000,50955000,5.1e+07,"chr14",520517,1,6,4,11,"chr14",1,0.0296530707923113
"16980","chr14.90840000.90845000","chr14.90975000.90980000",135000,14,0.006894153,90840000,90975000,90845000,90980000,"chr14",520542,0,7,8,15,"chr14",1,0.0246132208157525
"16981","chr14.77315000.77320000","chr14.77760000.77765000",445000,9,0.005728642,77315000,77760000,77320000,77765000,"chr14",520576,3,4,7,14,"chr14",1,0.0147679324894515
"16982","chr14.93180000.93185000","chr14.93265000.93270000",85000,21,8.163305e-05,93180000,93265000,93185000,93270000,"chr14",520607,0,4,1,5,"chr14",1,0.0123066104078762
"16983","chr14.59580000.59585000","chr14.59915000.59920000",335000,10,0.00534322,59580000,59915000,59585000,59920000,"chr14",520620,1,2,5,8,"chr14",1,0.00937646507266761
"16984","chr14.76915000.76920000","chr14.76935000.76940000",20000,38,0.001810636,76915000,76935000,76920000,76940000,"chr14",520628,1,2,6,9,"chr14",1,0.040084388185654
"16985","chr14.73645000.73650000","chr14.73750000.73755000",105000,21,8.553724e-06,73645000,73750000,73650000,73755000,"chr14",520680,2,2,6,10,"chr14",1,0.0246132208157525
"16986","chr14.73755000.73760000","chr14.73950000.73955000",195000,12,0.008370895,73755000,73950000,73760000,73955000,"chr14",520692,3,3,2,8,"chr14",1,0.0112517580872011
"16987","chr14.21105000.21110000","chr14.21135000.21140000",30000,30,0.005006818,21105000,21135000,21110000,21140000,"chr14",520749,2,7,6,15,"chr14",1,0.0527426160337553
"16988","chr14.51450000.51455000","chr14.51555000.51560000",105000,70,4.341761e-52,51450000,51555000,51455000,51560000,"chr14",520761,1,7,11,19,"chr14",1,0.155883731833099
"16989","chr14.91310000.91315000","chr14.91360000.91365000",50000,32,2.232399e-07,91310000,91360000,91315000,91365000,"chr14",520794,3,8,13,24,"chr14",1,0.090014064697609
"16990","chr14.91235000.91240000","chr14.91635000.91640000",400000,10,0.002295126,91235000,91635000,91240000,91640000,"chr14",520796,3,9,9,21,"chr14",1,0.0246132208157525
"16991","chr14.75855000.75860000","chr14.75910000.75915000",55000,21,0.006689366,75855000,75910000,75860000,75915000,"chr14",520819,1,5,5,11,"chr14",1,0.0270745428973277
"16992","chr14.102445000.102450000","chr14.102470000.102475000",25000,38,0.0002904985,102445000,102470000,102450000,102475000,"chr14",520821,8,34,16,58,"chr14",1,0.258321612751993
"16993","chr14.71690000.71695000","chr14.71960000.71965000",270000,11,0.004360978,71690000,71960000,71695000,71965000,"chr14",520963,0,2,1,3,"chr14",1,0.00386779184247539
"16994","chr14.71960000.71965000","chr14.72020000.72025000",60000,20,0.006908664,71960000,72020000,71965000,72025000,"chr14",520969,0,2,1,3,"chr14",1,0.0070323488045007
"16995","chr14.64220000.64225000","chr14.64785000.64790000",565000,9,0.001653099,64220000,64785000,64225000,64790000,"chr14",520974,2,4,3,9,"chr14",1,0.00949367088607595
"16996","chr14.50105000.50110000","chr14.50230000.50235000",125000,41,3.216556e-23,50105000,50230000,50110000,50235000,"chr14",520981,5,8,7,20,"chr14",1,0.0961087669948429
"16997","chr14.23445000.23450000","chr14.23535000.23540000",90000,18,0.001414052,23445000,23535000,23450000,23540000,"chr14",520999,1,4,1,6,"chr14",1,0.0126582278481013
"16998","chr14.102435000.102440000","chr14.102985000.102990000",550000,8,0.008884369,102435000,102985000,102440000,102990000,"chr14",521048,3,2,9,14,"chr14",1,0.0131270511017346
"16999","chr14.77425000.77430000","chr14.77540000.77545000",115000,16,0.002007903,77425000,77540000,77430000,77545000,"chr14",521120,3,9,7,19,"chr14",1,0.0356305672761369
"17000","chr14.77375000.77380000","chr14.77585000.77590000",210000,16,2.294521e-05,77375000,77585000,77380000,77590000,"chr14",521144,0,0,4,4,"chr14",1,0.00750117205813408
"17001","chr14.89485000.89490000","chr14.90165000.90170000",680000,9,0.0005765573,89485000,90165000,89490000,90170000,"chr14",521152,1,3,2,6,"chr14",1,0.00632911392405063
"17002","chr14.35155000.35160000","chr14.35340000.35345000",185000,14,0.001065664,35155000,35340000,35160000,35345000,"chr14",521160,2,6,7,15,"chr14",1,0.0246132208157525
"17003","chr14.68345000.68350000","chr14.69310000.69315000",965000,15,1.349018e-11,68345000,69310000,68350000,69315000,"chr14",521227,2,7,7,16,"chr14",1,0.0281293952180028
"17004","chr14.50105000.50110000","chr14.50310000.50315000",205000,13,0.001873389,50105000,50310000,50110000,50315000,"chr14",521237,5,9,7,21,"chr14",1,0.0319971870604782
"17005","chr14.54000000.54005000","chr14.54805000.54810000",805000,11,3.178663e-06,5.4e+07,54805000,54005000,54810000,"chr14",521255,0,5,8,13,"chr14",1,0.0167604313173933
"17006","chr14.21865000.21870000","chr14.21915000.21920000",50000,24,0.001251694,21865000,21915000,21870000,21920000,"chr14",521275,1,7,10,18,"chr14",1,0.0506329113924051
"17007","chr14.23940000.23945000","chr14.24035000.24040000",95000,23,1.67819e-06,23940000,24035000,23945000,24040000,"chr14",521297,0,2,0,2,"chr14",1,0.00539146741678387
"17008","chr14.23035000.23040000","chr14.23070000.23075000",35000,29,0.001160061,23035000,23070000,23040000,23075000,"chr14",521314,0,8,9,17,"chr14",1,0.0577824660103141
"17009","chr14.73640000.73645000","chr14.73950000.73955000",310000,10,0.007618584,73640000,73950000,73645000,73955000,"chr14",521324,8,34,48,90,"chr14",1,0.105485232067511
"17010","chr14.71290000.71295000","chr14.71430000.71435000",140000,18,4.231874e-05,71290000,71430000,71295000,71435000,"chr14",521334,4,5,7,16,"chr14",1,0.0337552742616034
"17011","chr14.77410000.77415000","chr14.77565000.77570000",155000,15,0.001007124,77410000,77565000,77415000,77570000,"chr14",521353,3,11,20,34,"chr14",1,0.059774964838256
"17012","chr14.90850000.90855000","chr14.91225000.91230000",375000,12,0.000144153,90850000,91225000,90855000,91230000,"chr14",521391,0,5,2,7,"chr14",1,0.00984528832630099
"17013","chr14.67695000.67700000","chr14.67815000.67820000",120000,15,0.004559122,67695000,67815000,67700000,67820000,"chr14",521421,4,7,11,22,"chr14",1,0.0386779184247539
"17014","chr14.55070000.55075000","chr14.55125000.55130000",55000,26,5.703657e-05,55070000,55125000,55075000,55130000,"chr14",521427,0,2,2,4,"chr14",1,0.0121894045944679
"17015","chr14.79480000.79485000","chr14.80270000.80275000",790000,9,0.0002318334,79480000,80270000,79485000,80275000,"chr14",521461,1,2,2,5,"chr14",1,0.00527426160337553
"17016","chr14.56545000.56550000","chr14.56575000.56580000",30000,42,1.037543e-07,56545000,56575000,56550000,56580000,"chr14",521506,0,1,1,2,"chr14",1,0.00984528832630099
"17017","chr14.50860000.50865000","chr14.51010000.51015000",150000,18,2.382667e-05,50860000,51010000,50865000,51015000,"chr14",521516,0,4,4,8,"chr14",1,0.0168776371308017
"17018","chr14.75790000.75795000","chr14.75855000.75860000",65000,19,0.007907143,75790000,75855000,75795000,75860000,"chr14",521531,1,8,5,14,"chr14",1,0.0311767463666198
"17019","chr14.75855000.75860000","chr14.75875000.75880000",20000,36,0.006432007,75855000,75875000,75860000,75880000,"chr14",521556,0,3,2,5,"chr14",1,0.0210970464135021
"17020","chr14.23235000.23240000","chr14.23305000.23310000",70000,19,0.004207485,23235000,23305000,23240000,23310000,"chr14",521570,0,6,1,7,"chr14",1,0.0155883731833099
"17021","chr14.50335000.50340000","chr14.50555000.50560000",220000,13,0.001163082,50335000,50555000,50340000,50560000,"chr14",521581,4,7,11,22,"chr14",1,0.0335208626347867
"17022","chr14.50790000.50795000","chr14.50995000.51000000",205000,34,4.652161e-21,50790000,50995000,50795000,5.1e+07,"chr14",521646,1,1,2,4,"chr14",1,0.0159399906235349
"17023","chr14.92585000.92590000","chr14.93265000.93270000",680000,11,1.229736e-05,92585000,93265000,92590000,93270000,"chr14",521690,0,4,1,5,"chr14",1,0.00644631973745898
"17024","chr14.102235000.102240000","chr14.102775000.102780000",540000,11,6.831422e-05,102235000,102775000,102240000,102780000,"chr14",521723,1,1,2,4,"chr14",1,0.00515705578996718
"17025","chr14.102235000.102240000","chr14.102360000.102365000",125000,16,0.001166956,102235000,102360000,102240000,102365000,"chr14",521728,0,1,2,3,"chr14",1,0.00562587904360056
"17026","chr14.102435000.102440000","chr14.102775000.102780000",340000,10,0.005006818,102435000,102775000,102440000,102780000,"chr14",521755,3,2,8,13,"chr14",1,0.0152367557430849
"17027","chr14.103545000.103550000","chr14.103745000.103750000",200000,13,0.002239794,103545000,103745000,103550000,103750000,"chr14",521768,0,2,0,2,"chr14",1,0.00304735114861697
"17028","chr14.50790000.50795000","chr14.50855000.50860000",65000,21,0.001271444,50790000,50855000,50795000,50860000,"chr14",521817,1,1,2,4,"chr14",1,0.00984528832630099
"17029","chr14.69005000.69010000","chr14.69085000.69090000",80000,19,0.0013419,69005000,69085000,69010000,69090000,"chr14",521830,0,3,4,7,"chr14",1,0.0155883731833099
"17030","chr14.35220000.35225000","chr14.35410000.35415000",190000,14,0.0008893257,35220000,35410000,35225000,35415000,"chr14",521838,0,3,1,4,"chr14",1,0.00656352555086732
"17031","chr14.91910000.91915000","chr14.91945000.91950000",35000,40,1.731693e-08,91910000,91945000,91915000,91950000,"chr14",521903,0,2,1,3,"chr14",1,0.0140646976090014
"17032","chr14.23570000.23575000","chr14.23770000.23775000",200000,12,0.007253688,23570000,23770000,23575000,23775000,"chr14",521916,0,2,2,4,"chr14",1,0.00562587904360056
"17033","chr14.102235000.102240000","chr14.102310000.102315000",75000,33,1.804781e-11,102235000,102310000,102240000,102315000,"chr14",521979,1,1,2,4,"chr14",1,0.0154711673699015
"17034","chr14.96560000.96565000","chr14.96760000.96765000",200000,13,0.002239794,96560000,96760000,96565000,96765000,"chr14",522030,0,2,1,3,"chr14",1,0.00457102672292546
"17035","chr14.81450000.81455000","chr14.81625000.81630000",175000,15,0.0004363719,81450000,81625000,81455000,81630000,"chr14",522076,0,6,3,9,"chr14",1,0.0158227848101266
"17036","chr14.99985000.99990000","chr14.100065000.100070000",80000,17,0.00932719,99985000,100065000,99990000,100070000,"chr14",522094,1,9,3,13,"chr14",1,0.0259024847632443
"17037","chr14.50835000.50840000","chr14.50860000.50865000",25000,40,5.831079e-05,50835000,50860000,50840000,50865000,"chr14",522161,0,5,9,14,"chr14",1,0.0656352555086732
"17038","chr14.73610000.73615000","chr14.73750000.73755000",140000,15,0.001875477,73610000,73750000,73615000,73755000,"chr14",522172,2,2,6,10,"chr14",1,0.0175808720112518
"17039","chr14.50860000.50865000","chr14.50955000.50960000",95000,21,2.489743e-05,50860000,50955000,50865000,50960000,"chr14",522174,0,5,9,14,"chr14",1,0.0344585091420534
"17040","chr14.51480000.51485000","chr14.51555000.51560000",75000,39,5.683593e-16,51480000,51555000,51485000,51560000,"chr14",522197,0,2,3,5,"chr14",1,0.0228551336146273
"17041","chr14.67615000.67620000","chr14.67750000.67755000",135000,14,0.006894153,67615000,67750000,67620000,67755000,"chr14",522198,4,11,12,27,"chr14",1,0.0443037974683544
"17042","chr14.32545000.32550000","chr14.32940000.32945000",395000,14,2.864222e-06,32545000,32940000,32550000,32945000,"chr14",522214,0,3,0,3,"chr14",1,0.00492264416315049
"17043","chr14.102890000.102895000","chr14.102985000.102990000",95000,16,0.007111399,102890000,102985000,102895000,102990000,"chr14",522287,3,6,8,17,"chr14",1,0.0318799812470699
"17044","chr14.74290000.74295000","chr14.74550000.74555000",260000,12,0.001449769,74290000,74550000,74295000,74555000,"chr14",522314,0,1,1,2,"chr14",1,0.00281293952180028
"17045","chr14.50905000.50910000","chr14.50960000.50965000",55000,21,0.006689366,50905000,50960000,50910000,50965000,"chr14",522315,0,3,0,3,"chr14",1,0.00738396624472574
"17046","chr14.65015000.65020000","chr14.65080000.65085000",65000,19,0.007907143,65015000,65080000,65020000,65085000,"chr14",522341,2,0,2,4,"chr14",1,0.00890764181903422
"17047","chr14.65025000.65030000","chr14.65080000.65085000",55000,27,1.906072e-05,65025000,65080000,65030000,65085000,"chr14",522354,2,0,2,4,"chr14",1,0.0126582278481013
"17048","chr14.60180000.60185000","chr14.60350000.60355000",170000,14,0.001860181,60180000,60350000,60185000,60355000,"chr14",522360,4,5,2,11,"chr14",1,0.0180496952648851
"17049","chr14.32560000.32565000","chr14.32645000.32650000",85000,17,0.006029456,32560000,32645000,32565000,32650000,"chr14",522392,0,6,7,13,"chr14",1,0.0259024847632443
"17050","chr14.66425000.66430000","chr14.66535000.66540000",110000,16,0.002676957,66425000,66535000,66430000,66540000,"chr14",522409,1,1,3,5,"chr14",1,0.00937646507266761
"17051","chr14.90770000.90775000","chr14.90850000.90855000",80000,24,3.75964e-06,90770000,90850000,90775000,90855000,"chr14",522429,0,5,6,11,"chr14",1,0.0309423347398031
"17052","chr14.67620000.67625000","chr14.67750000.67755000",130000,15,0.002883085,67620000,67750000,67625000,67755000,"chr14",522461,3,11,6,20,"chr14",1,0.0351617440225035
"17053","chr14.78220000.78225000","chr14.78250000.78255000",30000,29,0.009775897,78220000,78250000,78225000,78255000,"chr14",522465,0,0,2,2,"chr14",1,0.00679793717768401
"17054","chr14.95560000.95565000","chr14.95895000.95900000",335000,19,6.02521e-10,95560000,95895000,95565000,95900000,"chr14",522512,3,6,1,10,"chr14",1,0.0222691045475856
"17055","chr14.102515000.102520000","chr14.102775000.102780000",260000,11,0.005393391,102515000,102775000,102520000,102780000,"chr14",522563,5,7,8,20,"chr14",1,0.0257852789498359
"17056","chr14.95155000.95160000","chr14.95895000.95900000",740000,8,0.002136162,95155000,95895000,95160000,95900000,"chr14",522567,0,4,1,5,"chr14",1,0.0046882325363338
"17057","chr14.91925000.91930000","chr14.92360000.92365000",435000,9,0.006349867,91925000,92360000,91930000,92365000,"chr14",522569,2,0,3,5,"chr14",1,0.00527426160337553
"17058","chr14.91320000.91325000","chr14.91360000.91365000",40000,26,0.002351642,91320000,91360000,91325000,91365000,"chr14",522572,0,2,2,4,"chr14",1,0.0121894045944679
"17059","chr14.50800000.50805000","chr14.50985000.50990000",185000,20,1.245542e-07,50800000,50985000,50805000,50990000,"chr14",522573,0,3,1,4,"chr14",1,0.00937646507266761
"17060","chr14.70070000.70075000","chr14.70175000.70180000",105000,16,0.003614085,70070000,70175000,70075000,70180000,"chr14",522574,0,2,0,2,"chr14",1,0.00375058602906704
"17061","chr14.77565000.77570000","chr14.77585000.77590000",20000,96,2.654889e-35,77565000,77585000,77570000,77590000,"chr14",522698,3,11,20,34,"chr14",1,0.382559774964838
"17062","chr14.102235000.102240000","chr14.102305000.102310000",70000,32,3.483406e-10,102235000,102305000,102240000,102310000,"chr14",522822,1,1,2,4,"chr14",1,0.0150023441162682
"17063","chr14.50345000.50350000","chr14.50770000.50775000",425000,9,0.007013364,50345000,50770000,50350000,50775000,"chr14",522825,1,2,2,5,"chr14",1,0.00527426160337553
"17064","chr14.90820000.90825000","chr14.91125000.91130000",305000,10,0.008297014,90820000,91125000,90825000,91130000,"chr14",522844,3,8,14,25,"chr14",1,0.0293014533520863
"17065","chr14.103545000.103550000","chr14.103725000.103730000",180000,17,2.064505e-05,103545000,103725000,103550000,103730000,"chr14",522866,0,4,0,4,"chr14",1,0.00796999531176746
"17066","chr14.102445000.102450000","chr14.102775000.102780000",330000,14,1.16863e-05,102445000,102775000,102450000,102780000,"chr14",522868,5,7,8,20,"chr14",1,0.0328176277543366
"17067","chr14.89485000.89490000","chr14.90370000.90375000",885000,11,1.334016e-06,89485000,90370000,89490000,90375000,"chr14",522931,3,3,4,10,"chr14",1,0.012892639474918
"17068","chr14.89490000.89495000","chr14.90395000.90400000",905000,12,9.513946e-08,89490000,90395000,89495000,90400000,"chr14",522953,0,3,0,3,"chr14",1,0.00421940928270042
"17069","chr14.73770000.73775000","chr14.73900000.73905000",130000,20,4.530856e-06,73770000,73900000,73775000,73905000,"chr14",522994,0,3,3,6,"chr14",1,0.0140646976090014
"17070","chr14.50795000.50800000","chr14.50960000.50965000",165000,21,8.79304e-08,50795000,50960000,50800000,50965000,"chr14",523014,0,9,5,14,"chr14",1,0.0344585091420534
"17071","chr14.37030000.37035000","chr14.37055000.37060000",25000,45,6.449093e-07,37030000,37055000,37035000,37060000,"chr14",523028,0,0,3,3,"chr14",1,0.0158227848101266
"17072","chr14.81460000.81465000","chr14.81530000.81535000",70000,19,0.004207485,81460000,81530000,81465000,81535000,"chr14",523036,2,0,2,4,"chr14",1,0.00890764181903422
"17073","chr14.89465000.89470000","chr14.90275000.90280000",810000,7,0.007242185,89465000,90275000,89470000,90280000,"chr14",523088,0,0,3,3,"chr14",1,0.00246132208157525
"17074","chr14.61935000.61940000","chr14.62160000.62165000",225000,20,1.127446e-08,61935000,62160000,61940000,62165000,"chr14",523090,0,2,0,2,"chr14",1,0.0046882325363338
"17075","chr14.31935000.31940000","chr14.32645000.32650000",710000,9,0.0004516266,31935000,32645000,31940000,32650000,"chr14",523093,1,1,4,6,"chr14",1,0.00632911392405063
"17076","chr14.95480000.95485000","chr14.95560000.95565000",80000,17,0.00932719,95480000,95560000,95485000,95565000,"chr14",523106,0,3,1,4,"chr14",1,0.00796999531176746
"17077","chr14.24795000.24800000","chr14.24910000.24915000",115000,15,0.00580482,24795000,24910000,24800000,24915000,"chr14",523185,1,1,1,3,"chr14",1,0.00527426160337553
"17078","chr14.70070000.70075000","chr14.70155000.70160000",85000,18,0.002290551,70070000,70155000,70075000,70160000,"chr14",523232,0,2,0,2,"chr14",1,0.00421940928270042
"17079","chr14.55050000.55055000","chr14.55070000.55075000",20000,54,1.389292e-09,55050000,55070000,55055000,55075000,"chr14",523327,2,6,5,13,"chr14",1,0.0822784810126582
"17080","chr14.77800000.77805000","chr14.77835000.77840000",35000,31,0.0002093662,77800000,77835000,77805000,77840000,"chr14",523352,3,8,14,25,"chr14",1,0.0908345053914674
"17081","chr14.56335000.56340000","chr14.56545000.56550000",210000,13,0.001598457,56335000,56545000,56340000,56550000,"chr14",523356,0,1,1,2,"chr14",1,0.00304735114861697
"17082","chr14.50335000.50340000","chr14.50355000.50360000",20000,42,9.875529e-05,50335000,50355000,50340000,50360000,"chr14",523368,0,2,1,3,"chr14",1,0.0147679324894515
"17083","chr14.91365000.91370000","chr14.91575000.91580000",210000,21,4.310318e-09,91365000,91575000,91370000,91580000,"chr14",523427,0,6,2,8,"chr14",1,0.019690576652602
"17084","chr14.68730000.68735000","chr14.69295000.69300000",565000,11,4.942072e-05,68730000,69295000,68735000,69300000,"chr14",523430,0,4,3,7,"chr14",1,0.00902484763244257
"17085","chr14.67650000.67655000","chr14.67695000.67700000",45000,34,1.10527e-07,67650000,67695000,67655000,67700000,"chr14",523437,3,7,11,21,"chr14",1,0.0836849507735584
"17086","chr14.102235000.102240000","chr14.102460000.102465000",225000,12,0.003600476,102235000,102460000,102240000,102465000,"chr14",523461,1,1,2,4,"chr14",1,0.00562587904360056
"17087","chr14.75660000.75665000","chr14.75720000.75725000",60000,20,0.006908664,75660000,75720000,75665000,75725000,"chr14",523463,0,7,7,14,"chr14",1,0.0328176277543366
"17088","chr14.91395000.91400000","chr14.91635000.91640000",240000,13,0.0006250009,91395000,91635000,91400000,91640000,"chr14",523499,5,6,9,20,"chr14",1,0.0304735114861697
"17089","chr14.102275000.102280000","chr14.102305000.102310000",30000,32,0.001160061,102275000,102305000,102280000,102310000,"chr14",523572,9,7,22,38,"chr14",1,0.142522269104548
"17090","chr14.90725000.90730000","chr14.91270000.91275000",545000,10,0.0003891405,90725000,91270000,90730000,91275000,"chr14",523670,4,10,12,26,"chr14",1,0.0304735114861697
"17091","chr14.90730000.90735000","chr14.91300000.91305000",570000,8,0.00747829,90730000,91300000,90735000,91305000,"chr14",523695,2,10,6,18,"chr14",1,0.0168776371308017
"17092","chr14.50855000.50860000","chr14.50960000.50965000",105000,16,0.003614085,50855000,50960000,50860000,50965000,"chr14",523713,0,9,5,14,"chr14",1,0.0262541022034693
"17093","chr14.58125000.58130000","chr14.58530000.58535000",405000,10,0.00215308,58125000,58530000,58130000,58535000,"chr14",523784,0,0,1,1,"chr14",1,0.00117205813408345
"17094","chr14.74110000.74115000","chr14.74290000.74295000",180000,13,0.004262602,74110000,74290000,74115000,74295000,"chr14",523827,0,2,1,3,"chr14",1,0.00457102672292546
"17095","chr14.102230000.102235000","chr14.102315000.102320000",85000,23,6.601484e-06,102230000,102315000,102235000,102320000,"chr14",523838,1,0,1,2,"chr14",1,0.00539146741678387
"17096","chr14.50060000.50065000","chr14.50230000.50235000",170000,14,0.001860181,50060000,50230000,50065000,50235000,"chr14",523895,2,2,6,10,"chr14",1,0.0164088138771683
"17097","chr14.90770000.90775000","chr14.91240000.91245000",470000,9,0.004360978,90770000,91240000,90775000,91245000,"chr14",523896,3,2,6,11,"chr14",1,0.0116033755274262
"17098","chr14.90755000.90760000","chr14.91255000.91260000",500000,9,0.003193849,90755000,91255000,90760000,91260000,"chr14",523906,3,11,13,27,"chr14",1,0.0284810126582278
"17099","chr14.67615000.67620000","chr14.67735000.67740000",120000,16,0.001517054,67615000,67735000,67620000,67740000,"chr14",523936,5,11,12,28,"chr14",1,0.0525082044069386
"17100","chr14.64010000.64015000","chr14.64195000.64200000",185000,14,0.001065664,64010000,64195000,64015000,64200000,"chr14",523984,0,3,2,5,"chr14",1,0.00820440693858415
"17101","chr14.32040000.32045000","chr14.32560000.32565000",520000,9,0.002608192,32040000,32560000,32045000,32565000,"chr14",523991,0,6,2,8,"chr14",1,0.00843881856540084
"17102","chr14.88710000.88715000","chr14.88825000.88830000",115000,15,0.00580482,88710000,88825000,88715000,88830000,"chr14",524024,0,1,4,5,"chr14",1,0.00879043600562588
"17103","chr14.58570000.58575000","chr14.58605000.58610000",35000,32,8.497712e-05,58570000,58605000,58575000,58610000,"chr14",524053,0,3,2,5,"chr14",1,0.0187529301453352
"17104","chr14.90795000.90800000","chr14.90855000.90860000",60000,25,5.226859e-05,90795000,90855000,90800000,90860000,"chr14",524070,1,7,6,14,"chr14",1,0.0410220346929208
"17105","chr14.103445000.103450000","chr14.103525000.103530000",80000,23,1.376023e-05,103445000,103525000,103450000,103530000,"chr14",524081,4,16,16,36,"chr14",1,0.0970464135021097
"17106","chr14.68360000.68365000","chr14.69295000.69300000",935000,7,0.003389125,68360000,69295000,68365000,69300000,"chr14",524094,0,5,0,5,"chr14",1,0.00410220346929208
"17107","chr14.50800000.50805000","chr14.50950000.50955000",150000,15,0.001239412,50800000,50950000,50805000,50955000,"chr14",524106,1,7,3,11,"chr14",1,0.0193389592123769
"17108","chr14.103020000.103025000","chr14.103725000.103730000",705000,8,0.002698791,103020000,103725000,103025000,103730000,"chr14",524156,0,4,0,4,"chr14",1,0.00375058602906704
"17109","chr14.65000000.65005000","chr14.65140000.65145000",140000,14,0.005749199,6.5e+07,65140000,65005000,65145000,"chr14",524193,1,6,3,10,"chr14",1,0.0164088138771683
"17110","chr14.93430000.93435000","chr14.93615000.93620000",185000,13,0.003596248,93430000,93615000,93435000,93620000,"chr14",524244,1,1,1,3,"chr14",1,0.00457102672292546
"17111","chr14.23030000.23035000","chr14.23325000.23330000",295000,16,8.565759e-07,23030000,23325000,23035000,23330000,"chr14",524248,6,13,18,37,"chr14",1,0.0693858415377403
"17112","chr14.73490000.73495000","chr14.73750000.73755000",260000,11,0.005393391,73490000,73750000,73495000,73755000,"chr14",524252,2,2,6,10,"chr14",1,0.012892639474918
"17113","chr14.50790000.50795000","chr14.51010000.51015000",220000,20,1.508164e-08,50790000,51010000,50795000,51015000,"chr14",524254,1,1,2,4,"chr14",1,0.00937646507266761
"17114","chr14.68910000.68915000","chr14.69295000.69300000",385000,12,0.0001218958,68910000,69295000,68915000,69300000,"chr14",524257,3,4,3,10,"chr14",1,0.0140646976090014
"17115","chr14.96490000.96495000","chr14.96795000.96800000",305000,13,0.000110873,96490000,96795000,96495000,96800000,"chr14",524306,1,1,4,6,"chr14",1,0.00914205344585091
"17116","chr14.74215000.74220000","chr14.74295000.74300000",80000,17,0.00932719,74215000,74295000,74220000,74300000,"chr14",524328,1,13,13,27,"chr14",1,0.0537974683544304
"17117","chr14.100020000.100025000","chr14.100045000.100050000",25000,39,0.000132513,100020000,100045000,100025000,100050000,"chr14",524469,2,3,5,10,"chr14",1,0.0457102672292546
"17118","chr14.70085000.70090000","chr14.70175000.70180000",90000,23,3.299755e-06,70085000,70175000,70090000,70180000,"chr14",524490,0,2,0,2,"chr14",1,0.00539146741678387
"17119","chr14.81460000.81465000","chr14.81625000.81630000",165000,21,8.79304e-08,81460000,81625000,81465000,81630000,"chr14",524505,0,6,3,9,"chr14",1,0.0221518987341772
"17120","chr14.91225000.91230000","chr14.91635000.91640000",410000,9,0.008297014,91225000,91635000,91230000,91640000,"chr14",524588,3,5,2,10,"chr14",1,0.0105485232067511
"17121","chr14.64955000.64960000","chr14.65000000.65005000",45000,23,0.007600586,64955000,6.5e+07,64960000,65005000,"chr14",524616,1,6,3,10,"chr14",1,0.0269573370839194
"17122","chr14.58810000.58815000","chr14.58865000.58870000",55000,21,0.006689366,58810000,58865000,58815000,58870000,"chr14",524628,0,3,3,6,"chr14",1,0.0147679324894515
"17123","chr14.50790000.50795000","chr14.51040000.51045000",250000,11,0.006694501,50790000,51040000,50795000,51045000,"chr14",524659,1,1,2,4,"chr14",1,0.00515705578996718
"17124","chr14.99985000.99990000","chr14.100020000.100025000",35000,28,0.002552297,99985000,100020000,99990000,100025000,"chr14",524714,1,9,3,13,"chr14",1,0.0426629160806376
"17125","chr14.60220000.60225000","chr14.60245000.60250000",25000,35,0.002569474,60220000,60245000,60225000,60250000,"chr14",524975,0,0,3,3,"chr14",1,0.0123066104078762
"17126","chr14.100660000.100665000","chr14.100705000.100710000",45000,25,0.001492163,100660000,100705000,100665000,100710000,"chr14",524986,0,3,1,4,"chr14",1,0.0117205813408345
"17127","chr14.77375000.77380000","chr14.77760000.77765000",385000,12,0.0001218958,77375000,77760000,77380000,77765000,"chr14",525011,0,0,4,4,"chr14",1,0.00562587904360056
"17128","chr14.90770000.90775000","chr14.91175000.91180000",405000,12,8.7745e-05,90770000,91175000,90775000,91180000,"chr14",525025,4,5,6,15,"chr14",1,0.0210970464135021
"17129","chr14.32005000.32010000","chr14.32940000.32945000",935000,7,0.003389125,32005000,32940000,32010000,32945000,"chr14",525065,0,3,0,3,"chr14",1,0.00246132208157525
"17130","chr14.102320000.102325000","chr14.102340000.102345000",20000,50,8.300927e-08,102320000,102340000,102325000,102345000,"chr14",525086,4,10,5,19,"chr14",1,0.111345522737928
"17131","chr14.90855000.90860000","chr14.91360000.91365000",505000,11,0.0001087035,90855000,91360000,90860000,91365000,"chr14",525129,2,7,14,23,"chr14",1,0.0296530707923113
"17132","chr14.102235000.102240000","chr14.102315000.102320000",80000,23,1.376023e-05,102235000,102315000,102240000,102320000,"chr14",525135,1,1,2,4,"chr14",1,0.0107829348335677
"17133","chr14.70105000.70110000","chr14.70155000.70160000",50000,22,0.006864315,70105000,70155000,70110000,70160000,"chr14",525171,0,5,1,6,"chr14",1,0.0154711673699015
"17134","chr14.102265000.102270000","chr14.102775000.102780000",510000,9,0.002883085,102265000,102775000,102270000,102780000,"chr14",525183,3,7,8,18,"chr14",1,0.0189873417721519
"17135","chr14.50790000.50795000","chr14.50860000.50865000",70000,29,2.884982e-08,50790000,50860000,50795000,50865000,"chr14",525221,0,1,2,3,"chr14",1,0.010196905766526
"17136","chr14.96500000.96505000","chr14.96560000.96565000",60000,23,0.0004358361,96500000,96560000,96505000,96565000,"chr14",525276,0,4,2,6,"chr14",1,0.0161744022503516
"17137","chr14.102235000.102240000","chr14.102275000.102280000",40000,62,5.827217e-25,102235000,102275000,102240000,102280000,"chr14",525282,1,1,2,4,"chr14",1,0.0290670417252696
"17138","chr14.90805000.90810000","chr14.91270000.91275000",465000,9,0.004631469,90805000,91270000,90810000,91275000,"chr14",525332,3,7,3,13,"chr14",1,0.0137130801687764
"17139","chr14.91365000.91370000","chr14.91505000.91510000",140000,21,5.053344e-07,91365000,91505000,91370000,91510000,"chr14",525347,0,6,2,8,"chr14",1,0.019690576652602
"17140","chr14.73565000.73570000","chr14.74400000.74405000",835000,10,2.057687e-05,73565000,74400000,73570000,74405000,"chr14",525368,3,8,4,15,"chr14",1,0.0175808720112518
"17141","chr14.51010000.51015000","chr14.51235000.51240000",225000,15,5.703657e-05,51010000,51235000,51015000,51240000,"chr14",525369,3,4,4,11,"chr14",1,0.0193389592123769
"17142","chr14.75400000.75405000","chr14.75790000.75795000",390000,10,0.002592257,75400000,75790000,75405000,75795000,"chr14",525382,2,3,4,9,"chr14",1,0.0105485232067511
"17143","chr14.65040000.65045000","chr14.65100000.65105000",60000,39,1.853473e-13,65040000,65100000,65045000,65105000,"chr14",525415,1,8,3,12,"chr14",1,0.0548523206751055
"17144","chr14.50345000.50350000","chr14.50555000.50560000",210000,16,2.294521e-05,50345000,50555000,50350000,50560000,"chr14",525416,1,6,6,13,"chr14",1,0.0243788091889358
"17145","chr14.90805000.90810000","chr14.91505000.91510000",700000,8,0.002797777,90805000,91505000,90810000,91510000,"chr14",525427,3,7,3,13,"chr14",1,0.0121894045944679
"17146","chr14.95440000.95445000","chr14.95460000.95465000",20000,39,0.0009125548,95440000,95460000,95445000,95465000,"chr14",525429,0,2,1,3,"chr14",1,0.0137130801687764
"17147","chr14.71370000.71375000","chr14.71435000.71440000",65000,30,2.646692e-08,71370000,71435000,71375000,71440000,"chr14",525464,3,12,7,22,"chr14",1,0.0773558368495077
"17148","chr14.92600000.92605000","chr14.92900000.92905000",300000,11,0.002441076,92600000,92900000,92605000,92905000,"chr14",525510,1,0,0,1,"chr14",1,0.0012892639474918
"17149","chr14.67650000.67655000","chr14.67750000.67755000",100000,19,0.0001832856,67650000,67750000,67655000,67755000,"chr14",525584,3,11,18,32,"chr14",1,0.0712611345522738
"17150","chr14.102985000.102990000","chr14.103055000.103060000",70000,21,0.0005909405,102985000,103055000,102990000,103060000,"chr14",525608,0,7,4,11,"chr14",1,0.0270745428973277
"17151","chr14.50875000.50880000","chr14.50905000.50910000",30000,36,4.157914e-05,50875000,50905000,50880000,50910000,"chr14",525613,0,3,0,3,"chr14",1,0.0126582278481013
"17152","chr14.94125000.94130000","chr14.94155000.94160000",30000,30,0.005006818,94125000,94155000,94130000,94160000,"chr14",525656,2,0,1,3,"chr14",1,0.0105485232067511
"17153","chr14.32560000.32565000","chr14.32675000.32680000",115000,15,0.00580482,32560000,32675000,32565000,32680000,"chr14",525674,0,1,2,3,"chr14",1,0.00527426160337553
"17154","chr14.96760000.96765000","chr14.96795000.96800000",35000,31,0.0002093662,96760000,96795000,96765000,96800000,"chr14",525690,1,1,1,3,"chr14",1,0.0109001406469761
"17155","chr14.23035000.23040000","chr14.23065000.23070000",30000,31,0.002455784,23035000,23065000,23040000,23070000,"chr14",525729,0,6,3,9,"chr14",1,0.0327004219409283
"17156","chr14.55050000.55055000","chr14.55120000.55125000",70000,24,2.057687e-05,55050000,55120000,55055000,55125000,"chr14",525731,2,6,5,13,"chr14",1,0.0365682137834037
"17157","chr14.77615000.77620000","chr14.77780000.77785000",165000,35,6.424359e-20,77615000,77780000,77620000,77785000,"chr14",525744,0,1,0,1,"chr14",1,0.00410220346929208
"17158","chr14.23065000.23070000","chr14.23285000.23290000",220000,13,0.001163082,23065000,23285000,23070000,23290000,"chr14",525769,0,6,3,9,"chr14",1,0.0137130801687764
"17159","chr14.96795000.96800000","chr14.96850000.96855000",55000,24,0.0004493798,96795000,96850000,96800000,96855000,"chr14",525785,0,1,2,3,"chr14",1,0.00843881856540084
"17160","chr14.74865000.74870000","chr14.74915000.74920000",50000,25,0.0004949311,74865000,74915000,74870000,74920000,"chr14",525827,2,6,14,22,"chr14",1,0.0644631973745898
"17161","chr14.50790000.50795000","chr14.51250000.51255000",460000,14,7.65535e-07,50790000,51250000,50795000,51255000,"chr14",525832,1,1,2,4,"chr14",1,0.00656352555086732
"17162","chr14.91170000.91175000","chr14.91225000.91230000",55000,21,0.006689366,91170000,91225000,91175000,91230000,"chr14",525846,3,5,2,10,"chr14",1,0.0246132208157525
"17163","chr14.64590000.64595000","chr14.64720000.64725000",130000,14,0.008334047,64590000,64720000,64595000,64725000,"chr14",525874,3,2,11,16,"chr14",1,0.0262541022034693
"17164","chr14.90740000.90745000","chr14.91300000.91305000",560000,9,0.001751229,90740000,91300000,90745000,91305000,"chr14",525945,4,12,6,22,"chr14",1,0.0232067510548523
"17165","chr14.103155000.103160000","chr14.103540000.103545000",385000,10,0.002752884,103155000,103540000,103160000,103545000,"chr14",526036,4,10,8,22,"chr14",1,0.0257852789498359
"17166","chr14.95585000.95590000","chr14.95660000.95665000",75000,18,0.006029456,95585000,95660000,95590000,95665000,"chr14",526095,0,3,3,6,"chr14",1,0.0126582278481013
"17167","chr14.102310000.102315000","chr14.102435000.102440000",125000,17,0.0003585019,102310000,102435000,102315000,102440000,"chr14",526168,3,2,9,14,"chr14",1,0.0278949835911861
"17168","chr14.90850000.90855000","chr14.91360000.91365000",510000,9,0.002883085,90850000,91360000,90855000,91365000,"chr14",526182,0,5,7,12,"chr14",1,0.0126582278481013
"17169","chr14.90825000.90830000","chr14.90960000.90965000",135000,14,0.006894153,90825000,90960000,90830000,90965000,"chr14",526202,3,4,6,13,"chr14",1,0.0213314580403188
"17170","chr14.65140000.65145000","chr14.65225000.65230000",85000,18,0.002290551,65140000,65225000,65145000,65230000,"chr14",526213,0,2,4,6,"chr14",1,0.0126582278481013
"17171","chr14.64985000.64990000","chr14.65100000.65105000",115000,17,0.0006333175,64985000,65100000,64990000,65105000,"chr14",526270,1,8,3,12,"chr14",1,0.0239099859353024
"17172","chr14.90840000.90845000","chr14.91360000.91365000",520000,11,8.924784e-05,90840000,91360000,90845000,91365000,"chr14",526280,5,8,17,30,"chr14",1,0.0386779184247539
"17173","chr14.69310000.69315000","chr14.69545000.69550000",235000,14,0.0001765974,69310000,69545000,69315000,69550000,"chr14",526367,7,8,7,22,"chr14",1,0.0360993905297703
"17174","chr14.70085000.70090000","chr14.70155000.70160000",70000,23,6.67557e-05,70085000,70155000,70090000,70160000,"chr14",526370,0,3,1,4,"chr14",1,0.0107829348335677
"17175","chr14.75790000.75795000","chr14.75975000.75980000",185000,13,0.003596248,75790000,75975000,75795000,75980000,"chr14",526388,0,8,11,19,"chr14",1,0.0289498359118612
"17176","chr14.69610000.69615000","chr14.69685000.69690000",75000,19,0.002358881,69610000,69685000,69615000,69690000,"chr14",526403,0,2,1,3,"chr14",1,0.00668073136427567
"17177","chr14.35630000.35635000","chr14.35685000.35690000",55000,30,5.39666e-07,35630000,35685000,35635000,35690000,"chr14",526510,0,6,5,11,"chr14",1,0.0386779184247539
"17178","chr14.90785000.90790000","chr14.90840000.90845000",55000,24,0.0004493798,90785000,90840000,90790000,90845000,"chr14",526581,2,19,18,39,"chr14",1,0.109704641350211
"17179","chr14.29240000.29245000","chr14.30005000.30010000",765000,9,0.0002849374,29240000,30005000,29245000,30010000,"chr14",526611,0,2,6,8,"chr14",1,0.00843881856540084
"17180","chr14.23030000.23035000","chr14.23300000.23305000",270000,11,0.004360978,23030000,23300000,23035000,23305000,"chr14",526628,3,13,11,27,"chr14",1,0.0348101265822785
"17181","chr14.50770000.50775000","chr14.50985000.50990000",215000,15,8.44536e-05,50770000,50985000,50775000,50990000,"chr14",526749,0,2,1,3,"chr14",1,0.00527426160337553
"17182","chr14.24710000.24715000","chr14.24795000.24800000",85000,20,0.0002621112,24710000,24795000,24715000,24800000,"chr14",526804,0,0,3,3,"chr14",1,0.0070323488045007
"17183","chr14.68860000.68865000","chr14.69100000.69105000",240000,15,3.252064e-05,68860000,69100000,68865000,69105000,"chr14",526829,0,8,6,14,"chr14",1,0.0246132208157525
"17184","chr14.50345000.50350000","chr14.50995000.51000000",650000,9,0.0007523692,50345000,50995000,50350000,5.1e+07,"chr14",526889,1,6,6,13,"chr14",1,0.0137130801687764
"17185","chr14.73770000.73775000","chr14.73885000.73890000",115000,15,0.00580482,73770000,73885000,73775000,73890000,"chr14",526899,0,3,3,6,"chr14",1,0.0105485232067511
"17186","chr14.54880000.54885000","chr14.54900000.54905000",20000,37,0.003472832,54880000,54900000,54885000,54905000,"chr14",526950,1,7,6,14,"chr14",1,0.0607126113455227
"17187","chr14.74215000.74220000","chr14.74290000.74295000",75000,48,1.603831e-23,74215000,74290000,74220000,74295000,"chr14",526957,0,2,1,3,"chr14",1,0.0168776371308017
"17188","chr14.35685000.35690000","chr14.35750000.35755000",65000,23,0.0001620954,35685000,35750000,35690000,35755000,"chr14",526974,0,1,1,2,"chr14",1,0.00539146741678387
"17189","chr14.73610000.73615000","chr14.74045000.74050000",435000,9,0.006349867,73610000,74045000,73615000,74050000,"chr14",527006,5,14,9,28,"chr14",1,0.029535864978903
"17190","chr14.90490000.90495000","chr14.90520000.90525000",30000,32,0.001160061,90490000,90520000,90495000,90525000,"chr14",527053,0,3,6,9,"chr14",1,0.0337552742616034
"17191","chr14.77410000.77415000","chr14.77495000.77500000",85000,28,5.224045e-09,77410000,77495000,77415000,77500000,"chr14",527056,7,17,4,28,"chr14",1,0.0918893577121425
"17192","chr14.23055000.23060000","chr14.23325000.23330000",270000,14,5.738844e-05,23055000,23325000,23060000,23330000,"chr14",527089,2,2,6,10,"chr14",1,0.0164088138771683
"17193","chr14.23035000.23040000","chr14.23120000.23125000",85000,24,1.717877e-06,23035000,23120000,23040000,23125000,"chr14",527093,2,4,1,7,"chr14",1,0.019690576652602
"17194","chr14.72995000.73000000","chr14.73355000.73360000",360000,13,3.516681e-05,72995000,73355000,7.3e+07,73360000,"chr14",527095,2,19,8,29,"chr14",1,0.0441865916549461
"17195","chr14.90740000.90745000","chr14.91635000.91640000",895000,10,1.14597e-05,90740000,91635000,90745000,91640000,"chr14",527122,5,9,9,23,"chr14",1,0.0269573370839194
"17196","chr14.91505000.91510000","chr14.91575000.91580000",70000,20,0.001624697,91505000,91575000,91510000,91580000,"chr14",527128,5,14,17,36,"chr14",1,0.0843881856540084
"17197","chr14.35750000.35755000","chr14.35865000.35870000",115000,15,0.00580482,35750000,35865000,35755000,35870000,"chr14",527166,2,1,1,4,"chr14",1,0.0070323488045007
"17198","chr14.102235000.102240000","chr14.102280000.102285000",45000,28,9.102955e-05,102235000,102280000,102240000,102285000,"chr14",527199,1,1,2,4,"chr14",1,0.0131270511017346
"17199","chr14.93710000.93715000","chr14.94000000.94005000",290000,17,1.576623e-07,93710000,9.4e+07,93715000,94005000,"chr14",527210,0,2,2,4,"chr14",1,0.00796999531176746
"17200","chr14.90840000.90845000","chr14.91290000.91295000",450000,14,9.359235e-07,90840000,91290000,90845000,91295000,"chr14",527224,0,3,2,5,"chr14",1,0.00820440693858415
"17201","chr14.50860000.50865000","chr14.50985000.50990000",125000,21,1.500114e-06,50860000,50985000,50865000,50990000,"chr14",527239,0,3,1,4,"chr14",1,0.00984528832630099
"17202","chr14.100020000.100025000","chr14.100065000.100070000",45000,27,0.0002398135,100020000,100065000,100025000,100070000,"chr14",527241,5,11,3,19,"chr14",1,0.060126582278481
"17203","chr14.89540000.89545000","chr14.90330000.90335000",790000,9,0.0002318334,89540000,90330000,89545000,90335000,"chr14",527245,5,12,12,29,"chr14",1,0.0305907172995781
"17204","chr14.104050000.104055000","chr14.104275000.104280000",225000,14,0.0002473461,104050000,104275000,104055000,104280000,"chr14",527327,2,5,2,9,"chr14",1,0.0147679324894515
"17205","chr14.51025000.51030000","chr14.51235000.51240000",210000,14,0.0004314653,51025000,51235000,51030000,51240000,"chr14",527356,0,2,0,2,"chr14",1,0.00328176277543366
"17206","chr14.93290000.93295000","chr14.93615000.93620000",325000,12,0.0003555231,93290000,93615000,93295000,93620000,"chr14",527362,4,2,5,11,"chr14",1,0.0154711673699015
"17207","chr14.68905000.68910000","chr14.69190000.69195000",285000,11,0.003226215,68905000,69190000,68910000,69195000,"chr14",527364,4,9,8,21,"chr14",1,0.0270745428973277
"17208","chr14.90755000.90760000","chr14.91310000.91315000",555000,10,0.000345317,90755000,91310000,90760000,91315000,"chr14",527371,3,11,13,27,"chr14",1,0.0316455696202532
"17209","chr14.68795000.68800000","chr14.69045000.69050000",250000,11,0.006694501,68795000,69045000,68800000,69050000,"chr14",527415,0,3,2,5,"chr14",1,0.00644631973745898
"17210","chr14.90785000.90790000","chr14.91170000.91175000",385000,13,2.183733e-05,90785000,91170000,90790000,91175000,"chr14",527510,2,10,4,16,"chr14",1,0.0243788091889358
"17211","chr14.102265000.102270000","chr14.102445000.102450000",180000,16,8.870467e-05,102265000,102445000,102270000,102450000,"chr14",527624,3,14,19,36,"chr14",1,0.0675105485232067
"17212","chr14.75790000.75795000","chr14.75930000.75935000",140000,19,1.022857e-05,75790000,75930000,75795000,75935000,"chr14",527627,2,1,4,7,"chr14",1,0.0155883731833099
"17213","chr14.65165000.65170000","chr14.65225000.65230000",60000,22,0.001160061,65165000,65225000,65170000,65230000,"chr14",527662,0,2,4,6,"chr14",1,0.0154711673699015
"17214","chr14.23055000.23060000","chr14.23305000.23310000",250000,18,1.245542e-07,23055000,23305000,23060000,23310000,"chr14",527671,0,2,1,3,"chr14",1,0.00632911392405063
"17215","chr14.64010000.64015000","chr14.64805000.64810000",795000,7,0.007891718,64010000,64805000,64015000,64810000,"chr14",527688,0,3,3,6,"chr14",1,0.00492264416315049
"17216","chr14.77375000.77380000","chr14.77550000.77555000",175000,21,4.38141e-08,77375000,77550000,77380000,77555000,"chr14",527725,0,0,4,4,"chr14",1,0.00984528832630099
"17217","chr14.102985000.102990000","chr14.103070000.103075000",85000,17,0.006029456,102985000,103070000,102990000,103075000,"chr14",527729,0,4,1,5,"chr14",1,0.00996249413970933
"17218","chr14.99880000.99885000","chr14.99915000.99920000",35000,27,0.005372273,99880000,99915000,99885000,99920000,"chr14",527764,2,5,2,9,"chr14",1,0.0284810126582278
"17219","chr14.23005000.23010000","chr14.23325000.23330000",320000,13,7.958943e-05,23005000,23325000,23010000,23330000,"chr14",527769,2,2,3,7,"chr14",1,0.0106657290201594
"17220","chr14.50790000.50795000","chr14.50970000.50975000",180000,25,1.953122e-11,50790000,50970000,50795000,50975000,"chr14",527817,1,1,2,4,"chr14",1,0.0117205813408345
"17221","chr14.32005000.32010000","chr14.32250000.32255000",245000,11,0.00747829,32005000,32250000,32010000,32255000,"chr14",527892,2,4,3,9,"chr14",1,0.0116033755274262
"17222","chr14.102230000.102235000","chr14.102300000.102305000",70000,26,1.67819e-06,102230000,102300000,102235000,102305000,"chr14",527897,1,0,1,2,"chr14",1,0.00609470229723394
"17223","chr14.65000000.65005000","chr14.65100000.65105000",100000,33,5.486502e-14,6.5e+07,65100000,65005000,65105000,"chr14",527948,1,6,3,10,"chr14",1,0.0386779184247539
"17224","chr14.74110000.74115000","chr14.74320000.74325000",210000,12,0.005500873,74110000,74320000,74115000,74325000,"chr14",528021,11,21,18,50,"chr14",1,0.070323488045007
"17225","chr14.35245000.35250000","chr14.35880000.35885000",635000,8,0.004541757,35245000,35880000,35250000,35885000,"chr14",528041,3,4,2,9,"chr14",1,0.00843881856540084
"17226","chr14.99860000.99865000","chr14.99880000.99885000",20000,45,8.384713e-06,99860000,99880000,99865000,99885000,"chr14",528042,0,5,1,6,"chr14",1,0.0316455696202532
"17227","chr14.102265000.102270000","chr14.102415000.102420000",150000,19,5.573081e-06,102265000,102415000,102270000,102420000,"chr14",528051,0,5,2,7,"chr14",1,0.0155883731833099
"17228","chr14.22990000.22995000","chr14.23480000.23485000",490000,9,0.003532756,22990000,23480000,22995000,23485000,"chr14",528058,0,2,6,8,"chr14",1,0.00843881856540084
"17229","chr14.90890000.90895000","chr14.91115000.91120000",225000,13,0.001004131,90890000,91115000,90895000,91120000,"chr14",528072,1,11,5,17,"chr14",1,0.0259024847632443
"17230","chr14.65140000.65145000","chr14.65165000.65170000",25000,36,0.001271444,65140000,65165000,65145000,65170000,"chr14",528084,2,15,16,33,"chr14",1,0.139240506329114
"17231","chr14.91235000.91240000","chr14.91290000.91295000",55000,22,0.002854808,91235000,91290000,91240000,91295000,"chr14",528085,0,3,2,5,"chr14",1,0.012892639474918
"17232","chr14.91890000.91895000","chr14.91910000.91915000",20000,44,1.968028e-05,91890000,91910000,91895000,91915000,"chr14",528122,0,5,3,8,"chr14",1,0.0412564463197375
"17233","chr14.35630000.35635000","chr14.35875000.35880000",245000,19,2.535014e-08,35630000,35875000,35635000,35880000,"chr14",528134,1,4,2,7,"chr14",1,0.0155883731833099
"17234","chr14.103800000.103805000","chr14.103845000.103850000",45000,28,9.102955e-05,103800000,103845000,103805000,103850000,"chr14",528200,1,2,2,5,"chr14",1,0.0164088138771683
"17235","chr14.73590000.73595000","chr14.73645000.73650000",55000,23,0.001160061,73590000,73645000,73595000,73650000,"chr14",528255,3,9,5,17,"chr14",1,0.0458274730426629
"17236","chr14.50795000.50800000","chr14.50950000.50955000",155000,19,4.085783e-06,50795000,50950000,50800000,50955000,"chr14",528277,1,12,4,17,"chr14",1,0.0378574777308955
"17237","chr14.89485000.89490000","chr14.90440000.90445000",955000,7,0.002922707,89485000,90440000,89490000,90445000,"chr14",528278,1,3,4,8,"chr14",1,0.00656352555086732
"17238","chr14.77375000.77380000","chr14.77495000.77500000",120000,31,8.659446e-14,77375000,77495000,77380000,77500000,"chr14",528297,0,0,4,4,"chr14",1,0.0145335208626348
"17239","chr14.102265000.102270000","chr14.102435000.102440000",170000,19,1.658466e-06,102265000,102435000,102270000,102440000,"chr14",528365,3,2,9,14,"chr14",1,0.0311767463666198
"17240","chr14.90725000.90730000","chr14.90840000.90845000",115000,15,0.00580482,90725000,90840000,90730000,90845000,"chr14",528383,5,16,28,49,"chr14",1,0.0861462728551336
"17241","chr14.76180000.76185000","chr14.76385000.76390000",205000,15,0.0001252186,76180000,76385000,76185000,76390000,"chr14",528390,2,1,5,8,"chr14",1,0.0140646976090014
"17242","chr14.78025000.78030000","chr14.78225000.78230000",200000,13,0.002239794,78025000,78225000,78030000,78230000,"chr14",528409,0,3,5,8,"chr14",1,0.0121894045944679
"17243","chr14.50795000.50800000","chr14.50995000.51000000",200000,31,8.352741e-18,50795000,50995000,50800000,5.1e+07,"chr14",528429,1,6,8,15,"chr14",1,0.0545007032348805
"17244","chr14.32405000.32410000","chr14.32545000.32550000",140000,15,0.001875477,32405000,32545000,32410000,32550000,"chr14",528433,0,5,4,9,"chr14",1,0.0158227848101266
"17245","chr14.91360000.91365000","chr14.91570000.91575000",210000,13,0.001598457,91360000,91570000,91365000,91575000,"chr14",528437,2,5,6,13,"chr14",1,0.0198077824660103
"17246","chr14.90770000.90775000","chr14.91190000.91195000",420000,13,1.138115e-05,90770000,91190000,90775000,91195000,"chr14",528475,1,5,6,12,"chr14",1,0.0182841068917018
"17247","chr14.89700000.89705000","chr14.90395000.90400000",695000,8,0.002898357,89700000,90395000,89705000,90400000,"chr14",528517,0,3,0,3,"chr14",1,0.00281293952180028
"17248","chr14.90900000.90905000","chr14.91235000.91240000",335000,12,0.0002904435,90900000,91235000,90905000,91240000,"chr14",528581,3,7,10,20,"chr14",1,0.0281293952180028
"17249","chr14.50790000.50795000","chr14.51025000.51030000",235000,14,0.0001765974,50790000,51025000,50795000,51030000,"chr14",528600,0,1,0,1,"chr14",1,0.00164088138771683
"17250","chr14.50760000.50765000","chr14.50995000.51000000",235000,13,0.0007320306,50760000,50995000,50765000,5.1e+07,"chr14",528606,2,1,5,8,"chr14",1,0.0121894045944679
"17251","chr14.90825000.90830000","chr14.91125000.91130000",300000,10,0.009006076,90825000,91125000,90830000,91130000,"chr14",528613,3,8,19,30,"chr14",1,0.0351617440225035
"17252","chr14.55050000.55055000","chr14.55100000.55105000",50000,24,0.001251694,55050000,55100000,55055000,55105000,"chr14",528674,2,6,5,13,"chr14",1,0.0365682137834037
"17253","chr14.51450000.51455000","chr14.51620000.51625000",170000,16,0.0001403927,51450000,51620000,51455000,51625000,"chr14",528677,1,2,0,3,"chr14",1,0.00562587904360056
"17254","chr14.68905000.68910000","chr14.69295000.69300000",390000,16,6.307485e-08,68905000,69295000,68910000,69300000,"chr14",528684,3,6,3,12,"chr14",1,0.0225035161744023
"17255","chr14.99995000.100000000","chr14.100020000.100025000",25000,38,0.0002904985,99995000,100020000,1e+08,100025000,"chr14",528727,6,11,10,27,"chr14",1,0.120253164556962
"17256","chr14.64805000.64810000","chr14.65100000.65105000",295000,14,2.813335e-05,64805000,65100000,64810000,65105000,"chr14",528781,0,8,3,11,"chr14",1,0.0180496952648851
"17257","chr14.35355000.35360000","chr14.35380000.35385000",25000,34,0.004999711,35355000,35380000,35360000,35385000,"chr14",528806,7,15,12,34,"chr14",1,0.135489920300047
"17258","chr14.65025000.65030000","chr14.65165000.65170000",140000,14,0.005749199,65025000,65165000,65030000,65170000,"chr14",528849,2,2,3,7,"chr14",1,0.0114861697140178
"17259","chr14.77375000.77380000","chr14.77575000.77580000",200000,13,0.002239794,77375000,77575000,77380000,77580000,"chr14",528922,0,0,4,4,"chr14",1,0.00609470229723394
"17260","chr14.102230000.102235000","chr14.102305000.102310000",75000,22,9.541834e-05,102230000,102305000,102235000,102310000,"chr14",528944,1,0,1,2,"chr14",1,0.00515705578996718
"17261","chr14.74215000.74220000","chr14.74270000.74275000",55000,29,1.826724e-06,74215000,74270000,74220000,74275000,"chr14",528950,1,13,13,27,"chr14",1,0.0917721518987342
"17262","chr14.74430000.74435000","chr14.74465000.74470000",35000,30,0.0004969798,74430000,74465000,74435000,74470000,"chr14",528984,2,1,0,3,"chr14",1,0.0105485232067511
"17263","chr14.65015000.65020000","chr14.65040000.65045000",25000,42,1.047123e-05,65015000,65040000,65020000,65045000,"chr14",529062,2,12,5,19,"chr14",1,0.0935302390998594
"17264","chr14.77180000.77185000","chr14.77575000.77580000",395000,9,0.009775897,77180000,77575000,77185000,77580000,"chr14",529086,0,5,5,10,"chr14",1,0.0105485232067511
"17265","chr14.51090000.51095000","chr14.51235000.51240000",145000,20,1.67819e-06,51090000,51235000,51095000,51240000,"chr14",529152,0,3,1,4,"chr14",1,0.00937646507266761
"17266","chr14.102775000.102780000","chr14.102985000.102990000",210000,12,0.005500873,102775000,102985000,102780000,102990000,"chr14",529166,5,7,8,20,"chr14",1,0.0281293952180028
"17267","chr14.102190000.102195000","chr14.102445000.102450000",255000,11,0.006029456,102190000,102445000,102195000,102450000,"chr14",529178,3,18,13,34,"chr14",1,0.0438349742147211
"17268","chr14.77920000.77925000","chr14.78025000.78030000",105000,18,0.0004036942,77920000,78025000,77925000,78030000,"chr14",529181,0,3,5,8,"chr14",1,0.0168776371308017
"17269","chr14.90840000.90845000","chr14.91170000.91175000",330000,18,5.545944e-09,90840000,91170000,90845000,91175000,"chr14",529209,3,10,4,17,"chr14",1,0.0358649789029536
"17270","chr14.22850000.22855000","chr14.23010000.23015000",160000,13,0.008297014,22850000,23010000,22855000,23015000,"chr14",529242,1,15,9,25,"chr14",1,0.0380918893577121
"17271","chr14.90840000.90845000","chr14.91175000.91180000",335000,18,4.760586e-09,90840000,91175000,90845000,91180000,"chr14",529317,6,21,28,55,"chr14",1,0.116033755274262
"17272","chr14.64295000.64300000","chr14.64590000.64595000",295000,11,0.002654598,64295000,64590000,64300000,64595000,"chr14",529327,0,2,7,9,"chr14",1,0.0116033755274262
"17273","chr14.90795000.90800000","chr14.91360000.91365000",565000,8,0.007803896,90795000,91360000,90800000,91365000,"chr14",529355,1,8,6,15,"chr14",1,0.0140646976090014
"17274","chr14.102230000.102235000","chr14.102265000.102270000",35000,39,5.581619e-08,102230000,102265000,102235000,102270000,"chr14",529360,1,0,1,2,"chr14",1,0.00914205344585091
"17275","chr14.23035000.23040000","chr14.23285000.23290000",250000,17,7.645124e-07,23035000,23285000,23040000,23290000,"chr14",529369,7,8,16,31,"chr14",1,0.0617674636661978
"17276","chr14.21180000.21185000","chr14.21260000.21265000",80000,17,0.00932719,21180000,21260000,21185000,21265000,"chr14",529402,3,9,9,21,"chr14",1,0.0418424753867792
"17277","chr14.65140000.65145000","chr14.65210000.65215000",70000,21,0.0005909405,65140000,65210000,65145000,65215000,"chr14",529407,1,9,5,15,"chr14",1,0.0369198312236287
"17278","chr14.93905000.93910000","chr14.94000000.94005000",95000,21,2.489743e-05,93905000,9.4e+07,93910000,94005000,"chr14",529417,2,9,8,19,"chr14",1,0.0467651195499297
"17279","chr14.61285000.61290000","chr14.61325000.61330000",40000,25,0.005099286,61285000,61325000,61290000,61330000,"chr14",529437,3,2,6,11,"chr14",1,0.0322315986872949
"17280","chr14.91365000.91370000","chr14.91570000.91575000",205000,14,0.0005023318,91365000,91570000,91370000,91575000,"chr14",529441,0,5,2,7,"chr14",1,0.0114861697140178
"17281","chr14.93615000.93620000","chr14.93645000.93650000",30000,29,0.009775897,93615000,93645000,93620000,93650000,"chr14",529459,2,0,5,7,"chr14",1,0.023792780121894
"17282","chr14.91300000.91305000","chr14.91635000.91640000",335000,10,0.00534322,91300000,91635000,91305000,91640000,"chr14",529494,4,9,6,19,"chr14",1,0.0222691045475856
"17283","chr14.90850000.90855000","chr14.91290000.91295000",440000,9,0.006029456,90850000,91290000,90855000,91295000,"chr14",529528,0,3,2,5,"chr14",1,0.00527426160337553
"17284","chr14.75085000.75090000","chr14.75255000.75260000",170000,14,0.001860181,75085000,75255000,75090000,75260000,"chr14",529555,2,11,3,16,"chr14",1,0.0262541022034693
"17285","chr14.89700000.89705000","chr14.89955000.89960000",255000,11,0.006029456,89700000,89955000,89705000,89960000,"chr14",529586,0,3,2,5,"chr14",1,0.00644631973745898
"17286","chr14.75790000.75795000","chr14.75875000.75880000",85000,17,0.006029456,75790000,75875000,75795000,75880000,"chr14",529609,0,3,2,5,"chr14",1,0.00996249413970933
"17287","chr14.50795000.50800000","chr14.51250000.51255000",455000,11,0.0002196122,50795000,51250000,50800000,51255000,"chr14",529610,1,1,5,7,"chr14",1,0.00902484763244257
"17288","chr14.69545000.69550000","chr14.69610000.69615000",65000,21,0.001271444,69545000,69610000,69550000,69615000,"chr14",529619,0,2,1,3,"chr14",1,0.00738396624472574
"17289","chr14.50795000.50800000","chr14.50955000.50960000",160000,15,0.000816505,50795000,50955000,50800000,50960000,"chr14",529659,1,13,8,22,"chr14",1,0.0386779184247539
"17290","chr14.90770000.90775000","chr14.91170000.91175000",400000,13,1.655351e-05,90770000,91170000,90775000,91175000,"chr14",529713,3,5,4,12,"chr14",1,0.0182841068917018
"17291","chr14.30005000.30010000","chr14.30470000.30475000",465000,12,3.289654e-05,30005000,30470000,30010000,30475000,"chr14",529732,0,0,2,2,"chr14",1,0.00281293952180028
"17292","chr14.32560000.32565000","chr14.32720000.32725000",160000,14,0.002705321,32560000,32720000,32565000,32725000,"chr14",529765,0,6,7,13,"chr14",1,0.0213314580403188
"17293","chr14.100285000.100290000","chr14.100305000.100310000",20000,53,3.925274e-09,100285000,100305000,100290000,100310000,"chr14",529771,1,0,0,1,"chr14",1,0.00621190811064229
"17294","chr14.60105000.60110000","chr14.60150000.60155000",45000,25,0.001492163,60105000,60150000,60110000,60155000,"chr14",529809,0,2,4,6,"chr14",1,0.0175808720112518
"17295","chr14.95265000.95270000","chr14.95560000.95565000",295000,12,0.0006387715,95265000,95560000,95270000,95565000,"chr14",529879,0,2,3,5,"chr14",1,0.0070323488045007
"17296","chr14.90805000.90810000","chr14.91290000.91295000",485000,10,0.0007869971,90805000,91290000,90810000,91295000,"chr14",529894,0,3,2,5,"chr14",1,0.00586029067041725
"17297","chr14.31450000.31455000","chr14.31570000.31575000",120000,15,0.004559122,31450000,31570000,31455000,31575000,"chr14",529896,1,1,6,8,"chr14",1,0.0140646976090014
"17298","chr14.75085000.75090000","chr14.75295000.75300000",210000,12,0.005500873,75085000,75295000,75090000,75300000,"chr14",529912,4,7,4,15,"chr14",1,0.0210970464135021
"17299","chr14.59215000.59220000","chr14.59320000.59325000",105000,15,0.009887114,59215000,59320000,59220000,59325000,"chr14",529973,1,11,17,29,"chr14",1,0.0509845288326301
"17300","chr14.103310000.103315000","chr14.103725000.103730000",415000,9,0.007821677,103310000,103725000,103315000,103730000,"chr14",529983,0,4,0,4,"chr14",1,0.00421940928270042
"17301","chr14.50335000.50340000","chr14.50790000.50795000",455000,11,0.0002196122,50335000,50790000,50340000,50795000,"chr14",529997,1,1,2,4,"chr14",1,0.00515705578996718
"17302","chr14.102525000.102530000","chr14.102775000.102780000",250000,20,2.861429e-09,102525000,102775000,102530000,102780000,"chr14",530003,5,7,8,20,"chr14",1,0.046882325363338
"17303","chr14.89660000.89665000","chr14.90370000.90375000",710000,9,0.0004516266,89660000,90370000,89665000,90375000,"chr14",530079,1,8,4,13,"chr14",1,0.0137130801687764
"17304","chr14.102230000.102235000","chr14.102445000.102450000",215000,20,2.035615e-08,102230000,102445000,102235000,102450000,"chr14",530103,1,0,1,2,"chr14",1,0.0046882325363338
"17305","chr14.50860000.50865000","chr14.50880000.50885000",20000,37,0.003472832,50860000,50880000,50865000,50885000,"chr14",530155,0,5,9,14,"chr14",1,0.0607126113455227
"17306","chr14.69005000.69010000","chr14.69110000.69115000",105000,17,0.001246206,69005000,69110000,69010000,69115000,"chr14",530187,2,3,5,10,"chr14",1,0.0199249882794187
"17307","chr14.102230000.102235000","chr14.102275000.102280000",45000,39,1.671917e-10,102230000,102275000,102235000,102280000,"chr14",530188,1,0,1,2,"chr14",1,0.00914205344585091
"17308","chr14.66840000.66845000","chr14.67580000.67585000",740000,9,0.0003555231,66840000,67580000,66845000,67585000,"chr14",530220,0,2,1,3,"chr14",1,0.00316455696202532
"17309","chr14.55070000.55075000","chr14.55120000.55125000",50000,27,6.831422e-05,55070000,55120000,55075000,55125000,"chr14",530221,2,10,12,24,"chr14",1,0.0759493670886076
"17310","chr14.23235000.23240000","chr14.23300000.23305000",65000,19,0.007907143,23235000,23300000,23240000,23305000,"chr14",530244,3,13,11,27,"chr14",1,0.060126582278481
"17311","chr14.78175000.78180000","chr14.78750000.78755000",575000,8,0.007182806,78175000,78750000,78180000,78755000,"chr14",530254,0,3,1,4,"chr14",1,0.00375058602906704
"17312","chr14.72995000.73000000","chr14.73385000.73390000",390000,10,0.002592257,72995000,73385000,7.3e+07,73390000,"chr14",530343,12,39,34,85,"chr14",1,0.0996249413970933
"17313","chr14.89540000.89545000","chr14.90305000.90310000",765000,8,0.001789511,89540000,90305000,89545000,90310000,"chr14",530433,5,12,12,29,"chr14",1,0.0271917487107361
"17314","chr14.50795000.50800000","chr14.51010000.51015000",215000,19,1.2061e-07,50795000,51010000,50800000,51015000,"chr14",530563,1,4,4,9,"chr14",1,0.020042194092827
"17315","chr14.90995000.91000000","chr14.91170000.91175000",175000,15,0.0004363719,90995000,91170000,9.1e+07,91175000,"chr14",530627,3,10,4,17,"chr14",1,0.029887482419128
"17316","chr14.32410000.32415000","chr14.32720000.32725000",310000,13,9.875529e-05,32410000,32720000,32415000,32725000,"chr14",530646,2,0,4,6,"chr14",1,0.00914205344585091
"17317","chr14.63850000.63855000","chr14.64195000.64200000",345000,13,4.714889e-05,63850000,64195000,63855000,64200000,"chr14",530666,0,3,2,5,"chr14",1,0.00761837787154243
"17318","chr14.102235000.102240000","chr14.102300000.102305000",65000,21,0.001271444,102235000,102300000,102240000,102305000,"chr14",530674,1,1,2,4,"chr14",1,0.00984528832630099
"17319","chr14.50790000.50795000","chr14.50950000.50955000",160000,16,0.0002225443,50790000,50950000,50795000,50955000,"chr14",530703,1,1,2,4,"chr14",1,0.00750117205813408
"17320","chr14.75420000.75425000","chr14.75450000.75455000",30000,34,0.0002318334,75420000,75450000,75425000,75455000,"chr14",530735,3,9,7,19,"chr14",1,0.0757149554617909
"17321","chr14.65700000.65705000","chr14.65845000.65850000",145000,19,7.559097e-06,65700000,65845000,65705000,65850000,"chr14",530791,0,3,3,6,"chr14",1,0.0133614627285513
"17322","chr14.90855000.90860000","chr14.91190000.91195000",335000,10,0.00534322,90855000,91190000,90860000,91195000,"chr14",531018,1,7,9,17,"chr14",1,0.0199249882794187
"17323","chr14.50860000.50865000","chr14.50960000.50965000",100000,19,0.0001832856,50860000,50960000,50865000,50965000,"chr14",531038,0,5,5,10,"chr14",1,0.0222691045475856
"17324","chr14.102235000.102240000","chr14.102435000.102440000",200000,18,1.521728e-06,102235000,102435000,102240000,102440000,"chr14",531053,1,1,2,4,"chr14",1,0.00843881856540084
"17325","chr14.50085000.50090000","chr14.50230000.50235000",145000,18,3.187558e-05,50085000,50230000,50090000,50235000,"chr14",531083,2,8,10,20,"chr14",1,0.0421940928270042
"17326","chr14.68730000.68735000","chr14.69260000.69265000",530000,9,0.002359429,68730000,69260000,68735000,69265000,"chr14",531087,0,4,3,7,"chr14",1,0.00738396624472574
"17327","chr14.74250000.74255000","chr14.74290000.74295000",40000,31,2.370386e-05,74250000,74290000,74255000,74295000,"chr14",531181,0,2,1,3,"chr14",1,0.0109001406469761
"17328","chr14.20800000.20805000","chr14.21435000.21440000",635000,9,0.0008664074,20800000,21435000,20805000,21440000,"chr14",531212,0,7,6,13,"chr14",1,0.0137130801687764
"17329","chr14.102510000.102515000","chr14.102775000.102780000",265000,14,6.716782e-05,102510000,102775000,102515000,102780000,"chr14",531213,0,6,4,10,"chr14",1,0.0164088138771683
"17330","chr14.75910000.75915000","chr14.75930000.75935000",20000,50,8.300927e-08,75910000,75930000,75915000,75935000,"chr14",531219,2,1,4,7,"chr14",1,0.0410220346929208
"17331","chr14.102275000.102280000","chr14.102405000.102410000",130000,15,0.002883085,102275000,102405000,102280000,102410000,"chr14",531229,2,7,22,31,"chr14",1,0.0545007032348805
"17332","chr14.33950000.33955000","chr14.34550000.34555000",600000,8,0.005953207,33950000,34550000,33955000,34555000,"chr14",531275,0,8,3,11,"chr14",1,0.0103141115799344
"17333","chr14.90855000.90860000","chr14.91270000.91275000",415000,9,0.007821677,90855000,91270000,90860000,91275000,"chr14",531335,2,7,12,21,"chr14",1,0.0221518987341772
"17334","chr14.75145000.75150000","chr14.75275000.75280000",130000,15,0.002883085,75145000,75275000,75150000,75280000,"chr14",531395,1,4,1,6,"chr14",1,0.0105485232067511
"17335","chr14.64890000.64895000","chr14.64955000.64960000",65000,21,0.001271444,64890000,64955000,64895000,64960000,"chr14",531412,4,10,9,23,"chr14",1,0.0566104078762307
"17336","chr14.102230000.102235000","chr14.102435000.102440000",205000,16,2.849095e-05,102230000,102435000,102235000,102440000,"chr14",531469,1,0,1,2,"chr14",1,0.00375058602906704
"17337","chr14.98680000.98685000","chr14.99395000.99400000",715000,8,0.002533432,98680000,99395000,98685000,99400000,"chr14",531559,0,4,1,5,"chr14",1,0.0046882325363338
"17338","chr14.90770000.90775000","chr14.90855000.90860000",85000,19,0.0008000068,90770000,90855000,90775000,90860000,"chr14",531588,2,5,6,13,"chr14",1,0.0289498359118612
"17339","chr14.50790000.50795000","chr14.50945000.50950000",155000,15,0.001007124,50790000,50945000,50795000,50950000,"chr14",531666,1,1,2,4,"chr14",1,0.0070323488045007
"17340","chr14.102265000.102270000","chr14.102310000.102315000",45000,27,0.0002398135,102265000,102310000,102270000,102315000,"chr14",531746,3,14,21,38,"chr14",1,0.120253164556962
"17341","chr14.102230000.102235000","chr14.102415000.102420000",185000,17,1.62111e-05,102230000,102415000,102235000,102420000,"chr14",531750,0,0,1,1,"chr14",1,0.00199249882794187
"17342","chr14.89485000.89490000","chr14.90395000.90400000",910000,8,0.0006253264,89485000,90395000,89490000,90400000,"chr14",531768,0,3,0,3,"chr14",1,0.00281293952180028
"17343","chr14.90855000.90860000","chr14.91170000.91175000",315000,12,0.0004332524,90855000,91170000,90860000,91175000,"chr14",531803,2,7,4,13,"chr14",1,0.0182841068917018
"17344","chr14.67700000.67705000","chr14.67755000.67760000",55000,21,0.006689366,67700000,67755000,67705000,67760000,"chr14",531842,0,7,7,14,"chr14",1,0.0344585091420534
"17345","chr14.68685000.68690000","chr14.69295000.69300000",610000,8,0.005474278,68685000,69295000,68690000,69300000,"chr14",531848,0,4,3,7,"chr14",1,0.00656352555086732
"17346","chr14.50970000.50975000","chr14.50985000.50990000",15000,36,0.006432007,50970000,50985000,50975000,50990000,"chr14",531971,0,3,1,4,"chr14",1,0.0168776371308017
"17347","chr14.90840000.90845000","chr14.90990000.90995000",150000,15,0.001239412,90840000,90990000,90845000,90995000,"chr14",531997,2,8,9,19,"chr14",1,0.0334036568213783
"17348","chr14.75400000.75405000","chr14.75465000.75470000",65000,23,0.0001620954,75400000,75465000,75405000,75470000,"chr14",532058,2,3,4,9,"chr14",1,0.0242616033755274
"17349","chr14.50790000.50795000","chr14.51000000.51005000",210000,28,2.622562e-15,50790000,5.1e+07,50795000,51005000,"chr14",532065,0,0,2,2,"chr14",1,0.00656352555086732
"17350","chr14.20800000.20805000","chr14.21075000.21080000",275000,28,1.293431e-17,20800000,21075000,20805000,21080000,"chr14",532116,0,1,3,4,"chr14",1,0.0131270511017346
"17351","chr14.95155000.95160000","chr14.95560000.95565000",405000,16,4.356313e-08,95155000,95560000,95160000,95565000,"chr14",532123,0,4,4,8,"chr14",1,0.0150023441162682
"17352","chr14.77375000.77380000","chr14.77565000.77570000",190000,23,4.160109e-10,77375000,77565000,77380000,77570000,"chr14",532153,0,0,4,4,"chr14",1,0.0107829348335677
"17353","chr14.50600000.50605000","chr14.50760000.50765000",160000,13,0.008297014,50600000,50760000,50605000,50765000,"chr14",532182,2,0,1,3,"chr14",1,0.00457102672292546
"17354","chr14.50775000.50780000","chr14.50985000.50990000",210000,17,4.700638e-06,50775000,50985000,50780000,50990000,"chr14",532213,0,0,1,1,"chr14",1,0.00199249882794187
"17355","chr14.90770000.90775000","chr14.91255000.91260000",485000,9,0.003693587,90770000,91255000,90775000,91260000,"chr14",532216,4,5,6,15,"chr14",1,0.0158227848101266
"17356","chr14.69065000.69070000","chr14.69085000.69090000",20000,36,0.006432007,69065000,69085000,69070000,69090000,"chr14",532305,0,3,4,7,"chr14",1,0.029535864978903
"17357","chr14.73280000.73285000","chr14.73355000.73360000",75000,27,1.576623e-07,73280000,73355000,73285000,73360000,"chr14",532307,1,5,2,8,"chr14",1,0.0253164556962025
"17358","chr14.90725000.90730000","chr14.91235000.91240000",510000,9,0.002883085,90725000,91235000,90730000,91240000,"chr14",532335,3,16,14,33,"chr14",1,0.0348101265822785
"17359","chr14.32560000.32565000","chr14.32985000.32990000",425000,9,0.007013364,32560000,32985000,32565000,32990000,"chr14",532347,0,0,5,5,"chr14",1,0.00527426160337553
"17360","chr14.100175000.100180000","chr14.100270000.100275000",95000,17,0.002646317,100175000,100270000,100180000,100275000,"chr14",532368,6,3,5,14,"chr14",1,0.0278949835911861
"17361","chr14.68345000.68350000","chr14.69170000.69175000",825000,7,0.006689366,68345000,69170000,68350000,69175000,"chr14",532392,2,7,11,20,"chr14",1,0.0164088138771683
"17362","chr14.103135000.103140000","chr14.103780000.103785000",645000,8,0.004182728,103135000,103780000,103140000,103785000,"chr14",532408,1,0,1,2,"chr14",1,0.00187529301453352
"17363","chr14.50875000.50880000","chr14.50960000.50965000",85000,17,0.006029456,50875000,50960000,50880000,50965000,"chr14",532432,0,9,5,14,"chr14",1,0.0278949835911861
"17364","chr14.55160000.55165000","chr14.55245000.55250000",85000,17,0.006029456,55160000,55245000,55165000,55250000,"chr14",532449,2,6,3,11,"chr14",1,0.0219174871073605
"17365","chr14.90770000.90775000","chr14.90795000.90800000",25000,45,6.449093e-07,90770000,90795000,90775000,90800000,"chr14",532469,1,5,6,12,"chr14",1,0.0632911392405063
"17366","chr14.67705000.67710000","chr14.67735000.67740000",30000,60,8.074723e-18,67705000,67735000,67710000,67740000,"chr14",532522,5,11,22,38,"chr14",1,0.267229254571027
"17367","chr14.96760000.96765000","chr14.96850000.96855000",90000,19,0.0004724425,96760000,96850000,96765000,96855000,"chr14",532569,0,2,1,3,"chr14",1,0.00668073136427567
"17368","chr14.68345000.68350000","chr14.69295000.69300000",950000,17,5.64058e-14,68345000,69295000,68350000,69300000,"chr14",532578,2,6,3,11,"chr14",1,0.0219174871073605
"17369","chr14.91225000.91230000","chr14.91290000.91295000",65000,19,0.007907143,91225000,91290000,91230000,91295000,"chr14",532608,0,3,2,5,"chr14",1,0.0111345522737928
"17370","chr14.31935000.31940000","chr14.32910000.32915000",975000,7,0.002534564,31935000,32910000,31940000,32915000,"chr14",532639,0,1,0,1,"chr14",1,0.000820440693858415
"17371","chr14.50860000.50865000","chr14.51000000.51005000",140000,21,5.053344e-07,50860000,5.1e+07,50865000,51005000,"chr14",532753,0,0,8,8,"chr14",1,0.019690576652602
"17372","chr14.21015000.21020000","chr14.21060000.21065000",45000,23,0.007600586,21015000,21060000,21020000,21065000,"chr14",532771,2,1,2,5,"chr14",1,0.0134786685419597
"17373","chr14.67695000.67700000","chr14.67750000.67755000",55000,26,5.703657e-05,67695000,67750000,67700000,67755000,"chr14",532774,4,7,11,22,"chr14",1,0.0670417252695734
"17374","chr14.50790000.50795000","chr14.50875000.50880000",85000,20,0.0002621112,50790000,50875000,50795000,50880000,"chr14",532801,1,1,2,4,"chr14",1,0.00937646507266761
"17375","chr14.90455000.90460000","chr14.90520000.90525000",65000,26,5.071536e-06,90455000,90520000,90460000,90525000,"chr14",532870,0,3,5,8,"chr14",1,0.0243788091889358
"17376","chr14.91360000.91365000","chr14.91575000.91580000",215000,16,1.851846e-05,91360000,91575000,91365000,91580000,"chr14",532884,5,8,17,30,"chr14",1,0.0562587904360056
"17377","chr14.99995000.100000000","chr14.100100000.100105000",105000,18,0.0004036942,99995000,100100000,1e+08,100105000,"chr14",533053,6,12,10,28,"chr14",1,0.0590717299578059
"17378","chr14.39015000.39020000","chr14.39035000.39040000",20000,39,0.0009125548,39015000,39035000,39020000,39040000,"chr14",533104,3,4,7,14,"chr14",1,0.0639943741209564
"17379","chr14.78175000.78180000","chr14.78220000.78225000",45000,30,1.138115e-05,78175000,78220000,78180000,78225000,"chr14",533129,0,0,1,1,"chr14",1,0.00351617440225035
"17380","chr14.64835000.64840000","chr14.64995000.65000000",160000,13,0.008297014,64835000,64995000,64840000,6.5e+07,"chr14",533204,0,5,3,8,"chr14",1,0.0121894045944679
"17381","chr14.35220000.35225000","chr14.35465000.35470000",245000,12,0.00215308,35220000,35465000,35225000,35470000,"chr14",533221,0,3,1,4,"chr14",1,0.00562587904360056
"17382","chr14.91885000.91890000","chr14.91910000.91915000",25000,42,1.047123e-05,91885000,91910000,91890000,91915000,"chr14",533243,2,3,6,11,"chr14",1,0.0541490857946554
"17383","chr14.94685000.94690000","chr14.95560000.95565000",875000,8,0.0008291809,94685000,95560000,94690000,95565000,"chr14",533244,3,7,10,20,"chr14",1,0.0187529301453352
"17384","chr14.103280000.103285000","chr14.103310000.103315000",30000,34,0.0002318334,103280000,103310000,103285000,103315000,"chr14",533258,0,5,3,8,"chr14",1,0.0318799812470699
"17385","chr14.67705000.67710000","chr14.67815000.67820000",110000,15,0.00747829,67705000,67815000,67710000,67820000,"chr14",533265,4,17,21,42,"chr14",1,0.0738396624472574
"17386","chr14.102275000.102280000","chr14.102315000.102320000",40000,25,0.005099286,102275000,102315000,102280000,102320000,"chr14",533270,1,5,10,16,"chr14",1,0.046882325363338
"17387","chr14.91270000.91275000","chr14.91290000.91295000",20000,38,0.001810636,91270000,91290000,91275000,91295000,"chr14",533313,0,3,2,5,"chr14",1,0.0222691045475856
"17388","chr14.55050000.55055000","chr14.55160000.55165000",110000,15,0.00747829,55050000,55160000,55055000,55165000,"chr14",533378,2,6,5,13,"chr14",1,0.0228551336146273
"17389","chr14.74215000.74220000","chr14.74250000.74255000",35000,30,0.0004969798,74215000,74250000,74220000,74255000,"chr14",533382,1,13,13,27,"chr14",1,0.0949367088607595
"17390","chr14.90820000.90825000","chr14.91255000.91260000",435000,14,1.266823e-06,90820000,91255000,90825000,91260000,"chr14",533397,3,10,14,27,"chr14",1,0.0443037974683544
"17391","chr14.90805000.90810000","chr14.91365000.91370000",560000,8,0.008159851,90805000,91365000,90810000,91370000,"chr14",533434,0,6,2,8,"chr14",1,0.00750117205813408
"17392","chr14.65015000.65020000","chr14.65100000.65105000",85000,26,1.035832e-07,65015000,65100000,65020000,65105000,"chr14",533469,1,8,3,12,"chr14",1,0.0365682137834037
"17393","chr14.77585000.77590000","chr14.77615000.77620000",30000,31,0.002455784,77585000,77615000,77590000,77620000,"chr14",533482,0,1,0,1,"chr14",1,0.0036333802156587
"17394","chr14.73165000.73170000","chr14.73290000.73295000",125000,18,9.875529e-05,73165000,73290000,73170000,73295000,"chr14",533512,2,16,13,31,"chr14",1,0.0654008438818565
"17395","chr14.103445000.103450000","chr14.103780000.103785000",335000,10,0.00534322,103445000,103780000,103450000,103785000,"chr14",533518,4,16,22,42,"chr14",1,0.0492264416315049
"17396","chr14.50790000.50795000","chr14.50905000.50910000",115000,18,0.0001900271,50790000,50905000,50795000,50910000,"chr14",533588,0,1,0,1,"chr14",1,0.00210970464135021
"17397","chr14.71180000.71185000","chr14.71240000.71245000",60000,20,0.006908664,71180000,71240000,71185000,71245000,"chr14",533643,0,1,3,4,"chr14",1,0.00937646507266761
"17398","chr14.35805000.35810000","chr14.35875000.35880000",70000,28,1.141599e-07,35805000,35875000,35810000,35880000,"chr14",533648,2,4,2,8,"chr14",1,0.0262541022034693
"17399","chr14.23480000.23485000","chr14.23540000.23545000",60000,21,0.002898357,23480000,23540000,23485000,23545000,"chr14",533729,0,2,6,8,"chr14",1,0.019690576652602
"17400","chr14.73095000.73100000","chr14.73355000.73360000",260000,15,1.590412e-05,73095000,73355000,73100000,73360000,"chr14",533753,2,19,8,29,"chr14",1,0.0509845288326301
"17401","chr14.90440000.90445000","chr14.90490000.90495000",50000,24,0.001251694,90440000,90490000,90445000,90495000,"chr14",533812,1,3,4,8,"chr14",1,0.0225035161744023
"17402","chr14.55050000.55055000","chr14.55135000.55140000",85000,17,0.006029456,55050000,55135000,55055000,55140000,"chr14",533852,2,6,3,11,"chr14",1,0.0219174871073605
"17403","chr14.50795000.50800000","chr14.50865000.50870000",70000,26,1.67819e-06,50795000,50865000,50800000,50870000,"chr14",533918,0,5,1,6,"chr14",1,0.0182841068917018
"17404","chr14.69610000.69615000","chr14.69875000.69880000",265000,11,0.004894512,69610000,69875000,69615000,69880000,"chr14",533995,0,2,1,3,"chr14",1,0.00386779184247539
"17405","chr14.60105000.60110000","chr14.60165000.60170000",60000,21,0.002898357,60105000,60165000,60110000,60170000,"chr14",534007,3,2,2,7,"chr14",1,0.0172292545710267
"17406","chr14.35685000.35690000","chr14.35875000.35880000",190000,47,1.69983e-34,35685000,35875000,35690000,35880000,"chr14",534009,0,4,2,6,"chr14",1,0.0330520393811533
"17407","chr14.102275000.102280000","chr14.102415000.102420000",140000,17,0.0001599041,102275000,102415000,102280000,102420000,"chr14",534010,0,5,2,7,"chr14",1,0.0139474917955931
"17408","chr14.50355000.50360000","chr14.50775000.50780000",420000,9,0.007426126,50355000,50775000,50360000,50780000,"chr14",534104,0,0,1,1,"chr14",1,0.00105485232067511
"17409","chr14.103805000.103810000","chr14.103845000.103850000",40000,25,0.005099286,103805000,103845000,103810000,103850000,"chr14",534166,1,2,2,5,"chr14",1,0.0146507266760431
"17410","chr14.20800000.20805000","chr14.21065000.21070000",265000,11,0.004894512,20800000,21065000,20805000,21070000,"chr14",534231,0,7,4,11,"chr14",1,0.0141819034224098
"17411","chr14.91395000.91400000","chr14.91575000.91580000",180000,18,4.4873e-06,91395000,91575000,91400000,91580000,"chr14",534278,6,6,13,25,"chr14",1,0.0527426160337553
"17412","chr14.75400000.75405000","chr14.75560000.75565000",160000,16,0.0002225443,75400000,75560000,75405000,75565000,"chr14",534284,2,3,4,9,"chr14",1,0.0168776371308017
"17413","chr14.90825000.90830000","chr14.91235000.91240000",410000,17,4.658845e-09,90825000,91235000,90830000,91240000,"chr14",534306,3,19,14,36,"chr14",1,0.0717299578059072
"17414","chr14.74215000.74220000","chr14.74300000.74305000",85000,17,0.006029456,74215000,74300000,74220000,74305000,"chr14",534428,1,13,13,27,"chr14",1,0.0537974683544304
"17415","chr14.102635000.102640000","chr14.102775000.102780000",140000,17,0.0001599041,102635000,102775000,102640000,102780000,"chr14",534449,5,7,8,20,"chr14",1,0.0398499765588373
"17416","chr14.71655000.71660000","chr14.71690000.71695000",35000,28,0.002552297,71655000,71690000,71660000,71695000,"chr14",534459,0,1,2,3,"chr14",1,0.00984528832630099
"17417","chr14.77980000.77985000","chr14.78025000.78030000",45000,26,0.0006099138,77980000,78025000,77985000,78030000,"chr14",534476,0,3,4,7,"chr14",1,0.0213314580403188
"17418","chr14.50795000.50800000","chr14.51235000.51240000",440000,12,4.930327e-05,50795000,51235000,50800000,51240000,"chr14",534480,1,13,8,22,"chr14",1,0.0309423347398031
"17419","chr14.72945000.72950000","chr14.73385000.73390000",440000,9,0.006029456,72945000,73385000,72950000,73390000,"chr14",534504,10,12,16,38,"chr14",1,0.040084388185654
"17420","chr14.50800000.50805000","chr14.50995000.51000000",195000,38,9.053267e-25,50800000,50995000,50805000,5.1e+07,"chr14",534556,1,6,3,10,"chr14",1,0.0445382090951711
"17421","chr14.75650000.75655000","chr14.75720000.75725000",70000,28,1.141599e-07,75650000,75720000,75655000,75725000,"chr14",534618,0,6,3,9,"chr14",1,0.029535864978903
"17422","chr14.77795000.77800000","chr14.78025000.78030000",230000,12,0.00317142,77795000,78025000,77800000,78030000,"chr14",534619,0,5,6,11,"chr14",1,0.0154711673699015
"17423","chr14.50905000.50910000","chr14.50950000.50955000",45000,23,0.007600586,50905000,50950000,50910000,50955000,"chr14",534694,0,3,0,3,"chr14",1,0.00808720112517581
"17424","chr14.75635000.75640000","chr14.75720000.75725000",85000,19,0.0008000068,75635000,75720000,75640000,75725000,"chr14",534732,2,15,14,31,"chr14",1,0.0690342240975152
"17425","chr14.23065000.23070000","chr14.23480000.23485000",415000,9,0.007821677,23065000,23480000,23070000,23485000,"chr14",534758,0,2,3,5,"chr14",1,0.00527426160337553
"17426","chr14.50790000.50795000","chr14.50985000.50990000",195000,28,1.050982e-14,50790000,50985000,50795000,50990000,"chr14",534810,0,1,1,2,"chr14",1,0.00656352555086732
"17427","chr14.92120000.92125000","chr14.92425000.92430000",305000,14,2.160521e-05,92120000,92425000,92125000,92430000,"chr14",534863,2,5,7,14,"chr14",1,0.0229723394280356
"17428","chr14.32545000.32550000","chr14.32720000.32725000",175000,23,1.29149e-09,32545000,32720000,32550000,32725000,"chr14",534879,2,5,7,14,"chr14",1,0.0377402719174871
"17429","chr14.34350000.34355000","chr14.34785000.34790000",435000,9,0.006349867,34350000,34785000,34355000,34790000,"chr14",534897,1,2,2,5,"chr14",1,0.00527426160337553
"17430","chr14.75905000.75910000","chr14.75930000.75935000",25000,42,1.047123e-05,75905000,75930000,75910000,75935000,"chr14",534902,2,1,2,5,"chr14",1,0.0246132208157525
"17431","chr14.39170000.39175000","chr14.39320000.39325000",150000,16,0.0003603348,39170000,39320000,39175000,39325000,"chr14",534957,4,10,15,29,"chr14",1,0.0543834974214721
"17432","chr14.93180000.93185000","chr14.93215000.93220000",35000,30,0.0004969798,93180000,93215000,93185000,93220000,"chr14",534963,2,13,16,31,"chr14",1,0.109001406469761
"17433","chr14.47405000.47410000","chr14.47445000.47450000",40000,25,0.005099286,47405000,47445000,47410000,47450000,"chr14",534982,0,3,1,4,"chr14",1,0.0117205813408345
"17434","chr14.74370000.74375000","chr14.74400000.74405000",30000,29,0.009775897,74370000,74400000,74375000,74405000,"chr14",535036,3,8,4,15,"chr14",1,0.0509845288326301
"17435","chr14.65030000.65035000","chr14.65165000.65170000",135000,17,0.0002074511,65030000,65165000,65035000,65170000,"chr14",535103,2,13,15,30,"chr14",1,0.059774964838256
"17436","chr14.73770000.73775000","chr14.73895000.73900000",125000,17,0.0003585019,73770000,73895000,73775000,73900000,"chr14",535177,0,3,3,6,"chr14",1,0.0119549929676512
"17437","chr14.90805000.90810000","chr14.90840000.90845000",35000,34,1.244002e-05,90805000,90840000,90810000,90845000,"chr14",535184,3,7,3,13,"chr14",1,0.0518049695264885
"17438","chr14.32405000.32410000","chr14.32720000.32725000",315000,10,0.007076984,32405000,32720000,32410000,32725000,"chr14",535203,0,5,4,9,"chr14",1,0.0105485232067511
"17439","chr14.23235000.23240000","chr14.23285000.23290000",50000,23,0.003007492,23235000,23285000,23240000,23290000,"chr14",535217,8,8,16,32,"chr14",1,0.086263478668542
"17440","chr14.77420000.77425000","chr14.77495000.77500000",75000,28,3.810695e-08,77420000,77495000,77425000,77500000,"chr14",535221,4,2,4,10,"chr14",1,0.0328176277543366
"17441","chr14.23035000.23040000","chr14.23300000.23305000",265000,18,6.467132e-08,23035000,23300000,23040000,23305000,"chr14",535249,3,13,11,27,"chr14",1,0.0569620253164557
"17442","chr14.50795000.50800000","chr14.50985000.50990000",190000,20,9.262272e-08,50795000,50985000,50800000,50990000,"chr14",535252,0,3,1,4,"chr14",1,0.00937646507266761
"17443","chr14.58570000.58575000","chr14.58640000.58645000",70000,24,2.057687e-05,58570000,58640000,58575000,58645000,"chr14",535261,3,9,15,27,"chr14",1,0.0759493670886076
"17444","chr14.55085000.55090000","chr14.55120000.55125000",35000,29,0.001160061,55085000,55120000,55090000,55125000,"chr14",535299,2,10,12,24,"chr14",1,0.0815752461322082
"17445","chr14.68730000.68735000","chr14.69310000.69315000",580000,8,0.006908664,68730000,69310000,68735000,69315000,"chr14",535329,0,4,3,7,"chr14",1,0.00656352555086732
"17446","chr14.73825000.73830000","chr14.73850000.73855000",25000,33,0.00932719,73825000,73850000,73830000,73855000,"chr14",535334,2,8,12,22,"chr14",1,0.0850914205344585
"17447","chr14.50795000.50800000","chr14.50970000.50975000",175000,21,4.38141e-08,50795000,50970000,50800000,50975000,"chr14",535346,1,6,5,12,"chr14",1,0.029535864978903
"17448","chr14.103075000.103080000","chr14.103310000.103315000",235000,11,0.009454919,103075000,103310000,103080000,103315000,"chr14",535390,4,5,16,25,"chr14",1,0.0322315986872949
"17449","chr14.81740000.81745000","chr14.81925000.81930000",185000,34,5.060077e-20,81740000,81925000,81745000,81930000,"chr14",535403,1,6,0,7,"chr14",1,0.0278949835911861
"17450","chr14.70085000.70090000","chr14.70105000.70110000",20000,40,0.0004516266,70085000,70105000,70090000,70110000,"chr14",535406,1,3,10,14,"chr14",1,0.0656352555086732
"17451","chr14.73610000.73615000","chr14.73630000.73635000",20000,66,8.994212e-16,73610000,73630000,73615000,73635000,"chr14",535420,5,6,5,16,"chr14",1,0.123769338959212
"17452","chr14.89490000.89495000","chr14.90370000.90375000",880000,14,8.813853e-10,89490000,90370000,89495000,90375000,"chr14",535453,4,7,3,14,"chr14",1,0.0229723394280356
"17453","chr14.32330000.32335000","chr14.32430000.32435000",100000,16,0.005072834,32330000,32430000,32335000,32435000,"chr14",535455,0,3,5,8,"chr14",1,0.0150023441162682
"17454","chr14.91910000.91915000","chr14.92455000.92460000",545000,8,0.00932719,91910000,92455000,91915000,92460000,"chr14",535459,0,3,4,7,"chr14",1,0.00656352555086732
"17455","chr14.35750000.35755000","chr14.35875000.35880000",125000,24,1.335481e-08,35750000,35875000,35755000,35880000,"chr14",535461,2,1,1,4,"chr14",1,0.0112517580872011
"17456","chr14.91575000.91580000","chr14.91635000.91640000",60000,31,3.057176e-08,91575000,91635000,91580000,91640000,"chr14",535487,5,9,9,23,"chr14",1,0.08356774496015
"17457","chr14.68625000.68630000","chr14.69310000.69315000",685000,10,8.553433e-05,68625000,69310000,68630000,69315000,"chr14",535534,2,1,3,6,"chr14",1,0.0070323488045007
"17458","chr14.93750000.93755000","chr14.93935000.93940000",185000,15,0.0002841336,93750000,93935000,93755000,93940000,"chr14",535564,0,0,2,2,"chr14",1,0.00351617440225035
"17459","chr14.50800000.50805000","chr14.51000000.51005000",200000,24,2.767425e-11,50800000,5.1e+07,50805000,51005000,"chr14",535588,0,0,3,3,"chr14",1,0.00843881856540084
"17460","chr14.32040000.32045000","chr14.32545000.32550000",505000,9,0.003021382,32040000,32545000,32045000,32550000,"chr14",535701,0,5,2,7,"chr14",1,0.00738396624472574
"17461","chr14.74015000.74020000","chr14.74045000.74050000",30000,48,1.03191e-10,74015000,74045000,74020000,74050000,"chr14",535733,4,14,9,27,"chr14",1,0.151898734177215
"17462","chr14.59960000.59965000","chr14.60350000.60355000",390000,11,0.0005691824,59960000,60350000,59965000,60355000,"chr14",535756,0,2,0,2,"chr14",1,0.00257852789498359
"17463","chr14.67615000.67620000","chr14.67755000.67760000",140000,16,0.0005691824,67615000,67755000,67620000,67760000,"chr14",535784,0,7,7,14,"chr14",1,0.0262541022034693
"17464","chr14.78235000.78240000","chr14.79045000.79050000",810000,9,0.0001987015,78235000,79045000,78240000,79050000,"chr14",535796,0,0,2,2,"chr14",1,0.00210970464135021
"17465","chr14.32720000.32725000","chr14.32940000.32945000",220000,17,2.929494e-06,32720000,32940000,32725000,32945000,"chr14",535913,0,3,0,3,"chr14",1,0.0059774964838256
"17466","chr14.61225000.61230000","chr14.61480000.61485000",255000,12,0.001645702,61225000,61480000,61230000,61485000,"chr14",535922,5,9,6,20,"chr14",1,0.0281293952180028
"17467","chr14.90900000.90905000","chr14.91365000.91370000",465000,9,0.004631469,90900000,91365000,90905000,91370000,"chr14",535927,0,6,2,8,"chr14",1,0.00843881856540084
"17468","chr14.78025000.78030000","chr14.78220000.78225000",195000,14,0.0007316646,78025000,78220000,78030000,78225000,"chr14",535984,0,0,2,2,"chr14",1,0.00328176277543366
"17469","chr14.90825000.90830000","chr14.91360000.91365000",535000,13,1.491055e-06,90825000,91360000,90830000,91365000,"chr14",535992,3,8,17,28,"chr14",1,0.0426629160806376
"17470","chr14.32545000.32550000","chr14.32985000.32990000",440000,10,0.00135484,32545000,32985000,32550000,32990000,"chr14",536056,0,0,5,5,"chr14",1,0.00586029067041725
"17471","chr14.35215000.35220000","chr14.35245000.35250000",30000,31,0.002455784,35215000,35245000,35220000,35250000,"chr14",536095,6,4,2,12,"chr14",1,0.0436005625879044
"17472","chr14.91235000.91240000","chr14.91320000.91325000",85000,17,0.006029456,91235000,91320000,91240000,91325000,"chr14",536121,0,2,2,4,"chr14",1,0.00796999531176746
"17473","chr14.58080000.58085000","chr14.58125000.58130000",45000,24,0.003472832,58080000,58125000,58085000,58130000,"chr14",536123,0,4,1,5,"chr14",1,0.0140646976090014
"17474","chr14.100270000.100275000","chr14.100295000.100300000",25000,33,0.00932719,100270000,100295000,100275000,100300000,"chr14",536162,5,8,14,27,"chr14",1,0.104430379746835
"17475","chr14.55100000.55105000","chr14.55160000.55165000",60000,20,0.006908664,55100000,55160000,55105000,55165000,"chr14",536166,6,14,13,33,"chr14",1,0.0773558368495077
"17476","chr14.35155000.35160000","chr14.35880000.35885000",725000,12,8.452178e-07,35155000,35880000,35160000,35885000,"chr14",536230,3,6,14,23,"chr14",1,0.0323488045007032
"17477","chr14.23020000.23025000","chr14.23325000.23330000",305000,11,0.002237942,23020000,23325000,23025000,23330000,"chr14",536233,3,6,8,17,"chr14",1,0.0219174871073605
"17478","chr14.65025000.65030000","chr14.65100000.65105000",75000,26,6.249323e-07,65025000,65100000,65030000,65105000,"chr14",536236,1,2,3,6,"chr14",1,0.0182841068917018
"17479","chr14.21075000.21080000","chr14.21100000.21105000",25000,35,0.002569474,21075000,21100000,21080000,21105000,"chr14",536296,2,1,3,6,"chr14",1,0.0246132208157525
"17480","chr14.92600000.92605000","chr14.93130000.93135000",530000,10,0.0004574161,92600000,93130000,92605000,93135000,"chr14",536302,1,0,0,1,"chr14",1,0.00117205813408345
"17481","chr14.89540000.89545000","chr14.90395000.90400000",855000,9,0.0001362902,89540000,90395000,89545000,90400000,"chr14",536364,0,3,0,3,"chr14",1,0.00316455696202532
"17482","chr14.51145000.51150000","chr14.51650000.51655000",505000,9,0.003021382,51145000,51650000,51150000,51655000,"chr14",536370,2,4,3,9,"chr14",1,0.00949367088607595
"17483","chr14.99770000.99775000","chr14.99880000.99885000",110000,16,0.002676957,99770000,99880000,99775000,99885000,"chr14",536396,2,1,2,5,"chr14",1,0.00937646507266761
"17484","chr14.93690000.93695000","chr14.94000000.94005000",310000,13,9.875529e-05,93690000,9.4e+07,93695000,94005000,"chr14",536419,2,4,1,7,"chr14",1,0.0106657290201594
"17485","chr14.103500000.103505000","chr14.103725000.103730000",225000,12,0.003600476,103500000,103725000,103505000,103730000,"chr14",536442,0,4,0,4,"chr14",1,0.00562587904360056
"17486","chr14.77760000.77765000","chr14.77780000.77785000",20000,45,8.384713e-06,77760000,77780000,77765000,77785000,"chr14",536447,4,10,8,22,"chr14",1,0.116033755274262
"17487","chr14.91255000.91260000","chr14.91360000.91365000",105000,18,0.0004036942,91255000,91360000,91260000,91365000,"chr14",536483,4,8,14,26,"chr14",1,0.0548523206751055
"17488","chr14.32720000.32725000","chr14.32985000.32990000",265000,18,6.467132e-08,32720000,32985000,32725000,32990000,"chr14",536498,0,0,5,5,"chr14",1,0.0105485232067511
"17489","chr14.92500000.92505000","chr14.92585000.92590000",85000,17,0.006029456,92500000,92585000,92505000,92590000,"chr14",536502,5,8,9,22,"chr14",1,0.0438349742147211
"17490","chr14.77310000.77315000","chr14.77540000.77545000",230000,13,0.0008636935,77310000,77540000,77315000,77545000,"chr14",536625,0,8,3,11,"chr14",1,0.0167604313173933
"17491","chr14.102265000.102270000","chr14.102340000.102345000",75000,18,0.006029456,102265000,102340000,102270000,102345000,"chr14",536630,3,14,15,32,"chr14",1,0.0675105485232067
"17492","chr14.25245000.25250000","chr14.25515000.25520000",270000,11,0.004360978,25245000,25515000,25250000,25520000,"chr14",536633,0,0,1,1,"chr14",1,0.0012892639474918
"17493","chr14.77420000.77425000","chr14.77575000.77580000",155000,13,0.009775897,77420000,77575000,77425000,77580000,"chr14",536657,4,2,13,19,"chr14",1,0.0289498359118612
"17494","chr14.93655000.93660000","chr14.94000000.94005000",345000,14,8.298852e-06,93655000,9.4e+07,93660000,94005000,"chr14",536661,2,12,8,22,"chr14",1,0.0360993905297703
"17495","chr14.77375000.77380000","chr14.77555000.77560000",180000,22,5.295282e-09,77375000,77555000,77380000,77560000,"chr14",536754,0,0,4,4,"chr14",1,0.0103141115799344
"17496","chr14.89645000.89650000","chr14.90165000.90170000",520000,9,0.002608192,89645000,90165000,89650000,90170000,"chr14",536764,1,3,2,6,"chr14",1,0.00632911392405063
"17497","chr14.68860000.68865000","chr14.69085000.69090000",225000,12,0.003600476,68860000,69085000,68865000,69090000,"chr14",536786,0,3,4,7,"chr14",1,0.00984528832630099
"17498","chr14.50640000.50645000","chr14.51260000.51265000",620000,8,0.005072834,50640000,51260000,50645000,51265000,"chr14",536931,6,11,10,27,"chr14",1,0.0253164556962025
"17499","chr14.51010000.51015000","chr14.51185000.51190000",175000,16,0.000110873,51010000,51185000,51015000,51190000,"chr14",536939,0,3,3,6,"chr14",1,0.0112517580872011
"17500","chr14.103445000.103450000","chr14.103515000.103520000",70000,20,0.001624697,103445000,103515000,103450000,103520000,"chr14",536976,2,2,1,5,"chr14",1,0.0117205813408345
"17501","chr14.50955000.50960000","chr14.50995000.51000000",40000,25,0.005099286,50955000,50995000,50960000,5.1e+07,"chr14",537025,2,6,9,17,"chr14",1,0.0498124706985466
"17502","chr14.70105000.70110000","chr14.70150000.70155000",45000,25,0.001492163,70105000,70150000,70110000,70155000,"chr14",537032,1,5,2,8,"chr14",1,0.023441162681669
"17503","chr14.50860000.50865000","chr14.50970000.50975000",110000,16,0.002676957,50860000,50970000,50865000,50975000,"chr14",537047,0,5,5,10,"chr14",1,0.0187529301453352
"17504","chr14.77920000.77925000","chr14.78175000.78180000",255000,12,0.001645702,77920000,78175000,77925000,78180000,"chr14",537090,0,3,1,4,"chr14",1,0.00562587904360056
"17505","chr14.75790000.75795000","chr14.75910000.75915000",120000,20,9.338847e-06,75790000,75910000,75795000,75915000,"chr14",537119,2,5,7,14,"chr14",1,0.0328176277543366
"17506","chr14.50775000.50780000","chr14.51000000.51005000",225000,25,4.966955e-13,50775000,5.1e+07,50780000,51005000,"chr14",537133,0,0,4,4,"chr14",1,0.0117205813408345
"17507","chr14.91395000.91400000","chr14.91945000.91950000",550000,9,0.001916984,91395000,91945000,91400000,91950000,"chr14",537140,0,2,1,3,"chr14",1,0.00316455696202532
"17508","chr14.68860000.68865000","chr14.69035000.69040000",175000,13,0.005050053,68860000,69035000,68865000,69040000,"chr14",537176,2,8,6,16,"chr14",1,0.0243788091889358
"17509","chr14.102520000.102525000","chr14.102775000.102780000",255000,16,3.526437e-06,102520000,102775000,102525000,102780000,"chr14",537207,5,7,8,20,"chr14",1,0.0375058602906704
"17510","chr14.35685000.35690000","chr14.35880000.35885000",195000,34,1.532725e-20,35685000,35880000,35690000,35885000,"chr14",537250,0,7,8,15,"chr14",1,0.059774964838256
"17511","chr14.92600000.92605000","chr14.92920000.92925000",320000,14,1.483594e-05,92600000,92920000,92605000,92925000,"chr14",537293,1,0,0,1,"chr14",1,0.00164088138771683
"17512","chr14.73640000.73645000","chr14.73750000.73755000",110000,15,0.00747829,73640000,73750000,73645000,73755000,"chr14",537312,2,2,6,10,"chr14",1,0.0175808720112518
"17513","chr14.90440000.90445000","chr14.90520000.90525000",80000,39,1.150419e-16,90440000,90520000,90445000,90525000,"chr14",537355,0,3,4,7,"chr14",1,0.0319971870604782
"17514","chr14.100175000.100180000","chr14.100305000.100310000",130000,16,0.0009125548,100175000,100305000,100180000,100310000,"chr14",537396,1,0,0,1,"chr14",1,0.00187529301453352
"17515","chr14.90805000.90810000","chr14.91235000.91240000",430000,15,1.901289e-07,90805000,91235000,90810000,91240000,"chr14",537430,3,7,3,13,"chr14",1,0.0228551336146273
"17516","chr14.90820000.90825000","chr14.91170000.91175000",350000,12,0.0002201802,90820000,91170000,90825000,91175000,"chr14",537453,3,10,4,17,"chr14",1,0.0239099859353024
"17517","chr14.89485000.89490000","chr14.90110000.90115000",625000,10,0.0001573169,89485000,90110000,89490000,90115000,"chr14",537495,3,3,4,10,"chr14",1,0.0117205813408345
"17518","chr14.90850000.90855000","chr14.91270000.91275000",420000,13,1.138115e-05,90850000,91270000,90855000,91275000,"chr14",537509,0,5,7,12,"chr14",1,0.0182841068917018
"17519","chr14.103655000.103660000","chr14.103725000.103730000",70000,21,0.0005909405,103655000,103725000,103660000,103730000,"chr14",537547,0,4,0,4,"chr14",1,0.00984528832630099
"17520","chr14.55050000.55055000","chr14.55085000.55090000",35000,32,8.497712e-05,55050000,55085000,55055000,55090000,"chr14",537576,2,6,5,13,"chr14",1,0.0487576183778715
"17521","chr14.90770000.90775000","chr14.91365000.91370000",595000,16,6.297991e-10,90770000,91365000,90775000,91370000,"chr14",537595,0,5,2,7,"chr14",1,0.0131270511017346
"17522","chr14.23035000.23040000","chr14.23290000.23295000",255000,13,0.0004149928,23035000,23290000,23040000,23295000,"chr14",537609,7,20,23,50,"chr14",1,0.0761837787154243
"17523","chr14.89895000.89900000","chr14.90165000.90170000",270000,11,0.004360978,89895000,90165000,89900000,90170000,"chr14",537617,1,3,2,6,"chr14",1,0.00773558368495077
"17524","chr14.73025000.73030000","chr14.73165000.73170000",140000,15,0.001875477,73025000,73165000,73030000,73170000,"chr14",537625,0,16,8,24,"chr14",1,0.0421940928270042
"17525","chr14.69360000.69365000","chr14.69555000.69560000",195000,15,0.0001883648,69360000,69555000,69365000,69560000,"chr14",537659,2,8,4,14,"chr14",1,0.0246132208157525
"17526","chr14.96560000.96565000","chr14.96740000.96745000",180000,20,1.734847e-07,96560000,96740000,96565000,96745000,"chr14",537670,0,4,2,6,"chr14",1,0.0140646976090014
"17527","chr14.56545000.56550000","chr14.56565000.56570000",20000,45,8.384713e-06,56545000,56565000,56550000,56570000,"chr14",537820,0,1,1,2,"chr14",1,0.0105485232067511
"17528","chr14.21075000.21080000","chr14.21260000.21265000",185000,13,0.003596248,21075000,21260000,21080000,21265000,"chr14",537838,2,1,3,6,"chr14",1,0.00914205344585091
"17529","chr14.74290000.74295000","chr14.74415000.74420000",125000,16,0.001166956,74290000,74415000,74295000,74420000,"chr14",537879,0,2,0,2,"chr14",1,0.00375058602906704
"17530","chr14.90770000.90775000","chr14.91235000.91240000",465000,15,8.867116e-08,90770000,91235000,90775000,91240000,"chr14",537885,3,5,6,14,"chr14",1,0.0246132208157525
"17531","chr14.65040000.65045000","chr14.65080000.65085000",40000,31,2.370386e-05,65040000,65080000,65045000,65085000,"chr14",537911,2,0,2,4,"chr14",1,0.0145335208626348
"17532","chr14.73850000.73855000","chr14.73900000.73905000",50000,26,0.0001883648,73850000,73900000,73855000,73905000,"chr14",537913,2,8,12,22,"chr14",1,0.0670417252695734
"17533","chr14.50775000.50780000","chr14.50995000.51000000",220000,23,4.652437e-11,50775000,50995000,50780000,5.1e+07,"chr14",537920,2,0,4,6,"chr14",1,0.0161744022503516
"17534","chr14.31950000.31955000","chr14.32910000.32915000",960000,7,0.002828923,31950000,32910000,31955000,32915000,"chr14",537948,0,2,0,2,"chr14",1,0.00164088138771683
"17535","chr14.93690000.93695000","chr14.94095000.94100000",405000,10,0.00215308,93690000,94095000,93695000,94100000,"chr14",537988,2,2,1,5,"chr14",1,0.00586029067041725
"17536","chr14.22465000.22470000","chr14.22515000.22520000",50000,33,6.358362e-08,22465000,22515000,22470000,22520000,"chr14",537998,0,2,3,5,"chr14",1,0.0193389592123769
"17537","chr14.68395000.68400000","chr14.69285000.69290000",890000,9,0.0001000273,68395000,69285000,68400000,69290000,"chr14",538029,0,0,2,2,"chr14",1,0.00210970464135021
"17538","chr14.50770000.50775000","chr14.50995000.51000000",225000,17,2.316535e-06,50770000,50995000,50775000,5.1e+07,"chr14",538042,1,2,2,5,"chr14",1,0.00996249413970933
"17539","chr15.64555000.64560000","chr15.64695000.64700000",140000,17,0.0001256754,64555000,64695000,64560000,64700000,"chr15",538109,4,12,8,24,"chr15",1,0.0478199718706048
"17540","chr15.44535000.44540000","chr15.44575000.44580000",40000,35,2.504102e-07,44535000,44575000,44540000,44580000,"chr15",538125,4,15,19,38,"chr15",1,0.155883731833099
"17541","chr15.90895000.90900000","chr15.90930000.90935000",35000,30,0.0004171577,90895000,90930000,90900000,90935000,"chr15",538148,0,3,2,5,"chr15",1,0.0175808720112518
"17542","chr15.90420000.90425000","chr15.90645000.90650000",225000,14,0.00019965,90420000,90645000,90425000,90650000,"chr15",538160,0,3,5,8,"chr15",1,0.0131270511017346
"17543","chr15.42760000.42765000","chr15.42950000.42955000",190000,12,0.008126231,42760000,42950000,42765000,42955000,"chr15",538261,1,7,4,12,"chr15",1,0.0168776371308017
"17544","chr15.41915000.41920000","chr15.41935000.41940000",20000,63,3.161258e-14,41915000,41935000,41920000,41940000,"chr15",538268,2,4,4,10,"chr15",1,0.0738396624472574
"17545","chr15.41575000.41580000","chr15.41620000.41625000",45000,35,2.526238e-08,41575000,41620000,41580000,41625000,"chr15",538291,4,18,16,38,"chr15",1,0.155883731833099
"17546","chr15.63485000.63490000","chr15.64385000.64390000",900000,8,0.000442396,63485000,64385000,63490000,64390000,"chr15",538303,10,17,16,43,"chr15",1,0.0403187998124707
"17547","chr15.50985000.50990000","chr15.51190000.51195000",205000,19,1.689597e-07,50985000,51190000,50990000,51195000,"chr15",538319,0,1,0,1,"chr15",1,0.00222691045475856
"17548","chr15.77575000.77580000","chr15.77760000.77765000",185000,12,0.00931721,77575000,77760000,77580000,77765000,"chr15",538320,0,2,1,3,"chr15",1,0.00421940928270042
"17549","chr15.38265000.38270000","chr15.38645000.38650000",380000,15,4.831055e-07,38265000,38645000,38270000,38650000,"chr15",538332,1,7,6,14,"chr15",1,0.0246132208157525
"17550","chr15.89015000.89020000","chr15.89165000.89170000",150000,14,0.003186368,89015000,89165000,89020000,89170000,"chr15",538402,0,9,2,11,"chr15",1,0.0180496952648851
"17551","chr15.64985000.64990000","chr15.65100000.65105000",115000,18,0.0001494767,64985000,65100000,64990000,65105000,"chr15",538468,2,13,7,22,"chr15",1,0.0464135021097046
"17552","chr15.80695000.80700000","chr15.81270000.81275000",575000,12,4.399639e-06,80695000,81270000,80700000,81275000,"chr15",538521,0,0,5,5,"chr15",1,0.0070323488045007
"17553","chr15.74655000.74660000","chr15.74765000.74770000",110000,17,0.0007081382,74655000,74765000,74660000,74770000,"chr15",538580,4,12,8,24,"chr15",1,0.0478199718706048
"17554","chr15.38455000.38460000","chr15.38475000.38480000",20000,46,2.615974e-06,38455000,38475000,38460000,38480000,"chr15",538635,1,7,2,10,"chr15",1,0.0539146741678387
"17555","chr15.49620000.49625000","chr15.50075000.50080000",455000,10,0.0009207883,49620000,50075000,49625000,50080000,"chr15",538636,3,6,2,11,"chr15",1,0.012892639474918
"17556","chr15.58930000.58935000","chr15.58955000.58960000",25000,36,0.00100955,58930000,58955000,58935000,58960000,"chr15",538648,4,11,12,27,"chr15",1,0.113924050632911
"17557","chr15.90860000.90865000","chr15.90885000.90890000",25000,37,0.0004862494,90860000,90885000,90865000,90890000,"chr15",538695,1,2,4,7,"chr15",1,0.0303563056727614
"17558","chr15.40350000.40355000","chr15.40405000.40410000",55000,27,1.46338e-05,40350000,40405000,40355000,40410000,"chr15",538720,3,10,15,28,"chr15",1,0.0886075949367089
"17559","chr15.44185000.44190000","chr15.44535000.44540000",350000,10,0.003662891,44185000,44535000,44190000,44540000,"chr15",538791,4,13,7,24,"chr15",1,0.0281293952180028
"17560","chr15.80750000.80755000","chr15.81050000.81055000",300000,10,0.00766287,80750000,81050000,80755000,81055000,"chr15",538798,0,3,2,5,"chr15",1,0.00586029067041725
"17561","chr15.85840000.85845000","chr15.86050000.86055000",210000,16,1.80567e-05,85840000,86050000,85845000,86055000,"chr15",538800,1,9,3,13,"chr15",1,0.0243788091889358
"17562","chr15.44215000.44220000","chr15.44285000.44290000",70000,21,0.000486251,44215000,44285000,44220000,44290000,"chr15",538828,3,14,14,31,"chr15",1,0.0763009845288326
"17563","chr15.40890000.40895000","chr15.41180000.41185000",290000,16,8.288356e-07,40890000,41180000,40895000,41185000,"chr15",538847,4,8,10,22,"chr15",1,0.0412564463197375
"17564","chr15.42470000.42475000","chr15.42920000.42925000",450000,10,0.0009713471,42470000,42920000,42475000,42925000,"chr15",538850,5,21,15,41,"chr15",1,0.0480543834974215
"17565","chr15.52020000.52025000","chr15.52045000.52050000",25000,39,0.0001027297,52020000,52045000,52025000,52050000,"chr15",538897,7,19,17,43,"chr15",1,0.196554149085795
"17566","chr15.65030000.65035000","chr15.65180000.65185000",150000,14,0.003186368,65030000,65180000,65035000,65185000,"chr15",538945,3,6,6,15,"chr15",1,0.0246132208157525
"17567","chr15.52140000.52145000","chr15.52170000.52175000",30000,32,0.0009513778,52140000,52170000,52145000,52175000,"chr15",538955,3,4,3,10,"chr15",1,0.0375058602906704
"17568","chr15.65025000.65030000","chr15.65270000.65275000",245000,15,2.138711e-05,65025000,65270000,65030000,65275000,"chr15",538968,6,7,4,17,"chr15",1,0.029887482419128
"17569","chr15.90860000.90865000","chr15.91385000.91390000",525000,9,0.001961086,90860000,91385000,90865000,91390000,"chr15",539067,0,4,4,8,"chr15",1,0.00843881856540084
"17570","chr15.91270000.91275000","chr15.91385000.91390000",115000,16,0.001600898,91270000,91385000,91275000,91390000,"chr15",539080,0,2,2,4,"chr15",1,0.00750117205813408
"17571","chr15.52255000.52260000","chr15.52440000.52445000",185000,17,1.270304e-05,52255000,52440000,52260000,52445000,"chr15",539160,0,1,2,3,"chr15",1,0.0059774964838256
"17572","chr15.56460000.56465000","chr15.56490000.56495000",30000,30,0.004159079,56460000,56490000,56465000,56495000,"chr15",539168,1,0,5,6,"chr15",1,0.0210970464135021
"17573","chr15.49715000.49720000","chr15.50355000.50360000",640000,9,0.0005960449,49715000,50355000,49720000,50360000,"chr15",539177,0,1,3,4,"chr15",1,0.00421940928270042
"17574","chr15.42575000.42580000","chr15.42890000.42895000",315000,10,0.00600824,42575000,42890000,42580000,42895000,"chr15",539276,0,2,4,6,"chr15",1,0.0070323488045007
"17575","chr15.41915000.41920000","chr15.42105000.42110000",190000,14,0.0007081382,41915000,42105000,41920000,42110000,"chr15",539322,2,4,4,10,"chr15",1,0.0164088138771683
"17576","chr15.52285000.52290000","chr15.52380000.52385000",95000,16,0.005893442,52285000,52380000,52290000,52385000,"chr15",539328,1,13,5,19,"chr15",1,0.0356305672761369
"17577","chr15.90295000.90300000","chr15.90615000.90620000",320000,12,0.0003226557,90295000,90615000,90300000,90620000,"chr15",539351,4,8,6,18,"chr15",1,0.0253164556962025
"17578","chr15.38265000.38270000","chr15.38665000.38670000",400000,10,0.001888731,38265000,38665000,38270000,38670000,"chr15",539397,1,3,6,10,"chr15",1,0.0117205813408345
"17579","chr15.73600000.73605000","chr15.73990000.73995000",390000,9,0.008744482,73600000,73990000,73605000,73995000,"chr15",539444,1,5,5,11,"chr15",1,0.0116033755274262
"17580","chr15.64690000.64695000","chr15.64910000.64915000",220000,13,0.0009499001,64690000,64910000,64695000,64915000,"chr15",539448,0,7,3,10,"chr15",1,0.0152367557430849
"17581","chr15.34340000.34345000","chr15.34510000.34515000",170000,15,0.000422649,34340000,34510000,34345000,34515000,"chr15",539481,1,13,5,19,"chr15",1,0.0334036568213783
"17582","chr15.77495000.77500000","chr15.77760000.77765000",265000,14,5.421101e-05,77495000,77760000,77500000,77765000,"chr15",539514,0,2,1,3,"chr15",1,0.00492264416315049
"17583","chr15.42900000.42905000","chr15.42935000.42940000",35000,37,4.451337e-07,42900000,42935000,42905000,42940000,"chr15",539517,4,6,13,23,"chr15",1,0.0997421472105016
"17584","chr15.63945000.63950000","chr15.64355000.64360000",410000,10,0.001646131,63945000,64355000,63950000,64360000,"chr15",539574,3,6,9,18,"chr15",1,0.0210970464135021
"17585","chr15.51970000.51975000","chr15.52020000.52025000",50000,24,0.0009943956,51970000,52020000,51975000,52025000,"chr15",539605,7,19,17,43,"chr15",1,0.120956399437412
"17586","chr15.89175000.89180000","chr15.89205000.89210000",30000,44,9.169495e-09,89175000,89205000,89180000,89210000,"chr15",539613,1,5,5,11,"chr15",1,0.056727613689639
"17587","chr15.57210000.57215000","chr15.57320000.57325000",110000,24,4.817241e-08,57210000,57320000,57215000,57325000,"chr15",539649,1,1,3,5,"chr15",1,0.0140646976090014
"17588","chr15.89655000.89660000","chr15.89740000.89745000",85000,25,3.556142e-07,89655000,89740000,89660000,89745000,"chr15",539656,6,6,10,22,"chr15",1,0.0644631973745898
"17589","chr15.59265000.59270000","chr15.59385000.59390000",120000,16,0.001206606,59265000,59385000,59270000,59390000,"chr15",539675,3,11,14,28,"chr15",1,0.0525082044069386
"17590","chr15.90810000.90815000","chr15.91205000.91210000",395000,9,0.008237488,90810000,91205000,90815000,91210000,"chr15",539685,4,7,3,14,"chr15",1,0.0147679324894515
"17591","chr15.90295000.90300000","chr15.90425000.90430000",130000,14,0.006833992,90295000,90425000,90300000,90430000,"chr15",539729,4,8,8,20,"chr15",1,0.0328176277543366
"17592","chr15.44195000.44200000","chr15.44535000.44540000",340000,10,0.004197525,44195000,44535000,44200000,44540000,"chr15",539739,4,15,12,31,"chr15",1,0.036333802156587
"17593","chr15.42065000.42070000","chr15.42120000.42125000",55000,24,0.0003491618,42065000,42120000,42070000,42125000,"chr15",539761,0,0,1,1,"chr15",1,0.00281293952180028
"17594","chr15.63625000.63630000","chr15.63680000.63685000",55000,25,0.0001267361,63625000,63680000,63630000,63685000,"chr15",539780,1,5,4,10,"chr15",1,0.0293014533520863
"17595","chr15.99210000.99215000","chr15.99405000.99410000",195000,14,0.0005853274,99210000,99405000,99215000,99410000,"chr15",539781,1,4,2,7,"chr15",1,0.0114861697140178
"17596","chr15.74405000.74410000","chr15.74440000.74445000",35000,26,0.00931721,74405000,74440000,74410000,74445000,"chr15",539829,0,3,2,5,"chr15",1,0.0152367557430849
"17597","chr15.67240000.67245000","chr15.67520000.67525000",280000,11,0.002951888,67240000,67520000,67245000,67525000,"chr15",539833,0,2,1,3,"chr15",1,0.00386779184247539
"17598","chr15.41435000.41440000","chr15.41600000.41605000",165000,13,0.005714264,41435000,41600000,41440000,41605000,"chr15",539857,2,12,8,22,"chr15",1,0.0335208626347867
"17599","chr15.64840000.64845000","chr15.64905000.64910000",65000,21,0.001044138,64840000,64905000,64845000,64910000,"chr15",539859,0,3,1,4,"chr15",1,0.00984528832630099
"17600","chr15.90935000.90940000","chr15.91060000.91065000",125000,19,2.007129e-05,90935000,91060000,90940000,91065000,"chr15",539875,2,10,3,15,"chr15",1,0.0334036568213783
"17601","chr15.41545000.41550000","chr15.41615000.41620000",70000,18,0.008744482,41545000,41615000,41550000,41620000,"chr15",539977,10,45,35,90,"chr15",1,0.189873417721519
"17602","chr15.64460000.64465000","chr15.65030000.65035000",570000,9,0.00120619,64460000,65030000,64465000,65035000,"chr15",539979,4,6,6,16,"chr15",1,0.0168776371308017
"17603","chr15.52315000.52320000","chr15.52335000.52340000",20000,43,3.359096e-05,52315000,52335000,52320000,52340000,"chr15",539997,0,2,0,2,"chr15",1,0.0100796999531177
"17604","chr15.41980000.41985000","chr15.42065000.42070000",85000,17,0.00505316,41980000,42065000,41985000,42070000,"chr15",540096,0,0,1,1,"chr15",1,0.00199249882794187
"17605","chr15.64120000.64125000","chr15.64355000.64360000",235000,13,0.0005921178,64120000,64355000,64125000,64360000,"chr15",540177,4,6,8,18,"chr15",1,0.0274261603375527
"17606","chr15.85830000.85835000","chr15.86040000.86045000",210000,18,7.174404e-07,85830000,86040000,85835000,86045000,"chr15",540188,0,3,2,5,"chr15",1,0.0105485232067511
"17607","chr15.57215000.57220000","chr15.57320000.57325000",105000,17,0.0009950317,57215000,57320000,57220000,57325000,"chr15",540265,0,1,1,2,"chr15",1,0.00398499765588373
"17608","chr15.64065000.64070000","chr15.64355000.64360000",290000,10,0.008984683,64065000,64355000,64070000,64360000,"chr15",540276,9,26,19,54,"chr15",1,0.0632911392405063
"17609","chr15.64385000.64390000","chr15.64425000.64430000",40000,48,6.978949e-15,64385000,64425000,64390000,64430000,"chr15",540411,2,17,14,33,"chr15",1,0.185654008438819
"17610","chr15.57210000.57215000","chr15.57305000.57310000",95000,24,3.274238e-07,57210000,57305000,57215000,57310000,"chr15",540415,1,5,3,9,"chr15",1,0.0253164556962025
"17611","chr15.59385000.59390000","chr15.59685000.59690000",300000,11,0.002030524,59385000,59685000,59390000,59690000,"chr15",540453,6,14,6,26,"chr15",1,0.0335208626347867
"17612","chr15.40010000.40015000","chr15.40030000.40035000",20000,40,0.000347622,40010000,40030000,40015000,40035000,"chr15",540517,0,4,2,6,"chr15",1,0.0281293952180028
"17613","chr15.75025000.75030000","chr15.75045000.75050000",20000,50,6.074263e-08,75025000,75045000,75030000,75050000,"chr15",540620,2,2,3,7,"chr15",1,0.0410220346929208
"17614","chr15.64905000.64910000","chr15.64955000.64960000",50000,25,0.0003885091,64905000,64955000,64910000,64960000,"chr15",540639,2,7,6,15,"chr15",1,0.0439521800281294
"17615","chr15.75690000.75695000","chr15.75730000.75735000",40000,24,0.009166979,75690000,75730000,75695000,75735000,"chr15",540657,1,3,2,6,"chr15",1,0.0168776371308017
"17616","chr15.52255000.52260000","chr15.52365000.52370000",110000,20,1.63151e-05,52255000,52365000,52260000,52370000,"chr15",540694,0,1,0,1,"chr15",1,0.0023441162681669
"17617","chr15.80900000.80905000","chr15.81105000.81110000",205000,12,0.005213753,80900000,81105000,80905000,81110000,"chr15",540703,3,7,4,14,"chr15",1,0.019690576652602
"17618","chr15.74825000.74830000","chr15.74890000.74895000",65000,23,0.0001327902,74825000,74890000,74830000,74895000,"chr15",540823,0,0,3,3,"chr15",1,0.00808720112517581
"17619","chr15.91895000.91900000","chr15.92600000.92605000",705000,9,0.0003308997,91895000,92600000,91900000,92605000,"chr15",540824,0,2,0,2,"chr15",1,0.00210970464135021
"17620","chr15.68555000.68560000","chr15.68585000.68590000",30000,29,0.008226059,68555000,68585000,68560000,68590000,"chr15",540862,1,1,0,2,"chr15",1,0.00679793717768401
"17621","chr15.91020000.91025000","chr15.91135000.91140000",115000,15,0.00473363,91020000,91135000,91025000,91140000,"chr15",540912,2,1,3,6,"chr15",1,0.0105485232067511
"17622","chr15.74765000.74770000","chr15.74785000.74790000",20000,37,0.002716941,74765000,74785000,74770000,74790000,"chr15",540930,0,6,4,10,"chr15",1,0.0433661509610877
"17623","chr15.101540000.101545000","chr15.101795000.101800000",255000,12,0.001355314,101540000,101795000,101545000,101800000,"chr15",540968,1,1,1,3,"chr15",1,0.00421940928270042
"17624","chr15.78735000.78740000","chr15.78755000.78760000",20000,48,4.217941e-07,78735000,78755000,78740000,78760000,"chr15",540970,0,2,0,2,"chr15",1,0.0112517580872011
"17625","chr15.63915000.63920000","chr15.64355000.64360000",440000,9,0.004991769,63915000,64355000,63920000,64360000,"chr15",541034,0,14,9,23,"chr15",1,0.0242616033755274
"17626","chr15.90760000.90765000","chr15.91300000.91305000",540000,8,0.007806518,90760000,91300000,90765000,91305000,"chr15",541050,0,1,3,4,"chr15",1,0.00375058602906704
"17627","chr15.78255000.78260000","chr15.78295000.78300000",40000,28,0.000347838,78255000,78295000,78260000,78300000,"chr15",541112,2,2,2,6,"chr15",1,0.019690576652602
"17628","chr15.44295000.44300000","chr15.44500000.44505000",205000,12,0.005213753,44295000,44500000,44300000,44505000,"chr15",541121,4,16,8,28,"chr15",1,0.0393811533052039
"17629","chr15.90305000.90310000","chr15.90615000.90620000",310000,12,0.0003875569,90305000,90615000,90310000,90620000,"chr15",541148,0,2,1,3,"chr15",1,0.00421940928270042
"17630","chr15.91845000.91850000","chr15.92610000.92615000",765000,9,0.0001905856,91845000,92610000,91850000,92615000,"chr15",541170,1,1,0,2,"chr15",1,0.00210970464135021
"17631","chr15.90930000.90935000","chr15.91020000.91025000",90000,30,6.559771e-11,90930000,91020000,90935000,91025000,"chr15",541235,0,3,2,5,"chr15",1,0.0175808720112518
"17632","chr15.72180000.72185000","chr15.72355000.72360000",175000,13,0.004140243,72180000,72355000,72185000,72360000,"chr15",541238,1,3,2,6,"chr15",1,0.00914205344585091
"17633","chr15.64460000.64465000","chr15.64730000.64735000",270000,13,0.0002190433,64460000,64730000,64465000,64735000,"chr15",541250,7,8,20,35,"chr15",1,0.053328645100797
"17634","chr15.73080000.73085000","chr15.73375000.73380000",295000,14,2.293246e-05,73080000,73375000,73085000,73380000,"chr15",541272,0,3,1,4,"chr15",1,0.00656352555086732
"17635","chr15.30035000.30040000","chr15.30055000.30060000",20000,40,0.000347622,30035000,30055000,30040000,30060000,"chr15",541313,0,7,5,12,"chr15",1,0.0562587904360056
"17636","chr15.91865000.91870000","chr15.92600000.92605000",735000,7,0.008306871,91865000,92600000,91870000,92605000,"chr15",541327,3,10,2,15,"chr15",1,0.0123066104078762
"17637","chr15.91055000.91060000","chr15.91095000.91100000",40000,29,0.0001382725,91055000,91095000,91060000,91100000,"chr15",541403,1,7,1,9,"chr15",1,0.0305907172995781
"17638","chr15.74405000.74410000","chr15.74650000.74655000",245000,16,4.220694e-06,74405000,74650000,74410000,74655000,"chr15",541404,1,5,2,8,"chr15",1,0.0150023441162682
"17639","chr15.78730000.78735000","chr15.78750000.78755000",20000,36,0.005119318,78730000,78750000,78735000,78755000,"chr15",541423,0,1,1,2,"chr15",1,0.00843881856540084
"17640","chr15.74785000.74790000","chr15.75605000.75610000",820000,7,0.004939079,74785000,75605000,74790000,75610000,"chr15",541424,0,6,4,10,"chr15",1,0.00820440693858415
"17641","chr15.41020000.41025000","chr15.41490000.41495000",470000,13,3.544073e-06,41020000,41490000,41025000,41495000,"chr15",541433,0,5,3,8,"chr15",1,0.0121894045944679
"17642","chr15.85895000.85900000","chr15.86040000.86045000",145000,15,0.00121,85895000,86040000,85900000,86045000,"chr15",541509,0,3,2,5,"chr15",1,0.00879043600562588
"17643","chr15.38375000.38380000","chr15.38540000.38545000",165000,15,0.0005163019,38375000,38540000,38380000,38545000,"chr15",541513,3,7,5,15,"chr15",1,0.0263713080168776
"17644","chr15.90935000.90940000","chr15.91125000.91130000",190000,16,4.3827e-05,90935000,91125000,90940000,91130000,"chr15",541540,2,0,1,3,"chr15",1,0.00562587904360056
"17645","chr15.59525000.59530000","chr15.59675000.59680000",150000,16,0.0002833611,59525000,59675000,59530000,59680000,"chr15",541562,1,6,1,8,"chr15",1,0.0150023441162682
"17646","chr15.44195000.44200000","chr15.44485000.44490000",290000,16,8.288356e-07,44195000,44485000,44200000,44490000,"chr15",541605,3,10,2,15,"chr15",1,0.0281293952180028
"17647","chr15.44500000.44505000","chr15.44535000.44540000",35000,26,0.00931721,44500000,44535000,44505000,44540000,"chr15",541631,4,16,8,28,"chr15",1,0.0853258321612752
"17648","chr15.90415000.90420000","chr15.90635000.90640000",220000,12,0.003427084,90415000,90635000,90420000,90640000,"chr15",541650,2,4,1,7,"chr15",1,0.00984528832630099
"17649","chr15.90415000.90420000","chr15.90525000.90530000",110000,15,0.006137384,90415000,90525000,90420000,90530000,"chr15",541778,4,4,17,25,"chr15",1,0.0439521800281294
"17650","chr15.90545000.90550000","chr15.90615000.90620000",70000,24,1.681815e-05,90545000,90615000,90550000,90620000,"chr15",541805,4,10,6,20,"chr15",1,0.0562587904360056
"17651","chr15.90960000.90965000","chr15.91100000.91105000",140000,14,0.004690547,90960000,91100000,90965000,91105000,"chr15",541807,0,3,4,7,"chr15",1,0.0114861697140178
"17652","chr15.92375000.92380000","chr15.92625000.92630000",250000,12,0.001534547,92375000,92625000,92380000,92630000,"chr15",541919,2,0,0,2,"chr15",1,0.00281293952180028
"17653","chr15.40890000.40895000","chr15.41545000.41550000",655000,8,0.002894796,40890000,41545000,40895000,41550000,"chr15",541926,4,8,10,22,"chr15",1,0.0206282231598687
"17654","chr15.52330000.52335000","chr15.52365000.52370000",35000,37,4.451337e-07,52330000,52365000,52335000,52370000,"chr15",541933,0,2,0,2,"chr15",1,0.00867323019221753
"17655","chr15.38360000.38365000","chr15.38645000.38650000",285000,31,3.226844e-21,38360000,38645000,38365000,38650000,"chr15",541935,2,6,8,16,"chr15",1,0.0581340834505391
"17656","chr15.74950000.74955000","chr15.75045000.75050000",95000,19,0.0002320094,74950000,75045000,74955000,75050000,"chr15",541966,2,7,6,15,"chr15",1,0.0334036568213783
"17657","chr15.80745000.80750000","chr15.81045000.81050000",300000,10,0.00766287,80745000,81045000,80750000,81050000,"chr15",541976,2,1,0,3,"chr15",1,0.00351617440225035
"17658","chr15.51680000.51685000","chr15.52315000.52320000",635000,8,0.003421123,51680000,52315000,51685000,52320000,"chr15",542009,0,4,9,13,"chr15",1,0.0121894045944679
"17659","chr15.64710000.64715000","chr15.64730000.64735000",20000,35,0.00931721,64710000,64730000,64715000,64735000,"chr15",542024,7,14,24,45,"chr15",1,0.184599156118143
"17660","chr15.44425000.44430000","chr15.44535000.44540000",110000,18,0.0002142471,44425000,44535000,44430000,44540000,"chr15",542046,4,19,20,43,"chr15",1,0.0907172995780591
"17661","chr15.63925000.63930000","chr15.64180000.64185000",255000,11,0.00505316,63925000,64180000,63930000,64185000,"chr15",542065,2,4,2,8,"chr15",1,0.0103141115799344
"17662","chr15.78255000.78260000","chr15.78390000.78395000",135000,22,1.152736e-07,78255000,78390000,78260000,78395000,"chr15",542078,2,2,2,6,"chr15",1,0.0154711673699015
"17663","chr15.78255000.78260000","chr15.78395000.78400000",140000,28,2.014894e-12,78255000,78395000,78260000,78400000,"chr15",542226,0,2,2,4,"chr15",1,0.0131270511017346
"17664","chr15.26660000.26665000","chr15.27055000.27060000",395000,9,0.008237488,26660000,27055000,26665000,27060000,"chr15",542237,1,1,2,4,"chr15",1,0.00421940928270042
"17665","chr15.91860000.91865000","chr15.92625000.92630000",765000,8,0.001228245,91860000,92625000,91865000,92630000,"chr15",542266,2,3,3,8,"chr15",1,0.00750117205813408
"17666","chr15.77420000.77425000","chr15.77775000.77780000",355000,12,0.0001672397,77420000,77775000,77425000,77780000,"chr15",542275,0,2,3,5,"chr15",1,0.0070323488045007
"17667","chr15.42575000.42580000","chr15.42900000.42905000",325000,12,0.0002896939,42575000,42900000,42580000,42905000,"chr15",542286,0,2,4,6,"chr15",1,0.00843881856540084
"17668","chr15.90525000.90530000","chr15.90590000.90595000",65000,19,0.006702748,90525000,90590000,90530000,90595000,"chr15",542332,6,17,11,34,"chr15",1,0.0757149554617909
"17669","chr15.90305000.90310000","chr15.90635000.90640000",330000,10,0.004858391,90305000,90635000,90310000,90640000,"chr15",542344,0,2,1,3,"chr15",1,0.00351617440225035
"17670","chr15.90450000.90455000","chr15.90645000.90650000",195000,13,0.002125815,90450000,90645000,90455000,90650000,"chr15",542353,0,2,1,3,"chr15",1,0.00457102672292546
"17671","chr15.44575000.44580000","chr15.44710000.44715000",135000,16,0.0005693069,44575000,44710000,44580000,44715000,"chr15",542362,1,6,7,14,"chr15",1,0.0262541022034693
"17672","chr15.74830000.74835000","chr15.74990000.74995000",160000,16,0.0001761524,74830000,74990000,74835000,74995000,"chr15",542373,0,2,1,3,"chr15",1,0.00562587904360056
"17673","chr15.91860000.91865000","chr15.92610000.92615000",750000,8,0.001389372,91860000,92610000,91865000,92615000,"chr15",542397,2,2,3,7,"chr15",1,0.00656352555086732
"17674","chr15.64700000.64705000","chr15.64890000.64895000",190000,12,0.008126231,64700000,64890000,64705000,64895000,"chr15",542413,0,4,5,9,"chr15",1,0.0126582278481013
"17675","chr15.72670000.72675000","chr15.72785000.72790000",115000,15,0.00473363,72670000,72785000,72675000,72790000,"chr15",542508,1,5,3,9,"chr15",1,0.0158227848101266
"17676","chr15.41600000.41605000","chr15.42400000.42405000",800000,7,0.005568755,41600000,42400000,41605000,42405000,"chr15",542520,2,12,8,22,"chr15",1,0.0180496952648851
"17677","chr15.65130000.65135000","chr15.65185000.65190000",55000,48,4.72558e-19,65130000,65185000,65135000,65190000,"chr15",542664,3,14,9,26,"chr15",1,0.146272855133615
"17678","chr15.67210000.67215000","chr15.67805000.67810000",595000,8,0.004804303,67210000,67805000,67215000,67810000,"chr15",542691,0,2,1,3,"chr15",1,0.00281293952180028
"17679","chr15.64695000.64700000","chr15.64910000.64915000",215000,14,0.0002845581,64695000,64910000,64700000,64915000,"chr15",542699,1,7,8,16,"chr15",1,0.0262541022034693
"17680","chr15.74785000.74790000","chr15.75040000.75045000",255000,11,0.00505316,74785000,75040000,74790000,75045000,"chr15",542706,0,6,4,10,"chr15",1,0.012892639474918
"17681","chr15.90300000.90305000","chr15.90790000.90795000",490000,9,0.002832527,90300000,90790000,90305000,90795000,"chr15",542734,1,11,12,24,"chr15",1,0.0253164556962025
"17682","chr15.90885000.90890000","chr15.91060000.91065000",175000,14,0.001227606,90885000,91060000,90890000,91065000,"chr15",542759,1,2,3,6,"chr15",1,0.00984528832630099
"17683","chr15.67805000.67810000","chr15.68190000.68195000",385000,9,0.009240105,67805000,68190000,67810000,68195000,"chr15",542778,0,2,0,2,"chr15",1,0.00210970464135021
"17684","chr15.65025000.65030000","chr15.65315000.65320000",290000,14,2.620368e-05,65025000,65315000,65030000,65320000,"chr15",542791,5,7,4,16,"chr15",1,0.0262541022034693
"17685","chr15.89185000.89190000","chr15.89205000.89210000",20000,39,0.0007081382,89185000,89205000,89190000,89210000,"chr15",542794,3,5,5,13,"chr15",1,0.0594233473980309
"17686","chr15.65130000.65135000","chr15.65180000.65185000",50000,38,5.599721e-11,65130000,65180000,65135000,65185000,"chr15",542806,3,19,10,32,"chr15",1,0.142522269104548
"17687","chr15.41935000.41940000","chr15.41980000.41985000",45000,25,0.001206606,41935000,41980000,41940000,41985000,"chr15",542815,0,4,1,5,"chr15",1,0.0146507266760431
"17688","chr15.90525000.90530000","chr15.90635000.90640000",110000,19,6.097144e-05,90525000,90635000,90530000,90640000,"chr15",542891,2,13,1,16,"chr15",1,0.0356305672761369
"17689","chr15.89165000.89170000","chr15.89875000.89880000",710000,7,0.009695231,89165000,89875000,89170000,89880000,"chr15",542913,12,26,18,56,"chr15",1,0.0459446788560713
"17690","chr15.38360000.38365000","chr15.38665000.38670000",305000,11,0.001860411,38360000,38665000,38365000,38670000,"chr15",542973,2,3,9,14,"chr15",1,0.0180496952648851
"17691","chr15.31210000.31215000","chr15.31280000.31285000",70000,26,1.386685e-06,31210000,31280000,31215000,31285000,"chr15",542987,0,4,1,5,"chr15",1,0.0152367557430849
"17692","chr15.73240000.73245000","chr15.73270000.73275000",30000,34,0.0001892218,73240000,73270000,73245000,73275000,"chr15",543031,0,2,2,4,"chr15",1,0.0159399906235349
"17693","chr15.38360000.38365000","chr15.38560000.38565000",200000,12,0.00600824,38360000,38560000,38365000,38565000,"chr15",543035,2,6,9,17,"chr15",1,0.0239099859353024
"17694","chr15.90470000.90475000","chr15.90525000.90530000",55000,26,4.3778e-05,90470000,90525000,90475000,90530000,"chr15",543043,3,13,7,23,"chr15",1,0.0700890764181903
"17695","chr15.64695000.64700000","chr15.64905000.64910000",210000,14,0.0003458007,64695000,64905000,64700000,64910000,"chr15",543051,2,7,6,15,"chr15",1,0.0246132208157525
"17696","chr15.40675000.40680000","chr15.40695000.40700000",20000,55,3.433665e-10,40675000,40695000,40680000,40700000,"chr15",543056,2,10,11,23,"chr15",1,0.148265353961556
"17697","chr15.81015000.81020000","chr15.81045000.81050000",30000,31,0.002030524,81015000,81045000,81020000,81050000,"chr15",543059,3,2,1,6,"chr15",1,0.0218002812939522
"17698","chr15.75690000.75695000","chr15.75720000.75725000",30000,36,3.323219e-05,75690000,75720000,75695000,75725000,"chr15",543064,2,11,6,19,"chr15",1,0.080168776371308
"17699","chr15.49155000.49160000","chr15.49330000.49335000",175000,15,0.000347622,49155000,49330000,49160000,49335000,"chr15",543076,3,6,1,10,"chr15",1,0.0175808720112518
"17700","chr15.57525000.57530000","chr15.57560000.57565000",35000,29,0.0009630767,57525000,57560000,57530000,57565000,"chr15",543091,0,2,0,2,"chr15",1,0.00679793717768401
"17701","chr15.42580000.42585000","chr15.42720000.42725000",140000,17,0.0001256754,42580000,42720000,42585000,42725000,"chr15",543160,3,8,6,17,"chr15",1,0.0338724800750117
"17702","chr15.89740000.89745000","chr15.89850000.89855000",110000,17,0.0007081382,89740000,89850000,89745000,89855000,"chr15",543207,3,5,5,13,"chr15",1,0.0259024847632443
"17703","chr15.40080000.40085000","chr15.40505000.40510000",425000,9,0.005845787,40080000,40505000,40085000,40510000,"chr15",543261,0,2,0,2,"chr15",1,0.00210970464135021
"17704","chr15.33530000.33535000","chr15.33980000.33985000",450000,10,0.0009713471,33530000,33980000,33535000,33985000,"chr15",543272,0,6,1,7,"chr15",1,0.00820440693858415
"17705","chr15.42055000.42060000","chr15.42105000.42110000",50000,26,0.0001470364,42055000,42105000,42060000,42110000,"chr15",543287,4,16,6,26,"chr15",1,0.0792311298640413
"17706","chr15.52335000.52340000","chr15.52360000.52365000",25000,33,0.007630869,52335000,52360000,52340000,52365000,"chr15",543292,0,1,0,1,"chr15",1,0.00386779184247539
"17707","chr15.72310000.72315000","chr15.72355000.72360000",45000,23,0.006309388,72310000,72355000,72315000,72360000,"chr15",543315,1,3,2,6,"chr15",1,0.0161744022503516
"17708","chr15.58630000.58635000","chr15.58975000.58980000",345000,10,0.003948166,58630000,58975000,58635000,58980000,"chr15",543356,2,6,9,17,"chr15",1,0.0199249882794187
"17709","chr15.64690000.64695000","chr15.64725000.64730000",35000,28,0.002140514,64690000,64725000,64695000,64730000,"chr15",543357,0,10,3,13,"chr15",1,0.0426629160806376
"17710","chr15.52285000.52290000","chr15.52360000.52365000",75000,28,3.13269e-08,52285000,52360000,52290000,52365000,"chr15",543410,0,1,1,2,"chr15",1,0.00656352555086732
"17711","chr15.99905000.99910000","chr15.100240000.100245000",335000,13,4.687493e-05,99905000,100240000,99910000,100245000,"chr15",543426,0,2,1,3,"chr15",1,0.00457102672292546
"17712","chr15.65025000.65030000","chr15.65185000.65190000",160000,16,0.0001761524,65025000,65185000,65030000,65190000,"chr15",543472,3,7,4,14,"chr15",1,0.0262541022034693
"17713","chr15.58625000.58630000","chr15.58675000.58680000",50000,23,0.00240478,58625000,58675000,58630000,58680000,"chr15",543477,2,3,9,14,"chr15",1,0.0377402719174871
"17714","chr15.77420000.77425000","chr15.77590000.77595000",170000,13,0.004889429,77420000,77590000,77425000,77595000,"chr15",543481,0,4,3,7,"chr15",1,0.0106657290201594
"17715","chr15.64685000.64690000","chr15.64955000.64960000",270000,14,4.614799e-05,64685000,64955000,64690000,64960000,"chr15",543554,0,2,7,9,"chr15",1,0.0147679324894515
"17716","chr15.33525000.33530000","chr15.33985000.33990000",460000,15,7.646065e-08,33525000,33985000,33530000,33990000,"chr15",543634,0,2,0,2,"chr15",1,0.00351617440225035
"17717","chr15.65285000.65290000","chr15.65325000.65330000",40000,26,0.001960813,65285000,65325000,65290000,65330000,"chr15",543654,2,5,6,13,"chr15",1,0.0396155649320206
"17718","chr15.81275000.81280000","chr15.81310000.81315000",35000,30,0.0004171577,81275000,81310000,81280000,81315000,"chr15",543685,0,0,1,1,"chr15",1,0.00351617440225035
"17719","chr15.74765000.74770000","chr15.74800000.74805000",35000,31,0.0001740818,74765000,74800000,74770000,74805000,"chr15",543695,0,1,1,2,"chr15",1,0.00726676043131739
"17720","chr15.90450000.90455000","chr15.90530000.90535000",80000,17,0.007893422,90450000,90530000,90455000,90535000,"chr15",543696,0,1,1,2,"chr15",1,0.00398499765588373
"17721","chr15.40350000.40355000","chr15.40695000.40700000",345000,10,0.003948166,40350000,40695000,40355000,40700000,"chr15",543811,6,19,15,40,"chr15",1,0.046882325363338
"17722","chr15.64835000.64840000","chr15.64855000.64860000",20000,35,0.00931721,64835000,64855000,64840000,64860000,"chr15",543830,4,6,8,18,"chr15",1,0.0738396624472574
"17723","chr15.59100000.59105000","chr15.59150000.59155000",50000,29,6.037011e-06,59100000,59150000,59105000,59155000,"chr15",543869,6,8,10,24,"chr15",1,0.0815752461322082
"17724","chr15.74405000.74410000","chr15.74655000.74660000",250000,12,0.001534547,74405000,74655000,74410000,74660000,"chr15",543872,1,6,2,9,"chr15",1,0.0126582278481013
"17725","chr15.44190000.44195000","chr15.44485000.44490000",295000,11,0.002204283,44190000,44485000,44195000,44490000,"chr15",543908,3,10,2,15,"chr15",1,0.0193389592123769
"17726","chr15.64385000.64390000","chr15.64450000.64455000",65000,27,1.183404e-06,64385000,64450000,64390000,64455000,"chr15",543935,5,13,16,34,"chr15",1,0.107594936708861
"17727","chr15.90290000.90295000","chr15.90615000.90620000",325000,13,5.822676e-05,90290000,90615000,90295000,90620000,"chr15",543948,3,5,3,11,"chr15",1,0.0167604313173933
"17728","chr15.42065000.42070000","chr15.42105000.42110000",40000,32,6.812837e-06,42065000,42105000,42070000,42110000,"chr15",543988,2,0,2,4,"chr15",1,0.0150023441162682
"17729","chr15.68620000.68625000","chr15.68820000.68825000",200000,12,0.00600824,68620000,68820000,68625000,68825000,"chr15",543996,7,18,14,39,"chr15",1,0.0548523206751055
"17730","chr15.90860000.90865000","chr15.90960000.90965000",100000,17,0.001443741,90860000,90960000,90865000,90965000,"chr15",544139,5,8,13,26,"chr15",1,0.0518049695264885
"17731","chr15.63765000.63770000","chr15.64355000.64360000",590000,8,0.005036407,63765000,64355000,63770000,64360000,"chr15",544144,4,26,15,45,"chr15",1,0.0421940928270042
"17732","chr15.99405000.99410000","chr15.99650000.99655000",245000,11,0.00625113,99405000,99650000,99410000,99655000,"chr15",544149,0,1,2,3,"chr15",1,0.00386779184247539
"17733","chr15.23035000.23040000","chr15.23080000.23085000",45000,34,8.78961e-08,23035000,23080000,23040000,23085000,"chr15",544180,0,0,9,9,"chr15",1,0.0358649789029536
"17734","chr15.90470000.90475000","chr15.90590000.90595000",120000,17,0.0003734436,90470000,90590000,90475000,90595000,"chr15",544245,3,13,7,23,"chr15",1,0.0458274730426629
"17735","chr15.99665000.99670000","chr15.99700000.99705000",35000,31,0.0001740818,99665000,99700000,99670000,99705000,"chr15",544261,0,1,4,5,"chr15",1,0.0181669010782935
"17736","chr15.57040000.57045000","chr15.57080000.57085000",40000,28,0.000347838,57040000,57080000,57045000,57085000,"chr15",544265,1,8,10,19,"chr15",1,0.0623534927332396
"17737","chr15.41980000.41985000","chr15.42720000.42725000",740000,7,0.008126231,41980000,42720000,41985000,42725000,"chr15",544349,0,4,1,5,"chr15",1,0.00410220346929208
"17738","chr15.40695000.40700000","chr15.40855000.40860000",160000,14,0.002176251,40695000,40855000,40700000,40860000,"chr15",544367,6,12,11,29,"chr15",1,0.0475855602437881
"17739","chr15.29335000.29340000","chr15.29360000.29365000",25000,43,3.26955e-06,29335000,29360000,29340000,29365000,"chr15",544401,1,1,0,2,"chr15",1,0.0100796999531177
"17740","chr15.90885000.90890000","chr15.91205000.91210000",320000,11,0.001405124,90885000,91205000,90890000,91210000,"chr15",544428,1,2,4,7,"chr15",1,0.00902484763244257
"17741","chr15.63945000.63950000","chr15.64555000.64560000",610000,9,0.0008076717,63945000,64555000,63950000,64560000,"chr15",544432,3,6,9,18,"chr15",1,0.0189873417721519
"17742","chr15.67805000.67810000","chr15.68110000.68115000",305000,12,0.0004304044,67805000,68110000,67810000,68115000,"chr15",544443,1,2,1,4,"chr15",1,0.00562587904360056
"17743","chr15.52315000.52320000","chr15.52340000.52345000",25000,40,4.494341e-05,52315000,52340000,52320000,52345000,"chr15",544503,0,4,1,5,"chr15",1,0.023441162681669
"17744","chr15.80710000.80715000","chr15.80745000.80750000",35000,28,0.002140514,80710000,80745000,80715000,80750000,"chr15",544551,2,1,0,3,"chr15",1,0.00984528832630099
"17745","chr15.42980000.42985000","chr15.43225000.43230000",245000,11,0.00625113,42980000,43225000,42985000,43230000,"chr15",544647,3,5,3,11,"chr15",1,0.0141819034224098
"17746","chr15.74785000.74790000","chr15.75025000.75030000",240000,11,0.007032572,74785000,75025000,74790000,75030000,"chr15",544716,0,2,3,5,"chr15",1,0.00644631973745898
"17747","chr15.68225000.68230000","chr15.68285000.68290000",60000,22,0.0009355301,68225000,68285000,68230000,68290000,"chr15",544746,3,11,6,20,"chr15",1,0.0515705578996718
"17748","chr15.99650000.99655000","chr15.99755000.99760000",105000,17,0.0009950317,99650000,99755000,99655000,99760000,"chr15",544770,0,1,6,7,"chr15",1,0.0139474917955931
"17749","chr15.90305000.90310000","chr15.90415000.90420000",110000,30,1.918806e-12,90305000,90415000,90310000,90420000,"chr15",544837,0,2,1,3,"chr15",1,0.0105485232067511
"17750","chr15.91845000.91850000","chr15.92065000.92070000",220000,27,8.827182e-15,91845000,92065000,91850000,92070000,"chr15",544853,0,1,0,1,"chr15",1,0.00316455696202532
"17751","chr15.90645000.90650000","chr15.90715000.90720000",70000,19,0.003549507,90645000,90715000,90650000,90720000,"chr15",544881,0,3,5,8,"chr15",1,0.0178152836380684
"17752","chr15.52265000.52270000","chr15.52440000.52445000",175000,13,0.004140243,52265000,52440000,52270000,52445000,"chr15",544930,1,7,5,13,"chr15",1,0.0198077824660103
"17753","chr15.77505000.77510000","chr15.77585000.77590000",80000,17,0.007893422,77505000,77585000,77510000,77590000,"chr15",544933,0,6,3,9,"chr15",1,0.0179324894514768
"17754","chr15.90360000.90365000","chr15.90385000.90390000",25000,33,0.007630869,90360000,90385000,90365000,90390000,"chr15",544962,0,8,8,16,"chr15",1,0.0618846694796062
"17755","chr15.90580000.90585000","chr15.90615000.90620000",35000,27,0.004567474,90580000,90615000,90585000,90620000,"chr15",545019,2,8,6,16,"chr15",1,0.0506329113924051
"17756","chr15.90895000.90900000","chr15.91125000.91130000",230000,12,0.002609904,90895000,91125000,90900000,91130000,"chr15",545092,2,0,1,3,"chr15",1,0.00421940928270042
"17757","chr15.90550000.90555000","chr15.90570000.90575000",20000,38,0.001403223,90550000,90570000,90555000,90575000,"chr15",545164,1,9,2,12,"chr15",1,0.0534458509142053
"17758","chr15.51970000.51975000","chr15.52070000.52075000",100000,18,0.0004720639,51970000,52070000,51975000,52075000,"chr15",545179,6,17,20,43,"chr15",1,0.0907172995780591
"17759","chr15.42480000.42485000","chr15.42720000.42725000",240000,13,0.0005063808,42480000,42720000,42485000,42725000,"chr15",545197,5,12,8,25,"chr15",1,0.0380918893577121
"17760","chr15.74935000.74940000","chr15.74990000.74995000",55000,25,0.0001267361,74935000,74990000,74940000,74995000,"chr15",545272,3,8,7,18,"chr15",1,0.0527426160337553
"17761","chr15.100110000.100115000","chr15.100240000.100245000",130000,19,1.46338e-05,100110000,100240000,100115000,100245000,"chr15",545291,0,1,4,5,"chr15",1,0.0111345522737928
"17762","chr15.38525000.38530000","chr15.38680000.38685000",155000,17,5.765138e-05,38525000,38680000,38530000,38685000,"chr15",545340,0,2,3,5,"chr15",1,0.00996249413970933
"17763","chr15.41915000.41920000","chr15.41985000.41990000",70000,23,5.438413e-05,41915000,41985000,41920000,41990000,"chr15",545345,2,0,1,3,"chr15",1,0.00808720112517581
"17764","chr15.91535000.91540000","chr15.91560000.91565000",25000,41,1.926698e-05,91535000,91560000,91540000,91565000,"chr15",545375,0,1,2,3,"chr15",1,0.0144163150492264
"17765","chr15.22860000.22865000","chr15.23735000.23740000",875000,7,0.003472519,22860000,23735000,22865000,23740000,"chr15",545382,4,9,17,30,"chr15",1,0.0246132208157525
"17766","chr15.42595000.42600000","chr15.43225000.43230000",630000,8,0.003564293,42595000,43225000,42600000,43230000,"chr15",545482,3,5,3,11,"chr15",1,0.0103141115799344
"17767","chr15.42920000.42925000","chr15.42950000.42955000",30000,34,0.0001892218,42920000,42950000,42925000,42955000,"chr15",545515,7,21,18,46,"chr15",1,0.183309892170652
"17768","chr15.77940000.77945000","chr15.78105000.78110000",165000,13,0.005714264,77940000,78105000,77945000,78110000,"chr15",545517,0,2,0,2,"chr15",1,0.00304735114861697
"17769","chr15.57225000.57230000","chr15.57305000.57310000",80000,23,1.108833e-05,57225000,57305000,57230000,57310000,"chr15",545545,1,0,1,2,"chr15",1,0.00539146741678387
"17770","chr15.89015000.89020000","chr15.89205000.89210000",190000,17,9.894063e-06,89015000,89205000,89020000,89210000,"chr15",545660,0,9,2,11,"chr15",1,0.0219174871073605
"17771","chr15.38375000.38380000","chr15.38525000.38530000",150000,14,0.003186368,38375000,38525000,38380000,38530000,"chr15",545721,3,7,3,13,"chr15",1,0.0213314580403188
"17772","chr15.90885000.90890000","chr15.91020000.91025000",135000,21,5.540754e-07,90885000,91020000,90890000,91025000,"chr15",545764,1,2,4,7,"chr15",1,0.0172292545710267
"17773","chr15.76930000.76935000","chr15.76970000.76975000",40000,25,0.00431559,76930000,76970000,76935000,76975000,"chr15",545796,0,1,3,4,"chr15",1,0.0117205813408345
"17774","chr15.64700000.64705000","chr15.64955000.64960000",255000,14,7.378122e-05,64700000,64955000,64705000,64960000,"chr15",545829,0,4,5,9,"chr15",1,0.0147679324894515
"17775","chr15.91100000.91105000","chr15.91135000.91140000",35000,37,4.451337e-07,91100000,91135000,91105000,91140000,"chr15",545840,0,1,3,4,"chr15",1,0.0173464603844351
"17776","chr15.64865000.64870000","chr15.64910000.64915000",45000,25,0.001206606,64865000,64910000,64870000,64915000,"chr15",545893,1,7,15,23,"chr15",1,0.0673933427097984
"17777","chr15.63460000.63465000","chr15.63485000.63490000",25000,33,0.007630869,63460000,63485000,63465000,63490000,"chr15",545902,2,5,2,9,"chr15",1,0.0348101265822785
"17778","chr15.85830000.85835000","chr15.86050000.86055000",220000,14,0.0002372888,85830000,86050000,85835000,86055000,"chr15",545991,1,5,3,9,"chr15",1,0.0147679324894515
"17779","chr15.38375000.38380000","chr15.38535000.38540000",160000,14,0.002176251,38375000,38535000,38380000,38540000,"chr15",545997,2,5,5,12,"chr15",1,0.019690576652602
"17780","chr15.76865000.76870000","chr15.76930000.76935000",65000,19,0.006702748,76865000,76930000,76870000,76935000,"chr15",546006,0,6,3,9,"chr15",1,0.020042194092827
"17781","chr15.90420000.90425000","chr15.90615000.90620000",195000,21,8.939047e-09,90420000,90615000,90425000,90620000,"chr15",546035,4,10,6,20,"chr15",1,0.0492264416315049
"17782","chr15.90315000.90320000","chr15.90635000.90640000",320000,10,0.005588575,90315000,90635000,90320000,90640000,"chr15",546045,2,13,1,16,"chr15",1,0.0187529301453352
"17783","chr15.59265000.59270000","chr15.59675000.59680000",410000,12,6.46764e-05,59265000,59675000,59270000,59680000,"chr15",546046,1,6,1,8,"chr15",1,0.0112517580872011
"17784","chr15.91895000.91900000","chr15.92830000.92835000",935000,7,0.002289828,91895000,92830000,91900000,92835000,"chr15",546068,0,2,0,2,"chr15",1,0.00164088138771683
"17785","chr15.38360000.38365000","chr15.38525000.38530000",165000,14,0.001828956,38360000,38525000,38365000,38530000,"chr15",546079,2,6,3,11,"chr15",1,0.0180496952648851
"17786","chr15.42720000.42725000","chr15.42760000.42765000",40000,29,0.0001382725,42720000,42760000,42725000,42765000,"chr15",546174,1,7,4,12,"chr15",1,0.0407876230661041
"17787","chr15.90315000.90320000","chr15.90615000.90620000",300000,15,3.617014e-06,90315000,90615000,90320000,90620000,"chr15",546239,4,10,6,20,"chr15",1,0.0351617440225035
"17788","chr15.90300000.90305000","chr15.90550000.90555000",250000,11,0.00559719,90300000,90550000,90305000,90555000,"chr15",546250,1,9,2,12,"chr15",1,0.0154711673699015
"17789","chr15.89890000.89895000","chr15.90105000.90110000",215000,13,0.001102564,89890000,90105000,89895000,90110000,"chr15",546260,5,16,20,41,"chr15",1,0.0624706985466479
"17790","chr15.49155000.49160000","chr15.49715000.49720000",560000,8,0.006473689,49155000,49715000,49160000,49720000,"chr15",546304,0,1,1,2,"chr15",1,0.00187529301453352
"17791","chr15.90860000.90865000","chr15.91205000.91210000",345000,10,0.003948166,90860000,91205000,90865000,91210000,"chr15",546373,4,9,9,22,"chr15",1,0.0257852789498359
"17792","chr15.52330000.52335000","chr15.52440000.52445000",110000,16,0.00215011,52330000,52440000,52335000,52445000,"chr15",546458,0,2,2,4,"chr15",1,0.00750117205813408
"17793","chr15.41330000.41335000","chr15.41615000.41620000",285000,14,3.021681e-05,41330000,41615000,41335000,41620000,"chr15",546494,5,22,32,59,"chr15",1,0.096812001875293
"17794","chr15.90860000.90865000","chr15.91300000.91305000",440000,10,0.001102564,90860000,91300000,90865000,91305000,"chr15",546495,0,1,3,4,"chr15",1,0.0046882325363338
"17795","chr15.38190000.38195000","chr15.38210000.38215000",20000,35,0.00931721,38190000,38210000,38195000,38215000,"chr15",546503,1,8,2,11,"chr15",1,0.0451242381622128
"17796","chr15.74955000.74960000","chr15.75045000.75050000",90000,19,0.0003840904,74955000,75045000,74960000,75050000,"chr15",546556,0,3,1,4,"chr15",1,0.00890764181903422
"17797","chr15.73075000.73080000","chr15.73355000.73360000",280000,12,0.0007387203,73075000,73355000,73080000,73360000,"chr15",546602,1,2,2,5,"chr15",1,0.0070323488045007
"17798","chr15.52440000.52445000","chr15.52460000.52465000",20000,37,0.002716941,52440000,52460000,52445000,52465000,"chr15",546622,1,11,5,17,"chr15",1,0.073722456633849
"17799","chr15.65025000.65030000","chr15.65180000.65185000",155000,16,0.0002231216,65025000,65180000,65030000,65185000,"chr15",546642,3,7,4,14,"chr15",1,0.0262541022034693
"17800","chr15.64465000.64470000","chr15.64825000.64830000",360000,11,0.0007338723,64465000,64825000,64470000,64830000,"chr15",546646,10,16,19,45,"chr15",1,0.0580168776371308
"17801","chr15.90960000.90965000","chr15.90990000.90995000",30000,34,0.0001892218,90960000,90990000,90965000,90995000,"chr15",546665,5,8,13,26,"chr15",1,0.103609939052977
"17802","chr15.42575000.42580000","chr15.42675000.42680000",100000,17,0.001443741,42575000,42675000,42580000,42680000,"chr15",546683,0,2,1,3,"chr15",1,0.0059774964838256
"17803","chr15.42760000.42765000","chr15.42920000.42925000",160000,14,0.002176251,42760000,42920000,42765000,42925000,"chr15",546736,1,7,4,12,"chr15",1,0.019690576652602
"17804","chr15.80400000.80405000","chr15.80425000.80430000",25000,33,0.007630869,80400000,80425000,80405000,80430000,"chr15",546798,0,2,2,4,"chr15",1,0.0154711673699015
"17805","chr15.90295000.90300000","chr15.90760000.90765000",465000,10,0.000802076,90295000,90760000,90300000,90765000,"chr15",546808,3,1,6,10,"chr15",1,0.0117205813408345
"17806","chr15.64245000.64250000","chr15.64340000.64345000",95000,19,0.0002320094,64245000,64340000,64250000,64345000,"chr15",546859,6,7,13,26,"chr15",1,0.0578996718237225
"17807","chr15.64460000.64465000","chr15.64955000.64960000",495000,10,0.0005380116,64460000,64955000,64465000,64960000,"chr15",546879,3,8,9,20,"chr15",1,0.023441162681669
"17808","chr15.85295000.85300000","chr15.85605000.85610000",310000,10,0.00649297,85295000,85605000,85300000,85610000,"chr15",546884,0,1,0,1,"chr15",1,0.00117205813408345
"17809","chr15.101700000.101705000","chr15.101795000.101800000",95000,21,1.950866e-05,101700000,101795000,101705000,101800000,"chr15",546909,1,1,1,3,"chr15",1,0.00738396624472574
"17810","chr15.57235000.57240000","chr15.57525000.57530000",290000,11,0.002424804,57235000,57525000,57240000,57530000,"chr15",546929,0,2,0,2,"chr15",1,0.00257852789498359
"17811","chr15.90885000.90890000","chr15.91125000.91130000",240000,15,2.586495e-05,90885000,91125000,90890000,91130000,"chr15",546935,1,0,1,2,"chr15",1,0.00351617440225035
"17812","chr15.42695000.42700000","chr15.42760000.42765000",65000,19,0.006702748,42695000,42760000,42700000,42765000,"chr15",546944,1,7,4,12,"chr15",1,0.0267229254571027
"17813","chr15.40080000.40085000","chr15.40265000.40270000",185000,19,5.353844e-07,40080000,40265000,40085000,40270000,"chr15",546984,0,2,0,2,"chr15",1,0.00445382090951711
"17814","chr15.40405000.40410000","chr15.40505000.40510000",100000,20,4.173317e-05,40405000,40505000,40410000,40510000,"chr15",547010,3,10,19,32,"chr15",1,0.0750117205813408
"17815","chr15.73130000.73135000","chr15.73355000.73360000",225000,12,0.002965561,73130000,73355000,73135000,73360000,"chr15",547032,2,2,5,9,"chr15",1,0.0126582278481013
"17816","chr15.90930000.90935000","chr15.90960000.90965000",30000,50,6.901926e-12,90930000,90960000,90935000,90965000,"chr15",547086,0,3,2,5,"chr15",1,0.0293014533520863
"17817","chr15.90900000.90905000","chr15.90995000.91000000",95000,21,1.950866e-05,90900000,90995000,90905000,9.1e+07,"chr15",547122,5,17,13,35,"chr15",1,0.0861462728551336
"17818","chr15.58545000.58550000","chr15.59290000.59295000",745000,7,0.007871616,58545000,59290000,58550000,59295000,"chr15",547154,2,8,7,17,"chr15",1,0.0139474917955931
"17819","chr15.41555000.41560000","chr15.41660000.41665000",105000,15,0.008226059,41555000,41660000,41560000,41665000,"chr15",547177,1,2,1,4,"chr15",1,0.0070323488045007
"17820","chr15.67240000.67245000","chr15.67545000.67550000",305000,14,1.768242e-05,67240000,67545000,67245000,67550000,"chr15",547210,0,2,4,6,"chr15",1,0.00984528832630099
"17821","chr15.51970000.51975000","chr15.52255000.52260000",285000,10,0.009705474,51970000,52255000,51975000,52260000,"chr15",547259,0,1,2,3,"chr15",1,0.00351617440225035
"17822","chr15.85120000.85125000","chr15.85710000.85715000",590000,8,0.005036407,85120000,85710000,85125000,85715000,"chr15",547265,4,6,0,10,"chr15",1,0.00937646507266761
"17823","chr15.40890000.40895000","chr15.41400000.41405000",510000,11,7.725144e-05,40890000,41400000,40895000,41405000,"chr15",547267,4,8,10,22,"chr15",1,0.0283638068448195
"17824","chr15.72670000.72675000","chr15.72970000.72975000",300000,12,0.0004770372,72670000,72970000,72675000,72975000,"chr15",547274,0,5,4,9,"chr15",1,0.0126582278481013
"17825","chr15.64890000.64895000","chr15.64910000.64915000",20000,37,0.002716941,64890000,64910000,64895000,64915000,"chr15",547309,1,7,15,23,"chr15",1,0.0997421472105016
"17826","chr15.91895000.91900000","chr15.91940000.91945000",45000,29,2.596446e-05,91895000,91940000,91900000,91945000,"chr15",547312,0,2,0,2,"chr15",1,0.00679793717768401
"17827","chr15.68190000.68195000","chr15.68255000.68260000",65000,25,1.374465e-05,68190000,68255000,68195000,68260000,"chr15",547344,0,2,0,2,"chr15",1,0.00586029067041725
"17828","chr15.100140000.100145000","chr15.100240000.100245000",100000,21,1.132223e-05,100140000,100240000,100145000,100245000,"chr15",547372,0,4,0,4,"chr15",1,0.00984528832630099
"17829","chr15.56465000.56470000","chr15.56490000.56495000",25000,38,0.000227129,56465000,56490000,56470000,56495000,"chr15",547447,1,0,5,6,"chr15",1,0.0267229254571027
"17830","chr15.68840000.68845000","chr15.69160000.69165000",320000,14,1.218684e-05,68840000,69160000,68845000,69165000,"chr15",547496,1,1,0,2,"chr15",1,0.00328176277543366
"17831","chr15.64710000.64715000","chr15.65025000.65030000",315000,12,0.000351613,64710000,65025000,64715000,65030000,"chr15",547498,6,7,4,17,"chr15",1,0.0239099859353024
"17832","chr15.57215000.57220000","chr15.57305000.57310000",90000,26,3.555459e-08,57215000,57305000,57220000,57310000,"chr15",547536,0,3,1,4,"chr15",1,0.0121894045944679
"17833","chr15.76840000.76845000","chr15.76945000.76950000",105000,18,0.000318063,76840000,76945000,76845000,76950000,"chr15",547798,2,6,2,10,"chr15",1,0.0210970464135021
"17834","chr15.64725000.64730000","chr15.64985000.64990000",260000,12,0.001192965,64725000,64985000,64730000,64990000,"chr15",547827,2,20,17,39,"chr15",1,0.0548523206751055
"17835","chr15.90425000.90430000","chr15.90615000.90620000",190000,19,4.034359e-07,90425000,90615000,90430000,90620000,"chr15",547855,4,10,6,20,"chr15",1,0.0445382090951711
"17836","chr15.63890000.63895000","chr15.64180000.64185000",290000,10,0.008984683,63890000,64180000,63895000,64185000,"chr15",547860,2,4,5,11,"chr15",1,0.012892639474918
"17837","chr15.44145000.44150000","chr15.44595000.44600000",450000,9,0.004456992,44145000,44595000,44150000,44600000,"chr15",547867,0,1,1,2,"chr15",1,0.00210970464135021
"17838","chr15.59150000.59155000","chr15.59255000.59260000",105000,16,0.002951888,59150000,59255000,59155000,59260000,"chr15",547897,7,19,16,42,"chr15",1,0.0787623066104079
"17839","chr15.90545000.90550000","chr15.90580000.90585000",35000,39,4.694904e-08,90545000,90580000,90550000,90585000,"chr15",547910,2,8,11,21,"chr15",1,0.0959915611814346
"17840","chr15.52265000.52270000","chr15.52380000.52385000",115000,15,0.00473363,52265000,52380000,52270000,52385000,"chr15",547955,1,7,5,13,"chr15",1,0.0228551336146273
"17841","chr15.78255000.78260000","chr15.78485000.78490000",230000,15,3.749386e-05,78255000,78485000,78260000,78490000,"chr15",547960,2,2,2,6,"chr15",1,0.0105485232067511
"17842","chr15.38170000.38175000","chr15.38190000.38195000",20000,38,0.001403223,38170000,38190000,38175000,38195000,"chr15",547972,0,8,2,10,"chr15",1,0.0445382090951711
"17843","chr15.64910000.64915000","chr15.65270000.65275000",360000,11,0.0007338723,64910000,65270000,64915000,65275000,"chr15",547973,1,7,9,17,"chr15",1,0.0219174871073605
"17844","chr15.89630000.89635000","chr15.89690000.89695000",60000,24,0.0001219129,89630000,89690000,89635000,89695000,"chr15",548002,0,3,2,5,"chr15",1,0.0140646976090014
"17845","chr15.57195000.57200000","chr15.57590000.57595000",395000,11,0.0004304044,57195000,57590000,57200000,57595000,"chr15",548089,0,2,4,6,"chr15",1,0.00773558368495077
"17846","chr15.72785000.72790000","chr15.73000000.73005000",215000,12,0.003975359,72785000,7.3e+07,72790000,73005000,"chr15",548129,3,5,3,11,"chr15",1,0.0154711673699015
"17847","chr15.42720000.42725000","chr15.42920000.42925000",200000,16,2.801573e-05,42720000,42920000,42725000,42925000,"chr15",548192,5,12,18,35,"chr15",1,0.0656352555086732
"17848","chr15.38360000.38365000","chr15.38440000.38445000",80000,19,0.001104556,38360000,38440000,38365000,38445000,"chr15",548195,1,3,1,5,"chr15",1,0.0111345522737928
"17849","chr15.64985000.64990000","chr15.65185000.65190000",200000,14,0.0004862494,64985000,65185000,64990000,65190000,"chr15",548315,2,14,9,25,"chr15",1,0.0410220346929208
"17850","chr15.48645000.48650000","chr15.49165000.49170000",520000,8,0.009284671,48645000,49165000,48650000,49170000,"chr15",548365,0,8,8,16,"chr15",1,0.0150023441162682
"17851","chr15.41585000.41590000","chr15.42055000.42060000",470000,9,0.003549507,41585000,42055000,41590000,42060000,"chr15",548371,1,13,7,21,"chr15",1,0.0221518987341772
"17852","chr15.90810000.90815000","chr15.91060000.91065000",250000,11,0.00559719,90810000,91060000,90815000,91065000,"chr15",548483,4,7,3,14,"chr15",1,0.0180496952648851
"17853","chr15.89630000.89635000","chr15.89655000.89660000",25000,84,7.652169e-30,89630000,89655000,89635000,89660000,"chr15",548489,0,3,2,5,"chr15",1,0.0492264416315049
"17854","chr15.89205000.89210000","chr15.89740000.89745000",535000,11,5.452015e-05,89205000,89740000,89210000,89745000,"chr15",548530,6,12,10,28,"chr15",1,0.0360993905297703
"17855","chr15.64985000.64990000","chr15.65270000.65275000",285000,15,5.669647e-06,64985000,65270000,64990000,65275000,"chr15",548564,2,9,9,20,"chr15",1,0.0351617440225035
"17856","chr15.38350000.38355000","chr15.38475000.38480000",125000,15,0.002894796,38350000,38475000,38355000,38480000,"chr15",548650,0,2,1,3,"chr15",1,0.00527426160337553
"17857","chr15.68285000.68290000","chr15.68330000.68335000",45000,24,0.002832527,68285000,68330000,68290000,68335000,"chr15",548668,2,3,4,9,"chr15",1,0.0253164556962025
"17858","chr15.65610000.65615000","chr15.65665000.65670000",55000,31,1.175928e-07,65610000,65665000,65615000,65670000,"chr15",548671,3,12,14,29,"chr15",1,0.105368026254102
"17859","chr15.64130000.64135000","chr15.64355000.64360000",225000,18,3.393009e-07,64130000,64355000,64135000,64360000,"chr15",548672,0,2,3,5,"chr15",1,0.0105485232067511
"17860","chr15.78255000.78260000","chr15.78435000.78440000",180000,18,3.520567e-06,78255000,78435000,78260000,78440000,"chr15",548687,2,2,2,6,"chr15",1,0.0126582278481013
"17861","chr15.41985000.41990000","chr15.42010000.42015000",25000,33,0.007630869,41985000,42010000,41990000,42015000,"chr15",548717,2,0,1,3,"chr15",1,0.0116033755274262
"17862","chr15.41915000.41920000","chr15.42055000.42060000",140000,17,0.0001256754,41915000,42055000,41920000,42060000,"chr15",548771,2,4,4,10,"chr15",1,0.0199249882794187
"17863","chr15.64450000.64455000","chr15.64975000.64980000",525000,8,0.008880433,64450000,64975000,64455000,64980000,"chr15",548783,5,13,18,36,"chr15",1,0.0337552742616034
"17864","chr15.80710000.80715000","chr15.81270000.81275000",560000,8,0.006473689,80710000,81270000,80715000,81275000,"chr15",548798,5,5,12,22,"chr15",1,0.0206282231598687
"17865","chr15.77420000.77425000","chr15.77870000.77875000",450000,9,0.004456992,77420000,77870000,77425000,77875000,"chr15",548800,0,3,3,6,"chr15",1,0.00632911392405063
"17866","chr15.90790000.90795000","chr15.91020000.91025000",230000,11,0.00889367,90790000,91020000,90795000,91025000,"chr15",548830,1,11,12,24,"chr15",1,0.0309423347398031
"17867","chr15.90300000.90305000","chr15.90635000.90640000",335000,11,0.001092698,90300000,90635000,90305000,90640000,"chr15",548837,2,13,1,16,"chr15",1,0.0206282231598687
"17868","chr15.41980000.41985000","chr15.42010000.42015000",30000,29,0.008226059,41980000,42010000,41985000,42015000,"chr15",548849,0,4,1,5,"chr15",1,0.01699484294421
"17869","chr15.99075000.99080000","chr15.99405000.99410000",330000,10,0.004858391,99075000,99405000,99080000,99410000,"chr15",548871,1,4,2,7,"chr15",1,0.00820440693858415
"17870","chr15.90530000.90535000","chr15.90635000.90640000",105000,15,0.008226059,90530000,90635000,90535000,90640000,"chr15",548904,0,1,1,2,"chr15",1,0.00351617440225035
"17871","chr15.25620000.25625000","chr15.25680000.25685000",60000,22,0.0009355301,25620000,25680000,25625000,25685000,"chr15",548930,0,0,4,4,"chr15",1,0.0103141115799344
"17872","chr15.52340000.52345000","chr15.52360000.52365000",20000,53,2.884169e-09,52340000,52360000,52345000,52365000,"chr15",548957,0,1,1,2,"chr15",1,0.0124238162212846
"17873","chr15.91020000.91025000","chr15.91125000.91130000",105000,15,0.008226059,91020000,91125000,91025000,91130000,"chr15",548968,2,0,1,3,"chr15",1,0.00527426160337553
"17874","chr15.86040000.86045000","chr15.86060000.86065000",20000,47,1.064452e-06,86040000,86060000,86045000,86065000,"chr15",549016,0,3,1,4,"chr15",1,0.0220346929207689
"17875","chr15.91845000.91850000","chr15.92630000.92635000",785000,8,0.001060466,91845000,92630000,91850000,92635000,"chr15",549025,1,1,0,2,"chr15",1,0.00187529301453352
"17876","chr15.52285000.52290000","chr15.52460000.52465000",175000,16,8.705803e-05,52285000,52460000,52290000,52465000,"chr15",549067,5,22,18,45,"chr15",1,0.0843881856540084
"17877","chr15.63760000.63765000","chr15.63870000.63875000",110000,15,0.006137384,63760000,63870000,63765000,63875000,"chr15",549092,1,7,7,15,"chr15",1,0.0263713080168776
"17878","chr15.29335000.29340000","chr15.29375000.29380000",40000,25,0.00431559,29335000,29375000,29340000,29380000,"chr15",549110,0,2,1,3,"chr15",1,0.00879043600562588
"17879","chr15.90935000.90940000","chr15.91100000.91105000",165000,14,0.001828956,90935000,91100000,90940000,91105000,"chr15",549112,0,3,4,7,"chr15",1,0.0114861697140178
"17880","chr15.78295000.78300000","chr15.78390000.78395000",95000,17,0.002150076,78295000,78390000,78300000,78395000,"chr15",549117,6,8,13,27,"chr15",1,0.0537974683544304
"17881","chr15.51520000.51525000","chr15.51675000.51680000",155000,16,0.0002231216,51520000,51675000,51525000,51680000,"chr15",549131,1,7,4,12,"chr15",1,0.0225035161744023
"17882","chr15.78255000.78260000","chr15.78540000.78545000",285000,11,0.002687577,78255000,78540000,78260000,78545000,"chr15",549209,2,2,2,6,"chr15",1,0.00773558368495077
"17883","chr15.52255000.52260000","chr15.52325000.52330000",70000,21,0.000486251,52255000,52325000,52260000,52330000,"chr15",549229,0,1,2,3,"chr15",1,0.00738396624472574
"17884","chr15.33525000.33530000","chr15.33960000.33965000",435000,11,0.000235261,33525000,33960000,33530000,33965000,"chr15",549287,0,2,0,2,"chr15",1,0.00257852789498359
"17885","chr15.64065000.64070000","chr15.64340000.64345000",275000,12,0.0008398675,64065000,64340000,64070000,64345000,"chr15",549296,10,34,19,63,"chr15",1,0.0886075949367089
"17886","chr15.73075000.73080000","chr15.73600000.73605000",525000,10,0.0003734436,73075000,73600000,73080000,73605000,"chr15",549302,1,2,2,5,"chr15",1,0.00586029067041725
"17887","chr15.73240000.73245000","chr15.73280000.73285000",40000,25,0.00431559,73240000,73280000,73245000,73285000,"chr15",549359,0,5,4,9,"chr15",1,0.0263713080168776
"17888","chr15.64835000.64840000","chr15.64910000.64915000",75000,23,2.393376e-05,64835000,64910000,64840000,64915000,"chr15",549432,1,7,15,23,"chr15",1,0.0620018752930145
"17889","chr15.65325000.65330000","chr15.65595000.65600000",270000,11,0.003656018,65325000,65595000,65330000,65600000,"chr15",549448,0,2,2,4,"chr15",1,0.00515705578996718
"17890","chr15.80775000.80780000","chr15.81045000.81050000",270000,12,0.0009442505,80775000,81045000,80780000,81050000,"chr15",549471,0,2,1,3,"chr15",1,0.00421940928270042
"17891","chr15.57155000.57160000","chr15.57590000.57595000",435000,9,0.005214754,57155000,57590000,57160000,57595000,"chr15",549477,0,2,2,4,"chr15",1,0.00421940928270042
"17892","chr15.51925000.51930000","chr15.52080000.52085000",155000,15,0.000802076,51925000,52080000,51930000,52085000,"chr15",549525,2,10,8,20,"chr15",1,0.0351617440225035
"17893","chr15.91845000.91850000","chr15.92625000.92630000",780000,25,3.525331e-23,91845000,92625000,91850000,92630000,"chr15",549537,1,1,0,2,"chr15",1,0.00586029067041725
"17894","chr15.68840000.68845000","chr15.68925000.68930000",85000,19,0.0006491862,68840000,68925000,68845000,68930000,"chr15",549552,0,1,2,3,"chr15",1,0.00668073136427567
"17895","chr15.90645000.90650000","chr15.90810000.90815000",165000,16,0.0001402773,90645000,90810000,90650000,90815000,"chr15",549586,0,3,3,6,"chr15",1,0.0112517580872011
"17896","chr15.44185000.44190000","chr15.44500000.44505000",315000,12,0.000351613,44185000,44500000,44190000,44505000,"chr15",549596,4,13,7,24,"chr15",1,0.0337552742616034
"17897","chr15.90895000.90900000","chr15.91055000.91060000",160000,14,0.002176251,90895000,91055000,90900000,91060000,"chr15",549599,3,11,7,21,"chr15",1,0.0344585091420534
"17898","chr15.29265000.29270000","chr15.29375000.29380000",110000,18,0.0002142471,29265000,29375000,29270000,29380000,"chr15",549608,0,2,1,3,"chr15",1,0.00632911392405063
"17899","chr15.90895000.90900000","chr15.91020000.91025000",125000,29,1.598068e-12,90895000,91020000,90900000,91025000,"chr15",549610,3,12,18,33,"chr15",1,0.112165963431786
"17900","chr15.75345000.75350000","chr15.75455000.75460000",110000,16,0.00215011,75345000,75455000,75350000,75460000,"chr15",549636,5,11,8,24,"chr15",1,0.0450070323488045
"17901","chr15.33580000.33585000","chr15.33985000.33990000",405000,21,5.103207e-13,33580000,33985000,33585000,33990000,"chr15",549718,1,2,1,4,"chr15",1,0.00984528832630099
"17902","chr15.91095000.91100000","chr15.91135000.91140000",40000,29,0.0001382725,91095000,91135000,91100000,91140000,"chr15",549725,1,1,1,3,"chr15",1,0.010196905766526
"17903","chr15.90525000.90530000","chr15.90615000.90620000",90000,18,0.001147697,90525000,90615000,90530000,90620000,"chr15",549728,4,10,6,20,"chr15",1,0.0421940928270042
"17904","chr15.90930000.90935000","chr15.91060000.91065000",130000,16,0.0007243897,90930000,91060000,90935000,91065000,"chr15",549734,0,3,2,5,"chr15",1,0.00937646507266761
"17905","chr15.90900000.90905000","chr15.91020000.91025000",120000,28,1.801147e-11,90900000,91020000,90905000,91025000,"chr15",549738,5,26,13,44,"chr15",1,0.144397562119081
"17906","chr15.42580000.42585000","chr15.42675000.42680000",95000,17,0.002150076,42580000,42675000,42585000,42680000,"chr15",549819,0,2,1,3,"chr15",1,0.0059774964838256
"17907","chr15.42900000.42905000","chr15.42920000.42925000",20000,57,3.702059e-11,42900000,42920000,42905000,42925000,"chr15",549826,4,22,18,44,"chr15",1,0.293952180028129
"17908","chr15.44215000.44220000","chr15.44425000.44430000",210000,12,0.004567354,44215000,44425000,44220000,44430000,"chr15",549852,3,15,20,38,"chr15",1,0.0534458509142053
"17909","chr15.90935000.90940000","chr15.90995000.91000000",60000,44,3.623661e-17,90935000,90995000,90940000,9.1e+07,"chr15",549899,2,10,8,20,"chr15",1,0.103141115799344
"17910","chr15.73075000.73080000","chr15.73375000.73380000",300000,30,1.455617e-20,73075000,73375000,73080000,73380000,"chr15",549953,0,2,1,3,"chr15",1,0.0105485232067511
"17911","chr15.68555000.68560000","chr15.68970000.68975000",415000,9,0.006550562,68555000,68970000,68560000,68975000,"chr15",549972,1,1,0,2,"chr15",1,0.00210970464135021
"17912","chr15.89630000.89635000","chr15.89740000.89745000",110000,19,6.097144e-05,89630000,89740000,89635000,89745000,"chr15",549994,0,3,2,5,"chr15",1,0.0111345522737928
"17913","chr15.64460000.64465000","chr15.64700000.64705000",240000,14,0.0001208274,64460000,64700000,64465000,64705000,"chr15",550000,0,4,5,9,"chr15",1,0.0147679324894515
"17914","chr15.44485000.44490000","chr15.44535000.44540000",50000,22,0.005586357,44485000,44535000,44490000,44540000,"chr15",550005,3,10,2,15,"chr15",1,0.0386779184247539
"17915","chr15.80740000.80745000","chr15.81275000.81280000",535000,10,0.0003341806,80740000,81275000,80745000,81280000,"chr15",550014,1,0,1,2,"chr15",1,0.0023441162681669
"17916","chr15.99055000.99060000","chr15.99450000.99455000",395000,10,0.002019374,99055000,99450000,99060000,99455000,"chr15",550070,1,4,1,6,"chr15",1,0.0070323488045007
"17917","chr15.62845000.62850000","chr15.62885000.62890000",40000,24,0.009166979,62845000,62885000,62850000,62890000,"chr15",550071,0,2,1,3,"chr15",1,0.00843881856540084
"17918","chr15.90570000.90575000","chr15.90615000.90620000",45000,23,0.006309388,90570000,90615000,90575000,90620000,"chr15",550085,2,10,5,17,"chr15",1,0.0458274730426629
"17919","chr15.59150000.59155000","chr15.59200000.59205000",50000,22,0.005586357,59150000,59200000,59155000,59205000,"chr15",550156,4,4,8,16,"chr15",1,0.0412564463197375
"17920","chr15.51835000.51840000","chr15.51870000.51875000",35000,30,0.0004171577,51835000,51870000,51840000,51875000,"chr15",550173,3,13,7,23,"chr15",1,0.0808720112517581
"17921","chr15.48640000.48645000","chr15.49085000.49090000",445000,10,0.0010298,48640000,49085000,48645000,49090000,"chr15",550174,0,4,2,6,"chr15",1,0.0070323488045007
"17922","chr15.38475000.38480000","chr15.38505000.38510000",30000,40,7.028405e-07,38475000,38505000,38480000,38510000,"chr15",550201,2,4,1,7,"chr15",1,0.0328176277543366
"17923","chr15.68225000.68230000","chr15.68255000.68260000",30000,29,0.008226059,68225000,68255000,68230000,68260000,"chr15",550208,3,6,2,11,"chr15",1,0.0373886544772621
"17924","chr15.78260000.78265000","chr15.78390000.78395000",130000,16,0.0007243897,78260000,78390000,78265000,78395000,"chr15",550244,0,6,1,7,"chr15",1,0.0131270511017346
"17925","chr15.91860000.91865000","chr15.92065000.92070000",205000,14,0.0004060791,91860000,92065000,91865000,92070000,"chr15",550283,0,4,1,5,"chr15",1,0.00820440693858415
"17926","chr15.90895000.90900000","chr15.91560000.91565000",665000,8,0.002684212,90895000,91560000,90900000,91565000,"chr15",550284,0,1,2,3,"chr15",1,0.00281293952180028
"17927","chr15.64910000.64915000","chr15.64955000.64960000",45000,23,0.006309388,64910000,64955000,64915000,64960000,"chr15",550310,1,7,9,17,"chr15",1,0.0458274730426629
"17928","chr15.59105000.59110000","chr15.59150000.59155000",45000,26,0.0004892278,59105000,59150000,59110000,59155000,"chr15",550327,1,6,6,13,"chr15",1,0.0396155649320206
"17929","chr15.90550000.90555000","chr15.90615000.90620000",65000,29,8.449859e-08,90550000,90615000,90555000,90620000,"chr15",550394,1,9,2,12,"chr15",1,0.0407876230661041
"17930","chr15.64840000.64845000","chr15.64865000.64870000",25000,38,0.000227129,64840000,64865000,64845000,64870000,"chr15",550404,0,3,1,4,"chr15",1,0.0178152836380684
"17931","chr15.78730000.78735000","chr15.78755000.78760000",25000,35,0.002051446,78730000,78755000,78735000,78760000,"chr15",550418,0,1,0,1,"chr15",1,0.00410220346929208
"17932","chr15.40235000.40240000","chr15.40255000.40260000",20000,40,0.000347622,40235000,40255000,40240000,40260000,"chr15",550432,0,5,3,8,"chr15",1,0.0375058602906704
"17933","chr15.64130000.64135000","chr15.64180000.64185000",50000,26,0.0001470364,64130000,64180000,64135000,64185000,"chr15",550526,0,2,3,5,"chr15",1,0.0152367557430849
"17934","chr15.40350000.40355000","chr15.40505000.40510000",155000,14,0.002645315,40350000,40505000,40355000,40510000,"chr15",550610,5,19,15,39,"chr15",1,0.0639943741209564
"17935","chr15.64690000.64695000","chr15.65270000.65275000",580000,8,0.005440495,64690000,65270000,64695000,65275000,"chr15",550702,0,9,3,12,"chr15",1,0.0112517580872011
"17936","chr15.80745000.80750000","chr15.81310000.81315000",565000,8,0.006177903,80745000,81310000,80750000,81315000,"chr15",550721,0,1,0,1,"chr15",1,0.00093764650726676
"17937","chr15.52315000.52320000","chr15.52330000.52335000",15000,37,0.002716941,52315000,52330000,52320000,52335000,"chr15",550781,0,2,2,4,"chr15",1,0.0173464603844351
"17938","chr15.44575000.44580000","chr15.44725000.44730000",150000,13,0.009453083,44575000,44725000,44580000,44730000,"chr15",550819,7,15,16,38,"chr15",1,0.0578996718237225
"17939","chr15.67250000.67255000","chr15.67585000.67590000",335000,10,0.004534584,67250000,67585000,67255000,67590000,"chr15",550834,2,1,1,4,"chr15",1,0.0046882325363338
"17940","chr15.90300000.90305000","chr15.90415000.90420000",115000,41,1.856771e-22,90300000,90415000,90305000,90420000,"chr15",550932,4,4,16,24,"chr15",1,0.115330520393812
"17941","chr15.92635000.92640000","chr15.92780000.92785000",145000,18,2.453115e-05,92635000,92780000,92640000,92785000,"chr15",550967,0,6,6,12,"chr15",1,0.0253164556962025
"17942","chr15.41825000.41830000","chr15.42055000.42060000",230000,12,0.002609904,41825000,42055000,41830000,42060000,"chr15",550971,4,12,20,36,"chr15",1,0.0506329113924051
"17943","chr15.78755000.78760000","chr15.78810000.78815000",55000,24,0.0003491618,78755000,78810000,78760000,78815000,"chr15",550982,0,2,0,2,"chr15",1,0.00562587904360056
"17944","chr15.90420000.90425000","chr15.90545000.90550000",125000,16,0.0009407814,90420000,90545000,90425000,90550000,"chr15",551044,5,17,20,42,"chr15",1,0.0787623066104079
"17945","chr15.64180000.64185000","chr15.64355000.64360000",175000,17,2.066764e-05,64180000,64355000,64185000,64360000,"chr15",551047,4,12,10,26,"chr15",1,0.0518049695264885
"17946","chr15.33580000.33585000","chr15.33980000.33985000",400000,23,5.047064e-15,33580000,33980000,33585000,33985000,"chr15",551075,0,8,1,9,"chr15",1,0.0242616033755274
"17947","chr15.90315000.90320000","chr15.90570000.90575000",255000,11,0.00505316,90315000,90570000,90320000,90575000,"chr15",551083,2,11,5,18,"chr15",1,0.0232067510548523
"17948","chr15.33580000.33585000","chr15.33975000.33980000",395000,13,1.46338e-05,33580000,33975000,33585000,33980000,"chr15",551104,4,5,9,18,"chr15",1,0.0274261603375527
"17949","chr15.90425000.90430000","chr15.90635000.90640000",210000,13,0.00129158,90425000,90635000,90430000,90640000,"chr15",551169,2,13,1,16,"chr15",1,0.0243788091889358
"17950","chr15.48350000.48355000","chr15.48505000.48510000",155000,13,0.008126231,48350000,48505000,48355000,48510000,"chr15",551216,1,4,0,5,"chr15",1,0.00761837787154243
"17951","chr15.44595000.44600000","chr15.44710000.44715000",115000,15,0.00473363,44595000,44710000,44600000,44715000,"chr15",551221,0,6,1,7,"chr15",1,0.0123066104078762
"17952","chr15.74655000.74660000","chr15.74785000.74790000",130000,21,7.952014e-07,74655000,74785000,74660000,74790000,"chr15",551231,0,6,4,10,"chr15",1,0.0246132208157525
"17953","chr15.58700000.58705000","chr15.58955000.58960000",255000,17,5.036433e-07,58700000,58955000,58705000,58960000,"chr15",551266,1,4,6,11,"chr15",1,0.0219174871073605
"17954","chr15.45000000.45005000","chr15.45020000.45025000",20000,103,1.027038e-40,4.5e+07,45020000,45005000,45025000,"chr15",551275,0,0,5,5,"chr15",1,0.0603609939052977
"17955","chr15.59275000.59280000","chr15.59385000.59390000",110000,20,1.63151e-05,59275000,59385000,59280000,59390000,"chr15",551323,0,2,1,3,"chr15",1,0.0070323488045007
"17956","chr15.52255000.52260000","chr15.52340000.52345000",85000,21,6.545716e-05,52255000,52340000,52260000,52345000,"chr15",551355,0,1,1,2,"chr15",1,0.00492264416315049
"17957","chr15.75735000.75740000","chr15.75755000.75760000",20000,43,3.359096e-05,75735000,75755000,75740000,75760000,"chr15",551390,2,5,6,13,"chr15",1,0.0655180496952649
"17958","chr15.64065000.64070000","chr15.64270000.64275000",205000,12,0.005213753,64065000,64270000,64070000,64275000,"chr15",551411,3,7,10,20,"chr15",1,0.0281293952180028
"17959","chr15.90615000.90620000","chr15.90635000.90640000",20000,51,2.265216e-08,90615000,90635000,90620000,90640000,"chr15",551421,2,10,1,13,"chr15",1,0.0777074542897328
"17960","chr15.42900000.42905000","chr15.42950000.42955000",50000,30,1.907382e-06,42900000,42950000,42905000,42955000,"chr15",551425,4,21,20,45,"chr15",1,0.158227848101266
"17961","chr15.91060000.91065000","chr15.91125000.91130000",65000,24,4.360658e-05,91060000,91125000,91065000,91130000,"chr15",551474,2,0,1,3,"chr15",1,0.00843881856540084
"17962","chr15.77415000.77420000","chr15.77705000.77710000",290000,12,0.0005913411,77415000,77705000,77420000,77710000,"chr15",551507,0,3,0,3,"chr15",1,0.00421940928270042
"17963","chr15.57320000.57325000","chr15.57560000.57565000",240000,12,0.002012613,57320000,57560000,57325000,57565000,"chr15",551583,0,1,3,4,"chr15",1,0.00562587904360056
"17964","chr15.85840000.85845000","chr15.86080000.86085000",240000,12,0.002012613,85840000,86080000,85845000,86085000,"chr15",551587,0,2,3,5,"chr15",1,0.0070323488045007
"17965","chr15.34705000.34710000","chr15.34855000.34860000",150000,15,0.0009895776,34705000,34855000,34710000,34860000,"chr15",551660,0,7,2,9,"chr15",1,0.0158227848101266
"17966","chr15.90385000.90390000","chr15.90615000.90620000",230000,12,0.002609904,90385000,90615000,90390000,90620000,"chr15",551697,2,8,6,16,"chr15",1,0.0225035161744023
"17967","chr15.57305000.57310000","chr15.57590000.57595000",285000,11,0.002687577,57305000,57590000,57310000,57595000,"chr15",551708,0,2,3,5,"chr15",1,0.00644631973745898
"17968","chr15.90420000.90425000","chr15.90635000.90640000",215000,18,5.540754e-07,90420000,90635000,90425000,90640000,"chr15",551757,2,13,1,16,"chr15",1,0.0337552742616034
"17969","chr15.90415000.90420000","chr15.90615000.90620000",200000,17,6.037011e-06,90415000,90615000,90420000,90620000,"chr15",551774,4,4,6,14,"chr15",1,0.0278949835911861
"17970","chr15.59305000.59310000","chr15.59385000.59390000",80000,18,0.003021543,59305000,59385000,59310000,59390000,"chr15",551779,4,20,17,41,"chr15",1,0.0864978902953586
"17971","chr15.38560000.38565000","chr15.38620000.38625000",60000,25,4.106653e-05,38560000,38620000,38565000,38625000,"chr15",551841,2,5,6,13,"chr15",1,0.0380918893577121
"17972","chr15.89690000.89695000","chr15.89890000.89895000",200000,12,0.00600824,89690000,89890000,89695000,89895000,"chr15",551904,0,7,7,14,"chr15",1,0.019690576652602
"17973","chr15.74935000.74940000","chr15.75040000.75045000",105000,17,0.0009950317,74935000,75040000,74940000,75045000,"chr15",551923,4,16,12,32,"chr15",1,0.0637599624941397
"17974","chr15.90530000.90535000","chr15.90615000.90620000",85000,19,0.0006491862,90530000,90615000,90535000,90620000,"chr15",551967,0,1,6,7,"chr15",1,0.0155883731833099
"17975","chr15.52335000.52340000","chr15.52365000.52370000",30000,48,8.396187e-11,52335000,52365000,52340000,52370000,"chr15",552029,0,2,0,2,"chr15",1,0.0112517580872011
"17976","chr15.44475000.44480000","chr15.44535000.44540000",60000,21,0.002358672,44475000,44535000,44480000,44540000,"chr15",552036,4,19,33,56,"chr15",1,0.137834036568214
"17977","chr15.52265000.52270000","chr15.52340000.52345000",75000,29,7.408837e-09,52265000,52340000,52270000,52345000,"chr15",552061,2,4,1,7,"chr15",1,0.023792780121894
"17978","chr15.90545000.90550000","chr15.90645000.90650000",100000,17,0.001443741,90545000,90645000,90550000,90650000,"chr15",552074,0,3,5,8,"chr15",1,0.0159399906235349
"17979","chr15.44285000.44290000","chr15.44475000.44480000",190000,12,0.008126231,44285000,44475000,44290000,44480000,"chr15",552182,3,14,14,31,"chr15",1,0.0436005625879044
"17980","chr15.49715000.49720000","chr15.50350000.50355000",635000,9,0.000631291,49715000,50350000,49720000,50355000,"chr15",552212,0,1,3,4,"chr15",1,0.00421940928270042
"17981","chr15.52255000.52260000","chr15.52460000.52465000",205000,17,4.748529e-06,52255000,52460000,52260000,52465000,"chr15",552215,0,1,2,3,"chr15",1,0.0059774964838256
"17982","chr15.90715000.90720000","chr15.90760000.90765000",45000,41,7.935716e-12,90715000,90760000,90720000,90765000,"chr15",552268,0,1,6,7,"chr15",1,0.033638068448195
"17983","chr15.41415000.41420000","chr15.41495000.41500000",80000,17,0.007893422,41415000,41495000,41420000,41500000,"chr15",552285,1,12,7,20,"chr15",1,0.0398499765588373
"17984","chr15.33610000.33615000","chr15.33985000.33990000",375000,12,0.0001189128,33610000,33985000,33615000,33990000,"chr15",552341,1,2,1,4,"chr15",1,0.00562587904360056
"17985","chr15.90460000.90465000","chr15.90615000.90620000",155000,15,0.000802076,90460000,90615000,90465000,90620000,"chr15",552367,1,5,6,12,"chr15",1,0.0210970464135021
"17986","chr15.44195000.44200000","chr15.44575000.44580000",380000,10,0.002430085,44195000,44575000,44200000,44580000,"chr15",552429,4,15,12,31,"chr15",1,0.036333802156587
"17987","chr15.52180000.52185000","chr15.52365000.52370000",185000,14,0.0008529918,52180000,52365000,52185000,52370000,"chr15",552464,1,2,0,3,"chr15",1,0.00492264416315049
"17988","chr15.51970000.51975000","chr15.52040000.52045000",70000,19,0.003549507,51970000,52040000,51975000,52045000,"chr15",552479,6,13,8,27,"chr15",1,0.060126582278481
"17989","chr15.59350000.59355000","chr15.59370000.59375000",20000,39,0.0007081382,59350000,59370000,59355000,59375000,"chr15",552492,3,4,8,15,"chr15",1,0.0685654008438819
"17990","chr15.51970000.51975000","chr15.52010000.52015000",40000,24,0.009166979,51970000,52010000,51975000,52015000,"chr15",552512,9,31,28,68,"chr15",1,0.191279887482419
"17991","chr15.64385000.64390000","chr15.64440000.64445000",55000,46,1.569593e-17,64385000,64440000,64390000,64445000,"chr15",552548,9,15,16,40,"chr15",1,0.215658696671355
"17992","chr15.58625000.58630000","chr15.58700000.58705000",75000,18,0.005101528,58625000,58700000,58630000,58705000,"chr15",552558,1,3,6,10,"chr15",1,0.0210970464135021
"17993","chr15.64725000.64730000","chr15.64910000.64915000",185000,18,2.674085e-06,64725000,64910000,64730000,64915000,"chr15",552570,1,7,15,23,"chr15",1,0.0485232067510548
"17994","chr15.74445000.74450000","chr15.74540000.74545000",95000,16,0.005893442,74445000,74540000,74450000,74545000,"chr15",552601,2,2,3,7,"chr15",1,0.0131270511017346
"17995","chr15.63610000.63615000","chr15.63630000.63635000",20000,36,0.005119318,63610000,63630000,63615000,63635000,"chr15",552617,1,10,8,19,"chr15",1,0.080168776371308
"17996","chr15.85295000.85300000","chr15.85690000.85695000",395000,11,0.0004304044,85295000,85690000,85300000,85695000,"chr15",552632,3,8,4,15,"chr15",1,0.0193389592123769
"17997","chr15.44425000.44430000","chr15.44775000.44780000",350000,13,3.481697e-05,44425000,44775000,44430000,44780000,"chr15",552744,2,3,16,21,"chr15",1,0.0319971870604782
"17998","chr15.57040000.57045000","chr15.57075000.57080000",35000,27,0.004567474,57040000,57075000,57045000,57080000,"chr15",552756,6,9,14,29,"chr15",1,0.0917721518987342
"17999","chr15.44535000.44540000","chr15.44660000.44665000",125000,18,7.702952e-05,44535000,44660000,44540000,44665000,"chr15",552762,1,4,2,7,"chr15",1,0.0147679324894515
"18000","chr15.90895000.90900000","chr15.91205000.91210000",310000,11,0.001687543,90895000,91205000,90900000,91210000,"chr15",552763,3,9,9,21,"chr15",1,0.0270745428973277
"18001","chr15.77575000.77580000","chr15.77590000.77595000",15000,35,0.00931721,77575000,77590000,77580000,77595000,"chr15",552785,4,5,5,14,"chr15",1,0.0574308485700891
"18002","chr15.90290000.90295000","chr15.90420000.90425000",130000,18,5.74023e-05,90290000,90420000,90295000,90425000,"chr15",552810,3,5,3,11,"chr15",1,0.0232067510548523
"18003","chr15.80750000.80755000","chr15.81275000.81280000",525000,11,6.31944e-05,80750000,81275000,80755000,81280000,"chr15",552833,1,0,1,2,"chr15",1,0.00257852789498359
"18004","chr15.58630000.58635000","chr15.58700000.58705000",70000,19,0.003549507,58630000,58700000,58635000,58705000,"chr15",552888,1,4,6,11,"chr15",1,0.0244960150023441
"18005","chr15.38645000.38650000","chr15.38680000.38685000",35000,39,4.694904e-08,38645000,38680000,38650000,38685000,"chr15",552932,0,2,4,6,"chr15",1,0.0274261603375527
"18006","chr15.64725000.64730000","chr15.64905000.64910000",180000,14,0.001019254,64725000,64905000,64730000,64910000,"chr15",552936,2,7,6,15,"chr15",1,0.0246132208157525
"18007","chr15.29015000.29020000","chr15.29375000.29380000",360000,11,0.0007338723,29015000,29375000,29020000,29380000,"chr15",552974,0,2,1,3,"chr15",1,0.00386779184247539
"18008","chr15.63120000.63125000","chr15.63355000.63360000",235000,13,0.0005921178,63120000,63355000,63125000,63360000,"chr15",552994,0,2,0,2,"chr15",1,0.00304735114861697
"18009","chr15.85840000.85845000","chr15.86040000.86045000",200000,26,3.807999e-13,85840000,86040000,85845000,86045000,"chr15",553001,0,3,2,5,"chr15",1,0.0152367557430849
"18010","chr15.64710000.64715000","chr15.65060000.65065000",350000,11,0.0008643219,64710000,65060000,64715000,65065000,"chr15",553023,0,8,8,16,"chr15",1,0.0206282231598687
"18011","chr15.91940000.91945000","chr15.92000000.92005000",60000,22,0.0009355301,91940000,9.2e+07,91945000,92005000,"chr15",553080,0,0,1,1,"chr15",1,0.00257852789498359
"18012","chr15.44245000.44250000","chr15.44775000.44780000",530000,8,0.0084746,44245000,44775000,44250000,44780000,"chr15",553092,2,3,16,21,"chr15",1,0.019690576652602
"18013","chr15.40855000.40860000","chr15.41180000.41185000",325000,21,9.405679e-12,40855000,41180000,40860000,41185000,"chr15",553114,5,12,11,28,"chr15",1,0.0689170182841069
"18014","chr15.64465000.64470000","chr15.64700000.64705000",235000,12,0.00227715,64465000,64700000,64470000,64705000,"chr15",553141,0,4,5,9,"chr15",1,0.0126582278481013
"18015","chr15.71730000.71735000","chr15.71750000.71755000",20000,37,0.002716941,71730000,71750000,71735000,71755000,"chr15",553154,3,6,10,19,"chr15",1,0.0823956868260666
"18016","chr15.38360000.38365000","chr15.38605000.38610000",245000,13,0.0004398573,38360000,38605000,38365000,38610000,"chr15",553169,0,3,2,5,"chr15",1,0.00761837787154243
"18017","chr15.90295000.90300000","chr15.90635000.90640000",340000,15,1.243758e-06,90295000,90635000,90300000,90640000,"chr15",553186,2,8,1,11,"chr15",1,0.0193389592123769
"18018","chr15.90400000.90405000","chr15.90615000.90620000",215000,13,0.001102564,90400000,90615000,90405000,90620000,"chr15",553251,1,10,6,17,"chr15",1,0.0259024847632443
"18019","chr15.64985000.64990000","chr15.65180000.65185000",195000,20,5.303689e-08,64985000,65180000,64990000,65185000,"chr15",553275,2,20,17,39,"chr15",1,0.0914205344585091
"18020","chr15.38505000.38510000","chr15.38525000.38530000",20000,35,0.00931721,38505000,38525000,38510000,38530000,"chr15",553307,2,4,1,7,"chr15",1,0.0287154242850445
"18021","chr15.91690000.91695000","chr15.91750000.91755000",60000,26,1.325372e-05,91690000,91750000,91695000,91755000,"chr15",553342,0,4,5,9,"chr15",1,0.0274261603375527
"18022","chr15.63760000.63765000","chr15.64355000.64360000",595000,10,0.0001606997,63760000,64355000,63765000,64360000,"chr15",553352,8,9,7,24,"chr15",1,0.0281293952180028
"18023","chr15.64130000.64135000","chr15.64340000.64345000",210000,12,0.004567354,64130000,64340000,64135000,64345000,"chr15",553363,0,2,3,5,"chr15",1,0.0070323488045007
"18024","chr15.99075000.99080000","chr15.99180000.99185000",105000,22,1.661254e-06,99075000,99180000,99080000,99185000,"chr15",553384,0,2,4,6,"chr15",1,0.0154711673699015
"18025","chr15.40505000.40510000","chr15.40560000.40565000",55000,24,0.0003491618,40505000,40560000,40510000,40565000,"chr15",553409,5,15,13,33,"chr15",1,0.0928270042194093
"18026","chr15.63120000.63125000","chr15.63680000.63685000",560000,10,0.0002403409,63120000,63680000,63125000,63685000,"chr15",553527,0,2,0,2,"chr15",1,0.0023441162681669
"18027","chr15.64725000.64730000","chr15.64855000.64860000",130000,16,0.0007243897,64725000,64855000,64730000,64860000,"chr15",553562,4,6,8,18,"chr15",1,0.0337552742616034
"18028","chr15.51925000.51930000","chr15.52070000.52075000",145000,21,2.759588e-07,51925000,52070000,51930000,52075000,"chr15",553615,2,10,8,20,"chr15",1,0.0492264416315049
"18029","chr15.44190000.44195000","chr15.44500000.44505000",310000,11,0.001687543,44190000,44500000,44195000,44505000,"chr15",553666,3,13,8,24,"chr15",1,0.0309423347398031
"18030","chr15.48190000.48195000","chr15.48600000.48605000",410000,9,0.0069531,48190000,48600000,48195000,48605000,"chr15",553690,0,2,0,2,"chr15",1,0.00210970464135021
"18031","chr15.42575000.42580000","chr15.42720000.42725000",145000,21,2.759588e-07,42575000,42720000,42580000,42725000,"chr15",553695,0,2,4,6,"chr15",1,0.0147679324894515
"18032","chr15.78260000.78265000","chr15.78395000.78400000",135000,16,0.0005693069,78260000,78395000,78265000,78400000,"chr15",553703,0,2,1,3,"chr15",1,0.00562587904360056
"18033","chr15.59150000.59155000","chr15.59275000.59280000",125000,14,0.008349464,59150000,59275000,59155000,59280000,"chr15",553723,0,2,1,3,"chr15",1,0.00492264416315049
"18034","chr15.90530000.90535000","chr15.90550000.90555000",20000,37,0.002716941,90530000,90550000,90535000,90555000,"chr15",553781,0,1,2,3,"chr15",1,0.0130098452883263
"18035","chr15.77230000.77235000","chr15.77705000.77710000",475000,11,0.0001301077,77230000,77705000,77235000,77710000,"chr15",553802,0,3,0,3,"chr15",1,0.00386779184247539
"18036","chr15.64840000.64845000","chr15.64855000.64860000",15000,36,0.005119318,64840000,64855000,64845000,64860000,"chr15",553818,0,3,1,4,"chr15",1,0.0168776371308017
"18037","chr15.66265000.66270000","chr15.66480000.66485000",215000,13,0.001102564,66265000,66480000,66270000,66485000,"chr15",553847,3,4,5,12,"chr15",1,0.0182841068917018
"18038","chr15.48800000.48805000","chr15.48860000.48865000",60000,23,0.000347622,48800000,48860000,48805000,48865000,"chr15",553896,0,3,1,4,"chr15",1,0.0107829348335677
"18039","chr15.77505000.77510000","chr15.77590000.77595000",85000,21,6.545716e-05,77505000,77590000,77510000,77595000,"chr15",553993,3,5,4,12,"chr15",1,0.029535864978903
"18040","chr15.41825000.41830000","chr15.42225000.42230000",400000,9,0.007847817,41825000,42225000,41830000,42230000,"chr15",554006,3,11,9,23,"chr15",1,0.0242616033755274
"18041","chr15.61050000.61055000","chr15.61075000.61080000",25000,44,1.298606e-06,61050000,61075000,61055000,61080000,"chr15",554096,1,1,0,2,"chr15",1,0.0103141115799344
"18042","chr15.40890000.40895000","chr15.41415000.41420000",525000,8,0.008880433,40890000,41415000,40895000,41420000,"chr15",554176,4,8,10,22,"chr15",1,0.0206282231598687
"18043","chr15.92520000.92525000","chr15.92600000.92605000",80000,17,0.007893422,92520000,92600000,92525000,92605000,"chr15",554192,0,3,2,5,"chr15",1,0.00996249413970933
"18044","chr15.64460000.64465000","chr15.64685000.64690000",225000,11,0.009983125,64460000,64685000,64465000,64690000,"chr15",554214,0,2,7,9,"chr15",1,0.0116033755274262
"18045","chr15.40505000.40510000","chr15.40695000.40700000",190000,15,0.0001835008,40505000,40695000,40510000,40700000,"chr15",554229,5,19,20,44,"chr15",1,0.0773558368495077
"18046","chr15.58545000.58550000","chr15.59100000.59105000",555000,8,0.006779695,58545000,59100000,58550000,59105000,"chr15",554280,2,8,7,17,"chr15",1,0.0159399906235349
"18047","chr15.44185000.44190000","chr15.44485000.44490000",300000,10,0.00766287,44185000,44485000,44190000,44490000,"chr15",554290,3,10,2,15,"chr15",1,0.0175808720112518
"18048","chr15.68190000.68195000","chr15.68305000.68310000",115000,17,0.000500386,68190000,68305000,68195000,68310000,"chr15",554319,0,2,0,2,"chr15",1,0.00398499765588373
"18049","chr15.44595000.44600000","chr15.44730000.44735000",135000,14,0.005621474,44595000,44730000,44600000,44735000,"chr15",554379,0,6,1,7,"chr15",1,0.0114861697140178
"18050","chr15.80990000.80995000","chr15.81045000.81050000",55000,27,1.46338e-05,80990000,81045000,80995000,81050000,"chr15",554481,3,2,1,6,"chr15",1,0.0189873417721519
"18051","chr15.76950000.76955000","chr15.76970000.76975000",20000,36,0.005119318,76950000,76970000,76955000,76975000,"chr15",554526,2,1,7,10,"chr15",1,0.0421940928270042
"18052","chr15.63450000.63455000","chr15.63485000.63490000",35000,28,0.002140514,63450000,63485000,63455000,63490000,"chr15",554551,6,5,15,26,"chr15",1,0.0853258321612752
"18053","chr15.56820000.56825000","chr15.57075000.57080000",255000,12,0.001355314,56820000,57075000,56825000,57080000,"chr15",554570,0,1,1,2,"chr15",1,0.00281293952180028
"18054","chr15.41980000.41985000","chr15.42920000.42925000",940000,7,0.002208461,41980000,42920000,41985000,42925000,"chr15",554580,0,4,1,5,"chr15",1,0.00410220346929208
"18055","chr15.90295000.90300000","chr15.90645000.90650000",350000,17,1.960333e-08,90295000,90645000,90300000,90650000,"chr15",554587,0,3,5,8,"chr15",1,0.0159399906235349
"18056","chr15.64730000.64735000","chr15.64955000.64960000",225000,12,0.002965561,64730000,64955000,64735000,64960000,"chr15",554589,3,8,9,20,"chr15",1,0.0281293952180028
"18057","chr15.52265000.52270000","chr15.52460000.52465000",195000,15,0.0001494767,52265000,52460000,52270000,52465000,"chr15",554599,2,7,8,17,"chr15",1,0.029887482419128
"18058","chr15.86160000.86165000","chr15.86230000.86235000",70000,20,0.001355314,86160000,86230000,86165000,86235000,"chr15",554749,0,4,0,4,"chr15",1,0.00937646507266761
"18059","chr15.101575000.101580000","chr15.101795000.101800000",220000,24,4.888204e-12,101575000,101795000,101580000,101800000,"chr15",554758,1,1,1,3,"chr15",1,0.00843881856540084
"18060","chr15.75685000.75690000","chr15.75720000.75725000",35000,27,0.004567474,75685000,75720000,75690000,75725000,"chr15",554761,2,2,4,8,"chr15",1,0.0253164556962025
"18061","chr15.90305000.90310000","chr15.90420000.90425000",115000,20,1.07794e-05,90305000,90420000,90310000,90425000,"chr15",554787,0,2,1,3,"chr15",1,0.0070323488045007
"18062","chr15.90885000.90890000","chr15.90995000.91000000",110000,18,0.0002142471,90885000,90995000,90890000,9.1e+07,"chr15",554828,1,2,4,7,"chr15",1,0.0147679324894515
"18063","chr15.41915000.41920000","chr15.42010000.42015000",95000,17,0.002150076,41915000,42010000,41920000,42015000,"chr15",554839,2,4,2,8,"chr15",1,0.0159399906235349
"18064","chr15.90895000.90900000","chr15.90990000.90995000",95000,18,0.0007264674,90895000,90990000,90900000,90995000,"chr15",554858,3,12,18,33,"chr15",1,0.069620253164557
"18065","chr15.38375000.38380000","chr15.38645000.38650000",270000,12,0.0009442505,38375000,38645000,38380000,38650000,"chr15",554860,3,7,5,15,"chr15",1,0.0210970464135021
"18066","chr15.85690000.85695000","chr15.85830000.85835000",140000,14,0.004690547,85690000,85830000,85695000,85835000,"chr15",554886,2,5,4,11,"chr15",1,0.0180496952648851
"18067","chr15.74405000.74410000","chr15.74825000.74830000",420000,10,0.001435786,74405000,74825000,74410000,74830000,"chr15",554901,0,0,2,2,"chr15",1,0.0023441162681669
"18068","chr15.41585000.41590000","chr15.41615000.41620000",30000,34,0.0001892218,41585000,41615000,41590000,41620000,"chr15",554942,1,13,7,21,"chr15",1,0.0836849507735584
"18069","chr15.90320000.90325000","chr15.90415000.90420000",95000,18,0.0007264674,90320000,90415000,90325000,90420000,"chr15",554962,4,4,17,25,"chr15",1,0.0527426160337553
"18070","chr15.91060000.91065000","chr15.91245000.91250000",185000,12,0.00931721,91060000,91245000,91065000,91250000,"chr15",554977,0,0,3,3,"chr15",1,0.00421940928270042
"18071","chr15.90885000.90890000","chr15.91385000.91390000",500000,10,0.0005040098,90885000,91385000,90890000,91390000,"chr15",554998,0,2,4,6,"chr15",1,0.0070323488045007
"18072","chr15.73180000.73185000","chr15.73270000.73275000",90000,17,0.003245256,73180000,73270000,73185000,73275000,"chr15",555051,0,2,2,4,"chr15",1,0.00796999531176746
"18073","chr15.41810000.41815000","chr15.42105000.42110000",295000,10,0.008260023,41810000,42105000,41815000,42110000,"chr15",555060,1,1,1,3,"chr15",1,0.00351617440225035
"18074","chr15.42900000.42905000","chr15.42940000.42945000",40000,24,0.009166979,42900000,42940000,42905000,42945000,"chr15",555061,2,3,15,20,"chr15",1,0.0562587904360056
"18075","chr15.90450000.90455000","chr15.90615000.90620000",165000,18,7.989376e-06,90450000,90615000,90455000,90620000,"chr15",555091,0,2,1,3,"chr15",1,0.00632911392405063
"18076","chr15.41400000.41405000","chr15.41615000.41620000",215000,12,0.003975359,41400000,41615000,41405000,41620000,"chr15",555128,6,45,35,86,"chr15",1,0.120956399437412
"18077","chr15.23035000.23040000","chr15.23070000.23075000",35000,32,7.001419e-05,23035000,23070000,23040000,23075000,"chr15",555197,0,9,5,14,"chr15",1,0.0525082044069386
"18078","chr15.91100000.91105000","chr15.91125000.91130000",25000,54,3.243864e-11,91100000,91125000,91105000,91130000,"chr15",555221,0,0,1,1,"chr15",1,0.00632911392405063
"18079","chr15.89655000.89660000","chr15.89690000.89695000",35000,27,0.004567474,89655000,89690000,89660000,89695000,"chr15",555225,0,6,7,13,"chr15",1,0.0411392405063291
"18080","chr15.52265000.52270000","chr15.52335000.52340000",70000,27,3.808586e-07,52265000,52335000,52270000,52340000,"chr15",555237,0,2,0,2,"chr15",1,0.00632911392405063
"18081","chr15.44195000.44200000","chr15.44425000.44430000",230000,16,7.685629e-06,44195000,44425000,44200000,44430000,"chr15",555307,4,15,12,31,"chr15",1,0.0581340834505391
"18082","chr15.40905000.40910000","chr15.41435000.41440000",530000,8,0.0084746,40905000,41435000,40910000,41440000,"chr15",555507,2,8,1,11,"chr15",1,0.0103141115799344
"18083","chr15.90930000.90935000","chr15.91125000.91130000",195000,13,0.002125815,90930000,91125000,90935000,91130000,"chr15",555599,0,0,1,1,"chr15",1,0.00152367557430849
"18084","chr15.90885000.90890000","chr15.91095000.91100000",210000,12,0.004567354,90885000,91095000,90890000,91100000,"chr15",555630,1,2,1,4,"chr15",1,0.00562587904360056
"18085","chr15.38360000.38365000","chr15.38635000.38640000",275000,15,7.699512e-06,38360000,38635000,38365000,38640000,"chr15",555678,2,5,2,9,"chr15",1,0.0158227848101266
"18086","chr15.41915000.41920000","chr15.42065000.42070000",150000,20,9.495652e-07,41915000,42065000,41920000,42070000,"chr15",555751,2,0,2,4,"chr15",1,0.00937646507266761
"18087","chr15.65325000.65330000","chr15.65375000.65380000",50000,25,0.0003885091,65325000,65375000,65330000,65380000,"chr15",555784,2,5,6,13,"chr15",1,0.0380918893577121
"18088","chr15.59275000.59280000","chr15.59435000.59440000",160000,13,0.006808709,59275000,59435000,59280000,59440000,"chr15",555793,0,2,1,3,"chr15",1,0.00457102672292546
"18089","chr15.68875000.68880000","chr15.68935000.68940000",60000,23,0.000347622,68875000,68935000,68880000,68940000,"chr15",555807,0,4,1,5,"chr15",1,0.0134786685419597
"18090","chr15.74655000.74660000","chr15.74950000.74955000",295000,10,0.008260023,74655000,74950000,74660000,74955000,"chr15",555808,2,12,8,22,"chr15",1,0.0257852789498359
"18091","chr15.64985000.64990000","chr15.65130000.65135000",145000,16,0.000356912,64985000,65130000,64990000,65135000,"chr15",555816,2,19,10,31,"chr15",1,0.0581340834505391
"18092","chr15.90300000.90305000","chr15.90420000.90425000",120000,27,1.064978e-10,90300000,90420000,90305000,90425000,"chr15",555827,4,14,16,34,"chr15",1,0.107594936708861
"18093","chr15.40890000.40895000","chr15.41020000.41025000",130000,16,0.0007243897,40890000,41020000,40895000,41025000,"chr15",555844,0,5,3,8,"chr15",1,0.0150023441162682
"18094","chr15.99055000.99060000","chr15.99180000.99185000",125000,18,7.702952e-05,99055000,99180000,99060000,99185000,"chr15",555864,0,2,4,6,"chr15",1,0.0126582278481013
"18095","chr15.44425000.44430000","chr15.44475000.44480000",50000,32,1.709548e-07,44425000,44475000,44430000,44480000,"chr15",555987,8,21,20,49,"chr15",1,0.183778715424285
"18096","chr15.41980000.41985000","chr15.42105000.42110000",125000,17,0.0002803008,41980000,42105000,41985000,42110000,"chr15",555992,0,4,1,5,"chr15",1,0.00996249413970933
"18097","chr15.40320000.40325000","chr15.40510000.40515000",190000,18,2.039136e-06,40320000,40510000,40325000,40515000,"chr15",556016,1,0,6,7,"chr15",1,0.0147679324894515
"18098","chr15.38360000.38365000","chr15.38540000.38545000",180000,32,7.061813e-18,38360000,38540000,38365000,38545000,"chr15",556051,2,6,11,19,"chr15",1,0.0712611345522738
"18099","chr15.63055000.63060000","chr15.63370000.63375000",315000,10,0.00600824,63055000,63370000,63060000,63375000,"chr15",556056,0,2,4,6,"chr15",1,0.0070323488045007
"18100","chr15.58520000.58525000","chr15.58955000.58960000",435000,12,4.214006e-05,58520000,58955000,58525000,58960000,"chr15",556059,1,2,1,4,"chr15",1,0.00562587904360056
"18101","chr15.91860000.91865000","chr15.92375000.92380000",515000,13,1.555598e-06,91860000,92375000,91865000,92380000,"chr15",556069,2,0,0,2,"chr15",1,0.00304735114861697
"18102","chr15.68875000.68880000","chr15.68925000.68930000",50000,47,4.848002e-17,68875000,68925000,68880000,68930000,"chr15",556085,0,1,2,3,"chr15",1,0.0165260196905767
"18103","chr15.90885000.90890000","chr15.91135000.91140000",250000,11,0.00559719,90885000,91135000,90890000,91140000,"chr15",556146,1,1,3,5,"chr15",1,0.00644631973745898
"18104","chr15.91860000.91865000","chr15.92600000.92605000",740000,10,3.318371e-05,91860000,92600000,91865000,92605000,"chr15",556163,3,5,2,10,"chr15",1,0.0117205813408345
"18105","chr15.58625000.58630000","chr15.58955000.58960000",330000,14,9.610518e-06,58625000,58955000,58630000,58960000,"chr15",556176,2,3,9,14,"chr15",1,0.0229723394280356
"18106","chr15.41415000.41420000","chr15.41615000.41620000",200000,12,0.00600824,41415000,41615000,41420000,41620000,"chr15",556238,8,21,28,57,"chr15",1,0.080168776371308
"18107","chr15.74310000.74315000","chr15.74655000.74660000",345000,10,0.003948166,74310000,74655000,74315000,74660000,"chr15",556246,1,11,8,20,"chr15",1,0.023441162681669
"18108","chr15.85615000.85620000","chr15.85640000.85645000",25000,42,8.016595e-06,85615000,85640000,85620000,85645000,"chr15",556251,0,3,2,5,"chr15",1,0.0246132208157525
"18109","chr15.52265000.52270000","chr15.52365000.52370000",100000,28,3.026974e-10,52265000,52365000,52270000,52370000,"chr15",556300,1,2,0,3,"chr15",1,0.00984528832630099
"18110","chr15.77420000.77425000","chr15.78105000.78110000",685000,8,0.002280248,77420000,78105000,77425000,78110000,"chr15",556320,0,4,3,7,"chr15",1,0.00656352555086732
"18111","chr15.64465000.64470000","chr15.65315000.65320000",850000,8,0.0006608198,64465000,65315000,64470000,65320000,"chr15",556351,5,27,26,58,"chr15",1,0.0543834974214721
"18112","chr15.22935000.22940000","chr15.22975000.22980000",40000,28,0.000347838,22935000,22975000,22940000,22980000,"chr15",556358,4,9,8,21,"chr15",1,0.0689170182841069
"18113","chr15.38350000.38355000","chr15.38620000.38625000",270000,11,0.003656018,38350000,38620000,38355000,38625000,"chr15",556392,0,2,1,3,"chr15",1,0.00386779184247539
"18114","chr15.48800000.48805000","chr15.48925000.48930000",125000,19,2.007129e-05,48800000,48925000,48805000,48930000,"chr15",556393,0,3,1,4,"chr15",1,0.00890764181903422
"18115","chr15.52165000.52170000","chr15.52460000.52465000",295000,12,0.0005263262,52165000,52460000,52170000,52465000,"chr15",556403,3,14,10,27,"chr15",1,0.0379746835443038
"18116","chr15.68875000.68880000","chr15.68970000.68975000",95000,20,6.996686e-05,68875000,68970000,68880000,68975000,"chr15",556509,0,3,5,8,"chr15",1,0.0187529301453352
"18117","chr15.93345000.93350000","chr15.93425000.93430000",80000,23,1.108833e-05,93345000,93425000,93350000,93430000,"chr15",556536,0,1,4,5,"chr15",1,0.0134786685419597
"18118","chr15.90295000.90300000","chr15.90420000.90425000",125000,26,3.493094e-10,90295000,90420000,90300000,90425000,"chr15",556538,4,8,8,20,"chr15",1,0.0609470229723394
"18119","chr15.58470000.58475000","chr15.59150000.59155000",680000,11,8.121152e-06,58470000,59150000,58475000,59155000,"chr15",556596,6,13,16,35,"chr15",1,0.0451242381622128
"18120","chr15.90995000.91000000","chr15.91125000.91130000",130000,15,0.002302546,90995000,91125000,9.1e+07,91130000,"chr15",556606,2,0,1,3,"chr15",1,0.00527426160337553
"18121","chr15.77540000.77545000","chr15.77575000.77580000",35000,27,0.004567474,77540000,77575000,77545000,77580000,"chr15",556623,0,0,2,2,"chr15",1,0.00632911392405063
"18122","chr15.44535000.44540000","chr15.44565000.44570000",30000,37,1.325372e-05,44535000,44565000,44540000,44570000,"chr15",556702,4,17,10,31,"chr15",1,0.134435067979372
"18123","chr15.38620000.38625000","chr15.38680000.38685000",60000,20,0.005713776,38620000,38680000,38625000,38685000,"chr15",556740,0,2,4,6,"chr15",1,0.0140646976090014
"18124","chr15.65295000.65300000","chr15.65315000.65320000",20000,49,1.625807e-07,65295000,65315000,65300000,65320000,"chr15",556771,5,17,16,38,"chr15",1,0.218237224566338
"18125","chr15.38350000.38355000","chr15.38635000.38640000",285000,10,0.009705474,38350000,38635000,38355000,38640000,"chr15",556786,0,2,1,3,"chr15",1,0.00351617440225035
"18126","chr15.67805000.67810000","chr15.67835000.67840000",30000,29,0.008226059,67805000,67835000,67810000,67840000,"chr15",556837,1,2,1,4,"chr15",1,0.013595874355368
"18127","chr15.77585000.77590000","chr15.77705000.77710000",120000,15,0.003677894,77585000,77705000,77590000,77710000,"chr15",556970,0,3,0,3,"chr15",1,0.00527426160337553
"18128","chr15.68255000.68260000","chr15.68475000.68480000",220000,12,0.003427084,68255000,68475000,68260000,68480000,"chr15",556979,0,2,0,2,"chr15",1,0.00281293952180028
"18129","chr15.52175000.52180000","chr15.52365000.52370000",190000,14,0.0007081382,52175000,52365000,52180000,52370000,"chr15",557035,0,2,0,2,"chr15",1,0.00328176277543366
"18130","chr15.90935000.90940000","chr15.90990000.90995000",55000,34,2.122998e-09,90935000,90990000,90940000,90995000,"chr15",557068,2,10,8,20,"chr15",1,0.0796999531176746
"18131","chr15.85840000.85845000","chr15.85865000.85870000",25000,34,0.00402347,85840000,85865000,85845000,85870000,"chr15",557081,2,9,4,15,"chr15",1,0.059774964838256
"18132","chr15.42650000.42655000","chr15.42760000.42765000",110000,15,0.006137384,42650000,42760000,42655000,42765000,"chr15",557099,1,3,2,6,"chr15",1,0.0105485232067511
"18133","chr15.68555000.68560000","chr15.68575000.68580000",20000,48,4.217941e-07,68555000,68575000,68560000,68580000,"chr15",557156,0,1,0,1,"chr15",1,0.00562587904360056
"18134","chr15.101160000.101165000","chr15.101540000.101545000",380000,12,0.0001080353,101160000,101540000,101165000,101545000,"chr15",557159,2,1,5,8,"chr15",1,0.0112517580872011
"18135","chr15.90900000.90905000","chr15.91055000.91060000",155000,13,0.008126231,90900000,91055000,90905000,91060000,"chr15",557168,5,11,7,23,"chr15",1,0.0350445382090952
"18136","chr15.52290000.52295000","chr15.52360000.52365000",70000,21,0.000486251,52290000,52360000,52295000,52365000,"chr15",557202,0,1,1,2,"chr15",1,0.00492264416315049
"18137","chr15.91095000.91100000","chr15.91125000.91130000",30000,64,1.774589e-20,91095000,91125000,91100000,91130000,"chr15",557276,1,0,1,2,"chr15",1,0.0150023441162682
"18138","chr15.90300000.90305000","chr15.90590000.90595000",290000,11,0.002424804,90300000,90590000,90305000,90595000,"chr15",557287,4,14,11,29,"chr15",1,0.0373886544772621
"18139","chr15.63790000.63795000","chr15.64385000.64390000",595000,9,0.0009427506,63790000,64385000,63795000,64390000,"chr15",557295,1,3,11,15,"chr15",1,0.0158227848101266
"18140","chr15.44195000.44200000","chr15.44500000.44505000",305000,13,9.074111e-05,44195000,44500000,44200000,44505000,"chr15",557380,4,15,8,27,"chr15",1,0.0411392405063291
"18141","chr15.44190000.44195000","chr15.44535000.44540000",345000,12,0.00019965,44190000,44535000,44195000,44540000,"chr15",557396,3,13,8,24,"chr15",1,0.0337552742616034
"18142","chr15.52265000.52270000","chr15.52360000.52365000",95000,22,5.279153e-06,52265000,52360000,52270000,52365000,"chr15",557489,0,1,1,2,"chr15",1,0.00515705578996718
"18143","chr15.63925000.63930000","chr15.64340000.64345000",415000,10,0.001534547,63925000,64340000,63930000,64345000,"chr15",557501,2,4,2,8,"chr15",1,0.00937646507266761
"18144","chr15.90895000.90900000","chr15.91245000.91250000",350000,10,0.003662891,90895000,91245000,90900000,91250000,"chr15",557553,0,0,4,4,"chr15",1,0.0046882325363338
"18145","chr15.73080000.73085000","chr15.73355000.73360000",275000,14,4.040908e-05,73080000,73355000,73085000,73360000,"chr15",557575,2,2,5,9,"chr15",1,0.0147679324894515
"18146","chr15.73130000.73135000","chr15.73375000.73380000",245000,11,0.00625113,73130000,73375000,73135000,73380000,"chr15",557600,0,3,1,4,"chr15",1,0.00515705578996718
"18147","chr15.63485000.63490000","chr15.63500000.63505000",15000,41,0.0001629214,63485000,63500000,63490000,63505000,"chr15",557605,1,3,3,7,"chr15",1,0.033638068448195
"18148","chr15.44295000.44300000","chr15.44575000.44580000",280000,12,0.0007387203,44295000,44575000,44300000,44580000,"chr15",557631,6,15,19,40,"chr15",1,0.0562587904360056
"18149","chr15.29985000.29990000","chr15.30055000.30060000",70000,23,5.438413e-05,29985000,30055000,29990000,30060000,"chr15",557635,0,7,5,12,"chr15",1,0.0323488045007032
"18150","chr15.52340000.52345000","chr15.52365000.52370000",25000,44,1.298606e-06,52340000,52365000,52345000,52370000,"chr15",557652,1,2,0,3,"chr15",1,0.0154711673699015
"18151","chr15.90935000.90940000","chr15.90960000.90965000",25000,74,5.848232e-23,90935000,90960000,90940000,90965000,"chr15",557671,2,8,8,18,"chr15",1,0.156118143459916
"18152","chr15.31215000.31220000","chr15.31280000.31285000",65000,26,4.131506e-06,31215000,31280000,31220000,31285000,"chr15",557701,0,4,1,5,"chr15",1,0.0152367557430849
"18153","chr15.42480000.42485000","chr15.42705000.42710000",225000,12,0.002965561,42480000,42705000,42485000,42710000,"chr15",557804,5,15,8,28,"chr15",1,0.0393811533052039
"18154","chr15.71235000.71240000","chr15.72230000.72235000",995000,6,0.009132476,71235000,72230000,71240000,72235000,"chr15",557809,0,3,1,4,"chr15",1,0.00281293952180028
"18155","chr15.38375000.38380000","chr15.38475000.38480000",100000,16,0.004159079,38375000,38475000,38380000,38480000,"chr15",557818,3,7,5,15,"chr15",1,0.0281293952180028
"18156","chr15.44215000.44220000","chr15.44500000.44505000",285000,11,0.002687577,44215000,44500000,44220000,44505000,"chr15",557843,3,15,8,26,"chr15",1,0.0335208626347867
"18157","chr15.63925000.63930000","chr15.64355000.64360000",430000,9,0.005562765,63925000,64355000,63930000,64360000,"chr15",557857,2,4,2,8,"chr15",1,0.00843881856540084
"18158","chr15.89630000.89635000","chr15.89650000.89655000",20000,35,0.00931721,89630000,89650000,89635000,89655000,"chr15",557879,0,3,2,5,"chr15",1,0.0205110173464604
"18159","chr15.31215000.31220000","chr15.31250000.31255000",35000,39,4.694904e-08,31215000,31250000,31220000,31255000,"chr15",557996,3,7,8,18,"chr15",1,0.0822784810126582
"18160","chr15.52180000.52185000","chr15.52460000.52465000",280000,11,0.002951888,52180000,52460000,52185000,52465000,"chr15",558025,1,5,1,7,"chr15",1,0.00902484763244257
"18161","chr15.77230000.77235000","chr15.77775000.77780000",545000,8,0.007441463,77230000,77775000,77235000,77780000,"chr15",558034,4,2,4,10,"chr15",1,0.00937646507266761
"18162","chr15.44535000.44540000","chr15.44775000.44780000",240000,12,0.002012613,44535000,44775000,44540000,44780000,"chr15",558038,2,3,16,21,"chr15",1,0.029535864978903
"18163","chr15.40080000.40085000","chr15.40235000.40240000",155000,17,5.765138e-05,40080000,40235000,40085000,40240000,"chr15",558116,0,2,0,2,"chr15",1,0.00398499765588373
"18164","chr15.40380000.40385000","chr15.40505000.40510000",125000,16,0.0009407814,40380000,40505000,40385000,40510000,"chr15",558127,5,10,14,29,"chr15",1,0.0543834974214721
"18165","chr15.64710000.64715000","chr15.64910000.64915000",200000,19,2.266084e-07,64710000,64910000,64715000,64915000,"chr15",558218,1,7,15,23,"chr15",1,0.0512189404594468
"18166","chr15.44535000.44540000","chr15.44595000.44600000",60000,20,0.005713776,44535000,44595000,44540000,44600000,"chr15",558254,0,6,1,7,"chr15",1,0.0164088138771683
"18167","chr15.52255000.52260000","chr15.52330000.52335000",75000,25,1.930076e-06,52255000,52330000,52260000,52335000,"chr15",558286,0,1,2,3,"chr15",1,0.00879043600562588
"18168","chr15.64440000.64445000","chr15.64985000.64990000",545000,8,0.007441463,64440000,64985000,64445000,64990000,"chr15",558376,2,15,17,34,"chr15",1,0.0318799812470699
"18169","chr15.90450000.90455000","chr15.90635000.90640000",185000,18,2.674085e-06,90450000,90635000,90455000,90640000,"chr15",558377,0,2,1,3,"chr15",1,0.00632911392405063
"18170","chr15.38440000.38445000","chr15.38525000.38530000",85000,17,0.00505316,38440000,38525000,38445000,38530000,"chr15",558394,1,3,1,5,"chr15",1,0.00996249413970933
"18171","chr15.42055000.42060000","chr15.42580000.42585000",525000,9,0.001961086,42055000,42580000,42060000,42585000,"chr15",558452,3,8,6,17,"chr15",1,0.0179324894514768
"18172","chr15.42890000.42895000","chr15.42940000.42945000",50000,22,0.005586357,42890000,42940000,42895000,42945000,"chr15",558494,2,3,12,17,"chr15",1,0.0438349742147211
"18173","chr15.57155000.57160000","chr15.57560000.57565000",405000,11,0.0003734436,57155000,57560000,57160000,57565000,"chr15",558502,0,4,2,6,"chr15",1,0.00773558368495077
"18174","chr15.90530000.90535000","chr15.90595000.90600000",65000,20,0.002716941,90530000,90595000,90535000,90600000,"chr15",558529,0,0,4,4,"chr15",1,0.00937646507266761
"18175","chr15.90860000.90865000","chr15.90930000.90935000",70000,20,0.001355314,90860000,90930000,90865000,90935000,"chr15",558552,0,3,2,5,"chr15",1,0.0117205813408345
"18176","chr15.91860000.91865000","chr15.92780000.92785000",920000,7,0.002561652,91860000,92780000,91865000,92785000,"chr15",558570,3,5,3,11,"chr15",1,0.00902484763244257
"18177","chr15.86060000.86065000","chr15.86080000.86085000",20000,42,7.448057e-05,86060000,86080000,86065000,86085000,"chr15",558666,0,2,1,3,"chr15",1,0.0147679324894515
"18178","chr15.64725000.64730000","chr15.64955000.64960000",230000,20,6.82689e-09,64725000,64955000,64730000,64960000,"chr15",558667,3,8,9,20,"chr15",1,0.046882325363338
"18179","chr15.45505000.45510000","chr15.45715000.45720000",210000,13,0.00129158,45505000,45715000,45510000,45720000,"chr15",558686,5,11,2,18,"chr15",1,0.0274261603375527
"18180","chr15.41545000.41550000","chr15.41565000.41570000",20000,36,0.005119318,41545000,41565000,41550000,41570000,"chr15",558827,5,5,8,18,"chr15",1,0.0759493670886076
"18181","chr15.42705000.42710000","chr15.42935000.42940000",230000,12,0.002609904,42705000,42935000,42710000,42940000,"chr15",558901,4,6,13,23,"chr15",1,0.0323488045007032
"18182","chr15.90550000.90555000","chr15.90580000.90585000",30000,36,3.323219e-05,90550000,90580000,90555000,90585000,"chr15",558932,1,8,2,11,"chr15",1,0.0464135021097046
"18183","chr15.52175000.52180000","chr15.52460000.52465000",285000,11,0.002687577,52175000,52460000,52180000,52465000,"chr15",559024,0,12,6,18,"chr15",1,0.0232067510548523
"18184","chr15.92065000.92070000","chr15.92620000.92625000",555000,8,0.006779695,92065000,92620000,92070000,92625000,"chr15",559045,0,4,1,5,"chr15",1,0.0046882325363338
"18185","chr15.90895000.90900000","chr15.91060000.91065000",165000,14,0.001828956,90895000,91060000,90900000,91065000,"chr15",559048,3,11,3,17,"chr15",1,0.0278949835911861
"18186","chr15.29265000.29270000","chr15.29360000.29365000",95000,23,1.331241e-06,29265000,29360000,29270000,29365000,"chr15",559087,0,1,0,1,"chr15",1,0.00269573370839194
"18187","chr15.52330000.52335000","chr15.52360000.52365000",30000,29,0.008226059,52330000,52360000,52335000,52365000,"chr15",559115,0,1,1,2,"chr15",1,0.00679793717768401
"18188","chr15.42920000.42925000","chr15.42940000.42945000",20000,50,6.074263e-08,42920000,42940000,42925000,42945000,"chr15",559117,2,3,15,20,"chr15",1,0.117205813408345
"18189","chr15.64690000.64695000","chr15.64710000.64715000",20000,59,3.768342e-12,64690000,64710000,64695000,64715000,"chr15",559146,0,10,3,13,"chr15",1,0.0898968588842007
"18190","chr15.91260000.91265000","chr15.91300000.91305000",40000,25,0.00431559,91260000,91300000,91265000,91305000,"chr15",559201,0,1,3,4,"chr15",1,0.0117205813408345
"18191","chr15.78620000.78625000","chr15.78705000.78710000",85000,18,0.00188041,78620000,78705000,78625000,78710000,"chr15",559315,2,1,9,12,"chr15",1,0.0253164556962025
"18192","chr15.66250000.66255000","chr15.66475000.66480000",225000,11,0.009983125,66250000,66475000,66255000,66480000,"chr15",559332,1,2,1,4,"chr15",1,0.00515705578996718
"18193","chr15.89165000.89170000","chr15.89205000.89210000",40000,55,1.03644e-19,89165000,89205000,89170000,89210000,"chr15",559338,9,17,12,38,"chr15",1,0.244960150023441
"18194","chr15.90300000.90305000","chr15.90615000.90620000",315000,13,7.263963e-05,90300000,90615000,90305000,90620000,"chr15",559368,4,10,6,20,"chr15",1,0.0304735114861697
"18195","chr15.51980000.51985000","chr15.52045000.52050000",65000,19,0.006702748,51980000,52045000,51985000,52050000,"chr15",559450,8,17,26,51,"chr15",1,0.113572433192686
"18196","chr15.38265000.38270000","chr15.38680000.38685000",415000,11,0.0003226557,38265000,38680000,38270000,38685000,"chr15",559457,0,2,4,6,"chr15",1,0.00773558368495077
"18197","chr15.73180000.73185000","chr15.73240000.73245000",60000,25,4.106653e-05,73180000,73240000,73185000,73245000,"chr15",559529,0,5,4,9,"chr15",1,0.0263713080168776
"18198","chr15.91865000.91870000","chr15.92375000.92380000",510000,13,1.702508e-06,91865000,92375000,91870000,92380000,"chr15",559533,2,0,0,2,"chr15",1,0.00304735114861697
"18199","chr15.81090000.81095000","chr15.81110000.81115000",20000,44,1.46338e-05,81090000,81110000,81095000,81115000,"chr15",559541,1,2,4,7,"chr15",1,0.0360993905297703
"18200","chr15.77415000.77420000","chr15.77585000.77590000",170000,13,0.004889429,77415000,77585000,77420000,77590000,"chr15",559575,0,6,3,9,"chr15",1,0.0137130801687764
"18201","chr15.41935000.41940000","chr15.42105000.42110000",170000,13,0.004889429,41935000,42105000,41940000,42110000,"chr15",559587,5,10,6,21,"chr15",1,0.0319971870604782
"18202","chr15.40855000.40860000","chr15.41100000.41105000",245000,12,0.001767368,40855000,41100000,40860000,41105000,"chr15",559591,0,12,11,23,"chr15",1,0.0323488045007032
"18203","chr15.64855000.64860000","chr15.64910000.64915000",55000,26,4.3778e-05,64855000,64910000,64860000,64915000,"chr15",559618,1,6,8,15,"chr15",1,0.0457102672292546
"18204","chr15.90295000.90300000","chr15.90400000.90405000",105000,15,0.008226059,90295000,90400000,90300000,90405000,"chr15",559620,1,8,6,15,"chr15",1,0.0263713080168776
"18205","chr15.64985000.64990000","chr15.65025000.65030000",40000,27,0.0008398675,64985000,65025000,64990000,65030000,"chr15",559627,2,7,4,13,"chr15",1,0.0411392405063291
"18206","chr15.101180000.101185000","chr15.101525000.101530000",345000,11,0.0009407814,101180000,101525000,101185000,101530000,"chr15",559638,0,3,1,4,"chr15",1,0.00515705578996718
"18207","chr15.44295000.44300000","chr15.44425000.44430000",130000,16,0.0007243897,44295000,44425000,44300000,44430000,"chr15",559680,6,21,20,47,"chr15",1,0.0881387716830755
"18208","chr15.90895000.90900000","chr15.90960000.90965000",65000,25,1.374465e-05,90895000,90960000,90900000,90965000,"chr15",559689,3,8,13,24,"chr15",1,0.070323488045007
"18209","chr15.90930000.90935000","chr15.90995000.91000000",65000,35,1.309061e-11,90930000,90995000,90935000,9.1e+07,"chr15",559724,0,3,2,5,"chr15",1,0.0205110173464604
"18210","chr15.92455000.92460000","chr15.92600000.92605000",145000,15,0.00121,92455000,92600000,92460000,92605000,"chr15",559748,2,2,0,4,"chr15",1,0.0070323488045007
"18211","chr15.57235000.57240000","chr15.57320000.57325000",85000,19,0.0006491862,57235000,57320000,57240000,57325000,"chr15",559757,1,1,0,2,"chr15",1,0.00445382090951711
"18212","chr15.99180000.99185000","chr15.99405000.99410000",225000,19,5.644378e-08,99180000,99405000,99185000,99410000,"chr15",559841,0,2,2,4,"chr15",1,0.00890764181903422
"18213","chr15.63370000.63375000","chr15.63680000.63685000",310000,13,8.052857e-05,63370000,63680000,63375000,63685000,"chr15",559863,1,5,4,10,"chr15",1,0.0152367557430849
"18214","chr15.44215000.44220000","chr15.44535000.44540000",320000,11,0.001405124,44215000,44535000,44220000,44540000,"chr15",559867,3,15,25,43,"chr15",1,0.0554383497421472
"18215","chr15.60900000.60905000","chr15.61075000.61080000",175000,14,0.001227606,60900000,61075000,60905000,61080000,"chr15",559881,0,5,3,8,"chr15",1,0.0131270511017346
"18216","chr15.89015000.89020000","chr15.89185000.89190000",170000,13,0.004889429,89015000,89185000,89020000,89190000,"chr15",559917,0,5,2,7,"chr15",1,0.0106657290201594
"18217","chr15.63625000.63630000","chr15.63675000.63680000",50000,24,0.0009943956,63625000,63675000,63630000,63680000,"chr15",560065,1,6,3,10,"chr15",1,0.0281293952180028
"18218","chr15.58550000.58555000","chr15.58865000.58870000",315000,12,0.000351613,58550000,58865000,58555000,58870000,"chr15",560095,2,3,4,9,"chr15",1,0.0126582278481013
"18219","chr15.64000000.64005000","chr15.64355000.64360000",355000,12,0.0001672397,6.4e+07,64355000,64005000,64360000,"chr15",560128,2,7,4,13,"chr15",1,0.0182841068917018
"18220","chr15.90635000.90640000","chr15.90715000.90720000",80000,19,0.001104556,90635000,90715000,90640000,90720000,"chr15",560189,0,9,1,10,"chr15",1,0.0222691045475856
"18221","chr15.44145000.44150000","chr15.44775000.44780000",630000,8,0.003564293,44145000,44775000,44150000,44780000,"chr15",560211,0,1,4,5,"chr15",1,0.0046882325363338
"18222","chr15.44535000.44540000","chr15.44725000.44730000",190000,15,0.0001835008,44535000,44725000,44540000,44730000,"chr15",560238,4,15,16,35,"chr15",1,0.0615330520393812
"18223","chr15.64690000.64695000","chr15.64975000.64980000",285000,10,0.009705474,64690000,64975000,64695000,64980000,"chr15",560244,0,10,3,13,"chr15",1,0.0152367557430849
"18224","chr15.38505000.38510000","chr15.38540000.38545000",35000,28,0.002140514,38505000,38540000,38510000,38545000,"chr15",560342,2,4,1,7,"chr15",1,0.0229723394280356
"18225","chr15.89740000.89745000","chr15.89875000.89880000",135000,19,1.07794e-05,89740000,89875000,89745000,89880000,"chr15",560389,6,12,10,28,"chr15",1,0.0623534927332396
"18226","chr15.42940000.42945000","chr15.43380000.43385000",440000,9,0.004991769,42940000,43380000,42945000,43385000,"chr15",560394,2,3,8,13,"chr15",1,0.0137130801687764
"18227","chr15.44190000.44195000","chr15.44425000.44430000",235000,13,0.0005921178,44190000,44425000,44195000,44430000,"chr15",560404,3,13,8,24,"chr15",1,0.0365682137834037
"18228","chr15.66250000.66255000","chr15.66615000.66620000",365000,10,0.002965561,66250000,66615000,66255000,66620000,"chr15",560407,1,2,0,3,"chr15",1,0.00351617440225035
"18229","chr15.63460000.63465000","chr15.63680000.63685000",220000,13,0.0009499001,63460000,63680000,63465000,63685000,"chr15",560413,2,5,2,9,"chr15",1,0.0137130801687764
"18230","chr15.64000000.64005000","chr15.64340000.64345000",340000,10,0.004197525,6.4e+07,64340000,64005000,64345000,"chr15",560501,2,7,4,13,"chr15",1,0.0152367557430849
"18231","chr15.52020000.52025000","chr15.52040000.52045000",20000,40,0.000347622,52020000,52040000,52025000,52045000,"chr15",560516,6,13,8,27,"chr15",1,0.126582278481013
"18232","chr15.90930000.90935000","chr15.91095000.91100000",165000,16,0.0001402773,90930000,91095000,90935000,91100000,"chr15",560528,0,3,1,4,"chr15",1,0.00750117205813408
"18233","chr15.80710000.80715000","chr15.81275000.81280000",565000,10,0.000227129,80710000,81275000,80715000,81280000,"chr15",560573,1,0,1,2,"chr15",1,0.0023441162681669
"18234","chr15.91055000.91060000","chr15.91205000.91210000",150000,14,0.003186368,91055000,91205000,91060000,91210000,"chr15",560575,4,9,7,20,"chr15",1,0.0328176277543366
"18235","chr15.49165000.49170000","chr15.49330000.49335000",165000,23,2.122998e-09,49165000,49330000,49170000,49335000,"chr15",560582,0,6,1,7,"chr15",1,0.0188701359587436
"18236","chr15.71410000.71415000","chr15.71730000.71735000",320000,10,0.005588575,71410000,71730000,71415000,71735000,"chr15",560610,0,4,3,7,"chr15",1,0.00820440693858415
"18237","chr15.64380000.64385000","chr15.64440000.64445000",60000,28,1.194703e-06,64380000,64440000,64385000,64445000,"chr15",560624,7,15,17,39,"chr15",1,0.127988748241913
"18238","chr15.41540000.41545000","chr15.41560000.41565000",20000,35,0.00931721,41540000,41560000,41545000,41565000,"chr15",560630,1,4,1,6,"chr15",1,0.0246132208157525
"18239","chr15.33580000.33585000","chr15.33960000.33965000",380000,15,4.831055e-07,33580000,33960000,33585000,33965000,"chr15",560645,3,8,9,20,"chr15",1,0.0351617440225035
"18240","chr15.85120000.85125000","chr15.85295000.85300000",175000,19,9.691262e-07,85120000,85295000,85125000,85300000,"chr15",560779,4,6,0,10,"chr15",1,0.0222691045475856
"18241","chr15.91860000.91865000","chr15.92340000.92345000",480000,11,0.0001214753,91860000,92340000,91865000,92345000,"chr15",560836,0,5,3,8,"chr15",1,0.0103141115799344
"18242","chr15.38375000.38380000","chr15.38620000.38625000",245000,20,2.985873e-09,38375000,38620000,38380000,38625000,"chr15",560840,2,5,5,12,"chr15",1,0.0281293952180028
"18243","chr15.90320000.90325000","chr15.90425000.90430000",105000,15,0.008226059,90320000,90425000,90325000,90430000,"chr15",560910,9,18,11,38,"chr15",1,0.0668073136427567
"18244","chr15.52165000.52170000","chr15.52495000.52500000",330000,10,0.004858391,52165000,52495000,52170000,52500000,"chr15",560947,3,9,7,19,"chr15",1,0.0222691045475856
"18245","chr15.38560000.38565000","chr15.38635000.38640000",75000,18,0.005101528,38560000,38635000,38565000,38640000,"chr15",560952,2,5,2,9,"chr15",1,0.0189873417721519
"18246","chr15.58460000.58465000","chr15.59100000.59105000",640000,8,0.003271537,58460000,59100000,58465000,59105000,"chr15",560992,0,4,1,5,"chr15",1,0.0046882325363338
"18247","chr15.41915000.41920000","chr15.41980000.41985000",65000,26,4.131506e-06,41915000,41980000,41920000,41985000,"chr15",561001,0,4,1,5,"chr15",1,0.0152367557430849
"18248","chr15.65270000.65275000","chr15.65315000.65320000",45000,35,2.526238e-08,65270000,65315000,65275000,65320000,"chr15",561005,5,9,9,23,"chr15",1,0.0943506797937178
"18249","chr15.91860000.91865000","chr15.92635000.92640000",775000,9,0.0001745542,91860000,92635000,91865000,92640000,"chr15",561023,0,5,3,8,"chr15",1,0.00843881856540084
"18250","chr15.90460000.90465000","chr15.90580000.90585000",120000,20,7.168421e-06,90460000,90580000,90465000,90585000,"chr15",561046,1,5,11,17,"chr15",1,0.0398499765588373
"18251","chr15.57215000.57220000","chr15.57235000.57240000",20000,35,0.00931721,57215000,57235000,57220000,57240000,"chr15",561060,0,3,0,3,"chr15",1,0.0123066104078762
"18252","chr15.90860000.90865000","chr15.91020000.91025000",160000,25,8.478625e-11,90860000,91020000,90865000,91025000,"chr15",561063,6,13,16,35,"chr15",1,0.102555086732302
"18253","chr15.91050000.91055000","chr15.91205000.91210000",155000,13,0.008126231,91050000,91205000,91055000,91210000,"chr15",561088,4,9,9,22,"chr15",1,0.0335208626347867
"18254","chr15.38350000.38355000","chr15.38560000.38565000",210000,14,0.0003458007,38350000,38560000,38355000,38565000,"chr15",561201,0,2,1,3,"chr15",1,0.00492264416315049
"18255","chr15.52265000.52270000","chr15.52315000.52320000",50000,24,0.0009943956,52265000,52315000,52270000,52320000,"chr15",561213,0,7,8,15,"chr15",1,0.0421940928270042
"18256","chr15.63120000.63125000","chr15.63400000.63405000",280000,12,0.0007387203,63120000,63400000,63125000,63405000,"chr15",561245,0,2,0,2,"chr15",1,0.00281293952180028
"18257","chr15.42890000.42895000","chr15.42920000.42925000",30000,35,7.957562e-05,42890000,42920000,42895000,42925000,"chr15",561267,12,9,12,33,"chr15",1,0.135372714486639
"18258","chr15.64465000.64470000","chr15.64905000.64910000",440000,10,0.001102564,64465000,64905000,64470000,64910000,"chr15",561285,2,7,6,15,"chr15",1,0.0175808720112518
"18259","chr15.74830000.74835000","chr15.74905000.74910000",75000,21,0.0002401399,74830000,74905000,74835000,74910000,"chr15",561287,0,2,1,3,"chr15",1,0.00738396624472574
"18260","chr15.45825000.45830000","chr15.45880000.45885000",55000,24,0.0003491618,45825000,45880000,45830000,45885000,"chr15",561306,0,1,4,5,"chr15",1,0.0140646976090014
"18261","chr15.52265000.52270000","chr15.52285000.52290000",20000,45,6.23341e-06,52265000,52285000,52270000,52290000,"chr15",561324,2,7,8,17,"chr15",1,0.089662447257384
"18262","chr15.42900000.42905000","chr15.43225000.43230000",325000,13,5.822676e-05,42900000,43225000,42905000,43230000,"chr15",561366,3,5,3,11,"chr15",1,0.0167604313173933
"18263","chr15.64695000.64700000","chr15.64955000.64960000",260000,15,1.280145e-05,64695000,64955000,64700000,64960000,"chr15",561372,3,8,8,19,"chr15",1,0.0334036568213783
"18264","chr15.52285000.52290000","chr15.52335000.52340000",50000,22,0.005586357,52285000,52335000,52290000,52340000,"chr15",561458,0,2,0,2,"chr15",1,0.00515705578996718
"18265","chr15.42545000.42550000","chr15.42760000.42765000",215000,12,0.003975359,42545000,42760000,42550000,42765000,"chr15",561462,0,1,2,3,"chr15",1,0.00421940928270042
"18266","chr15.90895000.90900000","chr15.90935000.90940000",40000,28,0.000347838,90895000,90935000,90900000,90940000,"chr15",561468,2,10,8,20,"chr15",1,0.0656352555086732
"18267","chr15.65915000.65920000","chr15.66560000.66565000",645000,15,1.704509e-09,65915000,66560000,65920000,66565000,"chr15",561477,0,2,1,3,"chr15",1,0.00527426160337553
"18268","chr15.64180000.64185000","chr15.64340000.64345000",160000,14,0.002176251,64180000,64340000,64185000,64345000,"chr15",561511,4,12,10,26,"chr15",1,0.0426629160806376
"18269","chr15.64690000.64695000","chr15.65025000.65030000",335000,10,0.004534584,64690000,65025000,64695000,65030000,"chr15",561512,0,7,3,10,"chr15",1,0.0117205813408345
"18270","chr15.65270000.65275000","chr15.65310000.65315000",40000,39,1.89671e-09,65270000,65310000,65275000,65315000,"chr15",561534,11,9,9,29,"chr15",1,0.132559774964838
"18271","chr15.90660000.90665000","chr15.90760000.90765000",100000,17,0.001443741,90660000,90760000,90665000,90765000,"chr15",561547,2,1,6,9,"chr15",1,0.0179324894514768
"18272","chr15.90300000.90305000","chr15.90425000.90430000",125000,21,1.167262e-06,90300000,90425000,90305000,90430000,"chr15",561565,4,14,11,29,"chr15",1,0.0713783403656821
"18273","chr15.91055000.91060000","chr15.91125000.91130000",70000,29,2.363273e-08,91055000,91125000,91060000,91130000,"chr15",561574,2,0,1,3,"chr15",1,0.010196905766526
"18274","chr15.44425000.44430000","chr15.44485000.44490000",60000,22,0.0009355301,44425000,44485000,44430000,44490000,"chr15",561618,3,10,2,15,"chr15",1,0.0386779184247539
"18275","chr15.68970000.68975000","chr15.69160000.69165000",190000,13,0.002482802,68970000,69160000,68975000,69165000,"chr15",561745,1,1,0,2,"chr15",1,0.00304735114861697
"18276","chr15.90960000.90965000","chr15.90995000.91000000",35000,38,1.476298e-07,90960000,90995000,90965000,9.1e+07,"chr15",561766,5,8,13,26,"chr15",1,0.115799343647445
"18277","chr15.99680000.99685000","chr15.99700000.99705000",20000,35,0.00931721,99680000,99700000,99685000,99705000,"chr15",561792,0,2,1,3,"chr15",1,0.0123066104078762
"18278","chr15.68155000.68160000","chr15.68475000.68480000",320000,10,0.005588575,68155000,68475000,68160000,68480000,"chr15",561799,0,2,0,2,"chr15",1,0.0023441162681669
"18279","chr15.74935000.74940000","chr15.75045000.75050000",110000,22,9.962355e-07,74935000,75045000,74940000,75050000,"chr15",561864,4,7,6,17,"chr15",1,0.0438349742147211
"18280","chr15.38360000.38365000","chr15.38620000.38625000",260000,19,9.706495e-09,38360000,38620000,38365000,38625000,"chr15",561912,2,5,6,13,"chr15",1,0.0289498359118612
"18281","chr15.44245000.44250000","chr15.44485000.44490000",240000,12,0.002012613,44245000,44485000,44250000,44490000,"chr15",561967,3,10,2,15,"chr15",1,0.0210970464135021
"18282","chr15.65130000.65135000","chr15.65270000.65275000",140000,16,0.0004483756,65130000,65270000,65135000,65275000,"chr15",561968,7,9,9,25,"chr15",1,0.046882325363338
"18283","chr15.51970000.51975000","chr15.52045000.52050000",75000,28,3.13269e-08,51970000,52045000,51975000,52050000,"chr15",561985,13,36,31,80,"chr15",1,0.262541022034693
"18284","chr15.57040000.57045000","chr15.57060000.57065000",20000,48,4.217941e-07,57040000,57060000,57045000,57065000,"chr15",561987,3,4,7,14,"chr15",1,0.0787623066104079
"18285","chr15.68225000.68230000","chr15.68330000.68335000",105000,15,0.008226059,68225000,68330000,68230000,68335000,"chr15",562005,2,3,4,9,"chr15",1,0.0158227848101266
"18286","chr15.42545000.42550000","chr15.42735000.42740000",190000,12,0.008126231,42545000,42735000,42550000,42740000,"chr15",562018,0,1,2,3,"chr15",1,0.00421940928270042
"18287","chr15.57225000.57230000","chr15.57320000.57325000",95000,19,0.0002320094,57225000,57320000,57230000,57325000,"chr15",562022,1,0,1,2,"chr15",1,0.00445382090951711
"18288","chr15.52265000.52270000","chr15.52330000.52335000",65000,28,3.27644e-07,52265000,52330000,52270000,52335000,"chr15",562084,0,2,2,4,"chr15",1,0.0131270511017346
"18289","chr15.90930000.90935000","chr15.90990000.90995000",60000,27,4.075878e-06,90930000,90990000,90935000,90995000,"chr15",562113,0,3,2,5,"chr15",1,0.0158227848101266
"18290","chr15.62065000.62070000","chr15.62085000.62090000",20000,35,0.00931721,62065000,62085000,62070000,62090000,"chr15",562192,2,0,3,5,"chr15",1,0.0205110173464604
"18291","chr15.40095000.40100000","chr15.40255000.40260000",160000,13,0.006808709,40095000,40255000,40100000,40260000,"chr15",562195,0,1,1,2,"chr15",1,0.00304735114861697
"18292","chr15.74830000.74835000","chr15.74890000.74895000",60000,33,1.467822e-09,74830000,74890000,74835000,74895000,"chr15",562204,0,2,1,3,"chr15",1,0.0116033755274262
"18293","chr15.45585000.45590000","chr15.45705000.45710000",120000,18,0.0001064492,45585000,45705000,45590000,45710000,"chr15",562206,2,5,2,9,"chr15",1,0.0189873417721519
"18294","chr15.90860000.90865000","chr15.91050000.91055000",190000,12,0.008126231,90860000,91050000,90865000,91055000,"chr15",562224,6,13,16,35,"chr15",1,0.0492264416315049
"18295","chr15.72150000.72155000","chr15.72310000.72315000",160000,14,0.002176251,72150000,72310000,72155000,72315000,"chr15",562333,2,11,12,25,"chr15",1,0.0410220346929208
"18296","chr15.38360000.38365000","chr15.38610000.38615000",250000,11,0.00559719,38360000,38610000,38365000,38615000,"chr15",562386,0,1,3,4,"chr15",1,0.00515705578996718
"18297","chr15.74440000.74445000","chr15.74540000.74545000",100000,17,0.001443741,74440000,74540000,74445000,74545000,"chr15",562409,0,2,4,6,"chr15",1,0.0119549929676512
"18298","chr15.90935000.90940000","chr15.91020000.91025000",85000,34,2.149442e-13,90935000,91020000,90940000,91025000,"chr15",562482,2,10,8,20,"chr15",1,0.0796999531176746
"18299","chr15.90885000.90890000","chr15.91045000.91050000",160000,14,0.002176251,90885000,91045000,90890000,91050000,"chr15",562488,1,2,4,7,"chr15",1,0.0114861697140178
"18300","chr15.91095000.91100000","chr15.91115000.91120000",20000,46,2.615974e-06,91095000,91115000,91100000,91120000,"chr15",562504,1,2,0,3,"chr15",1,0.0161744022503516
"18301","chr15.33580000.33585000","chr15.33970000.33975000",390000,10,0.002143974,33580000,33970000,33585000,33975000,"chr15",562530,2,6,3,11,"chr15",1,0.012892639474918
"18302","chr15.56915000.56920000","chr15.57040000.57045000",125000,14,0.008349464,56915000,57040000,56920000,57045000,"chr15",562586,0,2,4,6,"chr15",1,0.00984528832630099
"18303","chr15.91850000.91855000","chr15.92625000.92630000",775000,8,0.001146786,91850000,92625000,91855000,92630000,"chr15",562593,0,2,1,3,"chr15",1,0.00281293952180028
"18304","chr15.77215000.77220000","chr15.77760000.77765000",545000,8,0.007441463,77215000,77760000,77220000,77765000,"chr15",562655,0,2,1,3,"chr15",1,0.00281293952180028
"18305","chr15.59100000.59105000","chr15.59370000.59375000",270000,11,0.003656018,59100000,59370000,59105000,59375000,"chr15",562673,3,8,8,19,"chr15",1,0.0244960150023441
"18306","chr15.63460000.63465000","chr15.64355000.64360000",895000,7,0.003017068,63460000,64355000,63465000,64360000,"chr15",562687,2,5,2,9,"chr15",1,0.00738396624472574
"18307","chr15.57215000.57220000","chr15.57525000.57530000",310000,11,0.001687543,57215000,57525000,57220000,57530000,"chr15",562701,0,2,0,2,"chr15",1,0.00257852789498359
"18308","chr15.64065000.64070000","chr15.64245000.64250000",180000,16,6.996686e-05,64065000,64245000,64070000,64250000,"chr15",562760,6,7,13,26,"chr15",1,0.0487576183778715
"18309","chr15.25965000.25970000","chr15.26160000.26165000",195000,13,0.002125815,25965000,26160000,25970000,26165000,"chr15",562773,1,4,1,6,"chr15",1,0.00914205344585091
"18310","chr15.63120000.63125000","chr15.63370000.63375000",250000,12,0.001534547,63120000,63370000,63125000,63375000,"chr15",562817,0,2,0,2,"chr15",1,0.00281293952180028
"18311","chr15.59265000.59270000","chr15.59435000.59440000",170000,16,0.0001108151,59265000,59435000,59270000,59440000,"chr15",562823,1,7,2,10,"chr15",1,0.0187529301453352
"18312","chr15.90550000.90555000","chr15.90590000.90595000",40000,25,0.00431559,90550000,90590000,90555000,90595000,"chr15",562844,1,9,2,12,"chr15",1,0.0351617440225035
"18313","chr15.64690000.64695000","chr15.64955000.64960000",265000,18,5.249213e-08,64690000,64955000,64695000,64960000,"chr15",562850,0,8,3,11,"chr15",1,0.0232067510548523
"18314","chr15.67240000.67245000","chr15.67715000.67720000",475000,11,0.0001301077,67240000,67715000,67245000,67720000,"chr15",562872,0,2,4,6,"chr15",1,0.00773558368495077
"18315","chr15.77415000.77420000","chr15.77775000.77780000",360000,10,0.003186368,77415000,77775000,77420000,77780000,"chr15",562898,1,2,3,6,"chr15",1,0.0070323488045007
"18316","chr15.90715000.90720000","chr15.90810000.90815000",95000,18,0.0007264674,90715000,90810000,90720000,90815000,"chr15",562905,0,7,3,10,"chr15",1,0.0210970464135021
"18317","chr15.90860000.90865000","chr15.91060000.91065000",200000,13,0.001817208,90860000,91060000,90865000,91065000,"chr15",562992,6,11,3,20,"chr15",1,0.0304735114861697
"18318","chr15.64700000.64705000","chr15.64840000.64845000",140000,14,0.004690547,64700000,64840000,64705000,64845000,"chr15",563027,0,3,1,4,"chr15",1,0.00656352555086732
"18319","chr15.58545000.58550000","chr15.59255000.59260000",710000,7,0.009695231,58545000,59255000,58550000,59260000,"chr15",563083,2,8,7,17,"chr15",1,0.0139474917955931
"18320","chr15.59150000.59155000","chr15.59265000.59270000",115000,15,0.00473363,59150000,59265000,59155000,59270000,"chr15",563135,3,11,14,28,"chr15",1,0.0492264416315049
"18321","chr15.58350000.58355000","chr15.58460000.58465000",110000,17,0.0007081382,58350000,58460000,58355000,58465000,"chr15",563144,0,4,1,5,"chr15",1,0.00996249413970933
"18322","chr15.64465000.64470000","chr15.65310000.65315000",845000,7,0.004200018,64465000,65310000,64470000,65315000,"chr15",563235,14,43,43,100,"chr15",1,0.0820440693858415
"18323","chr15.34355000.34360000","chr15.34510000.34515000",155000,21,1.36531e-07,34355000,34510000,34360000,34515000,"chr15",563236,1,0,2,3,"chr15",1,0.00738396624472574
"18324","chr15.38360000.38365000","chr15.38680000.38685000",320000,17,4.769962e-08,38360000,38680000,38365000,38685000,"chr15",563294,0,2,4,6,"chr15",1,0.0119549929676512
"18325","chr15.99210000.99215000","chr15.99285000.99290000",75000,19,0.001968823,99210000,99285000,99215000,99290000,"chr15",563295,1,6,7,14,"chr15",1,0.0311767463666198
"18326","chr15.65025000.65030000","chr15.65375000.65380000",350000,10,0.003662891,65025000,65375000,65030000,65380000,"chr15",563374,5,6,4,15,"chr15",1,0.0175808720112518
"18327","chr15.38265000.38270000","chr15.38690000.38695000",425000,9,0.005845787,38265000,38690000,38270000,38695000,"chr15",563394,1,4,0,5,"chr15",1,0.00527426160337553
"18328","chr15.78260000.78265000","chr15.78435000.78440000",175000,13,0.004140243,78260000,78435000,78265000,78440000,"chr15",563446,0,5,1,6,"chr15",1,0.00914205344585091
"18329","chr15.80750000.80755000","chr15.81085000.81090000",335000,10,0.004534584,80750000,81085000,80755000,81090000,"chr15",563453,0,3,1,4,"chr15",1,0.0046882325363338
"18330","chr15.51980000.51985000","chr15.52020000.52025000",40000,25,0.00431559,51980000,52020000,51985000,52025000,"chr15",563512,7,17,17,41,"chr15",1,0.120135958743554
"18331","chr15.41575000.41580000","chr15.41615000.41620000",40000,31,1.926698e-05,41575000,41615000,41580000,41620000,"chr15",563544,10,39,32,81,"chr15",1,0.294303797468354
"18332","chr15.58675000.58680000","chr15.59200000.59205000",525000,11,6.31944e-05,58675000,59200000,58680000,59205000,"chr15",563571,4,4,8,16,"chr15",1,0.0206282231598687
"18333","chr15.65100000.65105000","chr15.65180000.65185000",80000,20,0.0003840904,65100000,65180000,65105000,65185000,"chr15",563605,3,13,7,23,"chr15",1,0.0539146741678387
"18334","chr15.38360000.38365000","chr15.38535000.38540000",175000,20,1.870082e-07,38360000,38535000,38365000,38540000,"chr15",563615,2,5,5,12,"chr15",1,0.0281293952180028
"18335","chr15.65180000.65185000","chr15.65270000.65275000",90000,16,0.008605091,65180000,65270000,65185000,65275000,"chr15",563620,3,9,9,21,"chr15",1,0.0393811533052039
"18336","chr15.52295000.52300000","chr15.52365000.52370000",70000,18,0.008744482,52295000,52365000,52300000,52370000,"chr15",563633,1,2,0,3,"chr15",1,0.00632911392405063
"18337","chr15.86155000.86160000","chr15.86230000.86235000",75000,18,0.005101528,86155000,86230000,86160000,86235000,"chr15",563638,0,4,0,4,"chr15",1,0.00843881856540084
"18338","chr15.33370000.33375000","chr15.33985000.33990000",615000,9,0.000764497,33370000,33985000,33375000,33990000,"chr15",563729,0,2,1,3,"chr15",1,0.00316455696202532
"18339","chr15.77505000.77510000","chr15.77760000.77765000",255000,11,0.00505316,77505000,77760000,77510000,77765000,"chr15",563769,0,2,1,3,"chr15",1,0.00386779184247539
"18340","chr15.40080000.40085000","chr15.40255000.40260000",175000,16,8.705803e-05,40080000,40255000,40085000,40260000,"chr15",563886,0,2,0,2,"chr15",1,0.00375058602906704
"18341","chr15.56830000.56835000","chr15.56870000.56875000",40000,24,0.009166979,56830000,56870000,56835000,56875000,"chr15",563962,2,6,5,13,"chr15",1,0.0365682137834037
"18342","chr15.58700000.58705000","chr15.58975000.58980000",275000,11,0.003271537,58700000,58975000,58705000,58980000,"chr15",564031,1,4,6,11,"chr15",1,0.0141819034224098
"18343","chr15.64135000.64140000","chr15.64340000.64345000",205000,13,0.001523419,64135000,64340000,64140000,64345000,"chr15",564063,2,21,19,42,"chr15",1,0.0639943741209564
"18344","chr15.58630000.58635000","chr15.58675000.58680000",45000,25,0.001206606,58630000,58675000,58635000,58680000,"chr15",564085,2,6,9,17,"chr15",1,0.0498124706985466
"18345","chr15.65025000.65030000","chr15.65100000.65105000",75000,29,7.408837e-09,65025000,65100000,65030000,65105000,"chr15",564107,5,7,4,16,"chr15",1,0.0543834974214721
"18346","chr15.64700000.64705000","chr15.64910000.64915000",210000,14,0.0003458007,64700000,64910000,64705000,64915000,"chr15",564153,0,4,5,9,"chr15",1,0.0147679324894515
"18347","chr15.64425000.64430000","chr15.65270000.65275000",845000,7,0.004200018,64425000,65270000,64430000,65275000,"chr15",564238,2,9,9,20,"chr15",1,0.0164088138771683
"18348","chr15.72890000.72895000","chr15.73600000.73605000",710000,8,0.001894088,72890000,73600000,72895000,73605000,"chr15",564246,1,1,1,3,"chr15",1,0.00281293952180028
"18349","chr15.43775000.43780000","chr15.43800000.43805000",25000,41,1.926698e-05,43775000,43800000,43780000,43805000,"chr15",564259,4,6,7,17,"chr15",1,0.0816924519456165
"18350","chr15.91205000.91210000","chr15.91245000.91250000",40000,30,5.275894e-05,91205000,91245000,91210000,91250000,"chr15",564301,0,0,4,4,"chr15",1,0.0140646976090014
"18351","chr15.64700000.64705000","chr15.64855000.64860000",155000,14,0.002645315,64700000,64855000,64705000,64860000,"chr15",564327,0,4,5,9,"chr15",1,0.0147679324894515
"18352","chr15.49420000.49425000","chr15.50350000.50355000",930000,9,4.297475e-05,49420000,50350000,49425000,50355000,"chr15",564340,0,0,4,4,"chr15",1,0.00421940928270042
"18353","chr15.49170000.49175000","chr15.49330000.49335000",160000,24,5.246375e-10,49170000,49330000,49175000,49335000,"chr15",564352,0,6,1,7,"chr15",1,0.019690576652602
"18354","chr15.90530000.90535000","chr15.90580000.90585000",50000,22,0.005586357,90530000,90580000,90535000,90585000,"chr15",564429,0,1,11,12,"chr15",1,0.0309423347398031
"18355","chr15.90295000.90300000","chr15.90415000.90420000",120000,24,1.665766e-08,90295000,90415000,90300000,90420000,"chr15",564433,4,4,8,16,"chr15",1,0.0450070323488045
"18356","chr15.57560000.57565000","chr15.57590000.57595000",30000,37,1.325372e-05,57560000,57590000,57565000,57595000,"chr15",564453,0,2,4,6,"chr15",1,0.0260196905766526
"18357","chr15.38360000.38365000","chr15.38475000.38480000",115000,20,1.07794e-05,38360000,38475000,38365000,38480000,"chr15",564474,2,6,9,17,"chr15",1,0.0398499765588373
"18358","chr15.77590000.77595000","chr15.77705000.77710000",115000,16,0.001600898,77590000,77705000,77595000,77710000,"chr15",564494,0,3,0,3,"chr15",1,0.00562587904360056
"18359","chr15.64595000.64600000","chr15.65400000.65405000",805000,7,0.005394166,64595000,65400000,64600000,65405000,"chr15",564530,0,4,1,5,"chr15",1,0.00410220346929208
"18360","chr15.44195000.44200000","chr15.44295000.44300000",100000,16,0.004159079,44195000,44295000,44200000,44300000,"chr15",564533,4,15,12,31,"chr15",1,0.0581340834505391
"18361","chr15.64710000.64715000","chr15.64955000.64960000",245000,14,0.0001016766,64710000,64955000,64715000,64960000,"chr15",564544,3,8,9,20,"chr15",1,0.0328176277543366
"18362","chr15.41100000.41105000","chr15.41180000.41185000",80000,21,0.0001244803,41100000,41180000,41105000,41185000,"chr15",564631,0,18,13,31,"chr15",1,0.0763009845288326
"18363","chr15.92375000.92380000","chr15.92610000.92615000",235000,13,0.0005921178,92375000,92610000,92380000,92615000,"chr15",564643,2,0,0,2,"chr15",1,0.00304735114861697
"18364","chr15.68620000.68625000","chr15.68825000.68830000",205000,13,0.001523419,68620000,68825000,68625000,68830000,"chr15",564654,1,4,4,9,"chr15",1,0.0137130801687764
"18365","chr15.58520000.58525000","chr15.58930000.58935000",410000,9,0.0069531,58520000,58930000,58525000,58935000,"chr15",564668,1,2,1,4,"chr15",1,0.00421940928270042
"18366","chr15.64725000.64730000","chr15.65295000.65300000",570000,9,0.00120619,64725000,65295000,64730000,65300000,"chr15",564686,8,17,16,41,"chr15",1,0.0432489451476793
"18367","chr15.80850000.80855000","chr15.81050000.81055000",200000,13,0.001817208,80850000,81050000,80855000,81055000,"chr15",564698,0,3,1,4,"chr15",1,0.00609470229723394
"18368","chr15.63760000.63765000","chr15.63890000.63895000",130000,22,1.689597e-07,63760000,63890000,63765000,63895000,"chr15",564704,2,4,5,11,"chr15",1,0.0283638068448195
"18369","chr15.44190000.44195000","chr15.44775000.44780000",585000,12,3.779101e-06,44190000,44775000,44195000,44780000,"chr15",564746,2,3,8,13,"chr15",1,0.0182841068917018
"18370","chr16.53090000.53095000","chr16.53280000.53285000",190000,16,3.312337e-05,53090000,53280000,53095000,53285000,"chr16",564756,2,6,4,12,"chr16",1,0.0225035161744023
"18371","chr16.89400000.89405000","chr16.89560000.89565000",160000,18,7.732798e-06,89400000,89560000,89405000,89565000,"chr16",564764,4,18,11,33,"chr16",1,0.069620253164557
"18372","chr16.22190000.22195000","chr16.22300000.22305000",110000,24,3.3086e-08,22190000,22300000,22195000,22305000,"chr16",564773,1,3,4,8,"chr16",1,0.0225035161744023
"18373","chr16.58390000.58395000","chr16.58410000.58415000",20000,42,5.030701e-05,58390000,58410000,58395000,58415000,"chr16",564802,0,4,6,10,"chr16",1,0.0492264416315049
"18374","chr16.89310000.89315000","chr16.89585000.89590000",275000,10,0.009543218,89310000,89585000,89315000,89590000,"chr16",564818,0,2,1,3,"chr16",1,0.00351617440225035
"18375","chr16.67380000.67385000","chr16.67405000.67410000",25000,37,0.0003842759,67380000,67405000,67385000,67410000,"chr16",564833,0,5,7,12,"chr16",1,0.0520393811533052
"18376","chr16.75305000.75310000","chr16.75515000.75520000",210000,14,0.000263553,75305000,75515000,75310000,75520000,"chr16",564866,2,8,7,17,"chr16",1,0.0278949835911861
"18377","chr16.19600000.19605000","chr16.19880000.19885000",280000,10,0.008706611,19600000,19880000,19605000,19885000,"chr16",564895,4,8,8,20,"chr16",1,0.023441162681669
"18378","chr16.84545000.84550000","chr16.84735000.84740000",190000,17,7.041131e-06,84545000,84735000,84550000,84740000,"chr16",564910,7,7,9,23,"chr16",1,0.0458274730426629
"18379","chr16.84545000.84550000","chr16.84620000.84625000",75000,23,1.952718e-05,84545000,84620000,84550000,84625000,"chr16",564916,4,11,7,22,"chr16",1,0.0593061415846226
"18380","chr16.24990000.24995000","chr16.25050000.25055000",60000,25,3.578083e-05,24990000,25050000,24995000,25055000,"chr16",564962,7,12,11,30,"chr16",1,0.0879043600562588
"18381","chr16.69835000.69840000","chr16.69935000.69940000",100000,26,5.067111e-09,69835000,69935000,69840000,69940000,"chr16",564967,4,8,9,21,"chr16",1,0.0639943741209564
"18382","chr16.14285000.14290000","chr16.14600000.14605000",315000,15,1.559916e-06,14285000,14600000,14290000,14605000,"chr16",564979,4,18,13,35,"chr16",1,0.0615330520393812
"18383","chr16.29925000.29930000","chr16.30050000.30055000",125000,16,0.0007615578,29925000,30050000,29930000,30055000,"chr16",564993,6,22,21,49,"chr16",1,0.0918893577121425
"18384","chr16.68550000.68555000","chr16.68900000.68905000",350000,10,0.002848971,68550000,68900000,68555000,68905000,"chr16",565016,6,13,13,32,"chr16",1,0.0375058602906704
"18385","chr16.8790000.8795000","chr16.8910000.8915000",120000,14,0.008720428,8790000,8910000,8795000,8915000,"chr16",565038,3,18,17,38,"chr16",1,0.0623534927332396
"18386","chr16.19525000.19530000","chr16.19845000.19850000",320000,11,0.001083619,19525000,19845000,19530000,19850000,"chr16",565042,4,7,8,19,"chr16",1,0.0244960150023441
"18387","chr16.66690000.66695000","chr16.66865000.66870000",175000,25,1.327072e-11,66690000,66865000,66695000,66870000,"chr16",565054,4,21,12,37,"chr16",1,0.108415377402719
"18388","chr16.85450000.85455000","chr16.85640000.85645000",190000,12,0.006761307,85450000,85640000,85455000,85645000,"chr16",565057,1,3,2,6,"chr16",1,0.00843881856540084
"18389","chr16.27690000.27695000","chr16.28210000.28215000",520000,8,0.007119676,27690000,28210000,27695000,28215000,"chr16",565073,2,5,3,10,"chr16",1,0.00937646507266761
"18390","chr16.56460000.56465000","chr16.56545000.56550000",85000,18,0.00160782,56460000,56545000,56465000,56550000,"chr16",565102,2,5,6,13,"chr16",1,0.0274261603375527
"18391","chr16.68485000.68490000","chr16.68540000.68545000",55000,28,3.944371e-06,68485000,68540000,68490000,68545000,"chr16",565125,8,21,28,57,"chr16",1,0.187060478199719
"18392","chr16.14400000.14405000","chr16.14600000.14605000",200000,42,3.013827e-30,14400000,14600000,14405000,14605000,"chr16",565146,4,10,8,22,"chr16",1,0.108298171589311
"18393","chr16.30375000.30380000","chr16.30405000.30410000",30000,32,0.0007615578,30375000,30405000,30380000,30410000,"chr16",565162,5,15,11,31,"chr16",1,0.116268166901078
"18394","chr16.30060000.30065000","chr16.30595000.30600000",535000,10,0.0002276658,30060000,30595000,30065000,30600000,"chr16",565175,1,12,6,19,"chr16",1,0.0222691045475856
"18395","chr16.24735000.24740000","chr16.25125000.25130000",390000,9,0.00687557,24735000,25125000,24740000,25130000,"chr16",565192,1,8,7,16,"chr16",1,0.0168776371308017
"18396","chr16.29875000.29880000","chr16.30650000.30655000",775000,7,0.00520277,29875000,30650000,29880000,30655000,"chr16",565193,6,6,18,30,"chr16",1,0.0246132208157525
"18397","chr16.89490000.89495000","chr16.89560000.89565000",70000,18,0.007698675,89490000,89560000,89495000,89565000,"chr16",565211,6,13,11,30,"chr16",1,0.0632911392405063
"18398","chr16.67010000.67015000","chr16.67185000.67190000",175000,21,2.208483e-08,67010000,67185000,67015000,67190000,"chr16",565220,0,7,3,10,"chr16",1,0.0246132208157525
"18399","chr16.30900000.30905000","chr16.31460000.31465000",560000,8,0.004950958,30900000,31460000,30905000,31465000,"chr16",565269,7,16,10,33,"chr16",1,0.0309423347398031
"18400","chr16.480000.485000","chr16.570000.575000",90000,16,0.007362843,480000,570000,485000,575000,"chr16",565289,3,13,10,26,"chr16",1,0.0487576183778715
"18401","chr16.46705000.46710000","chr16.46890000.46895000",185000,12,0.007698675,46705000,46890000,46710000,46895000,"chr16",565317,6,15,17,38,"chr16",1,0.0534458509142053
"18402","chr16.67100000.67105000","chr16.67150000.67155000",50000,25,0.0003364571,67100000,67150000,67105000,67155000,"chr16",565323,2,4,8,14,"chr16",1,0.0410220346929208
"18403","chr16.67640000.67645000","chr16.67670000.67675000",30000,32,0.0007615578,67640000,67670000,67645000,67675000,"chr16",565352,6,24,22,52,"chr16",1,0.195030473511486
"18404","chr16.69460000.69465000","chr16.69740000.69745000",280000,12,0.000579144,69460000,69740000,69465000,69745000,"chr16",565417,3,7,7,17,"chr16",1,0.0239099859353024
"18405","chr16.22070000.22075000","chr16.22190000.22195000",120000,17,0.0003011612,22070000,22190000,22075000,22195000,"chr16",565438,1,3,4,8,"chr16",1,0.0159399906235349
"18406","chr16.19770000.19775000","chr16.19860000.19865000",90000,25,1.127897e-07,19770000,19860000,19775000,19865000,"chr16",565448,3,4,5,12,"chr16",1,0.0351617440225035
"18407","chr16.19600000.19605000","chr16.19845000.19850000",245000,12,0.001404086,19600000,19845000,19605000,19850000,"chr16",565467,5,8,10,23,"chr16",1,0.0323488045007032
"18408","chr16.23180000.23185000","chr16.23510000.23515000",330000,11,0.0009189483,23180000,23510000,23185000,23515000,"chr16",565491,7,16,14,37,"chr16",1,0.0477027660571964
"18409","chr16.85325000.85330000","chr16.85675000.85680000",350000,11,0.0006525356,85325000,85675000,85330000,85680000,"chr16",565496,2,4,8,14,"chr16",1,0.0180496952648851
"18410","chr16.30900000.30905000","chr16.30920000.30925000",20000,49,9.194442e-08,30900000,30920000,30905000,30925000,"chr16",565499,7,16,18,41,"chr16",1,0.235466479137365
"18411","chr16.56555000.56560000","chr16.56730000.56735000",175000,15,0.0002691406,56555000,56730000,56560000,56735000,"chr16",565541,3,3,1,7,"chr16",1,0.0123066104078762
"18412","chr16.53090000.53095000","chr16.53205000.53210000",115000,17,0.0004055458,53090000,53205000,53095000,53210000,"chr16",565545,0,5,4,9,"chr16",1,0.0179324894514768
"18413","chr16.56630000.56635000","chr16.56730000.56735000",100000,30,5.942333e-12,56630000,56730000,56635000,56735000,"chr16",565547,3,3,1,7,"chr16",1,0.0246132208157525
"18414","chr16.56545000.56550000","chr16.56735000.56740000",190000,31,8.515387e-18,56545000,56735000,56550000,56740000,"chr16",565552,1,5,4,10,"chr16",1,0.036333802156587
"18415","chr16.84585000.84590000","chr16.84615000.84620000",30000,31,0.001642127,84585000,84615000,84590000,84620000,"chr16",565574,1,2,2,5,"chr16",1,0.0181669010782935
"18416","chr16.4765000.4770000","chr16.4865000.4870000",100000,19,0.0001151089,4765000,4865000,4770000,4870000,"chr16",565580,4,2,5,11,"chr16",1,0.0244960150023441
"18417","chr16.89490000.89495000","chr16.89530000.89535000",40000,27,0.0006427282,89490000,89530000,89495000,89535000,"chr16",565590,6,13,14,33,"chr16",1,0.104430379746835
"18418","chr16.68550000.68555000","chr16.68840000.68845000",290000,14,1.86366e-05,68550000,68840000,68555000,68845000,"chr16",565591,6,13,16,35,"chr16",1,0.0574308485700891
"18419","chr16.84545000.84550000","chr16.84755000.84760000",210000,28,9.699822e-16,84545000,84755000,84550000,84760000,"chr16",565630,8,13,9,30,"chr16",1,0.0984528832630098
"18420","chr16.30390000.30395000","chr16.30595000.30600000",205000,13,0.001218964,30390000,30595000,30395000,30600000,"chr16",565640,4,22,6,32,"chr16",1,0.0487576183778715
"18421","chr16.8995000.9000000","chr16.9225000.9230000",230000,11,0.007287736,8995000,9225000,9e+06,9230000,"chr16",565641,10,16,13,39,"chr16",1,0.05028129395218
"18422","chr16.5010000.5015000","chr16.5030000.5035000",20000,43,2.204103e-05,5010000,5030000,5015000,5035000,"chr16",565652,3,5,4,12,"chr16",1,0.060478199718706
"18423","chr16.21945000.21950000","chr16.22195000.22200000",250000,12,0.001216873,21945000,22195000,21950000,22200000,"chr16",565656,3,8,5,16,"chr16",1,0.0225035161744023
"18424","chr16.75230000.75235000","chr16.75495000.75500000",265000,19,4.602456e-09,75230000,75495000,75235000,75500000,"chr16",565671,3,7,4,14,"chr16",1,0.0311767463666198
"18425","chr16.29895000.29900000","chr16.30060000.30065000",165000,13,0.00479582,29895000,30060000,29900000,30065000,"chr16",565676,1,5,7,13,"chr16",1,0.0198077824660103
"18426","chr16.4330000.4335000","chr16.4350000.4355000",20000,42,5.030701e-05,4330000,4350000,4335000,4355000,"chr16",565717,7,7,6,20,"chr16",1,0.0984528832630098
"18427","chr16.68295000.68300000","chr16.68340000.68345000",45000,31,2.188485e-06,68295000,68340000,68300000,68345000,"chr16",565721,1,0,0,1,"chr16",1,0.0036333802156587
"18428","chr16.89490000.89495000","chr16.89535000.89540000",45000,33,2.066587e-07,89490000,89535000,89495000,89540000,"chr16",565727,6,13,14,33,"chr16",1,0.127637130801688
"18429","chr16.81415000.81420000","chr16.81730000.81735000",315000,13,5.214706e-05,81415000,81730000,81420000,81735000,"chr16",565729,4,11,10,25,"chr16",1,0.0380918893577121
"18430","chr16.22345000.22350000","chr16.22370000.22375000",25000,34,0.003276528,22345000,22370000,22350000,22375000,"chr16",565766,0,5,2,7,"chr16",1,0.0278949835911861
"18431","chr16.19815000.19820000","chr16.19850000.19855000",35000,31,0.0001258492,19815000,19850000,19820000,19855000,"chr16",565809,5,12,13,30,"chr16",1,0.109001406469761
"18432","chr16.19715000.19720000","chr16.19850000.19855000",135000,14,0.004738125,19715000,19850000,19720000,19855000,"chr16",565838,0,12,6,18,"chr16",1,0.029535864978903
"18433","chr16.2100000.2105000","chr16.2190000.2195000",90000,20,9.805497e-05,2100000,2190000,2105000,2195000,"chr16",565852,0,2,5,7,"chr16",1,0.0164088138771683
"18434","chr16.56520000.56525000","chr16.56630000.56635000",110000,15,0.00520277,56520000,56630000,56525000,56635000,"chr16",565858,8,23,26,57,"chr16",1,0.100210970464135
"18435","chr16.67070000.67075000","chr16.67150000.67155000",80000,25,6.140704e-07,67070000,67150000,67075000,67155000,"chr16",565862,3,9,8,20,"chr16",1,0.0586029067041725
"18436","chr16.19585000.19590000","chr16.19770000.19775000",185000,16,4.174584e-05,19585000,19770000,19590000,19775000,"chr16",565880,7,5,7,19,"chr16",1,0.0356305672761369
"18437","chr16.4325000.4330000","chr16.4350000.4355000",25000,51,6.068987e-10,4325000,4350000,4330000,4355000,"chr16",565886,4,9,14,27,"chr16",1,0.161392405063291
"18438","chr16.56555000.56560000","chr16.56700000.56705000",145000,14,0.003211912,56555000,56700000,56560000,56705000,"chr16",565889,6,16,18,40,"chr16",1,0.0656352555086732
"18439","chr16.29875000.29880000","chr16.30060000.30065000",185000,16,4.174584e-05,29875000,30060000,29880000,30065000,"chr16",565943,1,12,14,27,"chr16",1,0.0506329113924051
"18440","chr16.89400000.89405000","chr16.89565000.89570000",165000,15,0.0004106149,89400000,89565000,89405000,89570000,"chr16",565955,4,23,23,50,"chr16",1,0.0879043600562588
"18441","chr16.19110000.19115000","chr16.19520000.19525000",410000,11,0.0002469003,19110000,19520000,19115000,19525000,"chr16",565959,2,6,4,12,"chr16",1,0.0154711673699015
"18442","chr16.22205000.22210000","chr16.22300000.22305000",95000,35,1.678156e-15,22205000,22300000,22210000,22305000,"chr16",565984,5,12,13,30,"chr16",1,0.123066104078762
"18443","chr16.70390000.70395000","chr16.70520000.70525000",130000,16,0.000589232,70390000,70520000,70395000,70525000,"chr16",565986,13,32,28,73,"chr16",1,0.136896390060947
"18444","chr16.75320000.75325000","chr16.75400000.75405000",80000,20,0.0003225332,75320000,75400000,75325000,75405000,"chr16",565991,3,13,9,25,"chr16",1,0.0586029067041725
"18445","chr16.47015000.47020000","chr16.47855000.47860000",840000,7,0.003535179,47015000,47855000,47020000,47860000,"chr16",565997,1,0,2,3,"chr16",1,0.00246132208157525
"18446","chr16.56545000.56550000","chr16.56590000.56595000",45000,35,1.716017e-08,56545000,56590000,56550000,56595000,"chr16",566049,2,5,6,13,"chr16",1,0.053328645100797
"18447","chr16.5010000.5015000","chr16.5065000.5070000",55000,22,0.002068492,5010000,5065000,5015000,5070000,"chr16",566059,6,7,13,26,"chr16",1,0.0670417252695734
"18448","chr16.24845000.24850000","chr16.25050000.25055000",205000,13,0.001218964,24845000,25050000,24850000,25055000,"chr16",566068,7,23,30,60,"chr16",1,0.0914205344585091
"18449","chr16.67715000.67720000","chr16.67860000.67865000",145000,13,0.009543218,67715000,67860000,67720000,67865000,"chr16",566105,2,4,6,12,"chr16",1,0.0182841068917018
"18450","chr16.56635000.56640000","chr16.56735000.56740000",100000,52,3.488323e-32,56635000,56735000,56640000,56740000,"chr16",566138,1,6,4,11,"chr16",1,0.0670417252695734
"18451","chr16.89380000.89385000","chr16.89565000.89570000",185000,15,0.0001747775,89380000,89565000,89385000,89570000,"chr16",566156,7,23,23,53,"chr16",1,0.0931786216596343
"18452","chr16.18800000.18805000","chr16.18980000.18985000",180000,14,0.0008267645,18800000,18980000,18805000,18985000,"chr16",566167,6,13,14,33,"chr16",1,0.0541490857946554
"18453","chr16.67100000.67105000","chr16.67125000.67130000",25000,63,1.914073e-16,67100000,67125000,67105000,67130000,"chr16",566199,0,4,4,8,"chr16",1,0.0590717299578059
"18454","chr16.66935000.66940000","chr16.67185000.67190000",250000,12,0.001216873,66935000,67185000,66940000,67190000,"chr16",566218,0,7,3,10,"chr16",1,0.0140646976090014
"18455","chr16.69795000.69800000","chr16.69835000.69840000",40000,28,0.0002605822,69795000,69835000,69800000,69840000,"chr16",566232,3,8,13,24,"chr16",1,0.0787623066104079
"18456","chr16.5005000.5010000","chr16.5065000.5070000",60000,30,7.342841e-08,5005000,5065000,5010000,5070000,"chr16",566257,4,7,9,20,"chr16",1,0.070323488045007
"18457","chr16.19705000.19710000","chr16.19885000.19890000",180000,18,2.461731e-06,19705000,19885000,19710000,19890000,"chr16",566262,2,1,2,5,"chr16",1,0.0105485232067511
"18458","chr16.56635000.56640000","chr16.56730000.56735000",95000,29,8.459972e-11,56635000,56730000,56640000,56735000,"chr16",566269,3,3,1,7,"chr16",1,0.023792780121894
"18459","chr16.29860000.29865000","chr16.30050000.30055000",190000,16,3.312337e-05,29860000,30050000,29865000,30055000,"chr16",566276,4,7,6,17,"chr16",1,0.0318799812470699
"18460","chr16.31105000.31110000","chr16.31880000.31885000",775000,9,0.0001260911,31105000,31880000,31110000,31885000,"chr16",566318,3,11,12,26,"chr16",1,0.0274261603375527
"18461","chr16.19525000.19530000","chr16.19905000.19910000",380000,10,0.001867465,19525000,19905000,19530000,19910000,"chr16",566328,4,7,8,19,"chr16",1,0.0222691045475856
"18462","chr16.2775000.2780000","chr16.2965000.2970000",190000,13,0.002020718,2775000,2965000,2780000,2970000,"chr16",566333,0,1,1,2,"chr16",1,0.00304735114861697
"18463","chr16.3770000.3775000","chr16.4350000.4355000",580000,8,0.004089466,3770000,4350000,3775000,4355000,"chr16",566345,5,16,9,30,"chr16",1,0.0281293952180028
"18464","chr16.66690000.66695000","chr16.66715000.66720000",25000,38,0.0001757114,66690000,66715000,66695000,66720000,"chr16",566407,3,18,12,33,"chr16",1,0.146976090014065
"18465","chr16.3995000.4000000","chr16.4325000.4330000",330000,10,0.003848083,3995000,4325000,4e+06,4330000,"chr16",566412,4,9,14,27,"chr16",1,0.0316455696202532
"18466","chr16.70435000.70440000","chr16.70490000.70495000",55000,26,3.836463e-05,70435000,70490000,70440000,70495000,"chr16",566423,1,9,2,12,"chr16",1,0.0365682137834037
"18467","chr16.30630000.30635000","chr16.30650000.30655000",20000,42,5.030701e-05,30630000,30650000,30635000,30655000,"chr16",566449,10,6,18,34,"chr16",1,0.167369901547117
"18468","chr16.9380000.9385000","chr16.10215000.10220000",835000,10,8.983038e-06,9380000,10215000,9385000,10220000,"chr16",566459,2,4,6,12,"chr16",1,0.0140646976090014
"18469","chr16.19745000.19750000","chr16.19850000.19855000",105000,23,2.746995e-07,19745000,19850000,19750000,19855000,"chr16",566479,5,12,6,23,"chr16",1,0.0620018752930145
"18470","chr16.56220000.56225000","chr16.56330000.56335000",110000,16,0.001789466,56220000,56330000,56225000,56335000,"chr16",566486,0,3,1,4,"chr16",1,0.00750117205813408
"18471","chr16.19110000.19115000","chr16.19500000.19505000",390000,10,0.001642127,19110000,19500000,19115000,19505000,"chr16",566509,7,24,13,44,"chr16",1,0.0515705578996718
"18472","chr16.25050000.25055000","chr16.25125000.25130000",75000,24,5.540295e-06,25050000,25125000,25055000,25130000,"chr16",566534,1,8,7,16,"chr16",1,0.0450070323488045
"18473","chr16.21580000.21585000","chr16.22350000.22355000",770000,7,0.005323408,21580000,22350000,21585000,22355000,"chr16",566539,1,6,2,9,"chr16",1,0.00738396624472574
"18474","chr16.11975000.11980000","chr16.12000000.12005000",25000,40,3.424475e-05,11975000,1.2e+07,11980000,12005000,"chr16",566540,3,12,15,30,"chr16",1,0.140646976090014
"18475","chr16.19585000.19590000","chr16.19850000.19855000",265000,14,3.953766e-05,19585000,19850000,19590000,19855000,"chr16",566546,5,12,13,30,"chr16",1,0.0492264416315049
"18476","chr16.15550000.15555000","chr16.15650000.15655000",100000,16,0.003511948,15550000,15650000,15555000,15655000,"chr16",566571,4,13,17,34,"chr16",1,0.0637599624941397
"18477","chr16.18815000.18820000","chr16.18980000.18985000",165000,16,0.0001080721,18815000,18980000,18820000,18985000,"chr16",566572,6,13,14,33,"chr16",1,0.0618846694796062
"18478","chr16.74720000.74725000","chr16.75430000.75435000",710000,8,0.001439964,74720000,75430000,74725000,75435000,"chr16",566592,1,13,14,28,"chr16",1,0.0262541022034693
"18479","chr16.2915000.2920000","chr16.2960000.2965000",45000,29,1.976342e-05,2915000,2960000,2920000,2965000,"chr16",566610,8,31,13,52,"chr16",1,0.176746366619784
"18480","chr16.14400000.14405000","chr16.14630000.14635000",230000,15,2.737387e-05,14400000,14630000,14405000,14635000,"chr16",566645,4,10,8,22,"chr16",1,0.0386779184247539
"18481","chr16.24610000.24615000","chr16.24990000.24995000",380000,11,0.000396116,24610000,24990000,24615000,24995000,"chr16",566656,5,12,7,24,"chr16",1,0.0309423347398031
"18482","chr16.84600000.84605000","chr16.84620000.84625000",20000,39,0.0005060861,84600000,84620000,84605000,84625000,"chr16",566663,4,11,7,22,"chr16",1,0.10056258790436
"18483","chr16.81415000.81420000","chr16.81720000.81725000",305000,19,8.151699e-10,81415000,81720000,81420000,81725000,"chr16",566666,5,14,8,27,"chr16",1,0.060126582278481
"18484","chr16.19705000.19710000","chr16.19850000.19855000",145000,15,0.0009921198,19705000,19850000,19710000,19855000,"chr16",566674,2,1,2,5,"chr16",1,0.00879043600562588
"18485","chr16.66750000.66755000","chr16.66870000.66875000",120000,14,0.008720428,66750000,66870000,66755000,66875000,"chr16",566678,1,4,3,8,"chr16",1,0.0131270511017346
"18486","chr16.58410000.58415000","chr16.58625000.58630000",215000,12,0.003214556,58410000,58625000,58415000,58630000,"chr16",566690,9,38,26,73,"chr16",1,0.10267229254571
"18487","chr16.50100000.50105000","chr16.50250000.50255000",150000,19,3.113479e-06,50100000,50250000,50105000,50255000,"chr16",566699,3,9,8,20,"chr16",1,0.0445382090951711
"18488","chr16.57115000.57120000","chr16.57280000.57285000",165000,20,2.404274e-07,57115000,57280000,57120000,57285000,"chr16",566703,2,5,12,19,"chr16",1,0.0445382090951711
"18489","chr16.8620000.8625000","chr16.8725000.8730000",105000,17,0.0008278942,8620000,8725000,8625000,8730000,"chr16",566723,6,12,12,30,"chr16",1,0.059774964838256
"18490","chr16.89410000.89415000","chr16.89720000.89725000",310000,11,0.001316445,89410000,89720000,89415000,89725000,"chr16",566743,5,4,12,21,"chr16",1,0.0270745428973277
"18491","chr16.69855000.69860000","chr16.69890000.69895000",35000,31,0.0001258492,69855000,69890000,69860000,69895000,"chr16",566774,5,12,8,25,"chr16",1,0.0908345053914674
"18492","chr16.67010000.67015000","chr16.67190000.67195000",180000,18,2.461731e-06,67010000,67190000,67015000,67195000,"chr16",566784,7,15,25,47,"chr16",1,0.0991561181434599
"18493","chr16.56555000.56560000","chr16.56635000.56640000",80000,25,6.140704e-07,56555000,56635000,56560000,56640000,"chr16",566788,3,14,10,27,"chr16",1,0.0791139240506329
"18494","chr16.19845000.19850000","chr16.19865000.19870000",20000,69,4.50912e-18,19845000,19865000,19850000,19870000,"chr16",566825,2,12,10,24,"chr16",1,0.194092827004219
"18495","chr16.3110000.3115000","chr16.3150000.3155000",40000,29,0.0001014801,3110000,3150000,3115000,3155000,"chr16",566829,1,9,5,15,"chr16",1,0.0509845288326301
"18496","chr16.19635000.19640000","chr16.19655000.19660000",20000,38,0.00101401,19635000,19655000,19640000,19660000,"chr16",566857,1,7,6,14,"chr16",1,0.0623534927332396
"18497","chr16.56510000.56515000","chr16.56735000.56740000",225000,11,0.008194837,56510000,56735000,56515000,56740000,"chr16",566874,1,6,4,11,"chr16",1,0.0141819034224098
"18498","chr16.31010000.31015000","chr16.31030000.31035000",20000,40,0.0002420863,31010000,31030000,31015000,31035000,"chr16",566880,5,9,9,23,"chr16",1,0.107829348335677
"18499","chr16.10615000.10620000","chr16.10825000.10830000",210000,37,3.355162e-25,10615000,10825000,10620000,10830000,"chr16",566899,2,11,12,25,"chr16",1,0.108415377402719
"18500","chr16.21985000.21990000","chr16.22295000.22300000",310000,10,0.005216722,21985000,22295000,21990000,22300000,"chr16",566928,5,14,14,33,"chr16",1,0.0386779184247539
"18501","chr16.75300000.75305000","chr16.75400000.75405000",100000,16,0.003511948,75300000,75400000,75305000,75405000,"chr16",566948,6,18,31,55,"chr16",1,0.103141115799344
"18502","chr16.89410000.89415000","chr16.89530000.89535000",120000,17,0.0003011612,89410000,89530000,89415000,89535000,"chr16",566977,6,4,12,22,"chr16",1,0.0438349742147211
"18503","chr16.19585000.19590000","chr16.19780000.19785000",195000,12,0.005750317,19585000,19780000,19590000,19785000,"chr16",567005,8,26,32,66,"chr16",1,0.0928270042194093
"18504","chr16.67010000.67015000","chr16.67155000.67160000",145000,17,7.459419e-05,67010000,67155000,67015000,67160000,"chr16",567075,3,7,3,13,"chr16",1,0.0259024847632443
"18505","chr16.56555000.56560000","chr16.56615000.56620000",60000,34,2.636569e-10,56555000,56615000,56560000,56620000,"chr16",567084,6,14,22,42,"chr16",1,0.167369901547117
"18506","chr16.66980000.66985000","chr16.67200000.67205000",220000,16,8.393591e-06,66980000,67200000,66985000,67205000,"chr16",567130,0,6,3,9,"chr16",1,0.0168776371308017
"18507","chr16.31035000.31040000","chr16.31710000.31715000",675000,7,0.00962365,31035000,31710000,31040000,31715000,"chr16",567156,5,9,7,21,"chr16",1,0.0172292545710267
"18508","chr16.84540000.84545000","chr16.84615000.84620000",75000,21,0.0002042379,84540000,84615000,84545000,84620000,"chr16",567164,1,2,2,5,"chr16",1,0.0123066104078762
"18509","chr16.48350000.48355000","chr16.48380000.48385000",30000,31,0.001642127,48350000,48380000,48355000,48385000,"chr16",567182,1,8,4,13,"chr16",1,0.0472339428035631
"18510","chr16.87805000.87810000","chr16.87905000.87910000",100000,23,5.069355e-07,87805000,87905000,87810000,87910000,"chr16",567198,1,14,10,25,"chr16",1,0.0673933427097984
"18511","chr16.31460000.31465000","chr16.31880000.31885000",420000,9,0.004814394,31460000,31880000,31465000,31885000,"chr16",567212,3,11,10,24,"chr16",1,0.0253164556962025
"18512","chr16.29815000.29820000","chr16.29970000.29975000",155000,14,0.002140424,29815000,29970000,29820000,29975000,"chr16",567217,1,8,13,22,"chr16",1,0.0360993905297703
"18513","chr16.56295000.56300000","chr16.56330000.56335000",35000,49,5.81667e-14,56295000,56330000,56300000,56335000,"chr16",567287,0,3,1,4,"chr16",1,0.0229723394280356
"18514","chr16.71805000.71810000","chr16.71930000.71935000",125000,15,0.002390746,71805000,71930000,71810000,71935000,"chr16",567366,4,16,12,32,"chr16",1,0.0562587904360056
"18515","chr16.67105000.67110000","chr16.67125000.67130000",20000,49,9.194442e-08,67105000,67125000,67110000,67130000,"chr16",567395,0,5,4,9,"chr16",1,0.0516877637130802
"18516","chr16.69855000.69860000","chr16.69885000.69890000",30000,37,9.560868e-06,69855000,69885000,69860000,69890000,"chr16",567420,8,16,8,32,"chr16",1,0.138771683075481
"18517","chr16.56545000.56550000","chr16.56630000.56635000",85000,65,3.955222e-43,56545000,56630000,56550000,56635000,"chr16",567447,2,5,6,13,"chr16",1,0.0990389123300516
"18518","chr16.15525000.15530000","chr16.15765000.15770000",240000,13,0.0003950427,15525000,15765000,15530000,15770000,"chr16",567486,3,6,6,15,"chr16",1,0.0228551336146273
"18519","chr16.21705000.21710000","chr16.22070000.22075000",365000,9,0.009325723,21705000,22070000,21710000,22075000,"chr16",567512,3,3,7,13,"chr16",1,0.0137130801687764
"18520","chr16.2915000.2920000","chr16.2965000.2970000",50000,25,0.0003364571,2915000,2965000,2920000,2970000,"chr16",567565,0,1,1,2,"chr16",1,0.00586029067041725
"18521","chr16.19735000.19740000","chr16.19770000.19775000",35000,35,2.452903e-06,19735000,19770000,19740000,19775000,"chr16",567578,7,5,7,19,"chr16",1,0.0779418659165495
"18522","chr16.78155000.78160000","chr16.78490000.78495000",335000,10,0.003560016,78155000,78490000,78160000,78495000,"chr16",567615,0,7,5,12,"chr16",1,0.0140646976090014
"18523","chr16.89440000.89445000","chr16.89555000.89560000",115000,17,0.0004055458,89440000,89555000,89445000,89560000,"chr16",567629,2,7,10,19,"chr16",1,0.0378574777308955
"18524","chr16.19755000.19760000","chr16.19850000.19855000",95000,16,0.005057701,19755000,19850000,19760000,19855000,"chr16",567645,4,12,12,28,"chr16",1,0.0525082044069386
"18525","chr16.12290000.12295000","chr16.12455000.12460000",165000,13,0.00479582,12290000,12455000,12295000,12460000,"chr16",567657,1,2,3,6,"chr16",1,0.00914205344585091
"18526","chr16.11640000.11645000","chr16.11695000.11700000",55000,23,0.0008278942,11640000,11695000,11645000,11700000,"chr16",567667,3,1,2,6,"chr16",1,0.0161744022503516
"18527","chr16.3995000.4000000","chr16.4285000.4290000",290000,11,0.001922953,3995000,4285000,4e+06,4290000,"chr16",567693,10,21,19,50,"chr16",1,0.0644631973745898
"18528","chr16.30445000.30450000","chr16.30630000.30635000",185000,14,0.0006794169,30445000,30630000,30450000,30635000,"chr16",567742,10,27,25,62,"chr16",1,0.101734646038444
"18529","chr16.66870000.66875000","chr16.66895000.66900000",25000,46,1.245293e-07,66870000,66895000,66875000,66900000,"chr16",567767,9,22,35,66,"chr16",1,0.355836849507736
"18530","chr16.2420000.2425000","chr16.2450000.2455000",30000,36,2.450125e-05,2420000,2450000,2425000,2455000,"chr16",567771,3,5,1,9,"chr16",1,0.0379746835443038
"18531","chr16.75465000.75470000","chr16.75590000.75595000",125000,16,0.0007615578,75465000,75590000,75470000,75595000,"chr16",567773,5,14,11,30,"chr16",1,0.0562587904360056
"18532","chr16.25065000.25070000","chr16.25110000.25115000",45000,23,0.005303841,25065000,25110000,25070000,25115000,"chr16",567777,3,14,5,22,"chr16",1,0.0593061415846226
"18533","chr16.29940000.29945000","chr16.29970000.29975000",30000,38,3.66726e-06,29940000,29970000,29945000,29975000,"chr16",567792,1,8,13,22,"chr16",1,0.0979840600093765
"18534","chr16.12810000.12815000","chr16.12905000.12910000",95000,21,1.51995e-05,12810000,12905000,12815000,12910000,"chr16",567823,0,13,6,19,"chr16",1,0.0467651195499297
"18535","chr16.14630000.14635000","chr16.14655000.14660000",25000,36,0.0008186653,14630000,14655000,14635000,14660000,"chr16",567857,8,24,16,48,"chr16",1,0.20253164556962
"18536","chr16.67715000.67720000","chr16.67845000.67850000",130000,16,0.000589232,67715000,67845000,67720000,67850000,"chr16",567862,2,10,15,27,"chr16",1,0.0506329113924051
"18537","chr16.30375000.30380000","chr16.30400000.30405000",25000,36,0.0008186653,30375000,30400000,30380000,30405000,"chr16",567868,5,15,20,40,"chr16",1,0.168776371308017
"18538","chr16.57620000.57625000","chr16.58020000.58025000",400000,10,0.001429702,57620000,58020000,57625000,58025000,"chr16",567872,1,0,4,5,"chr16",1,0.00586029067041725
"18539","chr16.21985000.21990000","chr16.22215000.22220000",230000,13,0.0005461793,21985000,22215000,21990000,22220000,"chr16",567887,5,10,7,22,"chr16",1,0.0335208626347867
"18540","chr16.69890000.69895000","chr16.69935000.69940000",45000,26,0.0003958408,69890000,69935000,69895000,69940000,"chr16",567893,4,12,9,25,"chr16",1,0.0761837787154243
"18541","chr16.56590000.56595000","chr16.56730000.56735000",140000,19,5.726099e-06,56590000,56730000,56595000,56735000,"chr16",567924,3,3,1,7,"chr16",1,0.0155883731833099
"18542","chr16.84310000.84315000","chr16.84405000.84410000",95000,19,0.000188706,84310000,84405000,84315000,84410000,"chr16",567934,3,3,3,9,"chr16",1,0.020042194092827
"18543","chr16.75265000.75270000","chr16.75300000.75305000",35000,35,2.452903e-06,75265000,75300000,75270000,75305000,"chr16",567947,4,25,10,39,"chr16",1,0.159985935302391
"18544","chr16.67720000.67725000","chr16.68235000.68240000",515000,8,0.007362843,67720000,68235000,67725000,68240000,"chr16",567996,3,6,2,11,"chr16",1,0.0103141115799344
"18545","chr16.69890000.69895000","chr16.69930000.69935000",40000,33,1.559916e-06,69890000,69930000,69895000,69935000,"chr16",567999,5,12,15,32,"chr16",1,0.123769338959212
"18546","chr16.30595000.30600000","chr16.30650000.30655000",55000,33,6.52704e-09,30595000,30650000,30600000,30655000,"chr16",568010,4,6,6,16,"chr16",1,0.0618846694796062
"18547","chr16.9930000.9935000","chr16.10000000.10005000",70000,20,0.00119393,9930000,1e+07,9935000,10005000,"chr16",568023,0,3,2,5,"chr16",1,0.0117205813408345
"18548","chr16.19780000.19785000","chr16.19865000.19870000",85000,21,5.251119e-05,19780000,19865000,19785000,19870000,"chr16",568038,2,12,11,25,"chr16",1,0.0615330520393812
"18549","chr16.85315000.85320000","chr16.85350000.85355000",35000,29,0.0007397556,85315000,85350000,85320000,85355000,"chr16",568122,4,3,0,7,"chr16",1,0.023792780121894
"18550","chr16.14330000.14335000","chr16.14625000.14630000",295000,11,0.001744005,14330000,14625000,14335000,14630000,"chr16",568130,3,10,11,24,"chr16",1,0.0309423347398031
"18551","chr16.22895000.22900000","chr16.23425000.23430000",530000,8,0.006524077,22895000,23425000,22900000,23430000,"chr16",568138,7,18,14,39,"chr16",1,0.0365682137834037
"18552","chr16.83955000.83960000","chr16.84095000.84100000",140000,17,9.805497e-05,83955000,84095000,83960000,84100000,"chr16",568158,0,1,2,3,"chr16",1,0.0059774964838256
"18553","chr16.67260000.67265000","chr16.67510000.67515000",250000,11,0.004565787,67260000,67510000,67265000,67515000,"chr16",568161,0,5,2,7,"chr16",1,0.00902484763244257
"18554","chr16.19635000.19640000","chr16.19850000.19855000",215000,18,3.633977e-07,19635000,19850000,19640000,19855000,"chr16",568168,4,8,6,18,"chr16",1,0.0379746835443038
"18555","chr16.6130000.6135000","chr16.6695000.6700000",565000,9,0.0009229991,6130000,6695000,6135000,6700000,"chr16",568196,0,2,2,4,"chr16",1,0.00421940928270042
"18556","chr16.68085000.68090000","chr16.68240000.68245000",155000,16,0.0001747775,68085000,68240000,68090000,68245000,"chr16",568207,2,10,9,21,"chr16",1,0.0393811533052039
"18557","chr16.14395000.14400000","chr16.14600000.14605000",205000,16,1.623345e-05,14395000,14600000,14400000,14605000,"chr16",568216,2,10,9,21,"chr16",1,0.0393811533052039
"18558","chr16.68905000.68910000","chr16.69155000.69160000",250000,13,0.0002964966,68905000,69155000,68910000,69160000,"chr16",568219,5,12,11,28,"chr16",1,0.0426629160806376
"18559","chr16.67840000.67845000","chr16.67925000.67930000",85000,22,1.50955e-05,67840000,67925000,67845000,67930000,"chr16",568220,2,3,5,10,"chr16",1,0.0257852789498359
"18560","chr16.66695000.66700000","chr16.66715000.66720000",20000,35,0.007147375,66695000,66715000,66700000,66720000,"chr16",568227,3,18,12,33,"chr16",1,0.135372714486639
"18561","chr16.12000000.12005000","chr16.12290000.12295000",290000,10,0.007285728,1.2e+07,12290000,12005000,12295000,"chr16",568243,3,2,3,8,"chr16",1,0.00937646507266761
"18562","chr16.25105000.25110000","chr16.25125000.25130000",20000,45,3.944371e-06,25105000,25125000,25110000,25130000,"chr16",568256,0,8,6,14,"chr16",1,0.0738396624472574
"18563","chr16.15525000.15530000","chr16.15640000.15645000",115000,28,2.001984e-11,15525000,15640000,15530000,15645000,"chr16",568270,3,6,6,15,"chr16",1,0.0492264416315049
"18564","chr16.67010000.67015000","chr16.67160000.67165000",150000,13,0.007907488,67010000,67160000,67015000,67165000,"chr16",568286,2,3,2,7,"chr16",1,0.0106657290201594
"18565","chr16.68885000.68890000","chr16.69155000.69160000",270000,18,2.596572e-08,68885000,69155000,68890000,69160000,"chr16",568326,2,12,11,25,"chr16",1,0.0527426160337553
"18566","chr16.24995000.25000000","chr16.25050000.25055000",55000,23,0.0008278942,24995000,25050000,2.5e+07,25055000,"chr16",568350,7,13,23,43,"chr16",1,0.115916549460853
"18567","chr16.68485000.68490000","chr16.68550000.68555000",65000,22,0.0003359441,68485000,68550000,68490000,68555000,"chr16",568362,6,13,20,39,"chr16",1,0.10056258790436
"18568","chr16.22635000.22640000","chr16.22705000.22710000",70000,18,0.007698675,22635000,22705000,22640000,22710000,"chr16",568368,4,7,5,16,"chr16",1,0.0337552742616034
"18569","chr16.66980000.66985000","chr16.67185000.67190000",205000,23,5.992915e-11,66980000,67185000,66985000,67190000,"chr16",568371,0,7,3,10,"chr16",1,0.0269573370839194
"18570","chr16.70435000.70440000","chr16.70475000.70480000",40000,25,0.003392301,70435000,70475000,70440000,70480000,"chr16",568373,1,5,2,8,"chr16",1,0.023441162681669
"18571","chr16.56545000.56550000","chr16.56585000.56590000",40000,45,2.676631e-13,56545000,56585000,56550000,56590000,"chr16",568406,2,5,6,13,"chr16",1,0.0685654008438819
"18572","chr16.24040000.24045000","chr16.24505000.24510000",465000,9,0.002807622,24040000,24505000,24045000,24510000,"chr16",568477,2,9,7,18,"chr16",1,0.0189873417721519
"18573","chr16.275000.280000","chr16.395000.400000",120000,14,0.008720428,275000,395000,280000,4e+05,"chr16",568478,8,24,26,58,"chr16",1,0.0951711204875762
"18574","chr16.21555000.21560000","chr16.22350000.22355000",795000,7,0.00463411,21555000,22350000,21560000,22355000,"chr16",568498,1,6,2,9,"chr16",1,0.00738396624472574
"18575","chr16.56550000.56555000","chr16.56580000.56585000",30000,54,1.784419e-14,56550000,56580000,56555000,56585000,"chr16",568527,3,8,6,17,"chr16",1,0.107594936708861
"18576","chr16.67015000.67020000","chr16.67200000.67205000",185000,15,0.0001747775,67015000,67200000,67020000,67205000,"chr16",568572,0,6,3,9,"chr16",1,0.0158227848101266
"18577","chr16.67070000.67075000","chr16.67125000.67130000",55000,35,4.063765e-10,67070000,67125000,67075000,67130000,"chr16",568576,0,5,4,9,"chr16",1,0.0369198312236287
"18578","chr16.66930000.66935000","chr16.67155000.67160000",225000,11,0.008194837,66930000,67155000,66935000,67160000,"chr16",568577,3,7,3,13,"chr16",1,0.0167604313173933
"18579","chr16.4475000.4480000","chr16.4520000.4525000",45000,25,0.0009921198,4475000,4520000,4480000,4525000,"chr16",568593,2,9,14,25,"chr16",1,0.0732536333802157
"18580","chr16.24745000.24750000","chr16.25125000.25130000",380000,10,0.001867465,24745000,25125000,24750000,25130000,"chr16",568653,1,8,7,16,"chr16",1,0.0187529301453352
"18581","chr16.19085000.19090000","chr16.19600000.19605000",515000,8,0.007362843,19085000,19600000,19090000,19605000,"chr16",568655,5,8,13,26,"chr16",1,0.0243788091889358
"18582","chr16.4400000.4405000","chr16.4475000.4480000",75000,19,0.001697679,4400000,4475000,4405000,4480000,"chr16",568658,4,17,7,28,"chr16",1,0.0623534927332396
"18583","chr16.19110000.19115000","chr16.19375000.19380000",265000,15,7.524554e-06,19110000,19375000,19115000,19380000,"chr16",568687,8,24,13,45,"chr16",1,0.0791139240506329
"18584","chr16.75495000.75500000","chr16.75575000.75580000",80000,18,0.002622682,75495000,75575000,75500000,75580000,"chr16",568704,3,7,4,14,"chr16",1,0.029535864978903
"18585","chr16.8620000.8625000","chr16.8880000.8885000",260000,11,0.003620202,8620000,8880000,8625000,8885000,"chr16",568718,3,11,9,23,"chr16",1,0.0296530707923113
"18586","chr16.69420000.69425000","chr16.69795000.69800000",375000,22,5.810154e-14,69420000,69795000,69425000,69800000,"chr16",568726,3,9,13,25,"chr16",1,0.0644631973745898
"18587","chr16.470000.475000","chr16.525000.530000",55000,31,9.373038e-08,470000,525000,475000,530000,"chr16",568751,1,0,3,4,"chr16",1,0.0145335208626348
"18588","chr16.3455000.3460000","chr16.3500000.3505000",45000,25,0.0009921198,3455000,3500000,3460000,3505000,"chr16",568770,4,19,13,36,"chr16",1,0.105485232067511
"18589","chr16.3305000.3310000","chr16.3505000.3510000",200000,14,0.0003828086,3305000,3505000,3310000,3510000,"chr16",568819,3,15,8,26,"chr16",1,0.0426629160806376
"18590","chr16.19065000.19070000","chr16.19530000.19535000",465000,9,0.002807622,19065000,19530000,19070000,19535000,"chr16",568834,4,13,13,30,"chr16",1,0.0316455696202532
"18591","chr16.77660000.77665000","chr16.77680000.77685000",20000,42,5.030701e-05,77660000,77680000,77665000,77685000,"chr16",568841,2,4,6,12,"chr16",1,0.0590717299578059
"18592","chr16.4585000.4590000","chr16.5005000.5010000",420000,10,0.001058448,4585000,5005000,4590000,5010000,"chr16",568845,4,8,9,21,"chr16",1,0.0246132208157525
"18593","chr16.77720000.77725000","chr16.78045000.78050000",325000,14,7.322298e-06,77720000,78045000,77725000,78050000,"chr16",568849,5,12,8,25,"chr16",1,0.0410220346929208
"18594","chr16.67405000.67410000","chr16.67535000.67540000",130000,14,0.005748029,67405000,67535000,67410000,67540000,"chr16",568863,1,5,3,9,"chr16",1,0.0147679324894515
"18595","chr16.24045000.24050000","chr16.24515000.24520000",470000,14,2.742168e-07,24045000,24515000,24050000,24520000,"chr16",568870,11,20,9,40,"chr16",1,0.0656352555086732
"18596","chr16.31030000.31035000","chr16.31440000.31445000",410000,10,0.001223055,31030000,31440000,31035000,31445000,"chr16",568878,2,9,9,20,"chr16",1,0.023441162681669
"18597","chr16.56555000.56560000","chr16.56590000.56595000",35000,29,0.0007397556,56555000,56590000,56560000,56595000,"chr16",568916,5,11,23,39,"chr16",1,0.132559774964838
"18598","chr16.30050000.30055000","chr16.30630000.30635000",580000,10,0.0001280742,30050000,30630000,30055000,30635000,"chr16",568921,10,22,21,53,"chr16",1,0.0621190811064229
"18599","chr16.85350000.85355000","chr16.85640000.85645000",290000,10,0.007285728,85350000,85640000,85355000,85645000,"chr16",568933,4,3,5,12,"chr16",1,0.0140646976090014
"18600","chr16.69060000.69065000","chr16.69100000.69105000",40000,24,0.007287736,69060000,69100000,69065000,69105000,"chr16",568956,8,33,26,67,"chr16",1,0.188466947960619
"18601","chr16.48290000.48295000","chr16.48610000.48615000",320000,10,0.004475095,48290000,48610000,48295000,48615000,"chr16",568965,1,6,6,13,"chr16",1,0.0152367557430849
"18602","chr16.56480000.56485000","chr16.56585000.56590000",105000,15,0.006985546,56480000,56585000,56485000,56590000,"chr16",569004,2,13,8,23,"chr16",1,0.040436005625879
"18603","chr16.48315000.48320000","chr16.48385000.48390000",70000,31,9.429795e-10,48315000,48385000,48320000,48390000,"chr16",569016,1,7,5,13,"chr16",1,0.0472339428035631
"18604","chr16.48315000.48320000","chr16.48490000.48495000",175000,15,0.0002691406,48315000,48490000,48320000,48495000,"chr16",569033,1,11,5,17,"chr16",1,0.029887482419128
"18605","chr16.1990000.1995000","chr16.2010000.2015000",20000,49,9.194442e-08,1990000,2010000,1995000,2015000,"chr16",569037,1,5,5,11,"chr16",1,0.063173933427098
"18606","chr16.18815000.18820000","chr16.19525000.19530000",710000,11,3.66726e-06,18815000,19525000,18820000,19530000,"chr16",569046,4,7,8,19,"chr16",1,0.0244960150023441
"18607","chr16.4865000.4870000","chr16.5090000.5095000",225000,15,3.360924e-05,4865000,5090000,4870000,5095000,"chr16",569086,4,2,5,11,"chr16",1,0.0193389592123769
"18608","chr16.75250000.75255000","chr16.75460000.75465000",210000,13,0.001020499,75250000,75460000,75255000,75465000,"chr16",569091,0,3,3,6,"chr16",1,0.00914205344585091
"18609","chr16.56270000.56275000","chr16.56330000.56335000",60000,22,0.0008299364,56270000,56330000,56275000,56335000,"chr16",569096,0,3,1,4,"chr16",1,0.0103141115799344
"18610","chr16.29970000.29975000","chr16.30060000.30065000",90000,25,1.127897e-07,29970000,30060000,29975000,30065000,"chr16",569107,1,8,13,22,"chr16",1,0.0644631973745898
"18611","chr16.69760000.69765000","chr16.69885000.69890000",125000,14,0.007052003,69760000,69885000,69765000,69890000,"chr16",569111,6,22,15,43,"chr16",1,0.0705578996718237
"18612","chr16.4350000.4355000","chr16.4460000.4465000",110000,19,4.768935e-05,4350000,4460000,4355000,4465000,"chr16",569117,10,28,26,64,"chr16",1,0.142522269104548
"18613","chr16.24050000.24055000","chr16.24250000.24255000",200000,13,0.001459092,24050000,24250000,24055000,24255000,"chr16",569130,2,0,2,4,"chr16",1,0.00609470229723394
"18614","chr16.67815000.67820000","chr16.68085000.68090000",270000,13,0.000164917,67815000,68085000,67820000,68090000,"chr16",569149,2,10,9,21,"chr16",1,0.0319971870604782
"18615","chr16.31175000.31180000","chr16.31455000.31460000",280000,10,0.008706611,31175000,31455000,31180000,31460000,"chr16",569161,1,2,1,4,"chr16",1,0.0046882325363338
"18616","chr16.67630000.67635000","chr16.67665000.67670000",35000,33,1.894927e-05,67630000,67665000,67635000,67670000,"chr16",569167,1,1,1,3,"chr16",1,0.0116033755274262
"18617","chr16.67055000.67060000","chr16.67125000.67130000",70000,34,8.624306e-12,67055000,67125000,67060000,67130000,"chr16",569202,0,5,4,9,"chr16",1,0.0358649789029536
"18618","chr16.69835000.69840000","chr16.69850000.69855000",15000,38,0.00101401,69835000,69850000,69840000,69855000,"chr16",569230,1,8,12,21,"chr16",1,0.0935302390998594
"18619","chr16.84540000.84545000","chr16.84755000.84760000",215000,29,6.466683e-17,84540000,84755000,84545000,84760000,"chr16",569275,8,17,9,34,"chr16",1,0.115564932020628
"18620","chr16.57040000.57045000","chr16.57090000.57095000",50000,24,0.000868766,57040000,57090000,57045000,57095000,"chr16",569283,1,3,1,5,"chr16",1,0.0140646976090014
"18621","chr16.56580000.56585000","chr16.56630000.56635000",50000,35,2.595446e-09,56580000,56630000,56585000,56635000,"chr16",569310,4,8,6,18,"chr16",1,0.0738396624472574
"18622","chr16.22210000.22215000","chr16.22300000.22305000",90000,30,4.218164e-11,22210000,22300000,22215000,22305000,"chr16",569316,5,14,15,34,"chr16",1,0.119549929676512
"18623","chr16.84770000.84775000","chr16.85005000.85010000",235000,11,0.006524708,84770000,85005000,84775000,85010000,"chr16",569317,5,16,13,34,"chr16",1,0.0438349742147211
"18624","chr16.22695000.22700000","chr16.23070000.23075000",375000,9,0.008147175,22695000,23070000,22700000,23075000,"chr16",569323,0,0,6,6,"chr16",1,0.00632911392405063
"18625","chr16.56480000.56485000","chr16.56545000.56550000",65000,19,0.006054777,56480000,56545000,56485000,56550000,"chr16",569330,2,5,6,13,"chr16",1,0.0289498359118612
"18626","chr16.30890000.30895000","chr16.30925000.30930000",35000,30,0.0003137383,30890000,30925000,30895000,30930000,"chr16",569338,0,1,1,2,"chr16",1,0.0070323488045007
"18627","chr16.56135000.56140000","chr16.56270000.56275000",135000,16,0.0004578839,56135000,56270000,56140000,56275000,"chr16",569351,1,0,3,4,"chr16",1,0.00750117205813408
"18628","chr16.68760000.68765000","chr16.68785000.68790000",25000,34,0.003276528,68760000,68785000,68765000,68790000,"chr16",569369,2,3,7,12,"chr16",1,0.0478199718706048
"18629","chr16.4545000.4550000","chr16.4765000.4770000",220000,13,0.0007536085,4545000,4765000,4550000,4770000,"chr16",569370,9,11,14,34,"chr16",1,0.0518049695264885
"18630","chr16.66980000.66985000","chr16.67260000.67265000",280000,11,0.002355765,66980000,67260000,66985000,67265000,"chr16",569400,0,5,2,7,"chr16",1,0.00902484763244257
"18631","chr16.56555000.56560000","chr16.56575000.56580000",20000,80,4.866282e-25,56555000,56575000,56560000,56580000,"chr16",569438,4,9,18,31,"chr16",1,0.290670417252696
"18632","chr16.85330000.85335000","chr16.85820000.85825000",490000,8,0.009519015,85330000,85820000,85335000,85825000,"chr16",569447,0,4,1,5,"chr16",1,0.0046882325363338
"18633","chr16.48330000.48335000","chr16.48380000.48385000",50000,38,3.965911e-11,48330000,48380000,48335000,48385000,"chr16",569453,2,14,6,22,"chr16",1,0.0979840600093765
"18634","chr16.24990000.24995000","chr16.25125000.25130000",135000,14,0.004738125,24990000,25125000,24995000,25130000,"chr16",569470,1,8,7,16,"chr16",1,0.0262541022034693
"18635","chr16.85315000.85320000","chr16.85640000.85645000",325000,16,1.730498e-07,85315000,85640000,85320000,85645000,"chr16",569513,4,3,0,7,"chr16",1,0.0131270511017346
"18636","chr16.56220000.56225000","chr16.56270000.56275000",50000,27,4.45292e-05,56220000,56270000,56225000,56275000,"chr16",569528,1,4,4,9,"chr16",1,0.0284810126582278
"18637","chr16.31450000.31455000","chr16.31880000.31885000",430000,12,3.090539e-05,31450000,31880000,31455000,31885000,"chr16",569568,3,11,12,26,"chr16",1,0.0365682137834037
"18638","chr16.89310000.89315000","chr16.89560000.89565000",250000,12,0.001216873,89310000,89560000,89315000,89565000,"chr16",569574,1,4,3,8,"chr16",1,0.0112517580872011
"18639","chr16.66700000.66705000","chr16.66740000.66745000",40000,33,1.559916e-06,66700000,66740000,66705000,66745000,"chr16",569598,4,11,10,25,"chr16",1,0.0966947960618847
"18640","chr16.18815000.18820000","chr16.19085000.19090000",270000,14,3.398352e-05,18815000,19085000,18820000,19090000,"chr16",569615,7,20,15,42,"chr16",1,0.0689170182841069
"18641","chr16.3110000.3115000","chr16.3155000.3160000",45000,25,0.0009921198,3110000,3155000,3115000,3160000,"chr16",569619,1,9,5,15,"chr16",1,0.0439521800281294
"18642","chr16.67055000.67060000","chr16.67190000.67195000",135000,14,0.004738125,67055000,67190000,67060000,67195000,"chr16",569628,2,11,7,20,"chr16",1,0.0328176277543366
"18643","chr16.75230000.75235000","chr16.75250000.75255000",20000,51,1.247379e-08,75230000,75250000,75235000,75255000,"chr16",569635,0,3,3,6,"chr16",1,0.0358649789029536
"18644","chr16.46695000.46700000","chr16.46870000.46875000",175000,15,0.0002691406,46695000,46870000,46700000,46875000,"chr16",569636,17,21,20,58,"chr16",1,0.10196905766526
"18645","chr16.3995000.4000000","chr16.4090000.4095000",95000,19,0.000188706,3995000,4090000,4e+06,4095000,"chr16",569645,3,10,12,25,"chr16",1,0.0556727613689639
"18646","chr16.74720000.74725000","chr16.74995000.75000000",275000,13,0.0001427014,74720000,74995000,74725000,7.5e+07,"chr16",569646,1,13,14,28,"chr16",1,0.0426629160806376
"18647","chr16.46695000.46700000","chr16.46890000.46895000",195000,13,0.00170678,46695000,46890000,46700000,46895000,"chr16",569703,6,15,21,42,"chr16",1,0.0639943741209564
"18648","chr16.50100000.50105000","chr16.50245000.50250000",145000,16,0.0002850268,50100000,50245000,50105000,50250000,"chr16",569709,1,4,3,8,"chr16",1,0.0150023441162682
"18649","chr16.15520000.15525000","chr16.15650000.15655000",130000,14,0.005748029,15520000,15650000,15525000,15655000,"chr16",569715,0,3,4,7,"chr16",1,0.0114861697140178
"18650","chr16.53090000.53095000","chr16.53550000.53555000",460000,9,0.002990822,53090000,53550000,53095000,53555000,"chr16",569735,2,6,4,12,"chr16",1,0.0126582278481013
"18651","chr16.19815000.19820000","chr16.19845000.19850000",30000,33,0.0003364571,19815000,19845000,19820000,19850000,"chr16",569783,6,12,10,28,"chr16",1,0.108298171589311
"18652","chr16.19780000.19785000","chr16.19845000.19850000",65000,34,4.458983e-11,19780000,19845000,19785000,19850000,"chr16",569787,7,12,10,29,"chr16",1,0.115564932020628
"18653","chr16.19005000.19010000","chr16.19065000.19070000",60000,35,5.950403e-11,19005000,19065000,19010000,19070000,"chr16",569798,1,8,9,18,"chr16",1,0.0738396624472574
"18654","chr16.24040000.24045000","chr16.24515000.24520000",475000,16,3.148961e-09,24040000,24515000,24045000,24520000,"chr16",569807,2,9,7,18,"chr16",1,0.0337552742616034
"18655","chr16.30595000.30600000","chr16.30630000.30635000",35000,54,3.422062e-17,30595000,30630000,30600000,30635000,"chr16",569845,4,22,6,32,"chr16",1,0.20253164556962
"18656","chr16.30900000.30905000","chr16.30925000.30930000",25000,48,1.602273e-08,30900000,30925000,30905000,30930000,"chr16",569858,0,1,1,2,"chr16",1,0.0112517580872011
"18657","chr16.4050000.4055000","chr16.4285000.4290000",235000,14,0.0001078269,4050000,4285000,4055000,4290000,"chr16",569873,2,5,10,17,"chr16",1,0.0278949835911861
"18658","chr16.24325000.24330000","chr16.24355000.24360000",30000,30,0.003383739,24325000,24355000,24330000,24360000,"chr16",569879,7,6,6,19,"chr16",1,0.0668073136427567
"18659","chr16.75495000.75500000","chr16.75550000.75555000",55000,50,6.527316e-21,75495000,75550000,75500000,75555000,"chr16",569898,3,7,4,14,"chr16",1,0.0820440693858415
"18660","chr16.14400000.14405000","chr16.14525000.14530000",125000,22,1.719402e-07,14400000,14525000,14405000,14530000,"chr16",569901,0,2,5,7,"chr16",1,0.0180496952648851
"18661","chr16.85325000.85330000","chr16.85640000.85645000",315000,15,1.559916e-06,85325000,85640000,85330000,85645000,"chr16",569907,2,3,5,10,"chr16",1,0.0175808720112518
"18662","chr16.74740000.74745000","chr16.74900000.74905000",160000,16,0.0001362096,74740000,74900000,74745000,74905000,"chr16",569918,5,7,13,25,"chr16",1,0.046882325363338
"18663","chr16.67000000.67005000","chr16.67180000.67185000",180000,12,0.009034139,6.7e+07,67180000,67005000,67185000,"chr16",569925,2,3,0,5,"chr16",1,0.0070323488045007
"18664","chr16.56550000.56555000","chr16.56590000.56595000",40000,29,0.0001014801,56550000,56590000,56555000,56595000,"chr16",569942,3,9,12,24,"chr16",1,0.0815752461322082
"18665","chr16.4460000.4465000","chr16.4520000.4525000",60000,23,0.0003104352,4460000,4520000,4465000,4525000,"chr16",569993,2,9,14,25,"chr16",1,0.0673933427097984
"18666","chr16.19585000.19590000","chr16.19865000.19870000",280000,17,1.163896e-07,19585000,19865000,19590000,19870000,"chr16",570030,2,12,11,25,"chr16",1,0.0498124706985466
"18667","chr16.29875000.29880000","chr16.30010000.30015000",135000,14,0.004738125,29875000,30010000,29880000,30015000,"chr16",570048,6,18,29,53,"chr16",1,0.086966713548992
"18668","chr16.24050000.24055000","chr16.24490000.24495000",440000,14,5.229329e-07,24050000,24490000,24055000,24495000,"chr16",570067,2,14,15,31,"chr16",1,0.0508673230192218
"18669","chr16.67025000.67030000","chr16.67185000.67190000",160000,20,3.311685e-07,67025000,67185000,67030000,67190000,"chr16",570072,0,7,3,10,"chr16",1,0.023441162681669
"18670","chr16.56555000.56560000","chr16.56735000.56740000",180000,18,2.461731e-06,56555000,56735000,56560000,56740000,"chr16",570080,1,6,4,11,"chr16",1,0.0232067510548523
"18671","chr16.23795000.23800000","chr16.24035000.24040000",240000,12,0.00160782,23795000,24035000,23800000,24040000,"chr16",570113,2,11,9,22,"chr16",1,0.0309423347398031
"18672","chr16.84545000.84550000","chr16.84750000.84755000",205000,14,0.0003181686,84545000,84750000,84550000,84755000,"chr16",570148,4,6,6,16,"chr16",1,0.0262541022034693
"18673","chr16.2480000.2485000","chr16.2530000.2535000",50000,25,0.0003364571,2480000,2530000,2485000,2535000,"chr16",570149,4,6,7,17,"chr16",1,0.0498124706985466
"18674","chr16.89300000.89305000","chr16.89560000.89565000",260000,17,2.626857e-07,89300000,89560000,89305000,89565000,"chr16",570152,2,8,7,17,"chr16",1,0.0338724800750117
"18675","chr16.69795000.69800000","chr16.69890000.69895000",95000,21,1.51995e-05,69795000,69890000,69800000,69895000,"chr16",570161,3,9,13,25,"chr16",1,0.0615330520393812
"18676","chr16.48270000.48275000","chr16.48330000.48335000",60000,23,0.0003104352,48270000,48330000,48275000,48335000,"chr16",570164,5,13,11,29,"chr16",1,0.0781762775433661
"18677","chr16.9415000.9420000","chr16.10240000.10245000",825000,7,0.003855657,9415000,10240000,9420000,10245000,"chr16",570178,1,4,7,12,"chr16",1,0.00984528832630099
"18678","chr16.50080000.50085000","chr16.50245000.50250000",165000,14,0.001486871,50080000,50245000,50085000,50250000,"chr16",570179,1,4,3,8,"chr16",1,0.0131270511017346
"18679","chr16.89395000.89400000","chr16.89555000.89560000",160000,23,1.92722e-09,89395000,89555000,89400000,89560000,"chr16",570186,2,16,13,31,"chr16",1,0.08356774496015
"18680","chr16.19905000.19910000","chr16.20385000.20390000",480000,9,0.002356525,19905000,20385000,19910000,20390000,"chr16",570206,2,15,8,25,"chr16",1,0.0263713080168776
"18681","chr16.480000.485000","chr16.510000.515000",30000,32,0.0007615578,480000,510000,485000,515000,"chr16",570219,8,8,10,26,"chr16",1,0.0975152367557431
"18682","chr16.19110000.19115000","chr16.19525000.19530000",415000,12,4.024478e-05,19110000,19525000,19115000,19530000,"chr16",570223,4,7,8,19,"chr16",1,0.0267229254571027
"18683","chr16.66980000.66985000","chr16.67100000.67105000",120000,21,1.224673e-06,66980000,67100000,66985000,67105000,"chr16",570268,2,4,13,19,"chr16",1,0.0467651195499297
"18684","chr16.24035000.24040000","chr16.24500000.24505000",465000,9,0.002807622,24035000,24500000,24040000,24505000,"chr16",570293,2,13,11,26,"chr16",1,0.0274261603375527
"18685","chr16.19600000.19605000","chr16.19905000.19910000",305000,15,2.083591e-06,19600000,19905000,19605000,19910000,"chr16",570297,5,8,13,26,"chr16",1,0.0457102672292546
"18686","chr16.69815000.69820000","chr16.69890000.69895000",75000,18,0.004475095,69815000,69890000,69820000,69895000,"chr16",570319,5,12,15,32,"chr16",1,0.0675105485232067
"18687","chr16.22005000.22010000","chr16.22190000.22195000",185000,32,1.466543e-18,22005000,22190000,22010000,22195000,"chr16",570342,1,3,4,8,"chr16",1,0.0300046882325363
"18688","chr16.74725000.74730000","chr16.74810000.74815000",85000,18,0.00160782,74725000,74810000,74730000,74815000,"chr16",570358,6,9,7,22,"chr16",1,0.0464135021097046
"18689","chr16.84300000.84305000","chr16.84505000.84510000",205000,14,0.0003181686,84300000,84505000,84305000,84510000,"chr16",570402,0,12,5,17,"chr16",1,0.0278949835911861
"18690","chr16.30650000.30655000","chr16.30810000.30815000",160000,14,0.001784119,30650000,30810000,30655000,30815000,"chr16",570413,11,6,18,35,"chr16",1,0.0574308485700891
"18691","chr16.66810000.66815000","chr16.66830000.66835000",20000,35,0.007147375,66810000,66830000,66815000,66835000,"chr16",570416,9,15,16,40,"chr16",1,0.164088138771683
"18692","chr16.30110000.30115000","chr16.30375000.30380000",265000,11,0.00326571,30110000,30375000,30115000,30380000,"chr16",570513,4,5,11,20,"chr16",1,0.0257852789498359
"18693","chr16.67070000.67075000","chr16.67170000.67175000",100000,17,0.001213745,67070000,67170000,67075000,67175000,"chr16",570522,3,16,17,36,"chr16",1,0.0717299578059072
"18694","chr16.74720000.74725000","chr16.74895000.74900000",175000,16,6.59274e-05,74720000,74895000,74725000,74900000,"chr16",570527,1,5,8,14,"chr16",1,0.0262541022034693
"18695","chr16.15055000.15060000","chr16.15705000.15710000",650000,8,0.002265146,15055000,15705000,15060000,15710000,"chr16",570530,3,9,13,25,"chr16",1,0.023441162681669
"18696","chr16.81195000.81200000","chr16.81210000.81215000",15000,49,9.194442e-08,81195000,81210000,81200000,81215000,"chr16",570561,0,12,6,18,"chr16",1,0.10337552742616
"18697","chr16.56550000.56555000","chr16.56625000.56630000",75000,30,1.176519e-09,56550000,56625000,56555000,56630000,"chr16",570570,3,9,12,24,"chr16",1,0.0843881856540084
"18698","chr16.30065000.30070000","chr16.30395000.30400000",330000,10,0.003848083,30065000,30395000,30070000,30400000,"chr16",570594,3,2,9,14,"chr16",1,0.0164088138771683
"18699","chr16.67845000.67850000","chr16.68020000.68025000",175000,14,0.0009921198,67845000,68020000,67850000,68025000,"chr16",570601,1,11,1,13,"chr16",1,0.0213314580403188
"18700","chr16.23930000.23935000","chr16.23950000.23955000",20000,41,0.0001115839,23930000,23950000,23935000,23955000,"chr16",570622,1,3,2,6,"chr16",1,0.0288326300984529
"18701","chr16.2045000.2050000","chr16.2190000.2195000",145000,20,9.029676e-07,2045000,2190000,2050000,2195000,"chr16",570623,0,7,11,18,"chr16",1,0.0421940928270042
"18702","chr16.66550000.66555000","chr16.66690000.66695000",140000,17,9.805497e-05,66550000,66690000,66555000,66695000,"chr16",570627,2,13,5,20,"chr16",1,0.0398499765588373
"18703","chr16.69440000.69445000","chr16.69740000.69745000",300000,16,3.787882e-07,69440000,69740000,69445000,69745000,"chr16",570653,4,11,7,22,"chr16",1,0.0412564463197375
"18704","chr16.69835000.69840000","chr16.69930000.69935000",95000,30,1.534175e-11,69835000,69930000,69840000,69935000,"chr16",570654,8,8,15,31,"chr16",1,0.109001406469761
"18705","chr16.24070000.24075000","chr16.24515000.24520000",445000,9,0.003560016,24070000,24515000,24075000,24520000,"chr16",570656,7,13,22,42,"chr16",1,0.0443037974683544
"18706","chr16.3730000.3735000","chr16.3995000.4000000",265000,14,3.953766e-05,3730000,3995000,3735000,4e+06,"chr16",570672,2,7,5,14,"chr16",1,0.0229723394280356
"18707","chr16.56555000.56560000","chr16.56600000.56605000",45000,26,0.0003958408,56555000,56600000,56560000,56605000,"chr16",570740,6,24,24,54,"chr16",1,0.164556962025316
"18708","chr16.3665000.3670000","chr16.4360000.4365000",695000,7,0.008423379,3665000,4360000,3670000,4365000,"chr16",570742,2,15,15,32,"chr16",1,0.0262541022034693
"18709","chr16.48330000.48335000","chr16.48350000.48355000",20000,93,3.957422e-34,48330000,48350000,48335000,48355000,"chr16",570750,1,8,4,13,"chr16",1,0.141701828410689
"18710","chr16.75010000.75015000","chr16.75115000.75120000",105000,15,0.006985546,75010000,75115000,75015000,75120000,"chr16",570772,3,10,2,15,"chr16",1,0.0263713080168776
"18711","chr16.69855000.69860000","chr16.69930000.69935000",75000,19,0.001697679,69855000,69930000,69860000,69935000,"chr16",570779,8,16,8,32,"chr16",1,0.0712611345522738
"18712","chr16.67015000.67020000","chr16.67170000.67175000",155000,13,0.006789433,67015000,67170000,67020000,67175000,"chr16",570813,3,16,17,36,"chr16",1,0.0548523206751055
"18713","chr16.84265000.84270000","chr16.84290000.84295000",25000,38,0.0001757114,84265000,84290000,84270000,84295000,"chr16",570819,3,10,11,24,"chr16",1,0.106891701828411
"18714","chr16.11640000.11645000","chr16.11945000.11950000",305000,12,0.0003258618,11640000,11945000,11645000,11950000,"chr16",570826,7,15,16,38,"chr16",1,0.0534458509142053
"18715","chr16.69750000.69755000","chr16.69770000.69775000",20000,42,5.030701e-05,69750000,69770000,69755000,69775000,"chr16",570841,7,19,16,42,"chr16",1,0.206751054852321
"18716","chr16.27710000.27715000","chr16.28090000.28095000",380000,9,0.007688005,27710000,28090000,27715000,28095000,"chr16",570852,6,14,15,35,"chr16",1,0.0369198312236287
"18717","chr16.4545000.4550000","chr16.5005000.5010000",460000,10,0.000616686,4545000,5005000,4550000,5010000,"chr16",570884,4,8,9,21,"chr16",1,0.0246132208157525
"18718","chr16.30075000.30080000","chr16.30375000.30380000",300000,11,0.00160782,30075000,30375000,30080000,30380000,"chr16",570893,4,15,8,27,"chr16",1,0.0348101265822785
"18719","chr16.84545000.84550000","chr16.84645000.84650000",100000,20,3.307904e-05,84545000,84645000,84550000,84650000,"chr16",570920,3,5,8,16,"chr16",1,0.0375058602906704
"18720","chr16.53745000.53750000","chr16.53840000.53845000",95000,16,0.005057701,53745000,53840000,53750000,53845000,"chr16",570928,2,3,5,10,"chr16",1,0.0187529301453352
"18721","chr16.19705000.19710000","chr16.19865000.19870000",160000,25,4.917881e-11,19705000,19865000,19710000,19870000,"chr16",570933,2,1,2,5,"chr16",1,0.0146507266760431
"18722","chr16.19745000.19750000","chr16.19870000.19875000",125000,14,0.007052003,19745000,19870000,19750000,19875000,"chr16",570949,2,11,6,19,"chr16",1,0.0311767463666198
"18723","chr16.4780000.4785000","chr16.5070000.5075000",290000,13,9.75083e-05,4780000,5070000,4785000,5075000,"chr16",570999,4,5,7,16,"chr16",1,0.0243788091889358
"18724","chr16.22220000.22225000","chr16.22295000.22300000",75000,23,1.952718e-05,22220000,22295000,22225000,22300000,"chr16",571003,5,14,20,39,"chr16",1,0.105133614627286
"18725","chr16.14525000.14530000","chr16.14630000.14635000",105000,17,0.0008278942,14525000,14630000,14530000,14635000,"chr16",571031,0,2,5,7,"chr16",1,0.0139474917955931
"18726","chr16.56135000.56140000","chr16.56210000.56215000",75000,18,0.004475095,56135000,56210000,56140000,56215000,"chr16",571033,2,0,3,5,"chr16",1,0.0105485232067511
"18727","chr16.56460000.56465000","chr16.56480000.56485000",20000,59,1.721557e-12,56460000,56480000,56465000,56485000,"chr16",571057,2,13,6,21,"chr16",1,0.14521800281294
"18728","chr16.56555000.56560000","chr16.56630000.56635000",75000,31,2.508222e-10,56555000,56630000,56560000,56635000,"chr16",571084,6,24,24,54,"chr16",1,0.19620253164557
"18729","chr16.14400000.14405000","chr16.14555000.14560000",155000,19,2.269253e-06,14400000,14555000,14405000,14560000,"chr16",571105,1,10,8,19,"chr16",1,0.0423112986404126
"18730","chr16.56545000.56550000","chr16.56625000.56630000",80000,46,4.532864e-23,56545000,56625000,56550000,56630000,"chr16",571147,2,5,6,13,"chr16",1,0.0700890764181903
"18731","chr16.77720000.77725000","chr16.78000000.78005000",280000,13,0.0001246171,77720000,7.8e+07,77725000,78005000,"chr16",571158,1,1,1,3,"chr16",1,0.00457102672292546
"18732","chr16.19780000.19785000","chr16.19850000.19855000",70000,27,2.859474e-07,19780000,19850000,19785000,19855000,"chr16",571181,5,12,13,30,"chr16",1,0.0949367088607595
"18733","chr16.19705000.19710000","chr16.19765000.19770000",60000,21,0.002125293,19705000,19765000,19710000,19770000,"chr16",571182,2,1,2,5,"chr16",1,0.0123066104078762
"18734","chr16.19530000.19535000","chr16.19905000.19910000",375000,11,0.0004307706,19530000,19905000,19535000,19910000,"chr16",571183,4,13,13,30,"chr16",1,0.0386779184247539
"18735","chr16.23080000.23085000","chr16.23130000.23135000",50000,25,0.0003364571,23080000,23130000,23085000,23135000,"chr16",571190,1,2,3,6,"chr16",1,0.0175808720112518
"18736","chr16.19680000.19685000","chr16.19880000.19885000",200000,12,0.004984849,19680000,19880000,19685000,19885000,"chr16",571212,3,4,6,13,"chr16",1,0.0182841068917018
"18737","chr16.58390000.58395000","chr16.58515000.58520000",125000,14,0.007052003,58390000,58515000,58395000,58520000,"chr16",571216,0,4,4,8,"chr16",1,0.0131270511017346
"18738","chr16.27720000.27725000","chr16.27755000.27760000",35000,29,0.0007397556,27720000,27755000,27725000,27760000,"chr16",571218,0,4,2,6,"chr16",1,0.020393811533052
"18739","chr16.56985000.56990000","chr16.57270000.57275000",285000,10,0.007886236,56985000,57270000,56990000,57275000,"chr16",571254,2,10,5,17,"chr16",1,0.0199249882794187
"18740","chr16.67015000.67020000","chr16.67125000.67130000",110000,26,1.245042e-09,67015000,67125000,67020000,67130000,"chr16",571261,0,5,4,9,"chr16",1,0.0274261603375527
"18741","chr16.67025000.67030000","chr16.67200000.67205000",175000,14,0.0009921198,67025000,67200000,67030000,67205000,"chr16",571263,0,6,3,9,"chr16",1,0.0147679324894515
"18742","chr16.84150000.84155000","chr16.84175000.84180000",25000,62,7.235237e-16,84150000,84175000,84155000,84180000,"chr16",571275,1,11,5,17,"chr16",1,0.123534927332396
"18743","chr16.56545000.56550000","chr16.56660000.56665000",115000,21,1.909011e-06,56545000,56660000,56550000,56665000,"chr16",571276,2,5,6,13,"chr16",1,0.0319971870604782
"18744","chr16.23800000.23805000","chr16.23955000.23960000",155000,13,0.006789433,23800000,23955000,23805000,23960000,"chr16",571308,3,15,15,33,"chr16",1,0.05028129395218
"18745","chr16.19755000.19760000","chr16.19845000.19850000",90000,16,0.007362843,19755000,19845000,19760000,19850000,"chr16",571311,4,12,10,26,"chr16",1,0.0487576183778715
"18746","chr16.75470000.75475000","chr16.75590000.75595000",120000,17,0.0003011612,75470000,75590000,75475000,75595000,"chr16",571314,3,14,11,28,"chr16",1,0.0557899671823722
"18747","chr16.30920000.30925000","chr16.31880000.31885000",960000,6,0.009939404,30920000,31880000,30925000,31885000,"chr16",571317,3,11,12,26,"chr16",1,0.0182841068917018
"18748","chr16.19770000.19775000","chr16.19835000.19840000",65000,20,0.002419056,19770000,19835000,19775000,19840000,"chr16",571335,4,5,7,16,"chr16",1,0.0375058602906704
"18749","chr16.75470000.75475000","chr16.75495000.75500000",25000,56,1.694082e-12,75470000,75495000,75475000,75500000,"chr16",571353,3,7,4,14,"chr16",1,0.0918893577121425
"18750","chr16.89410000.89415000","chr16.89475000.89480000",65000,19,0.006054777,89410000,89475000,89415000,89480000,"chr16",571373,6,4,12,22,"chr16",1,0.0489920300046882
"18751","chr16.2010000.2015000","chr16.2190000.2195000",180000,13,0.002838356,2010000,2190000,2015000,2195000,"chr16",571387,2,7,11,20,"chr16",1,0.0304735114861697
"18752","chr16.89325000.89330000","chr16.89565000.89570000",240000,12,0.00160782,89325000,89565000,89330000,89570000,"chr16",571401,6,13,20,39,"chr16",1,0.0548523206751055
"18753","chr16.30400000.30405000","chr16.30630000.30635000",230000,11,0.007287736,30400000,30630000,30405000,30635000,"chr16",571405,9,26,26,61,"chr16",1,0.0786451007969995
"18754","chr16.14335000.14340000","chr16.14555000.14560000",220000,12,0.002771159,14335000,14555000,14340000,14560000,"chr16",571424,1,7,11,19,"chr16",1,0.0267229254571027
"18755","chr16.3365000.3370000","chr16.3455000.3460000",90000,16,0.007362843,3365000,3455000,3370000,3460000,"chr16",571436,0,6,5,11,"chr16",1,0.0206282231598687
"18756","chr16.9340000.9345000","chr16.10215000.10220000",875000,7,0.002845933,9340000,10215000,9345000,10220000,"chr16",571442,0,3,1,4,"chr16",1,0.00328176277543366
"18757","chr16.67535000.67540000","chr16.68060000.68065000",525000,10,0.0002603319,67535000,68060000,67540000,68065000,"chr16",571453,0,8,3,11,"chr16",1,0.012892639474918
"18758","chr16.75495000.75500000","chr16.75590000.75595000",95000,28,4.549136e-10,75495000,75590000,75500000,75595000,"chr16",571464,3,7,4,14,"chr16",1,0.0459446788560713
"18759","chr16.11950000.11955000","chr16.12000000.12005000",50000,36,6.686718e-10,11950000,1.2e+07,11955000,12005000,"chr16",571474,3,12,17,32,"chr16",1,0.135021097046413
"18760","chr16.69850000.69855000","chr16.69935000.69940000",85000,25,2.584229e-07,69850000,69935000,69855000,69940000,"chr16",571477,1,13,9,23,"chr16",1,0.0673933427097984
"18761","chr16.11640000.11645000","chr16.11675000.11680000",35000,73,2.00491e-31,11640000,11675000,11645000,11680000,"chr16",571481,0,2,1,3,"chr16",1,0.0256680731364276
"18762","chr16.56545000.56550000","chr16.56730000.56735000",185000,24,4.013746e-11,56545000,56730000,56550000,56735000,"chr16",571524,2,3,1,6,"chr16",1,0.0168776371308017
"18763","chr16.46820000.46825000","chr16.46910000.46915000",90000,16,0.007362843,46820000,46910000,46825000,46915000,"chr16",571536,3,6,5,14,"chr16",1,0.0262541022034693
"18764","chr16.5030000.5035000","chr16.5070000.5075000",40000,26,0.001528327,5030000,5070000,5035000,5075000,"chr16",571546,3,5,4,12,"chr16",1,0.0365682137834037
"18765","chr16.75050000.75055000","chr16.75070000.75075000",20000,37,0.002020718,75050000,75070000,75055000,75075000,"chr16",571626,7,6,17,30,"chr16",1,0.130098452883263
"18766","chr16.22205000.22210000","chr16.22225000.22230000",20000,39,0.0005060861,22205000,22225000,22210000,22230000,"chr16",571633,7,12,13,32,"chr16",1,0.146272855133615
"18767","chr16.67025000.67030000","chr16.67190000.67195000",165000,14,0.001486871,67025000,67190000,67030000,67195000,"chr16",571640,6,15,19,40,"chr16",1,0.0656352555086732
"18768","chr16.22680000.22685000","chr16.22695000.22700000",15000,41,0.0001115839,22680000,22695000,22685000,22700000,"chr16",571659,5,6,2,13,"chr16",1,0.0624706985466479
"18769","chr16.22640000.22645000","chr16.22680000.22685000",40000,24,0.007287736,22640000,22680000,22645000,22685000,"chr16",571660,1,4,2,7,"chr16",1,0.019690576652602
"18770","chr16.31105000.31110000","chr16.31460000.31465000",355000,11,0.0006051072,31105000,31460000,31110000,31465000,"chr16",571668,7,11,10,28,"chr16",1,0.0360993905297703
"18771","chr16.66690000.66695000","chr16.66870000.66875000",180000,14,0.0008267645,66690000,66870000,66695000,66875000,"chr16",571675,12,21,19,52,"chr16",1,0.0853258321612752
"18772","chr16.31175000.31180000","chr16.31880000.31885000",705000,9,0.0002357857,31175000,31880000,31180000,31885000,"chr16",571681,3,11,12,26,"chr16",1,0.0274261603375527
"18773","chr16.69815000.69820000","chr16.69935000.69940000",120000,25,2.050868e-09,69815000,69935000,69820000,69940000,"chr16",571693,4,13,9,26,"chr16",1,0.0761837787154243
"18774","chr16.15950000.15955000","chr16.16230000.16235000",280000,12,0.000579144,15950000,16230000,15955000,16235000,"chr16",571710,1,4,2,7,"chr16",1,0.00984528832630099
"18775","chr16.17405000.17410000","chr16.17555000.17560000",150000,16,0.0002221557,17405000,17555000,17410000,17560000,"chr16",571728,0,5,2,7,"chr16",1,0.0131270511017346
"18776","chr16.56545000.56550000","chr16.56635000.56640000",90000,51,1.515073e-29,56545000,56635000,56550000,56640000,"chr16",571747,2,5,6,13,"chr16",1,0.0777074542897328
"18777","chr16.19085000.19090000","chr16.19525000.19530000",440000,15,6.595491e-08,19085000,19525000,19090000,19530000,"chr16",571756,4,7,8,19,"chr16",1,0.0334036568213783
"18778","chr16.3770000.3775000","chr16.3880000.3885000",110000,15,0.00520277,3770000,3880000,3775000,3885000,"chr16",571757,3,8,9,20,"chr16",1,0.0351617440225035
"18779","chr16.30445000.30450000","chr16.30595000.30600000",150000,22,2.443219e-08,30445000,30595000,30450000,30600000,"chr16",571758,4,22,6,32,"chr16",1,0.0825128926394749
"18780","chr16.68900000.68905000","chr16.69155000.69160000",255000,17,3.227953e-07,68900000,69155000,68905000,69160000,"chr16",571772,5,12,11,28,"chr16",1,0.0557899671823722
"18781","chr16.66740000.66745000","chr16.66895000.66900000",155000,16,0.0001747775,66740000,66895000,66745000,66900000,"chr16",571794,4,11,10,25,"chr16",1,0.046882325363338
"18782","chr16.67720000.67725000","chr16.68245000.68250000",525000,8,0.006804865,67720000,68245000,67725000,68250000,"chr16",571809,1,4,4,9,"chr16",1,0.00843881856540084
"18783","chr16.9135000.9140000","chr16.9225000.9230000",90000,19,0.0003181686,9135000,9225000,9140000,9230000,"chr16",571858,7,16,13,36,"chr16",1,0.080168776371308
"18784","chr16.56460000.56465000","chr16.56550000.56555000",90000,17,0.002771159,56460000,56550000,56465000,56555000,"chr16",571900,2,9,6,17,"chr16",1,0.0338724800750117
"18785","chr16.57375000.57380000","chr16.57400000.57405000",25000,37,0.0003842759,57375000,57400000,57380000,57405000,"chr16",571905,2,7,4,13,"chr16",1,0.056375996249414
"18786","chr16.70390000.70395000","chr16.70435000.70440000",45000,25,0.0009921198,70390000,70435000,70395000,70440000,"chr16",571915,2,9,2,13,"chr16",1,0.0380918893577121
"18787","chr16.30060000.30065000","chr16.30130000.30135000",70000,18,0.007698675,30060000,30130000,30065000,30135000,"chr16",571931,1,12,14,27,"chr16",1,0.0569620253164557
"18788","chr16.23070000.23075000","chr16.23145000.23150000",75000,26,3.897993e-07,23070000,23145000,23075000,23150000,"chr16",571943,0,0,2,2,"chr16",1,0.00609470229723394
"18789","chr16.3770000.3775000","chr16.4330000.4335000",560000,9,0.0009731324,3770000,4330000,3775000,4335000,"chr16",571961,5,7,6,18,"chr16",1,0.0189873417721519
"18790","chr16.66695000.66700000","chr16.66865000.66870000",170000,13,0.003989425,66695000,66865000,66700000,66870000,"chr16",571963,4,21,12,37,"chr16",1,0.056375996249414
"18791","chr16.25055000.25060000","chr16.25105000.25110000",50000,22,0.004984849,25055000,25105000,25060000,25110000,"chr16",571980,0,11,6,17,"chr16",1,0.0438349742147211
"18792","chr16.31090000.31095000","chr16.31455000.31460000",365000,10,0.002310262,31090000,31455000,31095000,31460000,"chr16",571989,1,2,1,4,"chr16",1,0.0046882325363338
"18793","chr16.30060000.30065000","chr16.30400000.30405000",340000,11,0.0007751206,30060000,30400000,30065000,30405000,"chr16",572002,1,12,14,27,"chr16",1,0.0348101265822785
"18794","chr16.30875000.30880000","chr16.30920000.30925000",45000,28,5.56616e-05,30875000,30920000,30880000,30925000,"chr16",572005,7,15,15,37,"chr16",1,0.121425222691045
"18795","chr16.69420000.69425000","chr16.69460000.69465000",40000,24,0.007287736,69420000,69460000,69425000,69465000,"chr16",572041,3,7,12,22,"chr16",1,0.0618846694796062
"18796","chr16.56520000.56525000","chr16.56545000.56550000",25000,37,0.0003842759,56520000,56545000,56525000,56550000,"chr16",572054,2,5,6,13,"chr16",1,0.056375996249414
"18797","chr16.56580000.56585000","chr16.56635000.56640000",55000,24,0.0003137383,56580000,56635000,56585000,56640000,"chr16",572063,3,8,6,17,"chr16",1,0.0478199718706048
"18798","chr16.68485000.68490000","chr16.68885000.68890000",400000,10,0.001429702,68485000,68885000,68490000,68890000,"chr16",572115,2,20,15,37,"chr16",1,0.0433661509610877
"18799","chr16.68885000.68890000","chr16.68910000.68915000",25000,36,0.0008186653,68885000,68910000,68890000,68915000,"chr16",572124,2,20,15,37,"chr16",1,0.156118143459916
"18800","chr16.8620000.8625000","chr16.8720000.8725000",100000,15,0.009543218,8620000,8720000,8625000,8725000,"chr16",572140,3,13,9,25,"chr16",1,0.0439521800281294
"18801","chr16.69795000.69800000","chr16.69885000.69890000",90000,21,2.810996e-05,69795000,69885000,69800000,69890000,"chr16",572187,3,9,13,25,"chr16",1,0.0615330520393812
"18802","chr16.75810000.75815000","chr16.76480000.76485000",670000,11,5.795587e-06,75810000,76480000,75815000,76485000,"chr16",572252,0,3,1,4,"chr16",1,0.00515705578996718
"18803","chr16.11620000.11625000","chr16.11680000.11685000",60000,20,0.005216722,11620000,11680000,11625000,11685000,"chr16",572282,4,9,7,20,"chr16",1,0.046882325363338
"18804","chr16.67535000.67540000","chr16.67670000.67675000",135000,19,7.901077e-06,67535000,67670000,67540000,67675000,"chr16",572310,1,8,3,12,"chr16",1,0.0267229254571027
"18805","chr16.30060000.30065000","chr16.30375000.30380000",315000,11,0.001200367,30060000,30375000,30065000,30380000,"chr16",572347,1,12,14,27,"chr16",1,0.0348101265822785
"18806","chr16.57115000.57120000","chr16.57275000.57280000",160000,14,0.001784119,57115000,57275000,57120000,57280000,"chr16",572375,5,9,17,31,"chr16",1,0.0508673230192218
"18807","chr16.84010000.84015000","chr16.84095000.84100000",85000,18,0.00160782,84010000,84095000,84015000,84100000,"chr16",572395,0,6,2,8,"chr16",1,0.0168776371308017
"18808","chr16.15590000.15595000","chr16.15640000.15645000",50000,25,0.0003364571,15590000,15640000,15595000,15645000,"chr16",572436,0,7,11,18,"chr16",1,0.0527426160337553
"18809","chr16.69795000.69800000","chr16.69850000.69855000",55000,21,0.004984849,69795000,69850000,69800000,69855000,"chr16",572447,1,9,12,22,"chr16",1,0.0541490857946554
"18810","chr16.30430000.30435000","chr16.30595000.30600000",165000,13,0.00479582,30430000,30595000,30435000,30600000,"chr16",572455,4,22,6,32,"chr16",1,0.0487576183778715
"18811","chr16.11620000.11625000","chr16.11675000.11680000",55000,31,9.373038e-08,11620000,11675000,11625000,11680000,"chr16",572476,0,2,1,3,"chr16",1,0.0109001406469761
"18812","chr16.15870000.15875000","chr16.16230000.16235000",360000,10,0.002460549,15870000,16230000,15875000,16235000,"chr16",572507,1,4,7,12,"chr16",1,0.0140646976090014
"18813","chr16.69795000.69800000","chr16.69880000.69885000",85000,19,0.0005472008,69795000,69880000,69800000,69885000,"chr16",572522,2,9,11,22,"chr16",1,0.0489920300046882
"18814","chr16.4325000.4330000","chr16.4360000.4365000",35000,48,2.437314e-13,4325000,4360000,4330000,4365000,"chr16",572543,4,9,14,27,"chr16",1,0.151898734177215
"18815","chr16.12065000.12070000","chr16.12110000.12115000",45000,23,0.005303841,12065000,12110000,12070000,12115000,"chr16",572567,3,13,6,22,"chr16",1,0.0593061415846226
"18816","chr16.74740000.74745000","chr16.74895000.74900000",155000,30,3.74326e-15,74740000,74895000,74745000,74900000,"chr16",572570,1,5,8,14,"chr16",1,0.0492264416315049
"18817","chr16.22220000.22225000","chr16.22300000.22305000",80000,33,2.688151e-12,22220000,22300000,22225000,22305000,"chr16",572585,5,14,15,34,"chr16",1,0.131504922644163
"18818","chr16.29595000.29600000","chr16.30335000.30340000",740000,23,1.431408e-20,29595000,30335000,29600000,30340000,"chr16",572596,1,16,8,25,"chr16",1,0.0673933427097984
"18819","chr16.23500000.23505000","chr16.23535000.23540000",35000,27,0.003560016,23500000,23535000,23505000,23540000,"chr16",572597,1,3,0,4,"chr16",1,0.0126582278481013
"18820","chr16.4585000.4590000","chr16.4665000.4670000",80000,20,0.0003225332,4585000,4665000,4590000,4670000,"chr16",572617,3,9,10,22,"chr16",1,0.0515705578996718
"18821","chr16.57620000.57625000","chr16.58000000.58005000",380000,9,0.007688005,57620000,5.8e+07,57625000,58005000,"chr16",572619,2,4,3,9,"chr16",1,0.00949367088607595
"18822","chr16.15520000.15525000","chr16.15705000.15710000",185000,19,3.552888e-07,15520000,15705000,15525000,15710000,"chr16",572620,0,3,4,7,"chr16",1,0.0155883731833099
"18823","chr16.67070000.67075000","chr16.67100000.67105000",30000,61,6.683058e-19,67070000,67100000,67075000,67105000,"chr16",572627,2,4,13,19,"chr16",1,0.135841537740272
"18824","chr16.21705000.21710000","chr16.22695000.22700000",990000,6,0.008023593,21705000,22695000,21710000,22700000,"chr16",572633,5,24,18,47,"chr16",1,0.0330520393811533
"18825","chr16.75515000.75520000","chr16.75550000.75555000",35000,45,1.507985e-11,75515000,75550000,75520000,75555000,"chr16",572636,5,17,17,39,"chr16",1,0.205696202531646
"18826","chr16.56555000.56560000","chr16.56585000.56590000",30000,49,1.412996e-11,56555000,56585000,56560000,56590000,"chr16",572646,6,24,24,54,"chr16",1,0.310126582278481
"18827","chr16.66980000.66985000","chr16.67510000.67515000",530000,8,0.006524077,66980000,67510000,66985000,67515000,"chr16",572666,9,14,20,43,"chr16",1,0.0403187998124707
"18828","chr16.67010000.67015000","chr16.67150000.67155000",140000,14,0.003855856,67010000,67150000,67015000,67155000,"chr16",572692,3,9,8,20,"chr16",1,0.0328176277543366
"18829","chr16.87775000.87780000","chr16.87790000.87795000",15000,36,0.003855657,87775000,87790000,87780000,87795000,"chr16",572694,6,18,23,47,"chr16",1,0.19831223628692
"18830","chr16.69815000.69820000","chr16.69835000.69840000",20000,38,0.00101401,69815000,69835000,69820000,69840000,"chr16",572706,10,8,15,33,"chr16",1,0.146976090014065
"18831","chr16.21600000.21605000","chr16.22195000.22200000",595000,8,0.003589638,21600000,22195000,21605000,22200000,"chr16",572707,0,6,2,8,"chr16",1,0.00750117205813408
"18832","chr16.58385000.58390000","chr16.58510000.58515000",125000,16,0.0007615578,58385000,58510000,58390000,58515000,"chr16",572711,1,4,4,9,"chr16",1,0.0168776371308017
"18833","chr16.12085000.12090000","chr16.12160000.12165000",75000,21,0.0002042379,12085000,12160000,12090000,12165000,"chr16",572714,0,5,3,8,"chr16",1,0.019690576652602
"18834","chr16.75515000.75520000","chr16.75645000.75650000",130000,15,0.001906977,75515000,75645000,75520000,75650000,"chr16",572732,5,17,14,36,"chr16",1,0.0632911392405063
"18835","chr16.24100000.24105000","chr16.24515000.24520000",415000,9,0.005080469,24100000,24515000,24105000,24520000,"chr16",572748,1,6,5,12,"chr16",1,0.0126582278481013
"18836","chr16.56585000.56590000","chr16.56735000.56740000",150000,18,1.377944e-05,56585000,56735000,56590000,56740000,"chr16",572759,1,6,4,11,"chr16",1,0.0232067510548523
"18837","chr16.68905000.68910000","chr16.69310000.69315000",405000,10,0.001322475,68905000,69310000,68910000,69315000,"chr16",572764,7,21,16,44,"chr16",1,0.0515705578996718
"18838","chr16.30130000.30135000","chr16.30375000.30380000",245000,12,0.001404086,30130000,30375000,30135000,30380000,"chr16",572767,5,15,20,40,"chr16",1,0.0562587904360056
"18839","chr16.21985000.21990000","chr16.22195000.22200000",210000,17,2.568773e-06,21985000,22195000,21990000,22200000,"chr16",572796,4,11,14,29,"chr16",1,0.0577824660103141
"18840","chr16.30690000.30695000","chr16.30925000.30930000",235000,15,2.234386e-05,30690000,30925000,30695000,30930000,"chr16",572835,0,1,1,2,"chr16",1,0.00351617440225035
"18841","chr16.68420000.68425000","chr16.68885000.68890000",465000,9,0.002807622,68420000,68885000,68425000,68890000,"chr16",572906,2,4,5,11,"chr16",1,0.0116033755274262
"18842","chr16.74520000.74525000","chr16.74620000.74625000",100000,18,0.000385307,74520000,74620000,74525000,74625000,"chr16",572927,1,5,5,11,"chr16",1,0.0232067510548523
"18843","chr16.70355000.70360000","chr16.70520000.70525000",165000,13,0.00479582,70355000,70520000,70360000,70525000,"chr16",572937,13,28,26,67,"chr16",1,0.102086263478669
"18844","chr16.69795000.69800000","chr16.69930000.69935000",135000,19,7.901077e-06,69795000,69930000,69800000,69935000,"chr16",572964,3,9,13,25,"chr16",1,0.0556727613689639
"18845","chr16.29710000.29715000","chr16.30030000.30035000",320000,10,0.004475095,29710000,30030000,29715000,30035000,"chr16",572969,2,10,6,18,"chr16",1,0.0210970464135021
"18846","chr16.22680000.22685000","chr16.22705000.22710000",25000,36,0.0008186653,22680000,22705000,22685000,22710000,"chr16",572974,5,6,2,13,"chr16",1,0.0548523206751055
"18847","chr16.75280000.75285000","chr16.75300000.75305000",20000,42,5.030701e-05,75280000,75300000,75285000,75305000,"chr16",572992,14,15,29,58,"chr16",1,0.285513361462729
"18848","chr16.87350000.87355000","chr16.87430000.87435000",80000,18,0.002622682,87350000,87430000,87355000,87435000,"chr16",573008,2,6,4,12,"chr16",1,0.0253164556962025
"18849","chr16.74740000.74745000","chr16.74810000.74815000",70000,31,9.429795e-10,74740000,74810000,74745000,74815000,"chr16",573038,9,9,7,25,"chr16",1,0.0908345053914674
"18850","chr16.21155000.21160000","chr16.21580000.21585000",425000,13,5.180913e-06,21155000,21580000,21160000,21585000,"chr16",573045,2,5,4,11,"chr16",1,0.0167604313173933
"18851","chr16.67000000.67005000","chr16.67125000.67130000",125000,19,1.515884e-05,6.7e+07,67125000,67005000,67130000,"chr16",573071,0,3,0,3,"chr16",1,0.00668073136427567
"18852","chr16.23930000.23935000","chr16.23955000.23960000",25000,40,3.424475e-05,23930000,23955000,23935000,23960000,"chr16",573076,1,3,2,6,"chr16",1,0.0281293952180028
"18853","chr16.57355000.57360000","chr16.57385000.57390000",30000,31,0.001642127,57355000,57385000,57360000,57390000,"chr16",573079,2,6,7,15,"chr16",1,0.0545007032348805
"18854","chr16.19600000.19605000","chr16.19835000.19840000",235000,13,0.0004617798,19600000,19835000,19605000,19840000,"chr16",573103,4,8,12,24,"chr16",1,0.0365682137834037
"18855","chr16.11680000.11685000","chr16.11735000.11740000",55000,22,0.002068492,11680000,11735000,11685000,11740000,"chr16",573104,3,9,7,19,"chr16",1,0.0489920300046882
"18856","chr16.5020000.5025000","chr16.5065000.5070000",45000,23,0.005303841,5020000,5065000,5025000,5070000,"chr16",573132,3,7,13,23,"chr16",1,0.0620018752930145
"18857","chr16.23820000.23825000","chr16.24010000.24015000",190000,18,1.417169e-06,23820000,24010000,23825000,24015000,"chr16",573134,4,8,3,15,"chr16",1,0.0316455696202532
"18858","chr16.21580000.21585000","chr16.21705000.21710000",125000,15,0.002390746,21580000,21705000,21585000,21710000,"chr16",573135,12,24,24,60,"chr16",1,0.105485232067511
"18859","chr16.19765000.19770000","chr16.19845000.19850000",80000,23,8.836018e-06,19765000,19845000,19770000,19850000,"chr16",573164,5,12,10,27,"chr16",1,0.0727848101265823
"18860","chr16.30530000.30535000","chr16.30630000.30635000",100000,16,0.003511948,30530000,30630000,30535000,30635000,"chr16",573186,3,3,5,11,"chr16",1,0.0206282231598687
"18861","chr16.56625000.56630000","chr16.56735000.56740000",110000,20,1.245263e-05,56625000,56735000,56630000,56740000,"chr16",573187,1,6,4,11,"chr16",1,0.0257852789498359
"18862","chr16.89395000.89400000","chr16.89440000.89445000",45000,24,0.002355765,89395000,89440000,89400000,89445000,"chr16",573193,3,7,10,20,"chr16",1,0.0562587904360056
"18863","chr16.52125000.52130000","chr16.53090000.53095000",965000,6,0.009572192,52125000,53090000,52130000,53095000,"chr16",573201,2,1,3,6,"chr16",1,0.00421940928270042
"18864","chr16.22215000.22220000","chr16.22300000.22305000",85000,28,2.902015e-09,22215000,22300000,22220000,22305000,"chr16",573220,5,10,7,22,"chr16",1,0.0721987810595406
"18865","chr16.30375000.30380000","chr16.30445000.30450000",70000,18,0.007698675,30375000,30445000,30380000,30450000,"chr16",573221,5,15,20,40,"chr16",1,0.0843881856540084
"18866","chr16.69855000.69860000","chr16.69935000.69940000",80000,20,0.0003225332,69855000,69935000,69860000,69940000,"chr16",573247,4,13,8,25,"chr16",1,0.0586029067041725
"18867","chr16.53840000.53845000","chr16.53860000.53865000",20000,58,5.624987e-12,53840000,53860000,53845000,53865000,"chr16",573316,1,5,2,8,"chr16",1,0.0543834974214721
"18868","chr16.69420000.69425000","chr16.69740000.69745000",320000,14,8.324614e-06,69420000,69740000,69425000,69745000,"chr16",573337,4,11,7,22,"chr16",1,0.0360993905297703
"18869","chr16.75230000.75235000","chr16.75265000.75270000",35000,32,5.022089e-05,75230000,75265000,75235000,75270000,"chr16",573354,4,25,10,39,"chr16",1,0.146272855133615
"18870","chr16.46830000.46835000","chr16.46855000.46860000",25000,37,0.0003842759,46830000,46855000,46835000,46860000,"chr16",573363,4,10,7,21,"chr16",1,0.0910689170182841
"18871","chr16.25030000.25035000","chr16.25050000.25055000",20000,36,0.003855657,25030000,25050000,25035000,25055000,"chr16",573369,2,7,8,17,"chr16",1,0.0717299578059072
"18872","chr16.89380000.89385000","chr16.89580000.89585000",200000,17,4.205171e-06,89380000,89580000,89385000,89585000,"chr16",573372,2,1,1,4,"chr16",1,0.00796999531176746
"18873","chr16.81535000.81540000","chr16.81600000.81605000",65000,22,0.0003359441,81535000,81600000,81540000,81605000,"chr16",573385,0,8,6,14,"chr16",1,0.0360993905297703
"18874","chr16.465000.470000","chr16.545000.550000",80000,19,0.0009533379,465000,545000,470000,550000,"chr16",573412,3,9,6,18,"chr16",1,0.040084388185654
"18875","chr16.19765000.19770000","chr16.19885000.19890000",120000,17,0.0003011612,19765000,19885000,19770000,19890000,"chr16",573438,5,20,28,53,"chr16",1,0.105602437880919
"18876","chr16.19585000.19590000","chr16.19845000.19850000",260000,17,2.626857e-07,19585000,19845000,19590000,19850000,"chr16",573443,7,12,10,29,"chr16",1,0.0577824660103141
"18877","chr16.31005000.31010000","chr16.31880000.31885000",875000,8,0.0004270547,31005000,31880000,31010000,31885000,"chr16",573461,3,3,5,11,"chr16",1,0.0103141115799344
"18878","chr16.29970000.29975000","chr16.30375000.30380000",405000,9,0.005748029,29970000,30375000,29975000,30380000,"chr16",573497,1,8,13,22,"chr16",1,0.0232067510548523
"18879","chr16.53100000.53105000","chr16.53205000.53210000",105000,18,0.000255429,53100000,53205000,53105000,53210000,"chr16",573504,0,5,6,11,"chr16",1,0.0232067510548523
"18880","chr16.31175000.31180000","chr16.31450000.31455000",275000,11,0.002617108,31175000,31450000,31180000,31455000,"chr16",573509,6,21,28,55,"chr16",1,0.0709095171120488
"18881","chr16.67845000.67850000","chr16.68085000.68090000",240000,11,0.005750317,67845000,68085000,67850000,68090000,"chr16",573513,2,10,9,21,"chr16",1,0.0270745428973277
"18882","chr16.71845000.71850000","chr16.71865000.71870000",20000,48,2.451113e-07,71845000,71865000,71850000,71870000,"chr16",573526,1,4,2,7,"chr16",1,0.0393811533052039
"18883","chr16.68530000.68535000","chr16.69155000.69160000",625000,8,0.002777131,68530000,69155000,68535000,69160000,"chr16",573544,5,12,11,28,"chr16",1,0.0262541022034693
"18884","chr16.23820000.23825000","chr16.24045000.24050000",225000,11,0.008194837,23820000,24045000,23825000,24050000,"chr16",573583,11,20,9,40,"chr16",1,0.0515705578996718
"18885","chr16.30805000.30810000","chr16.30875000.30880000",70000,20,0.00119393,30805000,30875000,30810000,30880000,"chr16",573592,7,15,15,37,"chr16",1,0.0867323019221753
"18886","chr16.30430000.30435000","chr16.30655000.30660000",225000,12,0.002390808,30430000,30655000,30435000,30660000,"chr16",573618,0,4,1,5,"chr16",1,0.0070323488045007
"18887","chr16.83995000.84000000","chr16.84095000.84100000",100000,20,3.307904e-05,83995000,84095000,8.4e+07,84100000,"chr16",573622,0,3,2,5,"chr16",1,0.0117205813408345
"18888","chr16.75195000.75200000","chr16.75515000.75520000",320000,13,4.671592e-05,75195000,75515000,75200000,75520000,"chr16",573626,7,5,15,27,"chr16",1,0.0411392405063291
"18889","chr16.53090000.53095000","chr16.53155000.53160000",65000,39,1.22482e-14,53090000,53155000,53095000,53160000,"chr16",573636,2,6,4,12,"chr16",1,0.0548523206751055
"18890","chr16.69740000.69745000","chr16.69760000.69765000",20000,54,5.193385e-10,69740000,69760000,69745000,69765000,"chr16",573638,4,11,7,22,"chr16",1,0.139240506329114
"18891","chr16.48315000.48320000","chr16.48350000.48355000",35000,46,3.930611e-12,48315000,48350000,48320000,48355000,"chr16",573639,1,8,4,13,"chr16",1,0.0700890764181903
"18892","chr16.67070000.67075000","chr16.67105000.67110000",35000,34,6.941566e-06,67070000,67105000,67075000,67110000,"chr16",573643,6,15,28,49,"chr16",1,0.195264885138303
"18893","chr16.66565000.66570000","chr16.66635000.66640000",70000,19,0.003143703,66565000,66635000,66570000,66640000,"chr16",573653,0,3,3,6,"chr16",1,0.0133614627285513
"18894","chr16.70330000.70335000","chr16.70560000.70565000",230000,11,0.007287736,70330000,70560000,70335000,70565000,"chr16",573672,9,20,11,40,"chr16",1,0.0515705578996718
"18895","chr16.68280000.68285000","chr16.68340000.68345000",60000,25,3.578083e-05,68280000,68340000,68285000,68345000,"chr16",573705,3,12,10,25,"chr16",1,0.0732536333802157
"18896","chr16.53870000.53875000","chr16.53900000.53905000",30000,29,0.006792525,53870000,53900000,53875000,53905000,"chr16",573714,1,5,0,6,"chr16",1,0.020393811533052
"18897","chr16.11545000.11550000","chr16.11735000.11740000",190000,12,0.006761307,11545000,11735000,11550000,11740000,"chr16",573720,3,4,15,22,"chr16",1,0.0309423347398031
"18898","chr16.75255000.75260000","chr16.75430000.75435000",175000,13,0.003383739,75255000,75430000,75260000,75435000,"chr16",573770,3,17,16,36,"chr16",1,0.0548523206751055
"18899","chr16.75230000.75235000","chr16.75470000.75475000",240000,11,0.005750317,75230000,75470000,75235000,75475000,"chr16",573800,3,22,20,45,"chr16",1,0.0580168776371308
"18900","chr16.14525000.14530000","chr16.14600000.14605000",75000,19,0.001697679,14525000,14600000,14530000,14605000,"chr16",573805,0,2,5,7,"chr16",1,0.0155883731833099
"18901","chr16.55955000.55960000","chr16.56210000.56215000",255000,14,5.392712e-05,55955000,56210000,55960000,56215000,"chr16",573806,2,4,1,7,"chr16",1,0.0114861697140178
"18902","chr16.19635000.19640000","chr16.19715000.19720000",80000,18,0.002622682,19635000,19715000,19640000,19720000,"chr16",573807,0,8,6,14,"chr16",1,0.029535864978903
"18903","chr16.56580000.56585000","chr16.56625000.56630000",45000,27,0.0001518733,56580000,56625000,56585000,56630000,"chr16",573835,4,8,6,18,"chr16",1,0.0569620253164557
"18904","chr16.74770000.74775000","chr16.74810000.74815000",40000,26,0.001528327,74770000,74810000,74775000,74815000,"chr16",573854,2,9,7,18,"chr16",1,0.0548523206751055
"18905","chr16.56580000.56585000","chr16.56725000.56730000",145000,15,0.0009921198,56580000,56725000,56585000,56730000,"chr16",573862,4,8,6,18,"chr16",1,0.0316455696202532
"18906","chr16.69760000.69765000","chr16.69795000.69800000",35000,42,7.342577e-10,69760000,69795000,69765000,69800000,"chr16",573920,3,9,13,25,"chr16",1,0.123066104078762
"18907","chr16.14395000.14400000","chr16.14630000.14635000",235000,18,1.310135e-07,14395000,14630000,14400000,14635000,"chr16",573995,2,10,9,21,"chr16",1,0.0443037974683544
"18908","chr16.23450000.23455000","chr16.23525000.23530000",75000,19,0.001697679,23450000,23525000,23455000,23530000,"chr16",574010,6,14,13,33,"chr16",1,0.0734880450070323
"18909","chr16.75465000.75470000","chr16.75495000.75500000",30000,41,1.643364e-07,75465000,75495000,75470000,75500000,"chr16",574074,3,7,4,14,"chr16",1,0.0672761368963901
"18910","chr16.69440000.69445000","chr16.69715000.69720000",275000,10,0.009543218,69440000,69715000,69445000,69720000,"chr16",574075,10,15,8,33,"chr16",1,0.0386779184247539
"18911","chr16.10000000.10005000","chr16.10025000.10030000",25000,36,0.0008186653,1e+07,10025000,10005000,10030000,"chr16",574109,0,2,1,3,"chr16",1,0.0126582278481013
"18912","chr16.48315000.48320000","chr16.48330000.48335000",15000,36,0.003855657,48315000,48330000,48320000,48335000,"chr16",574114,1,11,5,17,"chr16",1,0.0717299578059072
"18913","chr16.19705000.19710000","chr16.19755000.19760000",50000,28,1.502586e-05,19705000,19755000,19710000,19760000,"chr16",574188,2,1,2,5,"chr16",1,0.0164088138771683
"18914","chr16.69185000.69190000","chr16.69335000.69340000",150000,18,1.377944e-05,69185000,69335000,69190000,69340000,"chr16",574212,0,9,5,14,"chr16",1,0.029535864978903
"18915","chr16.30805000.30810000","chr16.30870000.30875000",65000,19,0.006054777,30805000,30870000,30810000,30875000,"chr16",574220,5,11,10,26,"chr16",1,0.0578996718237225
"18916","chr16.69750000.69755000","chr16.69795000.69800000",45000,39,8.129187e-11,69750000,69795000,69755000,69800000,"chr16",574244,3,9,13,25,"chr16",1,0.114275668073136
"18917","chr16.19715000.19720000","chr16.19905000.19910000",190000,12,0.006761307,19715000,19905000,19720000,19910000,"chr16",574256,0,13,6,19,"chr16",1,0.0267229254571027
"18918","chr16.24725000.24730000","chr16.24845000.24850000",120000,15,0.003074534,24725000,24845000,24730000,24850000,"chr16",574268,1,10,5,16,"chr16",1,0.0281293952180028
"18919","chr16.3980000.3985000","chr16.4270000.4275000",290000,13,9.75083e-05,3980000,4270000,3985000,4275000,"chr16",574282,2,7,5,14,"chr16",1,0.0213314580403188
"18920","chr16.68885000.68890000","chr16.68905000.68910000",20000,48,2.451113e-07,68885000,68905000,68890000,68910000,"chr16",574291,2,20,15,37,"chr16",1,0.208157524613221
"18921","chr16.29825000.29830000","chr16.30030000.30035000",205000,16,1.623345e-05,29825000,30030000,29830000,30035000,"chr16",574321,10,27,8,45,"chr16",1,0.0843881856540084
"18922","chr16.30445000.30450000","chr16.30530000.30535000",85000,33,7.466075e-13,30445000,30530000,30450000,30535000,"chr16",574322,3,3,5,11,"chr16",1,0.0425457102672293
"18923","chr16.71925000.71930000","chr16.72125000.72130000",200000,12,0.004984849,71925000,72125000,71930000,72130000,"chr16",574329,1,0,6,7,"chr16",1,0.00984528832630099
"18924","chr16.23070000.23075000","chr16.23140000.23145000",70000,21,0.0004203593,23070000,23140000,23075000,23145000,"chr16",574354,0,0,3,3,"chr16",1,0.00738396624472574
"18925","chr16.11640000.11645000","chr16.11740000.11745000",100000,20,3.307904e-05,11640000,11740000,11645000,11745000,"chr16",574366,3,10,6,19,"chr16",1,0.0445382090951711
"18926","chr16.22005000.22010000","chr16.22195000.22200000",190000,24,2.646354e-11,22005000,22195000,22010000,22200000,"chr16",574375,4,11,20,35,"chr16",1,0.0984528832630098
"18927","chr16.75310000.75315000","chr16.75400000.75405000",90000,21,2.810996e-05,75310000,75400000,75315000,75405000,"chr16",574378,5,17,18,40,"chr16",1,0.0984528832630098
"18928","chr16.27265000.27270000","chr16.28090000.28095000",825000,7,0.003855657,27265000,28090000,27270000,28095000,"chr16",574379,7,14,14,35,"chr16",1,0.0287154242850445
"18929","chr16.48385000.48390000","chr16.48620000.48625000",235000,11,0.006524708,48385000,48620000,48390000,48625000,"chr16",574386,3,7,11,21,"chr16",1,0.0270745428973277
"18930","chr16.30570000.30575000","chr16.30650000.30655000",80000,17,0.00687557,30570000,30650000,30575000,30655000,"chr16",574441,2,6,10,18,"chr16",1,0.0358649789029536
"18931","chr16.50250000.50255000","chr16.50835000.50840000",585000,8,0.003915828,50250000,50835000,50255000,50840000,"chr16",574461,3,2,7,12,"chr16",1,0.0112517580872011
"18932","chr16.21985000.21990000","chr16.22190000.22195000",205000,19,1.096424e-07,21985000,22190000,21990000,22195000,"chr16",574498,1,3,4,8,"chr16",1,0.0178152836380684
"18933","chr16.69845000.69850000","chr16.69885000.69890000",40000,30,3.782234e-05,69845000,69885000,69850000,69890000,"chr16",574500,10,23,21,54,"chr16",1,0.189873417721519
"18934","chr16.67025000.67030000","chr16.67070000.67075000",45000,25,0.0009921198,67025000,67070000,67030000,67075000,"chr16",574509,6,17,19,42,"chr16",1,0.123066104078762
"18935","chr16.24990000.24995000","chr16.25105000.25110000",115000,16,0.001325007,24990000,25105000,24995000,25110000,"chr16",574516,0,11,6,17,"chr16",1,0.0318799812470699
"18936","chr16.66695000.66700000","chr16.66725000.66730000",30000,41,1.643364e-07,66695000,66725000,66700000,66730000,"chr16",574552,9,21,18,48,"chr16",1,0.230661040787623
"18937","chr16.56575000.56580000","chr16.56635000.56640000",60000,20,0.005216722,56575000,56635000,56580000,56640000,"chr16",574576,3,9,10,22,"chr16",1,0.0515705578996718
"18938","chr16.53580000.53585000","chr16.53735000.53740000",155000,13,0.006789433,53580000,53735000,53585000,53740000,"chr16",574599,0,7,4,11,"chr16",1,0.0167604313173933
"18939","chr16.69465000.69470000","chr16.69690000.69695000",225000,14,0.000151492,69465000,69690000,69470000,69695000,"chr16",574609,1,4,8,13,"chr16",1,0.0213314580403188
"18940","chr16.3665000.3670000","chr16.3960000.3965000",295000,10,0.006766618,3665000,3960000,3670000,3965000,"chr16",574619,2,9,5,16,"chr16",1,0.0187529301453352
"18941","chr16.66710000.66715000","chr16.66740000.66745000",30000,29,0.006792525,66710000,66740000,66715000,66745000,"chr16",574633,4,11,10,25,"chr16",1,0.0849742147210502
"18942","chr16.19635000.19640000","chr16.19780000.19785000",145000,14,0.003211912,19635000,19780000,19640000,19785000,"chr16",574683,4,8,6,18,"chr16",1,0.029535864978903
"18943","chr16.19065000.19070000","chr16.19375000.19380000",310000,10,0.005216722,19065000,19375000,19070000,19380000,"chr16",574686,4,15,16,35,"chr16",1,0.0410220346929208
"18944","chr16.89485000.89490000","chr16.89505000.89510000",20000,42,5.030701e-05,89485000,89505000,89490000,89510000,"chr16",574709,4,6,4,14,"chr16",1,0.0689170182841069
"18945","chr16.30370000.30375000","chr16.30425000.30430000",55000,23,0.0008278942,30370000,30425000,30375000,30430000,"chr16",574725,3,15,16,34,"chr16",1,0.0916549460853258
"18946","chr16.30445000.30450000","chr16.30655000.30660000",210000,13,0.001020499,30445000,30655000,30450000,30660000,"chr16",574783,0,4,1,5,"chr16",1,0.00761837787154243
"18947","chr16.56555000.56560000","chr16.56625000.56630000",70000,25,3.961175e-06,56555000,56625000,56560000,56630000,"chr16",574785,4,24,24,52,"chr16",1,0.152367557430849
"18948","chr16.24610000.24615000","chr16.24700000.24705000",90000,18,0.0009731324,24610000,24700000,24615000,24705000,"chr16",574789,5,13,7,25,"chr16",1,0.0527426160337553
"18949","chr16.22640000.22645000","chr16.22675000.22680000",35000,30,0.0003137383,22640000,22675000,22645000,22680000,"chr16",574793,0,3,1,4,"chr16",1,0.0140646976090014
"18950","chr16.69845000.69850000","chr16.69890000.69895000",45000,30,6.700448e-06,69845000,69890000,69850000,69895000,"chr16",574799,5,12,15,32,"chr16",1,0.112517580872011
"18951","chr16.3570000.3575000","chr16.4350000.4355000",780000,7,0.005049184,3570000,4350000,3575000,4355000,"chr16",574820,11,28,33,72,"chr16",1,0.0590717299578059
"18952","chr16.66750000.66755000","chr16.66895000.66900000",145000,13,0.009543218,66750000,66895000,66755000,66900000,"chr16",574843,1,4,3,8,"chr16",1,0.0121894045944679
"18953","chr16.46890000.46895000","chr16.46945000.46950000",55000,29,1.177812e-06,46890000,46945000,46895000,46950000,"chr16",574852,6,15,21,42,"chr16",1,0.142756680731364
"18954","chr16.22350000.22355000","chr16.22675000.22680000",325000,10,0.004119022,22350000,22675000,22355000,22680000,"chr16",574913,0,3,1,4,"chr16",1,0.0046882325363338
"18955","chr16.69060000.69065000","chr16.69090000.69095000",30000,30,0.003383739,69060000,69090000,69065000,69095000,"chr16",574933,6,27,20,53,"chr16",1,0.186357243319269
"18956","chr16.67070000.67075000","chr16.67160000.67165000",90000,24,4.831331e-07,67070000,67160000,67075000,67165000,"chr16",574952,2,3,2,7,"chr16",1,0.019690576652602
"18957","chr16.56520000.56525000","chr16.56735000.56740000",215000,16,1.045578e-05,56520000,56735000,56525000,56740000,"chr16",574982,1,6,4,11,"chr16",1,0.0206282231598687
"18958","chr16.67720000.67725000","chr16.67800000.67805000",80000,20,0.0003225332,67720000,67800000,67725000,67805000,"chr16",574984,10,14,11,35,"chr16",1,0.0820440693858415
"18959","chr16.30870000.30875000","chr16.30925000.30930000",55000,24,0.0003137383,30870000,30925000,30875000,30930000,"chr16",575001,0,1,1,2,"chr16",1,0.00562587904360056
"18960","chr16.84725000.84730000","chr16.85025000.85030000",300000,11,0.00160782,84725000,85025000,84730000,85030000,"chr16",575025,0,4,1,5,"chr16",1,0.00644631973745898
"18961","chr16.71925000.71930000","chr16.71960000.71965000",35000,44,5.620749e-11,71925000,71960000,71930000,71965000,"chr16",575052,1,9,13,23,"chr16",1,0.118612283169245
"18962","chr16.53280000.53285000","chr16.53500000.53505000",220000,13,0.0007536085,53280000,53500000,53285000,53505000,"chr16",575100,0,3,1,4,"chr16",1,0.00609470229723394
"18963","chr16.21985000.21990000","chr16.22205000.22210000",220000,11,0.009396117,21985000,22205000,21990000,22210000,"chr16",575153,5,12,13,30,"chr16",1,0.0386779184247539
"18964","chr16.84540000.84545000","chr16.84645000.84650000",105000,16,0.002460549,84540000,84645000,84545000,84650000,"chr16",575163,3,5,8,16,"chr16",1,0.0300046882325363
"18965","chr16.19745000.19750000","chr16.19860000.19865000",115000,18,0.0001166476,19745000,19860000,19750000,19865000,"chr16",575198,3,4,5,12,"chr16",1,0.0253164556962025
"18966","chr16.69420000.69425000","chr16.69770000.69775000",350000,13,2.418673e-05,69420000,69770000,69425000,69775000,"chr16",575259,6,18,16,40,"chr16",1,0.0609470229723394
"18967","chr16.3665000.3670000","chr16.3935000.3940000",270000,11,0.002913646,3665000,3935000,3670000,3940000,"chr16",575264,2,15,12,29,"chr16",1,0.0373886544772621
"18968","chr16.4780000.4785000","chr16.5005000.5010000",225000,12,0.002390808,4780000,5005000,4785000,5010000,"chr16",575280,4,8,9,21,"chr16",1,0.029535864978903
"18969","chr16.48290000.48295000","chr16.48455000.48460000",165000,13,0.00479582,48290000,48455000,48295000,48460000,"chr16",575331,1,6,6,13,"chr16",1,0.0198077824660103
"18970","chr16.12065000.12070000","chr16.12085000.12090000",20000,40,0.0002420863,12065000,12085000,12070000,12090000,"chr16",575338,4,13,15,32,"chr16",1,0.150023441162682
"18971","chr16.89430000.89435000","chr16.89580000.89585000",150000,14,0.002622682,89430000,89580000,89435000,89585000,"chr16",575352,2,1,1,4,"chr16",1,0.00656352555086732
"18972","chr16.29925000.29930000","chr16.29970000.29975000",45000,30,6.700448e-06,29925000,29970000,29930000,29975000,"chr16",575363,1,8,13,22,"chr16",1,0.0773558368495077
"18973","chr16.46705000.46710000","chr16.46855000.46860000",150000,14,0.002622682,46705000,46855000,46710000,46860000,"chr16",575411,4,19,17,40,"chr16",1,0.0656352555086732
"18974","chr16.67840000.67845000","chr16.67890000.67895000",50000,22,0.004984849,67840000,67890000,67845000,67895000,"chr16",575422,2,4,5,11,"chr16",1,0.0283638068448195
"18975","chr16.24050000.24055000","chr16.24505000.24510000",455000,13,2.870022e-06,24050000,24505000,24055000,24510000,"chr16",575423,2,14,15,31,"chr16",1,0.0472339428035631
"18976","chr16.69845000.69850000","chr16.69880000.69885000",35000,27,0.003560016,69845000,69880000,69850000,69885000,"chr16",575454,2,14,11,27,"chr16",1,0.0854430379746835
"18977","chr16.48350000.48355000","chr16.48385000.48390000",35000,26,0.007362843,48350000,48385000,48355000,48390000,"chr16",575459,1,7,4,12,"chr16",1,0.0365682137834037
"18978","chr16.30050000.30055000","chr16.30375000.30380000",325000,10,0.004119022,30050000,30375000,30055000,30380000,"chr16",575484,5,15,20,40,"chr16",1,0.046882325363338
"18979","chr16.84670000.84675000","chr16.84735000.84740000",65000,19,0.006054777,84670000,84735000,84675000,84740000,"chr16",575486,3,7,10,20,"chr16",1,0.0445382090951711
"18980","chr16.10000000.10005000","chr16.10055000.10060000",55000,21,0.004984849,1e+07,10055000,10005000,10060000,"chr16",575500,0,3,3,6,"chr16",1,0.0147679324894515
"18981","chr16.56545000.56550000","chr16.56615000.56620000",70000,31,9.429795e-10,56545000,56615000,56550000,56620000,"chr16",575540,2,5,6,13,"chr16",1,0.0472339428035631
"18982","chr16.11640000.11645000","chr16.11735000.11740000",95000,23,9.827602e-07,11640000,11735000,11645000,11740000,"chr16",575565,3,15,16,34,"chr16",1,0.0916549460853258
"18983","chr16.71845000.71850000","chr16.71925000.71930000",80000,29,1.749499e-09,71845000,71925000,71850000,71930000,"chr16",575573,1,4,2,7,"chr16",1,0.023792780121894
"18984","chr16.84545000.84550000","chr16.84670000.84675000",125000,26,2.153767e-10,84545000,84670000,84550000,84675000,"chr16",575602,3,13,9,25,"chr16",1,0.0761837787154243
"18985","chr16.89470000.89475000","chr16.89490000.89495000",20000,38,0.00101401,89470000,89490000,89475000,89495000,"chr16",575641,6,12,14,32,"chr16",1,0.142522269104548
"18986","chr16.29875000.29880000","chr16.29970000.29975000",95000,29,8.459972e-11,29875000,29970000,29880000,29975000,"chr16",575681,1,8,13,22,"chr16",1,0.0747773089545241
"18987","chr16.56590000.56595000","chr16.56615000.56620000",25000,37,0.0003842759,56590000,56615000,56595000,56620000,"chr16",575694,5,11,22,38,"chr16",1,0.164791373652133
"18988","chr16.67720000.67725000","chr16.67890000.67895000",170000,13,0.003989425,67720000,67890000,67725000,67895000,"chr16",575697,7,14,11,32,"chr16",1,0.0487576183778715
"18989","chr16.22225000.22230000","chr16.22300000.22305000",75000,29,5.300869e-09,22225000,22300000,22230000,22305000,"chr16",575744,5,14,15,34,"chr16",1,0.115564932020628
"18990","chr16.56590000.56595000","chr16.56735000.56740000",145000,14,0.003211912,56590000,56735000,56595000,56740000,"chr16",575760,1,6,4,11,"chr16",1,0.0180496952648851
"18991","chr16.12545000.12550000","chr16.12770000.12775000",225000,11,0.008194837,12545000,12770000,12550000,12775000,"chr16",575762,1,9,10,20,"chr16",1,0.0257852789498359
"18992","chr16.24685000.24690000","chr16.25105000.25110000",420000,9,0.004814394,24685000,25105000,24690000,25110000,"chr16",575772,0,11,6,17,"chr16",1,0.0179324894514768
"18993","chr16.25055000.25060000","chr16.25125000.25130000",70000,18,0.007698675,25055000,25125000,25060000,25130000,"chr16",575780,1,8,7,16,"chr16",1,0.0337552742616034
"18994","chr16.22225000.22230000","chr16.22295000.22300000",70000,32,2.058007e-10,22225000,22295000,22230000,22300000,"chr16",575784,7,14,25,46,"chr16",1,0.172526957337084
"18995","chr16.51430000.51435000","chr16.51540000.51545000",110000,18,0.00017114,51430000,51540000,51435000,51545000,"chr16",575819,1,3,5,9,"chr16",1,0.0189873417721519
"18996","chr16.66830000.66835000","chr16.66865000.66870000",35000,26,0.007362843,66830000,66865000,66835000,66870000,"chr16",575844,4,20,12,36,"chr16",1,0.109704641350211
"18997","chr16.23800000.23805000","chr16.24500000.24505000",700000,7,0.008134943,23800000,24500000,23805000,24505000,"chr16",575853,3,17,15,35,"chr16",1,0.0287154242850445
"18998","chr16.84735000.84740000","chr16.84755000.84760000",20000,70,1.112968e-18,84735000,84755000,84740000,84760000,"chr16",575856,7,7,14,28,"chr16",1,0.229723394280356
"18999","chr16.74745000.74750000","chr16.74810000.74815000",65000,20,0.002419056,74745000,74810000,74750000,74815000,"chr16",575902,4,9,7,20,"chr16",1,0.046882325363338
"19000","chr16.84305000.84310000","chr16.84510000.84515000",205000,15,7.485245e-05,84305000,84510000,84310000,84515000,"chr16",575935,0,2,2,4,"chr16",1,0.0070323488045007
"19001","chr16.30130000.30135000","chr16.30530000.30535000",400000,10,0.001429702,30130000,30530000,30135000,30535000,"chr16",575943,3,3,5,11,"chr16",1,0.012892639474918
"19002","chr16.30945000.30950000","chr16.31460000.31465000",515000,8,0.007362843,30945000,31460000,30950000,31465000,"chr16",575964,6,12,5,23,"chr16",1,0.0215658696671355
"19003","chr16.46890000.46895000","chr16.46910000.46915000",20000,55,1.751371e-10,46890000,46910000,46895000,46915000,"chr16",575971,6,15,21,42,"chr16",1,0.270745428973277
"19004","chr16.74775000.74780000","chr16.74810000.74815000",35000,27,0.003560016,74775000,74810000,74780000,74815000,"chr16",575979,9,9,7,25,"chr16",1,0.0791139240506329
"19005","chr16.56480000.56485000","chr16.56630000.56635000",150000,18,1.377944e-05,56480000,56630000,56485000,56635000,"chr16",576017,2,13,8,23,"chr16",1,0.0485232067510548
"19006","chr16.30400000.30405000","chr16.30650000.30655000",250000,11,0.004565787,30400000,30650000,30405000,30655000,"chr16",576026,9,6,18,33,"chr16",1,0.0425457102672293
"19007","chr16.66710000.66715000","chr16.66870000.66875000",160000,13,0.005695588,66710000,66870000,66715000,66875000,"chr16",576035,12,23,35,70,"chr16",1,0.106657290201594
"19008","chr16.70435000.70440000","chr16.70520000.70525000",85000,20,0.0001747775,70435000,70520000,70440000,70525000,"chr16",576042,2,9,2,13,"chr16",1,0.0304735114861697
"19009","chr16.8620000.8625000","chr16.8885000.8890000",265000,11,0.00326571,8620000,8885000,8625000,8890000,"chr16",576044,4,6,6,16,"chr16",1,0.0206282231598687
"19010","chr16.14010000.14015000","chr16.14630000.14635000",620000,10,8.055964e-05,14010000,14630000,14015000,14635000,"chr16",576063,8,19,16,43,"chr16",1,0.0503984997655884
"19011","chr16.15500000.15505000","chr16.16235000.16240000",735000,8,0.00119289,15500000,16235000,15505000,16240000,"chr16",576093,4,15,14,33,"chr16",1,0.0309423347398031
"19012","chr16.3310000.3315000","chr16.3500000.3505000",190000,12,0.006761307,3310000,3500000,3315000,3505000,"chr16",576108,3,7,5,15,"chr16",1,0.0210970464135021
"19013","chr16.75515000.75520000","chr16.75565000.75570000",50000,56,2.243475e-24,75515000,75565000,75520000,75570000,"chr16",576127,0,6,4,10,"chr16",1,0.0656352555086732
"19014","chr16.74530000.74535000","chr16.74620000.74625000",90000,17,0.002771159,74530000,74620000,74535000,74625000,"chr16",576151,1,16,5,22,"chr16",1,0.0438349742147211
"19015","chr16.75515000.75520000","chr16.75590000.75595000",75000,22,6.418877e-05,75515000,75590000,75520000,75595000,"chr16",576162,5,14,11,30,"chr16",1,0.0773558368495077
"19016","chr16.29920000.29925000","chr16.29970000.29975000",50000,25,0.0003364571,29920000,29970000,29925000,29975000,"chr16",576166,1,8,10,19,"chr16",1,0.0556727613689639
"19017","chr16.67055000.67060000","chr16.67160000.67165000",105000,16,0.002460549,67055000,67160000,67060000,67165000,"chr16",576182,2,3,2,7,"chr16",1,0.0131270511017346
"19018","chr16.67000000.67005000","chr16.67150000.67155000",150000,16,0.0002221557,6.7e+07,67150000,67005000,67155000,"chr16",576207,2,3,0,5,"chr16",1,0.00937646507266761
"19019","chr16.67010000.67015000","chr16.67125000.67130000",115000,17,0.0004055458,67010000,67125000,67015000,67130000,"chr16",576215,0,5,4,9,"chr16",1,0.0179324894514768
"19020","chr16.9380000.9385000","chr16.10170000.10175000",790000,7,0.004786493,9380000,10170000,9385000,10175000,"chr16",576241,1,1,0,2,"chr16",1,0.00164088138771683
"19021","chr16.67535000.67540000","chr16.68225000.68230000",690000,7,0.008720428,67535000,68225000,67540000,68230000,"chr16",576266,0,5,2,7,"chr16",1,0.00574308485700891
"19022","chr16.19745000.19750000","chr16.19835000.19840000",90000,20,9.805497e-05,19745000,19835000,19750000,19840000,"chr16",576282,4,11,6,21,"chr16",1,0.0492264416315049
"19023","chr16.89400000.89405000","chr16.89555000.89560000",155000,13,0.006789433,89400000,89555000,89405000,89560000,"chr16",576317,2,26,33,61,"chr16",1,0.0929442100328176
"19024","chr16.67015000.67020000","chr16.67055000.67060000",40000,32,4.633877e-06,67015000,67055000,67020000,67060000,"chr16",576330,2,11,7,20,"chr16",1,0.0750117205813408
"19025","chr16.23735000.23740000","chr16.24040000.24045000",305000,15,2.083591e-06,23735000,24040000,23740000,24045000,"chr16",576336,2,9,7,18,"chr16",1,0.0316455696202532
"19026","chr16.23820000.23825000","chr16.24040000.24045000",220000,17,1.58944e-06,23820000,24040000,23825000,24045000,"chr16",576379,2,9,7,18,"chr16",1,0.0358649789029536
"19027","chr16.67040000.67045000","chr16.67155000.67160000",115000,18,0.0001166476,67040000,67155000,67045000,67160000,"chr16",576391,3,7,3,13,"chr16",1,0.0274261603375527
"19028","chr16.75460000.75465000","chr16.75490000.75495000",30000,41,1.643364e-07,75460000,75490000,75465000,75495000,"chr16",576416,0,7,5,12,"chr16",1,0.0576652601969058
"19029","chr16.75250000.75255000","chr16.75495000.75500000",245000,17,5.004006e-07,75250000,75495000,75255000,75500000,"chr16",576456,0,3,3,6,"chr16",1,0.0119549929676512
"19030","chr16.48270000.48275000","chr16.48385000.48390000",115000,18,0.0001166476,48270000,48385000,48275000,48390000,"chr16",576496,3,7,11,21,"chr16",1,0.0443037974683544
"19031","chr16.66690000.66695000","chr16.66710000.66715000",20000,45,3.944371e-06,66690000,66710000,66695000,66715000,"chr16",576530,12,21,19,52,"chr16",1,0.274261603375527
"19032","chr16.19715000.19720000","chr16.19845000.19850000",130000,14,0.005748029,19715000,19845000,19720000,19850000,"chr16",576536,0,12,6,18,"chr16",1,0.029535864978903
"19033","chr16.89475000.89480000","chr16.89580000.89585000",105000,21,5.017858e-06,89475000,89580000,89480000,89585000,"chr16",576538,2,1,1,4,"chr16",1,0.00984528832630099
"19034","chr16.69820000.69825000","chr16.69930000.69935000",110000,21,3.079237e-06,69820000,69930000,69825000,69935000,"chr16",576548,4,13,11,28,"chr16",1,0.0689170182841069
"19035","chr16.12085000.12090000","chr16.12110000.12115000",25000,50,1.825853e-09,12085000,12110000,12090000,12115000,"chr16",576567,3,14,6,23,"chr16",1,0.134786685419597
"19036","chr16.19110000.19115000","chr16.19165000.19170000",55000,23,0.0008278942,19110000,19165000,19115000,19170000,"chr16",576571,2,7,9,18,"chr16",1,0.0485232067510548
"19037","chr16.68310000.68315000","chr16.68340000.68345000",30000,39,1.332147e-06,68310000,68340000,68315000,68345000,"chr16",576577,3,12,10,25,"chr16",1,0.114275668073136
"19038","chr16.53840000.53845000","chr16.53870000.53875000",30000,32,0.0007615578,53840000,53870000,53845000,53875000,"chr16",576623,4,7,9,20,"chr16",1,0.0750117205813408
"19039","chr16.68885000.68890000","chr16.69150000.69155000",265000,15,7.524554e-06,68885000,69150000,68890000,69155000,"chr16",576657,2,16,15,33,"chr16",1,0.0580168776371308
"19040","chr16.30875000.30880000","chr16.30925000.30930000",50000,24,0.000868766,30875000,30925000,30880000,30930000,"chr16",576662,0,1,1,2,"chr16",1,0.00562587904360056
"19041","chr16.53080000.53085000","chr16.53155000.53160000",75000,24,5.540295e-06,53080000,53155000,53085000,53160000,"chr16",576680,6,14,15,35,"chr16",1,0.0984528832630098
"19042","chr16.14335000.14340000","chr16.14630000.14635000",295000,17,6.652969e-08,14335000,14630000,14340000,14635000,"chr16",576686,6,7,12,25,"chr16",1,0.0498124706985466
"19043","chr16.3665000.3670000","chr16.4325000.4330000",660000,8,0.002086763,3665000,4325000,3670000,4330000,"chr16",576701,2,9,14,25,"chr16",1,0.023441162681669
"19044","chr16.30050000.30055000","chr16.30430000.30435000",380000,9,0.007688005,30050000,30430000,30055000,30435000,"chr16",576713,11,22,21,54,"chr16",1,0.0569620253164557
"19045","chr16.69850000.69855000","chr16.69890000.69895000",40000,29,0.0001014801,69850000,69890000,69855000,69895000,"chr16",576751,1,12,12,25,"chr16",1,0.0849742147210502
"19046","chr16.1990000.1995000","chr16.2265000.2270000",275000,11,0.002617108,1990000,2265000,1995000,2270000,"chr16",576760,0,5,5,10,"chr16",1,0.012892639474918
"19047","chr16.22215000.22220000","chr16.22295000.22300000",80000,30,3.710503e-10,22215000,22295000,22220000,22300000,"chr16",576778,5,10,7,22,"chr16",1,0.0773558368495077
"19048","chr16.30375000.30380000","chr16.30425000.30430000",50000,22,0.004984849,30375000,30425000,30380000,30430000,"chr16",576785,3,15,20,38,"chr16",1,0.0979840600093765
"19049","chr16.67055000.67060000","chr16.67150000.67155000",95000,19,0.000188706,67055000,67150000,67060000,67155000,"chr16",576844,2,9,7,18,"chr16",1,0.040084388185654
"19050","chr16.30395000.30400000","chr16.30415000.30420000",20000,48,2.451113e-07,30395000,30415000,30400000,30420000,"chr16",576851,3,6,12,21,"chr16",1,0.118143459915612
"19051","chr16.56550000.56555000","chr16.56585000.56590000",35000,61,3.758058e-22,56550000,56585000,56555000,56590000,"chr16",576855,3,9,12,24,"chr16",1,0.171589310829817
"19052","chr16.69015000.69020000","chr16.69060000.69065000",45000,24,0.002355765,69015000,69060000,69020000,69065000,"chr16",576856,3,12,26,41,"chr16",1,0.115330520393812
"19053","chr16.6130000.6135000","chr16.6450000.6455000",320000,10,0.004475095,6130000,6450000,6135000,6455000,"chr16",576918,0,2,6,8,"chr16",1,0.00937646507266761
"19054","chr16.30370000.30375000","chr16.30395000.30400000",25000,37,0.0003842759,30370000,30395000,30375000,30400000,"chr16",576932,3,6,12,21,"chr16",1,0.0910689170182841
"19055","chr16.89400000.89405000","chr16.89440000.89445000",40000,29,0.0001014801,89400000,89440000,89405000,89445000,"chr16",576965,3,7,10,20,"chr16",1,0.0679793717768401
"19056","chr16.50065000.50070000","chr16.50250000.50255000",185000,14,0.0006794169,50065000,50250000,50070000,50255000,"chr16",577046,3,9,8,20,"chr16",1,0.0328176277543366
"19057","chr16.77695000.77700000","chr16.78000000.78005000",305000,15,2.083591e-06,77695000,7.8e+07,77700000,78005000,"chr16",577064,1,1,1,3,"chr16",1,0.00527426160337553
"19058","chr16.50080000.50085000","chr16.50100000.50105000",20000,35,0.007147375,50080000,50100000,50085000,50105000,"chr16",577108,9,19,19,47,"chr16",1,0.192803563056728
"19059","chr16.4520000.4525000","chr16.4610000.4615000",90000,18,0.0009731324,4520000,4610000,4525000,4615000,"chr16",577119,0,2,4,6,"chr16",1,0.0126582278481013
"19060","chr16.31035000.31040000","chr16.31455000.31460000",420000,12,3.688226e-05,31035000,31455000,31040000,31460000,"chr16",577120,1,2,1,4,"chr16",1,0.00562587904360056
"19061","chr16.29875000.29880000","chr16.30050000.30055000",175000,14,0.0009921198,29875000,30050000,29880000,30055000,"chr16",577130,6,18,21,45,"chr16",1,0.0738396624472574
"19062","chr16.84750000.84755000","chr16.85025000.85030000",275000,11,0.002617108,84750000,85025000,84755000,85030000,"chr16",577142,0,4,1,5,"chr16",1,0.00644631973745898
"19063","chr16.23820000.23825000","chr16.24515000.24520000",695000,10,3.578083e-05,23820000,24515000,23825000,24520000,"chr16",577146,12,20,18,50,"chr16",1,0.0586029067041725
"19064","chr16.15520000.15525000","chr16.15680000.15685000",160000,14,0.001784119,15520000,15680000,15525000,15685000,"chr16",577153,0,3,4,7,"chr16",1,0.0114861697140178
"19065","chr16.66740000.66745000","chr16.66870000.66875000",130000,19,1.092073e-05,66740000,66870000,66745000,66875000,"chr16",577169,4,11,10,25,"chr16",1,0.0556727613689639
"19066","chr16.48365000.48370000","chr16.48620000.48625000",255000,11,0.004044197,48365000,48620000,48370000,48625000,"chr16",577191,5,7,16,28,"chr16",1,0.0360993905297703
"19067","chr16.66715000.66720000","chr16.66865000.66870000",150000,13,0.007907488,66715000,66865000,66720000,66870000,"chr16",577195,3,18,12,33,"chr16",1,0.05028129395218
"19068","chr16.68060000.68065000","chr16.68345000.68350000",285000,11,0.002116259,68060000,68345000,68065000,68350000,"chr16",577219,0,1,5,6,"chr16",1,0.00773558368495077
"19069","chr16.67100000.67105000","chr16.67185000.67190000",85000,18,0.00160782,67100000,67185000,67105000,67190000,"chr16",577234,0,4,3,7,"chr16",1,0.0147679324894515
"19070","chr16.66700000.66705000","chr16.66750000.66755000",50000,23,0.002116259,66700000,66750000,66705000,66755000,"chr16",577255,1,4,3,8,"chr16",1,0.0215658696671355
"19071","chr16.75055000.75060000","chr16.75075000.75080000",20000,51,1.247379e-08,75055000,75075000,75060000,75080000,"chr16",577260,0,13,9,22,"chr16",1,0.131504922644163
"19072","chr16.19735000.19740000","chr16.19885000.19890000",150000,16,0.0002221557,19735000,19885000,19740000,19890000,"chr16",577293,8,13,12,33,"chr16",1,0.0618846694796062
"19073","chr16.67630000.67635000","chr16.67670000.67675000",40000,24,0.007287736,67630000,67670000,67635000,67675000,"chr16",577300,6,24,22,52,"chr16",1,0.146272855133615
"19074","chr16.84590000.84595000","chr16.84755000.84760000",165000,15,0.0004106149,84590000,84755000,84595000,84760000,"chr16",577325,2,2,11,15,"chr16",1,0.0263713080168776
"19075","chr16.9745000.9750000","chr16.10240000.10245000",495000,9,0.002001637,9745000,10240000,9750000,10245000,"chr16",577335,3,10,9,22,"chr16",1,0.0232067510548523
"19076","chr16.21580000.21585000","chr16.22345000.22350000",765000,7,0.005512017,21580000,22345000,21585000,22350000,"chr16",577346,1,6,2,9,"chr16",1,0.00738396624472574
"19077","chr16.84755000.84760000","chr16.85005000.85010000",250000,18,6.406796e-08,84755000,85005000,84760000,85010000,"chr16",577375,7,16,13,36,"chr16",1,0.0759493670886076
"19078","chr16.84545000.84550000","chr16.84725000.84730000",180000,13,0.002838356,84545000,84725000,84550000,84730000,"chr16",577398,0,8,4,12,"chr16",1,0.0182841068917018
"19079","chr16.69740000.69745000","chr16.69795000.69800000",55000,58,1.233798e-27,69740000,69795000,69745000,69800000,"chr16",577430,3,9,7,19,"chr16",1,0.129160806375996
"19080","chr16.84540000.84545000","chr16.84750000.84755000",210000,14,0.000263553,84540000,84750000,84545000,84755000,"chr16",577439,4,6,6,16,"chr16",1,0.0262541022034693
"19081","chr16.69845000.69850000","chr16.69935000.69940000",90000,23,1.975409e-06,69845000,69935000,69850000,69940000,"chr16",577446,4,13,9,26,"chr16",1,0.0700890764181903
"19082","chr16.67015000.67020000","chr16.67380000.67385000",365000,10,0.002310262,67015000,67380000,67020000,67385000,"chr16",577490,0,10,7,17,"chr16",1,0.0199249882794187
"19083","chr16.19635000.19640000","chr16.19735000.19740000",100000,15,0.009543218,19635000,19735000,19640000,19740000,"chr16",577514,4,8,6,18,"chr16",1,0.0316455696202532
"19084","chr16.67070000.67075000","chr16.67185000.67190000",115000,16,0.001325007,67070000,67185000,67075000,67190000,"chr16",577549,0,7,3,10,"chr16",1,0.0187529301453352
"19085","chr16.25050000.25055000","chr16.25105000.25110000",55000,28,3.944371e-06,25050000,25105000,25055000,25110000,"chr16",577550,0,11,6,17,"chr16",1,0.0557899671823722
"19086","chr16.76480000.76485000","chr16.76580000.76585000",100000,19,0.0001151089,76480000,76580000,76485000,76585000,"chr16",577560,0,2,1,3,"chr16",1,0.00668073136427567
"19087","chr16.23535000.23540000","chr16.23650000.23655000",115000,16,0.001325007,23535000,23650000,23540000,23655000,"chr16",577562,1,6,7,14,"chr16",1,0.0262541022034693
"19088","chr16.69420000.69425000","chr16.69760000.69765000",340000,24,1.930047e-15,69420000,69760000,69425000,69765000,"chr16",577635,6,18,15,39,"chr16",1,0.109704641350211
"19089","chr16.67925000.67930000","chr16.68060000.68065000",135000,15,0.001545516,67925000,68060000,67930000,68065000,"chr16",577645,0,3,7,10,"chr16",1,0.0175808720112518
"19090","chr16.57370000.57375000","chr16.57435000.57440000",65000,19,0.006054777,57370000,57435000,57375000,57440000,"chr16",577695,1,2,4,7,"chr16",1,0.0155883731833099
"19091","chr16.14600000.14605000","chr16.14630000.14635000",30000,30,0.003383739,14600000,14630000,14605000,14635000,"chr16",577700,4,20,16,40,"chr16",1,0.140646976090014
"19092","chr16.23650000.23655000","chr16.24610000.24615000",960000,6,0.009939404,23650000,24610000,23655000,24615000,"chr16",577714,1,6,7,14,"chr16",1,0.00984528832630099
"19093","chr16.9975000.9980000","chr16.10000000.10005000",25000,35,0.001657127,9975000,1e+07,9980000,10005000,"chr16",577739,0,3,1,4,"chr16",1,0.0164088138771683
"19094","chr16.20845000.20850000","chr16.21080000.21085000",235000,11,0.006524708,20845000,21080000,20850000,21085000,"chr16",577750,1,2,4,7,"chr16",1,0.00902484763244257
"19095","chr16.67150000.67155000","chr16.67185000.67190000",35000,26,0.007362843,67150000,67185000,67155000,67190000,"chr16",577766,0,7,3,10,"chr16",1,0.0304735114861697
"19096","chr16.67000000.67005000","chr16.67160000.67165000",160000,13,0.005695588,6.7e+07,67160000,67005000,67165000,"chr16",577768,2,3,0,5,"chr16",1,0.00761837787154243
"19097","chr16.22005000.22010000","chr16.22295000.22300000",290000,10,0.007285728,22005000,22295000,22010000,22300000,"chr16",577784,7,14,25,46,"chr16",1,0.0539146741678387
"19098","chr16.21580000.21585000","chr16.22435000.22440000",855000,8,0.0005022688,21580000,22435000,21585000,22440000,"chr16",577798,0,4,2,6,"chr16",1,0.00562587904360056
"19099","chr16.19525000.19530000","chr16.19840000.19845000",315000,10,0.004857685,19525000,19840000,19530000,19845000,"chr16",577827,3,7,4,14,"chr16",1,0.0164088138771683
"19100","chr16.10660000.10665000","chr16.10760000.10765000",100000,16,0.003511948,10660000,10760000,10665000,10765000,"chr16",577841,0,2,1,3,"chr16",1,0.00562587904360056
"19101","chr16.75490000.75495000","chr16.75550000.75555000",60000,32,4.679184e-09,75490000,75550000,75495000,75555000,"chr16",577845,5,20,18,43,"chr16",1,0.161275199249883
"19102","chr16.58410000.58415000","chr16.58515000.58520000",105000,15,0.006985546,58410000,58515000,58415000,58520000,"chr16",577878,0,6,4,10,"chr16",1,0.0175808720112518
"19103","chr16.84185000.84190000","chr16.84510000.84515000",325000,10,0.004119022,84185000,84510000,84190000,84515000,"chr16",577879,6,12,12,30,"chr16",1,0.0351617440225035
"19104","chr16.67015000.67020000","chr16.67180000.67185000",165000,14,0.001486871,67015000,67180000,67020000,67185000,"chr16",577886,7,17,12,36,"chr16",1,0.0590717299578059
"19105","chr16.24035000.24040000","chr16.24515000.24520000",480000,10,0.0004672465,24035000,24515000,24040000,24520000,"chr16",577922,2,13,11,26,"chr16",1,0.0304735114861697
"19106","chr16.19005000.19010000","chr16.19525000.19530000",520000,9,0.001526449,19005000,19525000,19010000,19530000,"chr16",577962,1,7,8,16,"chr16",1,0.0168776371308017
"19107","chr16.69705000.69710000","chr16.69795000.69800000",90000,18,0.0009731324,69705000,69795000,69710000,69800000,"chr16",577967,3,9,13,25,"chr16",1,0.0527426160337553
"19108","chr16.69850000.69855000","chr16.69880000.69885000",30000,29,0.006792525,69850000,69880000,69855000,69885000,"chr16",577989,1,14,11,26,"chr16",1,0.0883731833098922
"19109","chr16.48330000.48335000","chr16.48615000.48620000",285000,10,0.007886236,48330000,48615000,48335000,48620000,"chr16",578002,5,14,30,49,"chr16",1,0.0574308485700891
"19110","chr16.68280000.68285000","chr16.68345000.68350000",65000,21,0.0009347052,68280000,68345000,68285000,68350000,"chr16",578029,4,1,5,10,"chr16",1,0.0246132208157525
"19111","chr16.67845000.67850000","chr16.68060000.68065000",215000,16,1.045578e-05,67845000,68060000,67850000,68065000,"chr16",578034,0,13,10,23,"chr16",1,0.043131739334271
"19112","chr16.4545000.4550000","chr16.5030000.5035000",485000,8,0.009987116,4545000,5030000,4550000,5035000,"chr16",578057,3,5,4,12,"chr16",1,0.0112517580872011
"19113","chr16.48330000.48335000","chr16.48365000.48370000",35000,30,0.0003137383,48330000,48365000,48335000,48370000,"chr16",578062,5,7,16,28,"chr16",1,0.0984528832630098
"19114","chr16.68085000.68090000","chr16.68225000.68230000",140000,15,0.001223509,68085000,68225000,68090000,68230000,"chr16",578067,0,5,2,7,"chr16",1,0.0123066104078762
"19115","chr16.66565000.66570000","chr16.66690000.66695000",125000,17,0.0002220355,66565000,66690000,66570000,66695000,"chr16",578104,0,3,3,6,"chr16",1,0.0119549929676512
"19116","chr16.85315000.85320000","chr16.85340000.85345000",25000,48,1.602273e-08,85315000,85340000,85320000,85345000,"chr16",578117,4,3,0,7,"chr16",1,0.0393811533052039
"19117","chr16.30840000.30845000","chr16.30870000.30875000",30000,33,0.0003364571,30840000,30870000,30845000,30875000,"chr16",578147,3,8,10,21,"chr16",1,0.0812236286919831
"19118","chr16.30415000.30420000","chr16.30530000.30535000",115000,16,0.001325007,30415000,30530000,30420000,30535000,"chr16",578162,3,3,5,11,"chr16",1,0.0206282231598687
"19119","chr16.72270000.72275000","chr16.72890000.72895000",620000,9,0.0005224245,72270000,72890000,72275000,72895000,"chr16",578168,2,5,6,13,"chr16",1,0.0137130801687764
"19120","chr16.11620000.11625000","chr16.11735000.11740000",115000,36,3.272518e-18,11620000,11735000,11625000,11740000,"chr16",578176,3,18,19,40,"chr16",1,0.168776371308017
"19121","chr16.22000000.22005000","chr16.22195000.22200000",195000,17,5.446951e-06,2.2e+07,22195000,22005000,22200000,"chr16",578184,4,11,20,35,"chr16",1,0.0697374589779653
"19122","chr16.56550000.56555000","chr16.56575000.56580000",25000,51,6.068987e-10,56550000,56575000,56555000,56580000,"chr16",578188,3,9,12,24,"chr16",1,0.143459915611814
"19123","chr16.67100000.67105000","chr16.67160000.67165000",60000,20,0.005216722,67100000,67160000,67105000,67165000,"chr16",578207,2,3,2,7,"chr16",1,0.0164088138771683
"19124","chr16.68295000.68300000","chr16.68345000.68350000",50000,31,4.578486e-07,68295000,68345000,68300000,68350000,"chr16",578235,1,0,0,1,"chr16",1,0.0036333802156587
"19125","chr16.19680000.19685000","chr16.19845000.19850000",165000,17,2.581818e-05,19680000,19845000,19685000,19850000,"chr16",578241,3,4,6,13,"chr16",1,0.0259024847632443
"19126","chr16.69390000.69395000","chr16.69705000.69710000",315000,11,0.001200367,69390000,69705000,69395000,69710000,"chr16",578274,7,17,22,46,"chr16",1,0.0593061415846226
"19127","chr16.4330000.4335000","chr16.4460000.4465000",130000,14,0.005748029,4330000,4460000,4335000,4465000,"chr16",578286,7,7,6,20,"chr16",1,0.0328176277543366
"19128","chr16.19665000.19670000","chr16.19845000.19850000",180000,16,5.22657e-05,19665000,19845000,19670000,19850000,"chr16",578290,7,12,10,29,"chr16",1,0.0543834974214721
"19129","chr16.69770000.69775000","chr16.69795000.69800000",25000,38,0.0001757114,69770000,69795000,69775000,69800000,"chr16",578295,3,9,13,25,"chr16",1,0.111345522737928
"19130","chr16.19770000.19775000","chr16.19865000.19870000",95000,28,4.549136e-10,19770000,19865000,19775000,19870000,"chr16",578298,2,5,7,14,"chr16",1,0.0459446788560713
"19131","chr16.24685000.24690000","chr16.24725000.24730000",40000,27,0.0006427282,24685000,24725000,24690000,24730000,"chr16",578324,1,10,5,16,"chr16",1,0.0506329113924051
"19132","chr16.19585000.19590000","chr16.19860000.19865000",275000,10,0.009543218,19585000,19860000,19590000,19865000,"chr16",578334,3,4,5,12,"chr16",1,0.0140646976090014
"19133","chr16.66695000.66700000","chr16.66740000.66745000",45000,34,6.060201e-08,66695000,66740000,66700000,66745000,"chr16",578354,4,11,10,25,"chr16",1,0.0996249413970933
"19134","chr16.11620000.11625000","chr16.11740000.11745000",120000,17,0.0003011612,11620000,11740000,11625000,11745000,"chr16",578369,3,10,6,19,"chr16",1,0.0378574777308955
"19135","chr16.89400000.89405000","chr16.89580000.89585000",180000,13,0.002838356,89400000,89580000,89405000,89585000,"chr16",578372,2,1,1,4,"chr16",1,0.00609470229723394
"19136","chr16.69835000.69840000","chr16.69855000.69860000",20000,44,9.491101e-06,69835000,69855000,69840000,69860000,"chr16",578379,8,8,8,24,"chr16",1,0.123769338959212
"19137","chr16.31030000.31035000","chr16.31880000.31885000",850000,8,0.0005175128,31030000,31880000,31035000,31885000,"chr16",578381,3,9,9,21,"chr16",1,0.019690576652602
"19138","chr16.75515000.75520000","chr16.75555000.75560000",40000,24,0.007287736,75515000,75555000,75520000,75560000,"chr16",578398,7,17,17,41,"chr16",1,0.115330520393812
"19139","chr16.46705000.46710000","chr16.46830000.46835000",125000,18,5.961522e-05,46705000,46830000,46710000,46835000,"chr16",578403,4,10,7,21,"chr16",1,0.0443037974683544
"19140","chr16.11075000.11080000","chr16.11340000.11345000",265000,12,0.0008278942,11075000,11340000,11080000,11345000,"chr16",578404,4,11,11,26,"chr16",1,0.0365682137834037
"19141","chr16.1890000.1895000","chr16.1980000.1985000",90000,16,0.007362843,1890000,1980000,1895000,1985000,"chr16",578405,1,1,4,6,"chr16",1,0.0112517580872011
"19142","chr16.69850000.69855000","chr16.69885000.69890000",35000,26,0.007362843,69850000,69885000,69855000,69890000,"chr16",578414,1,17,12,30,"chr16",1,0.0914205344585091
"19143","chr16.56550000.56555000","chr16.56630000.56635000",80000,52,1.152947e-28,56550000,56630000,56555000,56635000,"chr16",578453,3,9,12,24,"chr16",1,0.146272855133615
"19144","chr16.19705000.19710000","chr16.19735000.19740000",30000,30,0.003383739,19705000,19735000,19710000,19740000,"chr16",578471,2,1,2,5,"chr16",1,0.0175808720112518
"19145","chr16.58380000.58385000","chr16.58510000.58515000",130000,22,1.138173e-07,58380000,58510000,58385000,58515000,"chr16",578476,1,1,4,6,"chr16",1,0.0154711673699015
"19146","chr16.22675000.22680000","chr16.22705000.22710000",30000,44,5.830641e-09,22675000,22705000,22680000,22710000,"chr16",578489,0,3,1,4,"chr16",1,0.0206282231598687
"19147","chr16.22190000.22195000","chr16.22225000.22230000",35000,26,0.007362843,22190000,22225000,22195000,22230000,"chr16",578493,1,3,4,8,"chr16",1,0.0243788091889358
"19148","chr16.85315000.85320000","chr16.85675000.85680000",360000,9,0.009910702,85315000,85675000,85320000,85680000,"chr16",578498,3,3,0,6,"chr16",1,0.00632911392405063
"19149","chr16.29875000.29880000","chr16.29895000.29900000",20000,35,0.007147375,29875000,29895000,29880000,29900000,"chr16",578530,2,5,7,14,"chr16",1,0.0574308485700891
"19150","chr16.14010000.14015000","chr16.14285000.14290000",275000,13,0.0001427014,14010000,14285000,14015000,14290000,"chr16",578538,6,18,13,37,"chr16",1,0.056375996249414
"19151","chr16.30130000.30135000","chr16.30390000.30395000",260000,12,0.0009414736,30130000,30390000,30135000,30395000,"chr16",578557,13,45,63,121,"chr16",1,0.170182841068917
"19152","chr16.56550000.56555000","chr16.56635000.56640000",85000,29,6.068987e-10,56550000,56635000,56555000,56640000,"chr16",578585,3,9,10,22,"chr16",1,0.0747773089545241
"19153","chr16.56545000.56550000","chr16.56655000.56660000",110000,20,1.245263e-05,56545000,56655000,56550000,56660000,"chr16",578593,2,5,6,13,"chr16",1,0.0304735114861697
"19154","chr16.3995000.4000000","chr16.4330000.4335000",335000,16,1.293355e-07,3995000,4330000,4e+06,4335000,"chr16",578617,7,7,6,20,"chr16",1,0.0375058602906704
"19155","chr16.11620000.11625000","chr16.11640000.11645000",20000,40,0.0002420863,11620000,11640000,11625000,11645000,"chr16",578630,7,15,16,38,"chr16",1,0.178152836380684
"19156","chr16.67070000.67075000","chr16.67155000.67160000",85000,32,4.28144e-12,67070000,67155000,67075000,67160000,"chr16",578640,3,7,3,13,"chr16",1,0.0487576183778715
"19157","chr16.67000000.67005000","chr16.67155000.67160000",155000,17,4.439479e-05,6.7e+07,67155000,67005000,67160000,"chr16",578644,2,3,0,5,"chr16",1,0.00996249413970933
"19158","chr16.23820000.23825000","chr16.23950000.23955000",130000,21,5.491804e-07,23820000,23950000,23825000,23955000,"chr16",578669,5,15,18,38,"chr16",1,0.0935302390998594
"19159","chr16.1470000.1475000","chr16.1780000.1785000",310000,12,0.0002963818,1470000,1780000,1475000,1785000,"chr16",578679,5,11,14,30,"chr16",1,0.0421940928270042
"19160","chr16.22640000.22645000","chr16.22695000.22700000",55000,31,9.373038e-08,22640000,22695000,22645000,22700000,"chr16",578700,1,4,3,8,"chr16",1,0.0290670417252696
"19161","chr16.56985000.56990000","chr16.57105000.57110000",120000,17,0.0003011612,56985000,57105000,56990000,57110000,"chr16",578707,2,9,5,16,"chr16",1,0.0318799812470699
"19162","chr16.58365000.58370000","chr16.58515000.58520000",150000,29,5.257095e-14,58365000,58515000,58370000,58520000,"chr16",578729,0,6,2,8,"chr16",1,0.0271917487107361
"19163","chr16.89505000.89510000","chr16.89535000.89540000",30000,34,0.0001447311,89505000,89535000,89510000,89540000,"chr16",578739,6,32,32,70,"chr16",1,0.278949835911861
"19164","chr16.14340000.14345000","chr16.14625000.14630000",285000,14,2.151339e-05,14340000,14625000,14345000,14630000,"chr16",578758,3,10,11,24,"chr16",1,0.0393811533052039
"19165","chr16.52125000.52130000","chr16.53040000.53045000",915000,7,0.002182749,52125000,53040000,52130000,53045000,"chr16",578803,2,1,3,6,"chr16",1,0.00492264416315049
"19166","chr16.67105000.67110000","chr16.67155000.67160000",50000,27,4.45292e-05,67105000,67155000,67110000,67160000,"chr16",578846,3,7,3,13,"chr16",1,0.0411392405063291
"19167","chr16.24610000.24615000","chr16.24685000.24690000",75000,24,5.540295e-06,24610000,24685000,24615000,24690000,"chr16",578872,5,13,7,25,"chr16",1,0.070323488045007
"19168","chr16.10615000.10620000","chr16.10815000.10820000",200000,18,8.168385e-07,10615000,10815000,10620000,10820000,"chr16",578882,2,11,12,25,"chr16",1,0.0527426160337553
"19169","chr16.48255000.48260000","chr16.48620000.48625000",365000,11,0.0005108504,48255000,48620000,48260000,48625000,"chr16",578917,0,7,6,13,"chr16",1,0.0167604313173933
"19170","chr16.30805000.30810000","chr16.30925000.30930000",120000,21,1.224673e-06,30805000,30925000,30810000,30930000,"chr16",578981,0,1,1,2,"chr16",1,0.00492264416315049
"19171","chr16.69855000.69860000","chr16.69880000.69885000",25000,37,0.0003842759,69855000,69880000,69860000,69885000,"chr16",578987,2,14,8,24,"chr16",1,0.10407876230661
"19172","chr16.84130000.84135000","chr16.84150000.84155000",20000,36,0.003855657,84130000,84150000,84135000,84155000,"chr16",579028,1,10,5,16,"chr16",1,0.0675105485232067
"19173","chr16.68530000.68535000","chr16.69060000.69065000",530000,8,0.006524077,68530000,69060000,68535000,69065000,"chr16",579042,5,24,34,63,"chr16",1,0.0590717299578059
"19174","chr16.77720000.77725000","chr16.77985000.77990000",265000,13,0.000188706,77720000,77985000,77725000,77990000,"chr16",579063,0,4,6,10,"chr16",1,0.0152367557430849
"19175","chr16.12185000.12190000","chr16.12815000.12820000",630000,8,0.002654355,12185000,12815000,12190000,12820000,"chr16",579065,0,2,1,3,"chr16",1,0.00281293952180028
"19176","chr16.67465000.67470000","chr16.67510000.67515000",45000,24,0.002355765,67465000,67510000,67470000,67515000,"chr16",579096,6,16,28,50,"chr16",1,0.140646976090014
"19177","chr16.30370000.30375000","chr16.30415000.30420000",45000,28,5.56616e-05,30370000,30415000,30375000,30420000,"chr16",579127,5,15,15,35,"chr16",1,0.114861697140178
"19178","chr16.18965000.18970000","chr16.19525000.19530000",560000,9,0.0009731324,18965000,19525000,18970000,19530000,"chr16",579156,4,7,8,19,"chr16",1,0.020042194092827
"19179","chr16.48315000.48320000","chr16.48380000.48385000",65000,23,0.0001138341,48315000,48380000,48320000,48385000,"chr16",579161,1,11,5,17,"chr16",1,0.0458274730426629
"19180","chr16.23525000.23530000","chr16.23555000.23560000",30000,36,2.450125e-05,23525000,23555000,23530000,23560000,"chr16",579194,6,20,8,34,"chr16",1,0.143459915611814
"19181","chr16.29970000.29975000","chr16.30030000.30035000",60000,20,0.005216722,29970000,30030000,29975000,30035000,"chr16",579213,1,8,8,17,"chr16",1,0.0398499765588373
"19182","chr16.76460000.76465000","chr16.76480000.76485000",20000,44,9.491101e-06,76460000,76480000,76465000,76485000,"chr16",579216,0,3,1,4,"chr16",1,0.0206282231598687
"19183","chr16.81415000.81420000","chr16.81660000.81665000",245000,11,0.005111756,81415000,81660000,81420000,81665000,"chr16",579227,0,1,2,3,"chr16",1,0.00386779184247539
"19184","chr16.23920000.23925000","chr16.23955000.23960000",35000,26,0.007362843,23920000,23955000,23925000,23960000,"chr16",579272,0,2,1,3,"chr16",1,0.00914205344585091
"19185","chr16.68525000.68530000","chr16.69060000.69065000",535000,9,0.001272984,68525000,69060000,68530000,69065000,"chr16",579282,3,8,2,13,"chr16",1,0.0137130801687764
"19186","chr16.84555000.84560000","chr16.84620000.84625000",65000,29,6.595491e-08,84555000,84620000,84560000,84625000,"chr16",579334,4,11,7,22,"chr16",1,0.0747773089545241
"19187","chr16.30805000.30810000","chr16.30920000.30925000",115000,18,0.0001166476,30805000,30920000,30810000,30925000,"chr16",579389,7,29,22,58,"chr16",1,0.122362869198312
"19188","chr16.67530000.67535000","chr16.67720000.67725000",190000,12,0.006761307,67530000,67720000,67535000,67725000,"chr16",579392,8,12,11,31,"chr16",1,0.0436005625879044
"19189","chr16.69795000.69800000","chr16.70155000.70160000",360000,9,0.009910702,69795000,70155000,69800000,70160000,"chr16",579396,3,9,13,25,"chr16",1,0.0263713080168776
"19190","chr16.21985000.21990000","chr16.22095000.22100000",110000,15,0.00520277,21985000,22095000,21990000,22100000,"chr16",579413,5,17,14,36,"chr16",1,0.0632911392405063
"19191","chr16.57355000.57360000","chr16.57400000.57405000",45000,26,0.0003958408,57355000,57400000,57360000,57405000,"chr16",579447,2,7,8,17,"chr16",1,0.0518049695264885
"19192","chr16.11945000.11950000","chr16.12000000.12005000",55000,22,0.002068492,11945000,1.2e+07,11950000,12005000,"chr16",579471,3,12,17,32,"chr16",1,0.0825128926394749
"19193","chr16.89490000.89495000","chr16.89565000.89570000",75000,18,0.004475095,89490000,89565000,89495000,89570000,"chr16",579482,6,13,14,33,"chr16",1,0.069620253164557
"19194","chr16.4325000.4330000","chr16.4345000.4350000",20000,38,0.00101401,4325000,4345000,4330000,4350000,"chr16",579483,4,9,14,27,"chr16",1,0.120253164556962
"19195","chr16.66960000.66965000","chr16.67185000.67190000",225000,12,0.002390808,66960000,67185000,66965000,67190000,"chr16",579491,0,7,3,10,"chr16",1,0.0140646976090014
"19196","chr16.23450000.23455000","chr16.23555000.23560000",105000,16,0.002460549,23450000,23555000,23455000,23560000,"chr16",579511,7,14,8,29,"chr16",1,0.0543834974214721
"19197","chr16.14340000.14345000","chr16.14655000.14660000",315000,10,0.004857685,14340000,14655000,14345000,14660000,"chr16",579538,7,30,15,52,"chr16",1,0.0609470229723394
"19198","chr16.84095000.84100000","chr16.84755000.84760000",660000,11,6.609588e-06,84095000,84755000,84100000,84760000,"chr16",579612,0,6,2,8,"chr16",1,0.0103141115799344
"19199","chr16.67055000.67060000","chr16.67155000.67160000",100000,34,3.592502e-15,67055000,67155000,67060000,67160000,"chr16",579618,2,7,3,12,"chr16",1,0.0478199718706048
"19200","chr16.75230000.75235000","chr16.75460000.75465000",230000,16,5.396892e-06,75230000,75460000,75235000,75465000,"chr16",579622,0,7,5,12,"chr16",1,0.0225035161744023
"19201","chr16.66690000.66695000","chr16.66725000.66730000",35000,41,2.526367e-09,66690000,66725000,66695000,66730000,"chr16",579626,10,21,18,49,"chr16",1,0.235466479137365
"19202","chr16.11675000.11680000","chr16.11705000.11710000",30000,31,0.001642127,11675000,11705000,11680000,11710000,"chr16",579628,0,2,1,3,"chr16",1,0.0109001406469761
"19203","chr16.30570000.30575000","chr16.30595000.30600000",25000,33,0.006284053,30570000,30595000,30575000,30600000,"chr16",579637,2,16,6,24,"chr16",1,0.0928270042194093
"19204","chr16.22675000.22680000","chr16.22695000.22700000",20000,69,4.50912e-18,22675000,22695000,22680000,22700000,"chr16",579662,0,3,1,4,"chr16",1,0.0323488045007032
"19205","chr16.24845000.24850000","chr16.24990000.24995000",145000,15,0.0009921198,24845000,24990000,24850000,24995000,"chr16",579669,7,12,11,30,"chr16",1,0.0527426160337553
"19206","chr16.84130000.84135000","chr16.84505000.84510000",375000,9,0.008147175,84130000,84505000,84135000,84510000,"chr16",579690,4,10,13,27,"chr16",1,0.0284810126582278
"19207","chr16.14010000.14015000","chr16.14625000.14630000",615000,9,0.0005511975,14010000,14625000,14015000,14630000,"chr16",579713,3,10,11,24,"chr16",1,0.0253164556962025
"19208","chr16.470000.475000","chr16.505000.510000",35000,38,9.059247e-08,470000,505000,475000,510000,"chr16",579730,3,6,8,17,"chr16",1,0.0757149554617909
"19209","chr16.56590000.56595000","chr16.56630000.56635000",40000,27,0.0006427282,56590000,56630000,56595000,56635000,"chr16",579740,5,11,23,39,"chr16",1,0.123417721518987
"19210","chr16.75860000.75865000","chr16.76290000.76295000",430000,11,0.0001767745,75860000,76290000,75865000,76295000,"chr16",579753,0,2,2,4,"chr16",1,0.00515705578996718
"19211","chr16.21595000.21600000","chr16.21640000.21645000",45000,24,0.002355765,21595000,21640000,21600000,21645000,"chr16",579786,0,4,3,7,"chr16",1,0.019690576652602
"19212","chr16.10605000.10610000","chr16.10825000.10830000",220000,31,3.371455e-19,10605000,10825000,10610000,10830000,"chr16",579820,3,8,9,20,"chr16",1,0.0726676043131739
"19213","chr16.74995000.75000000","chr16.75515000.75520000",520000,8,0.007119676,74995000,75515000,7.5e+07,75520000,"chr16",579892,6,17,17,40,"chr16",1,0.0375058602906704
"19214","chr16.19665000.19670000","chr16.19865000.19870000",200000,22,6.068987e-10,19665000,19865000,19670000,19870000,"chr16",579938,2,12,11,25,"chr16",1,0.0644631973745898
"19215","chr16.29920000.29925000","chr16.30050000.30055000",130000,16,0.000589232,29920000,30050000,29925000,30055000,"chr16",579954,2,18,10,30,"chr16",1,0.0562587904360056
"19216","chr16.3730000.3735000","chr16.3870000.3875000",140000,14,0.003855856,3730000,3870000,3735000,3875000,"chr16",580005,2,7,5,14,"chr16",1,0.0229723394280356
"19217","chr16.19585000.19590000","chr16.19815000.19820000",230000,14,0.0001258492,19585000,19815000,19590000,19820000,"chr16",580016,6,14,17,37,"chr16",1,0.0607126113455227
"19218","chr16.53095000.53100000","chr16.53155000.53160000",60000,30,7.342841e-08,53095000,53155000,53100000,53160000,"chr16",580025,6,14,21,41,"chr16",1,0.144163150492264
"19219","chr16.24995000.25000000","chr16.25015000.25020000",20000,40,0.0002420863,24995000,25015000,2.5e+07,25020000,"chr16",580037,8,13,4,25,"chr16",1,0.117205813408345
"19220","chr16.30375000.30380000","chr16.30415000.30420000",40000,43,4.79795e-12,30375000,30415000,30380000,30420000,"chr16",580081,5,15,15,35,"chr16",1,0.176394749179559
"19221","chr16.53550000.53555000","chr16.53580000.53585000",30000,29,0.006792525,53550000,53580000,53555000,53585000,"chr16",580083,0,7,4,11,"chr16",1,0.0373886544772621
"19222","chr16.30570000.30575000","chr16.30655000.30660000",85000,21,5.251119e-05,30570000,30655000,30575000,30660000,"chr16",580112,0,4,1,5,"chr16",1,0.0123066104078762
"19223","chr16.67025000.67030000","chr16.67105000.67110000",80000,18,0.002622682,67025000,67105000,67030000,67110000,"chr16",580125,6,15,19,40,"chr16",1,0.0843881856540084
"19224","chr16.46885000.46890000","chr16.46945000.46950000",60000,21,0.002125293,46885000,46945000,46890000,46950000,"chr16",580130,5,9,13,27,"chr16",1,0.0664556962025316
"19225","chr16.21580000.21585000","chr16.22190000.22195000",610000,8,0.00318429,21580000,22190000,21585000,22195000,"chr16",580135,1,3,4,8,"chr16",1,0.00750117205813408
"19226","chr16.19690000.19695000","chr16.19745000.19750000",55000,24,0.0003137383,19690000,19745000,19695000,19750000,"chr16",580142,8,12,6,26,"chr16",1,0.0731364275668073
"19227","chr16.56555000.56560000","chr16.56580000.56585000",25000,59,3.807746e-14,56555000,56580000,56560000,56585000,"chr16",580145,4,8,6,18,"chr16",1,0.124472573839662
"19228","chr16.11675000.11680000","chr16.11740000.11745000",65000,20,0.002419056,11675000,11740000,11680000,11745000,"chr16",580177,0,2,1,3,"chr16",1,0.0070323488045007
"19229","chr16.47455000.47460000","chr16.48135000.48140000",680000,7,0.009357784,47455000,48135000,47460000,48140000,"chr16",580188,3,13,4,20,"chr16",1,0.0164088138771683
"19230","chr16.4585000.4590000","chr16.4670000.4675000",85000,19,0.0005472008,4585000,4670000,4590000,4675000,"chr16",580212,6,9,10,25,"chr16",1,0.0556727613689639
"19231","chr16.56550000.56555000","chr16.56615000.56620000",65000,23,0.0001138341,56550000,56615000,56555000,56620000,"chr16",580219,3,9,12,24,"chr16",1,0.0646976090014065
"19232","chr16.66995000.67000000","chr16.67185000.67190000",190000,15,0.0001405079,66995000,67185000,6.7e+07,67190000,"chr16",580242,0,7,3,10,"chr16",1,0.0175808720112518
"19233","chr16.19780000.19785000","chr16.19870000.19875000",90000,17,0.002771159,19780000,19870000,19785000,19875000,"chr16",580250,2,11,12,25,"chr16",1,0.0498124706985466
"19234","chr16.30840000.30845000","chr16.30925000.30930000",85000,27,1.369943e-08,30840000,30925000,30845000,30930000,"chr16",580260,0,1,1,2,"chr16",1,0.00632911392405063
"19235","chr16.66700000.66705000","chr16.66725000.66730000",25000,43,2.339673e-06,66700000,66725000,66705000,66730000,"chr16",580286,10,21,18,49,"chr16",1,0.246952648851383
"19236","chr16.12185000.12190000","chr16.12360000.12365000",175000,17,1.51995e-05,12185000,12360000,12190000,12365000,"chr16",580320,0,2,1,3,"chr16",1,0.0059774964838256
"19237","chr16.21595000.21600000","chr16.22195000.22200000",600000,12,1.787437e-06,21595000,22195000,21600000,22200000,"chr16",580329,3,11,13,27,"chr16",1,0.0379746835443038
"19238","chr16.19585000.19590000","chr16.19635000.19640000",50000,28,1.502586e-05,19585000,19635000,19590000,19640000,"chr16",580353,4,8,6,18,"chr16",1,0.0590717299578059
"19239","chr16.3310000.3315000","chr16.3505000.3510000",195000,12,0.005750317,3310000,3505000,3315000,3510000,"chr16",580370,3,7,5,15,"chr16",1,0.0210970464135021
"19240","chr16.14000000.14005000","chr16.14630000.14635000",630000,8,0.002654355,1.4e+07,14630000,14005000,14635000,"chr16",580376,0,4,1,5,"chr16",1,0.0046882325363338
"19241","chr16.14555000.14560000","chr16.14600000.14605000",45000,25,0.0009921198,14555000,14600000,14560000,14605000,"chr16",580409,1,18,11,30,"chr16",1,0.0879043600562588
"19242","chr16.480000.485000","chr16.545000.550000",65000,20,0.002419056,480000,545000,485000,550000,"chr16",580410,3,9,6,18,"chr16",1,0.0421940928270042
"19243","chr16.3730000.3735000","chr16.3875000.3880000",145000,13,0.009543218,3730000,3875000,3735000,3880000,"chr16",580413,2,5,5,12,"chr16",1,0.0182841068917018
"19244","chr16.30605000.30610000","chr16.30630000.30635000",25000,42,5.797714e-06,30605000,30630000,30610000,30635000,"chr16",580422,5,23,19,47,"chr16",1,0.231364275668073
"19245","chr16.30810000.30815000","chr16.30900000.30905000",90000,17,0.002771159,30810000,30900000,30815000,30905000,"chr16",580432,7,16,18,41,"chr16",1,0.0816924519456165
"19246","chr16.23800000.23805000","chr16.24010000.24015000",210000,18,4.763842e-07,23800000,24010000,23805000,24015000,"chr16",580450,3,8,3,14,"chr16",1,0.029535864978903
"19247","chr16.50250000.50255000","chr16.50360000.50365000",110000,20,1.245263e-05,50250000,50360000,50255000,50365000,"chr16",580482,2,0,8,10,"chr16",1,0.023441162681669
"19248","chr16.1655000.1660000","chr16.1750000.1755000",95000,19,0.000188706,1655000,1750000,1660000,1755000,"chr16",580486,0,0,5,5,"chr16",1,0.0111345522737928
"19249","chr16.470000.475000","chr16.545000.550000",75000,23,1.952718e-05,470000,545000,475000,550000,"chr16",580533,3,6,6,15,"chr16",1,0.040436005625879
"19250","chr16.66980000.66985000","chr16.67190000.67195000",210000,23,4.218164e-11,66980000,67190000,66985000,67195000,"chr16",580570,8,14,20,42,"chr16",1,0.113220815752461
"19251","chr16.30595000.30600000","chr16.30625000.30630000",30000,30,0.003383739,30595000,30625000,30600000,30630000,"chr16",580583,4,22,6,32,"chr16",1,0.112517580872011
"19252","chr16.85330000.85335000","chr16.85675000.85680000",345000,12,0.0001447311,85330000,85675000,85335000,85680000,"chr16",580586,0,4,2,6,"chr16",1,0.00843881856540084
"19253","chr16.27615000.27620000","chr16.28210000.28215000",595000,8,0.003589638,27615000,28210000,27620000,28215000,"chr16",580595,5,7,5,17,"chr16",1,0.0159399906235349
"19254","chr16.68300000.68305000","chr16.68340000.68345000",40000,24,0.007287736,68300000,68340000,68305000,68345000,"chr16",580649,1,5,4,10,"chr16",1,0.0281293952180028
"19255","chr16.10920000.10925000","chr16.10960000.10965000",40000,25,0.003392301,10920000,10960000,10925000,10965000,"chr16",580677,1,2,1,4,"chr16",1,0.0117205813408345
"19256","chr16.30995000.31000000","chr16.31455000.31460000",460000,10,0.000616686,30995000,31455000,3.1e+07,31460000,"chr16",580736,1,2,1,4,"chr16",1,0.0046882325363338
"19257","chr16.68890000.68895000","chr16.68910000.68915000",20000,49,9.194442e-08,68890000,68910000,68895000,68915000,"chr16",580771,1,22,19,42,"chr16",1,0.241209563994374
"19258","chr16.24700000.24705000","chr16.24830000.24835000",130000,15,0.001906977,24700000,24830000,24705000,24835000,"chr16",580772,2,6,17,25,"chr16",1,0.0439521800281294
"19259","chr16.69495000.69500000","chr16.69690000.69695000",195000,13,0.00170678,69495000,69690000,69500000,69695000,"chr16",580774,1,4,8,13,"chr16",1,0.0198077824660103
"19260","chr16.30375000.30380000","chr16.30430000.30435000",55000,24,0.0003137383,30375000,30430000,30380000,30435000,"chr16",580779,5,15,20,40,"chr16",1,0.112517580872011
"19261","chr16.56545000.56550000","chr16.56725000.56730000",180000,13,0.002838356,56545000,56725000,56550000,56730000,"chr16",580807,2,5,6,13,"chr16",1,0.0198077824660103
"19262","chr16.27685000.27690000","chr16.28090000.28095000",405000,9,0.005748029,27685000,28090000,27690000,28095000,"chr16",580808,2,14,13,29,"chr16",1,0.0305907172995781
"19263","chr16.69420000.69425000","chr16.69815000.69820000",395000,10,0.001532218,69420000,69815000,69425000,69820000,"chr16",580811,6,18,18,42,"chr16",1,0.0492264416315049
"19264","chr16.46870000.46875000","chr16.46970000.46975000",100000,19,0.0001151089,46870000,46970000,46875000,46975000,"chr16",580816,0,7,3,10,"chr16",1,0.0222691045475856
"19265","chr16.22195000.22200000","chr16.22215000.22220000",20000,36,0.003855657,22195000,22215000,22200000,22220000,"chr16",580825,4,10,7,21,"chr16",1,0.0886075949367089
"19266","chr16.22005000.22010000","chr16.22075000.22080000",70000,18,0.007698675,22005000,22075000,22010000,22080000,"chr16",580830,1,2,1,4,"chr16",1,0.00843881856540084
"19267","chr16.3110000.3115000","chr16.3185000.3190000",75000,18,0.004475095,3110000,3185000,3115000,3190000,"chr16",580831,1,8,5,14,"chr16",1,0.029535864978903
"19268","chr16.12000000.12005000","chr16.12065000.12070000",65000,22,0.0003359441,1.2e+07,12065000,12005000,12070000,"chr16",580845,3,12,15,30,"chr16",1,0.0773558368495077
"19269","chr16.9855000.9860000","chr16.10130000.10135000",275000,14,2.90627e-05,9855000,10130000,9860000,10135000,"chr16",580882,0,0,7,7,"chr16",1,0.0114861697140178
"19270","chr16.66550000.66555000","chr16.66635000.66640000",85000,21,5.251119e-05,66550000,66635000,66555000,66640000,"chr16",580906,2,9,5,16,"chr16",1,0.0393811533052039
"19271","chr16.57370000.57375000","chr16.57400000.57405000",30000,45,1.835585e-09,57370000,57400000,57375000,57405000,"chr16",580911,2,2,5,9,"chr16",1,0.0474683544303797
"19272","chr16.4665000.4670000","chr16.5005000.5010000",340000,10,0.003314475,4665000,5005000,4670000,5010000,"chr16",580925,3,8,9,20,"chr16",1,0.023441162681669
"19273","chr16.9365000.9370000","chr16.10180000.10185000",815000,8,0.0006672993,9365000,10180000,9370000,10185000,"chr16",580926,2,3,0,5,"chr16",1,0.0046882325363338
"19274","chr16.19765000.19770000","chr16.19850000.19855000",85000,20,0.0001747775,19765000,19850000,19770000,19855000,"chr16",580939,5,12,13,30,"chr16",1,0.070323488045007
"19275","chr16.19635000.19640000","chr16.19665000.19670000",30000,30,0.003383739,19635000,19665000,19640000,19670000,"chr16",580942,4,8,6,18,"chr16",1,0.0632911392405063
"19276","chr16.84555000.84560000","chr16.84750000.84755000",195000,14,0.0004610481,84555000,84750000,84560000,84755000,"chr16",580948,4,6,6,16,"chr16",1,0.0262541022034693
"19277","chr16.22005000.22010000","chr16.22070000.22075000",65000,20,0.002419056,22005000,22070000,22010000,22075000,"chr16",580955,3,3,7,13,"chr16",1,0.0304735114861697
"19278","chr16.66315000.66320000","chr16.66335000.66340000",20000,45,3.944371e-06,66315000,66335000,66320000,66340000,"chr16",580986,0,2,1,3,"chr16",1,0.0158227848101266
"19279","chr16.89395000.89400000","chr16.89585000.89590000",190000,15,0.0001405079,89395000,89585000,89400000,89590000,"chr16",580996,0,2,1,3,"chr16",1,0.00527426160337553
"19280","chr16.48290000.48295000","chr16.48380000.48385000",90000,26,2.530877e-08,48290000,48380000,48295000,48385000,"chr16",581006,1,6,6,13,"chr16",1,0.0396155649320206
"19281","chr16.67520000.67525000","chr16.67845000.67850000",325000,10,0.004119022,67520000,67845000,67525000,67850000,"chr16",581009,4,15,23,42,"chr16",1,0.0492264416315049
"19282","chr16.67025000.67030000","chr16.67125000.67130000",100000,15,0.009543218,67025000,67125000,67030000,67130000,"chr16",581021,0,5,4,9,"chr16",1,0.0158227848101266
"19283","chr16.57975000.57980000","chr16.58000000.58005000",25000,38,0.0001757114,57975000,5.8e+07,57980000,58005000,"chr16",581023,2,4,3,9,"chr16",1,0.040084388185654
"19284","chr16.50080000.50085000","chr16.50250000.50255000",170000,16,8.461496e-05,50080000,50250000,50085000,50255000,"chr16",581054,3,9,8,20,"chr16",1,0.0375058602906704
"19285","chr16.56550000.56555000","chr16.56735000.56740000",185000,18,1.870579e-06,56550000,56735000,56555000,56740000,"chr16",581056,1,6,4,11,"chr16",1,0.0232067510548523
"19286","chr16.5010000.5015000","chr16.5070000.5075000",60000,30,7.342841e-08,5010000,5070000,5015000,5075000,"chr16",581071,5,5,7,17,"chr16",1,0.059774964838256
"19287","chr16.53580000.53585000","chr16.53865000.53870000",285000,10,0.007886236,53580000,53865000,53585000,53870000,"chr16",581074,0,2,2,4,"chr16",1,0.0046882325363338
"19288","chr16.75515000.75520000","chr16.75575000.75580000",60000,24,0.0001078269,75515000,75575000,75520000,75580000,"chr16",581101,4,13,17,34,"chr16",1,0.0956399437412096
"19289","chr16.30945000.30950000","chr16.31455000.31460000",510000,8,0.007716874,30945000,31455000,30950000,31460000,"chr16",581119,1,2,1,4,"chr16",1,0.00375058602906704
"19290","chr16.84150000.84155000","chr16.84505000.84510000",355000,13,2.177031e-05,84150000,84505000,84155000,84510000,"chr16",581208,1,11,5,17,"chr16",1,0.0259024847632443
"19291","chr16.29860000.29865000","chr16.29970000.29975000",110000,19,4.768935e-05,29860000,29970000,29865000,29975000,"chr16",581235,1,7,6,14,"chr16",1,0.0311767463666198
"19292","chr16.17405000.17410000","chr16.17475000.17480000",70000,18,0.007698675,17405000,17475000,17410000,17480000,"chr16",581260,2,11,9,22,"chr16",1,0.0464135021097046
"19293","chr16.70390000.70395000","chr16.70560000.70565000",170000,13,0.003989425,70390000,70560000,70395000,70565000,"chr16",581295,9,20,11,40,"chr16",1,0.0609470229723394
"19294","chr16.19665000.19670000","chr16.19870000.19875000",205000,14,0.0003181686,19665000,19870000,19670000,19875000,"chr16",581296,2,11,12,25,"chr16",1,0.0410220346929208
"19295","chr16.78560000.78565000","chr16.79285000.79290000",725000,8,0.001272984,78560000,79285000,78565000,79290000,"chr16",581323,0,4,1,5,"chr16",1,0.0046882325363338
"19296","chr16.56585000.56590000","chr16.56730000.56735000",145000,13,0.009543218,56585000,56730000,56590000,56735000,"chr16",581336,3,3,1,7,"chr16",1,0.0106657290201594
"19297","chr16.89395000.89400000","chr16.89535000.89540000",140000,15,0.001223509,89395000,89535000,89400000,89540000,"chr16",581353,9,16,13,38,"chr16",1,0.0668073136427567
"19298","chr16.67100000.67105000","chr16.68060000.68065000",960000,6,0.009939404,67100000,68060000,67105000,68065000,"chr16",581361,0,4,10,14,"chr16",1,0.00984528832630099
"19299","chr16.68910000.68915000","chr16.69185000.69190000",275000,12,0.0006473486,68910000,69185000,68915000,69190000,"chr16",581367,0,17,5,22,"chr16",1,0.0309423347398031
"19300","chr16.86055000.86060000","chr16.86555000.86560000",500000,8,0.008582045,86055000,86555000,86060000,86560000,"chr16",581380,0,7,5,12,"chr16",1,0.0112517580872011
"19301","chr16.3730000.3735000","chr16.3980000.3985000",250000,11,0.004565787,3730000,3980000,3735000,3985000,"chr16",581381,2,7,5,14,"chr16",1,0.0180496952648851
"19302","chr16.67015000.67020000","chr16.67160000.67165000",145000,17,7.459419e-05,67015000,67160000,67020000,67165000,"chr16",581389,2,3,2,7,"chr16",1,0.0139474917955931
"19303","chr16.75250000.75255000","chr16.75470000.75475000",220000,12,0.002771159,75250000,75470000,75255000,75475000,"chr16",581399,0,3,3,6,"chr16",1,0.00843881856540084
"19304","chr16.15520000.15525000","chr16.15640000.15645000",120000,25,2.050868e-09,15520000,15640000,15525000,15645000,"chr16",581403,0,3,4,7,"chr16",1,0.0205110173464604
"19305","chr16.51275000.51280000","chr16.51325000.51330000",50000,23,0.002116259,51275000,51325000,51280000,51330000,"chr16",581427,0,2,2,4,"chr16",1,0.0107829348335677
"19306","chr16.63935000.63940000","chr16.64455000.64460000",520000,9,0.001526449,63935000,64455000,63940000,64460000,"chr16",581462,0,0,4,4,"chr16",1,0.00421940928270042
"19307","chr16.56545000.56550000","chr16.56575000.56580000",30000,40,4.757038e-07,56545000,56575000,56550000,56580000,"chr16",581470,2,5,6,13,"chr16",1,0.0609470229723394
"19308","chr16.19085000.19090000","chr16.19375000.19380000",290000,10,0.007285728,19085000,19375000,19090000,19380000,"chr16",581492,7,20,21,48,"chr16",1,0.0562587904360056
"19309","chr16.75255000.75260000","chr16.75460000.75465000",205000,12,0.004287229,75255000,75460000,75260000,75465000,"chr16",581495,0,7,5,12,"chr16",1,0.0168776371308017
"19310","chr16.2100000.2105000","chr16.2250000.2255000",150000,13,0.007907488,2100000,2250000,2105000,2255000,"chr16",581511,0,2,5,7,"chr16",1,0.0106657290201594
"19311","chr16.67070000.67075000","chr16.67115000.67120000",45000,23,0.005303841,67070000,67115000,67075000,67120000,"chr16",581526,11,16,28,55,"chr16",1,0.148265353961556
"19312","chr16.19785000.19790000","chr16.19845000.19850000",60000,29,2.742168e-07,19785000,19845000,19790000,19850000,"chr16",581528,6,12,10,28,"chr16",1,0.0951711204875762
"19313","chr16.75050000.75055000","chr16.75075000.75080000",25000,37,0.0003842759,75050000,75075000,75055000,75080000,"chr16",581539,0,13,9,22,"chr16",1,0.0954055321143929
"19314","chr16.19690000.19695000","chr16.19845000.19850000",155000,13,0.006789433,19690000,19845000,19695000,19850000,"chr16",581553,7,12,10,29,"chr16",1,0.0441865916549461
"19315","chr16.81415000.81420000","chr16.81745000.81750000",330000,14,6.446887e-06,81415000,81745000,81420000,81750000,"chr16",581602,3,13,14,30,"chr16",1,0.0492264416315049
"19316","chr16.27630000.27635000","chr16.28090000.28095000",460000,11,0.0001115585,27630000,28090000,27635000,28095000,"chr16",581605,4,2,5,11,"chr16",1,0.0141819034224098
"19317","chr16.30375000.30380000","chr16.30395000.30400000",20000,45,3.944371e-06,30375000,30395000,30380000,30400000,"chr16",581609,3,6,12,21,"chr16",1,0.110759493670886
"19318","chr16.29900000.29905000","chr16.30395000.30400000",495000,8,0.009034139,29900000,30395000,29905000,30400000,"chr16",581644,3,6,12,21,"chr16",1,0.019690576652602
"19319","chr16.21195000.21200000","chr16.21580000.21585000",385000,9,0.007285728,21195000,21580000,21200000,21585000,"chr16",581647,2,15,3,20,"chr16",1,0.0210970464135021
"19320","chr16.11620000.11625000","chr16.11795000.11800000",175000,14,0.0009921198,11620000,11795000,11625000,11800000,"chr16",581657,5,18,14,37,"chr16",1,0.0607126113455227
"19321","chr16.30945000.30950000","chr16.31880000.31885000",935000,7,0.001916563,30945000,31880000,30950000,31885000,"chr16",581670,3,11,5,19,"chr16",1,0.0155883731833099
"19322","chr16.89410000.89415000","chr16.89555000.89560000",145000,13,0.009543218,89410000,89555000,89415000,89560000,"chr16",581705,2,4,12,18,"chr16",1,0.0274261603375527
"19323","chr16.14400000.14405000","chr16.14625000.14630000",225000,14,0.000151492,14400000,14625000,14405000,14630000,"chr16",581707,3,10,8,21,"chr16",1,0.0344585091420534
"19324","chr16.15500000.15505000","chr16.15520000.15525000",20000,36,0.003855657,15500000,15520000,15505000,15525000,"chr16",581718,0,3,4,7,"chr16",1,0.029535864978903
"19325","chr16.14340000.14345000","chr16.14630000.14635000",290000,11,0.001922953,14340000,14630000,14345000,14635000,"chr16",581738,7,24,15,46,"chr16",1,0.0593061415846226
"19326","chr16.14395000.14400000","chr16.14625000.14630000",230000,11,0.007287736,14395000,14625000,14400000,14630000,"chr16",581750,2,10,9,21,"chr16",1,0.0270745428973277
"19327","chr16.66980000.66985000","chr16.67000000.67005000",20000,36,0.003855657,66980000,6.7e+07,66985000,67005000,"chr16",581753,2,3,0,5,"chr16",1,0.0210970464135021
"19328","chr16.30805000.30810000","chr16.30890000.30895000",85000,20,0.0001747775,30805000,30890000,30810000,30895000,"chr16",581767,5,13,13,31,"chr16",1,0.0726676043131739
"19329","chr16.66995000.67000000","chr16.67160000.67165000",165000,13,0.00479582,66995000,67160000,6.7e+07,67165000,"chr16",581778,2,3,2,7,"chr16",1,0.0106657290201594
"19330","chr16.23795000.23800000","chr16.23950000.23955000",155000,16,0.0001747775,23795000,23950000,23800000,23955000,"chr16",581781,4,11,9,24,"chr16",1,0.0450070323488045
"19331","chr16.18840000.18845000","chr16.18925000.18930000",85000,17,0.004331599,18840000,18925000,18845000,18930000,"chr16",581797,5,22,18,45,"chr16",1,0.089662447257384
"19332","chr16.19525000.19530000","chr16.20380000.20385000",855000,8,0.0005022688,19525000,20380000,19530000,20385000,"chr16",581799,1,6,5,12,"chr16",1,0.0112517580872011
"19333","chr16.25015000.25020000","chr16.25050000.25055000",35000,31,0.0001258492,25015000,25050000,25020000,25055000,"chr16",581814,7,17,4,28,"chr16",1,0.101734646038444
"19334","chr16.29710000.29715000","chr16.29860000.29865000",150000,14,0.002622682,29710000,29860000,29715000,29865000,"chr16",581818,2,7,6,15,"chr16",1,0.0246132208157525
"19335","chr16.53095000.53100000","chr16.53535000.53540000",440000,9,0.003781398,53095000,53535000,53100000,53540000,"chr16",581839,7,21,18,46,"chr16",1,0.0485232067510548
"19336","chr16.19705000.19710000","chr16.19845000.19850000",140000,27,7.499367e-12,19705000,19845000,19710000,19850000,"chr16",581845,2,1,2,5,"chr16",1,0.0158227848101266
"19337","chr16.81075000.81080000","chr16.81095000.81100000",20000,41,0.0001115839,81075000,81095000,81080000,81100000,"chr16",581851,3,11,9,23,"chr16",1,0.110525082044069
"19338","chr16.30430000.30435000","chr16.30530000.30535000",100000,22,2.170285e-06,30430000,30530000,30435000,30535000,"chr16",581882,3,3,5,11,"chr16",1,0.0283638068448195
"19339","chr16.66565000.66570000","chr16.66865000.66870000",300000,12,0.0003617037,66565000,66865000,66570000,66870000,"chr16",581897,0,3,3,6,"chr16",1,0.00843881856540084
"19340","chr16.2455000.2460000","chr16.2530000.2535000",75000,18,0.004475095,2455000,2530000,2460000,2535000,"chr16",581910,2,7,6,15,"chr16",1,0.0316455696202532
"19341","chr16.66685000.66690000","chr16.66895000.66900000",210000,13,0.001020499,66685000,66895000,66690000,66900000,"chr16",581916,5,12,20,37,"chr16",1,0.056375996249414
"19342","chr16.47245000.47250000","chr16.48135000.48140000",890000,7,0.002590274,47245000,48135000,47250000,48140000,"chr16",581926,0,9,7,16,"chr16",1,0.0131270511017346
"19343","chr16.69440000.69445000","chr16.69770000.69775000",330000,13,3.749785e-05,69440000,69770000,69445000,69775000,"chr16",581947,7,15,16,38,"chr16",1,0.0578996718237225
"19344","chr16.84555000.84560000","chr16.84735000.84740000",180000,14,0.0008267645,84555000,84735000,84560000,84740000,"chr16",581981,6,7,9,22,"chr16",1,0.0360993905297703
"19345","chr16.19705000.19710000","chr16.19840000.19845000",135000,14,0.004738125,19705000,19840000,19710000,19845000,"chr16",581984,2,1,2,5,"chr16",1,0.00820440693858415
"19346","chr16.15055000.15060000","chr16.15090000.15095000",35000,29,0.0007397556,15055000,15090000,15060000,15095000,"chr16",582021,2,7,10,19,"chr16",1,0.0645804031879981
"19347","chr16.89475000.89480000","chr16.89535000.89540000",60000,21,0.002125293,89475000,89535000,89480000,89540000,"chr16",582028,6,22,24,52,"chr16",1,0.127988748241913
"19348","chr16.19665000.19670000","chr16.19835000.19840000",170000,13,0.003989425,19665000,19835000,19670000,19840000,"chr16",582029,4,11,12,27,"chr16",1,0.0411392405063291
"19349","chr16.50065000.50070000","chr16.50210000.50215000",145000,13,0.009543218,50065000,50210000,50070000,50215000,"chr16",582057,2,6,5,13,"chr16",1,0.0198077824660103
"19350","chr16.24070000.24075000","chr16.24500000.24505000",430000,9,0.004257453,24070000,24500000,24075000,24505000,"chr16",582070,7,13,22,42,"chr16",1,0.0443037974683544
"19351","chr16.89400000.89405000","chr16.89490000.89495000",90000,18,0.0009731324,89400000,89490000,89405000,89495000,"chr16",582090,4,13,14,31,"chr16",1,0.0654008438818565
"19352","chr16.69740000.69745000","chr16.69770000.69775000",30000,31,0.001642127,69740000,69770000,69745000,69775000,"chr16",582137,4,11,7,22,"chr16",1,0.0799343647444913
"19353","chr16.30430000.30435000","chr16.30650000.30655000",220000,14,0.0001806055,30430000,30650000,30435000,30655000,"chr16",582200,11,6,18,35,"chr16",1,0.0574308485700891
"19354","chr16.56365000.56370000","chr16.56735000.56740000",370000,10,0.002129323,56365000,56735000,56370000,56740000,"chr16",582213,0,1,3,4,"chr16",1,0.0046882325363338
"19355","chr16.67405000.67410000","chr16.67925000.67930000",520000,8,0.007119676,67405000,67925000,67410000,67930000,"chr16",582215,2,3,7,12,"chr16",1,0.0112517580872011
"19356","chr16.46695000.46700000","chr16.46970000.46975000",275000,10,0.009543218,46695000,46970000,46700000,46975000,"chr16",582240,0,7,3,10,"chr16",1,0.0117205813408345
"19357","chr16.30810000.30815000","chr16.30890000.30895000",80000,19,0.0009533379,30810000,30890000,30815000,30895000,"chr16",582264,5,13,13,31,"chr16",1,0.0690342240975152
"19358","chr16.66960000.66965000","chr16.67260000.67265000",300000,11,0.00160782,66960000,67260000,66965000,67265000,"chr16",582286,0,5,2,7,"chr16",1,0.00902484763244257
"19359","chr16.23120000.23125000","chr16.23145000.23150000",25000,34,0.003276528,23120000,23145000,23125000,23150000,"chr16",582291,3,4,2,9,"chr16",1,0.0358649789029536
"19360","chr16.74725000.74730000","chr16.75215000.75220000",490000,8,0.009519015,74725000,75215000,74730000,75220000,"chr16",582300,6,20,18,44,"chr16",1,0.0412564463197375
"19361","chr16.75590000.75595000","chr16.75620000.75625000",30000,30,0.003383739,75590000,75620000,75595000,75625000,"chr16",582311,0,14,11,25,"chr16",1,0.0879043600562588
"19362","chr16.18980000.18985000","chr16.19065000.19070000",85000,18,0.00160782,18980000,19065000,18985000,19070000,"chr16",582325,4,13,14,31,"chr16",1,0.0654008438818565
"19363","chr16.19665000.19670000","chr16.19860000.19865000",195000,13,0.00170678,19665000,19860000,19670000,19865000,"chr16",582329,3,4,5,12,"chr16",1,0.0182841068917018
"19364","chr16.1750000.1755000","chr16.1990000.1995000",240000,11,0.005750317,1750000,1990000,1755000,1995000,"chr16",582338,1,5,5,11,"chr16",1,0.0141819034224098
"19365","chr16.4570000.4575000","chr16.4610000.4615000",40000,28,0.0002605822,4570000,4610000,4575000,4615000,"chr16",582359,0,2,4,6,"chr16",1,0.019690576652602
"19366","chr16.30605000.30610000","chr16.30690000.30695000",85000,18,0.00160782,30605000,30690000,30610000,30695000,"chr16",582365,5,23,19,47,"chr16",1,0.0991561181434599
"19367","chr16.89535000.89540000","chr16.89580000.89585000",45000,23,0.005303841,89535000,89580000,89540000,89585000,"chr16",582372,2,1,1,4,"chr16",1,0.0107829348335677
"19368","chr16.67015000.67020000","chr16.67185000.67190000",170000,22,5.324288e-09,67015000,67185000,67020000,67190000,"chr16",582378,0,7,3,10,"chr16",1,0.0257852789498359
"19369","chr16.27615000.27620000","chr16.28085000.28090000",470000,13,2.142767e-06,27615000,28085000,27620000,28090000,"chr16",582384,5,7,5,17,"chr16",1,0.0259024847632443
"19370","chr16.4325000.4330000","chr16.4375000.4380000",50000,25,0.0003364571,4325000,4375000,4330000,4380000,"chr16",582390,0,0,2,2,"chr16",1,0.00586029067041725
"19371","chr16.56585000.56590000","chr16.56630000.56635000",45000,39,8.129187e-11,56585000,56630000,56590000,56635000,"chr16",582399,12,35,26,73,"chr16",1,0.333684950773558
"19372","chr16.4545000.4550000","chr16.4610000.4615000",65000,19,0.006054777,4545000,4610000,4550000,4615000,"chr16",582401,0,2,4,6,"chr16",1,0.0133614627285513
"19373","chr16.30570000.30575000","chr16.30605000.30610000",35000,31,0.0001258492,30570000,30605000,30575000,30610000,"chr16",582407,2,16,10,28,"chr16",1,0.101734646038444
"19374","chr16.57355000.57360000","chr16.57375000.57380000",20000,40,0.0002420863,57355000,57375000,57360000,57380000,"chr16",582418,2,12,4,18,"chr16",1,0.0843881856540084
"19375","chr16.89475000.89480000","chr16.89530000.89535000",55000,21,0.004984849,89475000,89530000,89480000,89535000,"chr16",582420,6,22,24,52,"chr16",1,0.127988748241913
"19376","chr16.81415000.81420000","chr16.81655000.81660000",240000,20,2.31553e-09,81415000,81655000,81420000,81660000,"chr16",582427,0,2,1,3,"chr16",1,0.0070323488045007
"19377","chr16.30595000.30600000","chr16.30655000.30660000",60000,26,1.128756e-05,30595000,30655000,30600000,30660000,"chr16",582433,0,4,1,5,"chr16",1,0.0152367557430849
"19378","chr16.9365000.9370000","chr16.10170000.10175000",805000,7,0.00435125,9365000,10170000,9370000,10175000,"chr16",582451,1,1,0,2,"chr16",1,0.00164088138771683
"19379","chr16.30110000.30115000","chr16.30415000.30420000",305000,11,0.001455937,30110000,30415000,30115000,30420000,"chr16",582506,4,5,11,20,"chr16",1,0.0257852789498359
"19380","chr16.57355000.57360000","chr16.57370000.57375000",15000,36,0.003855657,57355000,57370000,57360000,57375000,"chr16",582547,2,2,5,9,"chr16",1,0.0379746835443038
"19381","chr16.66550000.66555000","chr16.66570000.66575000",20000,39,0.0005060861,66550000,66570000,66555000,66575000,"chr16",582599,0,2,0,2,"chr16",1,0.00914205344585091
"19382","chr16.19735000.19740000","chr16.19765000.19770000",30000,44,5.830641e-09,19735000,19765000,19740000,19770000,"chr16",582668,5,13,12,30,"chr16",1,0.154711673699015
"19383","chr16.3570000.3575000","chr16.3995000.4000000",425000,9,0.004519311,3570000,3995000,3575000,4e+06,"chr16",582678,10,21,19,50,"chr16",1,0.0527426160337553
"19384","chr16.69795000.69800000","chr16.69820000.69825000",25000,57,4.804761e-13,69795000,69820000,69800000,69825000,"chr16",582682,3,9,11,23,"chr16",1,0.15365682137834
"19385","chr16.22350000.22355000","chr16.22370000.22375000",20000,45,3.944371e-06,22350000,22370000,22355000,22375000,"chr16",582685,0,5,2,7,"chr16",1,0.0369198312236287
"19386","chr16.14400000.14405000","chr16.14495000.14500000",95000,19,0.000188706,14400000,14495000,14405000,14500000,"chr16",582702,4,10,8,22,"chr16",1,0.0489920300046882
"19387","chr16.69460000.69465000","chr16.69690000.69695000",230000,12,0.002086732,69460000,69690000,69465000,69695000,"chr16",582710,1,4,8,13,"chr16",1,0.0182841068917018
"19388","chr16.23510000.23515000","chr16.23535000.23540000",25000,40,3.424475e-05,23510000,23535000,23515000,23540000,"chr16",582725,14,22,22,58,"chr16",1,0.271917487107361
"19389","chr16.18980000.18985000","chr16.19525000.19530000",545000,16,5.904083e-10,18980000,19525000,18985000,19530000,"chr16",582748,4,7,8,19,"chr16",1,0.0356305672761369
"19390","chr16.11640000.11645000","chr16.11680000.11685000",40000,45,2.676631e-13,11640000,11680000,11645000,11685000,"chr16",582761,4,9,7,20,"chr16",1,0.105485232067511
"19391","chr16.24205000.24210000","chr16.24500000.24505000",295000,11,0.001744005,24205000,24500000,24210000,24505000,"chr16",582765,7,12,14,33,"chr16",1,0.0425457102672293
"19392","chr16.19735000.19740000","chr16.19860000.19865000",125000,24,6.624984e-09,19735000,19860000,19740000,19865000,"chr16",582789,3,4,5,12,"chr16",1,0.0337552742616034
"19393","chr16.18980000.18985000","chr16.19085000.19090000",105000,19,7.324586e-05,18980000,19085000,18985000,19090000,"chr16",582811,6,13,14,33,"chr16",1,0.0734880450070323
"19394","chr16.48345000.48350000","chr16.48615000.48620000",270000,11,0.002913646,48345000,48615000,48350000,48620000,"chr16",582824,9,22,27,58,"chr16",1,0.0747773089545241
"19395","chr16.69835000.69840000","chr16.69895000.69900000",60000,25,3.578083e-05,69835000,69895000,69840000,69900000,"chr16",582830,10,8,15,33,"chr16",1,0.0966947960618847
"19396","chr16.66685000.66690000","chr16.66740000.66745000",55000,21,0.004984849,66685000,66740000,66690000,66745000,"chr16",582852,4,11,10,25,"chr16",1,0.0615330520393812
"19397","chr16.27900000.27905000","chr16.28090000.28095000",190000,14,0.0005618146,27900000,28090000,27905000,28095000,"chr16",582854,3,12,5,20,"chr16",1,0.0328176277543366
"19398","chr16.23180000.23185000","chr16.23435000.23440000",255000,17,3.227953e-07,23180000,23435000,23185000,23440000,"chr16",582863,5,13,13,31,"chr16",1,0.0617674636661978
"19399","chr16.30370000.30375000","chr16.30430000.30435000",60000,20,0.005216722,30370000,30430000,30375000,30435000,"chr16",582865,5,15,16,36,"chr16",1,0.0843881856540084
"19400","chr16.19735000.19740000","chr16.19865000.19870000",130000,20,2.51724e-06,19735000,19865000,19740000,19870000,"chr16",582916,2,12,11,25,"chr16",1,0.0586029067041725
"19401","chr16.48385000.48390000","chr16.48555000.48560000",170000,14,0.001213745,48385000,48555000,48390000,48560000,"chr16",582925,3,7,10,20,"chr16",1,0.0328176277543366
"19402","chr16.30805000.30810000","chr16.30900000.30905000",95000,20,5.512014e-05,30805000,30900000,30810000,30905000,"chr16",582934,7,16,18,41,"chr16",1,0.0961087669948429
"19403","chr16.21190000.21195000","chr16.21580000.21585000",390000,12,6.267351e-05,21190000,21580000,21195000,21585000,"chr16",582998,0,8,10,18,"chr16",1,0.0253164556962025
"19404","chr16.67015000.67020000","chr16.67405000.67410000",390000,11,0.0003364571,67015000,67405000,67020000,67410000,"chr16",582999,5,5,15,25,"chr16",1,0.0322315986872949
"19405","chr16.81400000.81405000","chr16.81730000.81735000",330000,15,1.022729e-06,81400000,81730000,81405000,81735000,"chr16",583005,4,9,10,23,"chr16",1,0.040436005625879
"19406","chr16.21185000.21190000","chr16.21580000.21585000",395000,17,2.970059e-09,21185000,21580000,21190000,21585000,"chr16",583100,7,19,17,43,"chr16",1,0.0856774496015002
"19407","chr16.19745000.19750000","chr16.19865000.19870000",120000,18,8.336953e-05,19745000,19865000,19750000,19870000,"chr16",583102,2,12,6,20,"chr16",1,0.0421940928270042
"19408","chr16.30650000.30655000","chr16.30840000.30845000",190000,13,0.002020718,30650000,30840000,30655000,30845000,"chr16",583111,3,6,13,22,"chr16",1,0.0335208626347867
"19409","chr16.30875000.30880000","chr16.30900000.30905000",25000,36,0.0008186653,30875000,30900000,30880000,30905000,"chr16",583137,7,15,15,37,"chr16",1,0.156118143459916
"19410","chr16.89440000.89445000","chr16.89560000.89565000",120000,20,5.319827e-06,89440000,89560000,89445000,89565000,"chr16",583143,3,7,10,20,"chr16",1,0.046882325363338
"19411","chr16.30570000.30575000","chr16.30630000.30635000",60000,23,0.0003104352,30570000,30630000,30575000,30635000,"chr16",583164,2,16,10,28,"chr16",1,0.0754805438349742
"19412","chr16.27645000.27650000","chr16.28050000.28055000",405000,10,0.001322475,27645000,28050000,27650000,28055000,"chr16",583169,10,9,11,30,"chr16",1,0.0351617440225035
"19413","chr16.4460000.4465000","chr16.5010000.5015000",550000,8,0.005353548,4460000,5010000,4465000,5015000,"chr16",583186,9,23,20,52,"chr16",1,0.0487576183778715
"19414","chr16.30395000.30400000","chr16.30650000.30655000",255000,11,0.004044197,30395000,30650000,30400000,30655000,"chr16",583215,3,6,12,21,"chr16",1,0.0270745428973277
"19415","chr16.75310000.75315000","chr16.75495000.75500000",185000,12,0.007698675,75310000,75495000,75315000,75500000,"chr16",583233,3,7,4,14,"chr16",1,0.019690576652602
"19416","chr16.73615000.73620000","chr16.73910000.73915000",295000,12,0.0004025842,73615000,73910000,73620000,73915000,"chr16",583243,0,3,6,9,"chr16",1,0.0126582278481013
"19417","chr16.22895000.22900000","chr16.22975000.22980000",80000,19,0.0009533379,22895000,22975000,22900000,22980000,"chr16",583256,1,5,3,9,"chr16",1,0.020042194092827
"19418","chr16.56550000.56555000","chr16.56660000.56665000",110000,17,0.000579144,56550000,56660000,56555000,56665000,"chr16",583309,3,9,12,24,"chr16",1,0.0478199718706048
"19419","chr16.66690000.66695000","chr16.66740000.66745000",50000,41,4.401966e-13,66690000,66740000,66695000,66745000,"chr16",583312,4,11,10,25,"chr16",1,0.120135958743554
"19420","chr16.19705000.19710000","chr16.19770000.19775000",65000,20,0.002419056,19705000,19770000,19710000,19775000,"chr16",583332,2,1,2,5,"chr16",1,0.0117205813408345
"19421","chr16.29825000.29830000","chr16.30050000.30055000",225000,14,0.000151492,29825000,30050000,29830000,30055000,"chr16",583339,11,22,21,54,"chr16",1,0.0886075949367089
"19422","chr16.24050000.24055000","chr16.24515000.24520000",465000,19,3.675178e-12,24050000,24515000,24055000,24520000,"chr16",583342,2,14,15,31,"chr16",1,0.0690342240975152
"19423","chr16.84310000.84315000","chr16.84510000.84515000",200000,15,9.289728e-05,84310000,84510000,84315000,84515000,"chr16",583349,3,11,11,25,"chr16",1,0.0439521800281294
"19424","chr16.28570000.28575000","chr16.28615000.28620000",45000,27,0.0001518733,28570000,28615000,28575000,28620000,"chr16",583372,0,5,6,11,"chr16",1,0.0348101265822785
"19425","chr16.30390000.30395000","chr16.30430000.30435000",40000,28,0.0002605822,30390000,30430000,30395000,30435000,"chr16",583374,19,40,33,92,"chr16",1,0.301922175339897
"19426","chr16.84580000.84585000","chr16.84615000.84620000",35000,31,0.0001258492,84580000,84615000,84585000,84620000,"chr16",583383,1,2,2,5,"chr16",1,0.0181669010782935
"19427","chr16.77720000.77725000","chr16.77810000.77815000",90000,22,7.672029e-06,77720000,77810000,77725000,77815000,"chr16",583400,2,12,8,22,"chr16",1,0.056727613689639
"19428","chr16.68200000.68205000","chr16.68225000.68230000",25000,43,2.339673e-06,68200000,68225000,68205000,68230000,"chr16",583473,0,5,2,7,"chr16",1,0.0352789498359119
"19429","chr16.24050000.24055000","chr16.24500000.24505000",450000,15,5.260845e-08,24050000,24500000,24055000,24505000,"chr16",583505,2,14,15,31,"chr16",1,0.0545007032348805
"19430","chr16.27240000.27245000","chr16.27465000.27470000",225000,13,0.0006406843,27240000,27465000,27245000,27470000,"chr16",583533,5,11,10,26,"chr16",1,0.0396155649320206
"19431","chr16.67720000.67725000","chr16.67805000.67810000",85000,18,0.00160782,67720000,67805000,67725000,67810000,"chr16",583544,6,14,11,31,"chr16",1,0.0654008438818565
"19432","chr16.27710000.27715000","chr16.27785000.27790000",75000,18,0.004475095,27710000,27785000,27715000,27790000,"chr16",583551,0,3,0,3,"chr16",1,0.00632911392405063
"19433","chr16.69390000.69395000","chr16.70155000.70160000",765000,8,0.0009533379,69390000,70155000,69395000,70160000,"chr16",583556,8,16,19,43,"chr16",1,0.0403187998124707
"19434","chr16.22195000.22200000","chr16.22300000.22305000",105000,20,1.976342e-05,22195000,22300000,22200000,22305000,"chr16",583606,4,11,15,30,"chr16",1,0.070323488045007
"19435","chr16.8910000.8915000","chr16.8990000.8995000",80000,17,0.00687557,8910000,8990000,8915000,8995000,"chr16",583649,10,20,17,47,"chr16",1,0.0936474449132677
"19436","chr16.19715000.19720000","chr16.19815000.19820000",100000,17,0.001213745,19715000,19815000,19720000,19820000,"chr16",583678,0,13,6,19,"chr16",1,0.0378574777308955
"19437","chr16.23535000.23540000","chr16.23555000.23560000",20000,49,9.194442e-08,23535000,23555000,23540000,23560000,"chr16",583687,7,22,8,37,"chr16",1,0.21249413970933
"19438","chr16.4400000.4405000","chr16.4460000.4465000",60000,29,2.742168e-07,4400000,4460000,4405000,4465000,"chr16",583702,4,17,7,28,"chr16",1,0.0951711204875762
"19439","chr16.84725000.84730000","chr16.84755000.84760000",30000,39,1.332147e-06,84725000,84755000,84730000,84760000,"chr16",583733,0,8,4,12,"chr16",1,0.0548523206751055
"19440","chr16.21280000.21285000","chr16.21580000.21585000",300000,12,0.0003617037,21280000,21580000,21285000,21585000,"chr16",583735,0,10,7,17,"chr16",1,0.0239099859353024
"19441","chr16.4460000.4465000","chr16.4480000.4485000",20000,35,0.007147375,4460000,4480000,4465000,4485000,"chr16",583760,5,28,26,59,"chr16",1,0.242030004688233
"19442","chr16.22190000.22195000","chr16.22295000.22300000",105000,17,0.0008278942,22190000,22295000,22195000,22300000,"chr16",583771,1,3,4,8,"chr16",1,0.0159399906235349
"19443","chr16.66690000.66695000","chr16.66895000.66900000",205000,13,0.001218964,66690000,66895000,66695000,66900000,"chr16",583773,9,21,19,49,"chr16",1,0.0746601031411158
"19444","chr16.56545000.56550000","chr16.56580000.56585000",35000,64,2.196174e-24,56545000,56580000,56550000,56585000,"chr16",583781,2,5,6,13,"chr16",1,0.0975152367557431
"19445","chr16.46800000.46805000","chr16.46830000.46835000",30000,32,0.0007615578,46800000,46830000,46805000,46835000,"chr16",583803,1,7,1,9,"chr16",1,0.0337552742616034
"19446","chr16.23180000.23185000","chr16.23425000.23430000",245000,11,0.005111756,23180000,23425000,23185000,23430000,"chr16",583835,7,16,14,37,"chr16",1,0.0477027660571964
"19447","chr16.24845000.24850000","chr16.24995000.25000000",150000,19,3.113479e-06,24845000,24995000,24850000,2.5e+07,"chr16",583876,8,13,23,44,"chr16",1,0.0979840600093765
"19448","chr16.74740000.74745000","chr16.74995000.75000000",255000,11,0.004044197,74740000,74995000,74745000,7.5e+07,"chr16",583888,6,17,20,43,"chr16",1,0.0554383497421472
"19449","chr16.480000.485000","chr16.525000.530000",45000,33,2.066587e-07,480000,525000,485000,530000,"chr16",583910,1,0,3,4,"chr16",1,0.0154711673699015
"19450","chr16.18965000.18970000","chr16.19065000.19070000",100000,23,5.069355e-07,18965000,19065000,18970000,19070000,"chr16",583922,4,15,16,35,"chr16",1,0.0943506797937178
"19451","chr16.84545000.84550000","chr16.84600000.84605000",55000,28,3.944371e-06,84545000,84600000,84550000,84605000,"chr16",583939,6,13,9,28,"chr16",1,0.0918893577121425
"19452","chr16.66690000.66695000","chr16.66750000.66755000",60000,24,0.0001078269,66690000,66750000,66695000,66755000,"chr16",583941,1,4,3,8,"chr16",1,0.0225035161744023
"19453","chr16.89400000.89405000","chr16.89585000.89590000",185000,13,0.002390746,89400000,89585000,89405000,89590000,"chr16",583947,0,2,1,3,"chr16",1,0.00457102672292546
"19454","chr16.19765000.19770000","chr16.19865000.19870000",100000,24,1.145107e-07,19765000,19865000,19770000,19870000,"chr16",583995,2,12,11,25,"chr16",1,0.070323488045007
"19455","chr16.53840000.53845000","chr16.53900000.53905000",60000,29,2.742168e-07,53840000,53900000,53845000,53905000,"chr16",584013,1,5,0,6,"chr16",1,0.020393811533052
"19456","chr16.66980000.66985000","chr16.67160000.67165000",180000,17,1.182742e-05,66980000,67160000,66985000,67165000,"chr16",584023,2,3,2,7,"chr16",1,0.0139474917955931
"19457","chr16.84725000.84730000","chr16.85055000.85060000",330000,10,0.003848083,84725000,85055000,84730000,85060000,"chr16",584028,0,8,4,12,"chr16",1,0.0140646976090014
"19458","chr16.19780000.19785000","chr16.19860000.19865000",80000,18,0.002622682,19780000,19860000,19785000,19865000,"chr16",584037,3,4,5,12,"chr16",1,0.0253164556962025
"19459","chr16.19635000.19640000","chr16.19705000.19710000",70000,20,0.00119393,19635000,19705000,19640000,19710000,"chr16",584042,2,1,2,5,"chr16",1,0.0117205813408345
"19460","chr16.19765000.19770000","chr16.19860000.19865000",95000,16,0.005057701,19765000,19860000,19770000,19865000,"chr16",584129,3,4,5,12,"chr16",1,0.0225035161744023
"19461","chr16.74720000.74725000","chr16.74915000.74920000",195000,12,0.005750317,74720000,74915000,74725000,74920000,"chr16",584130,1,10,5,16,"chr16",1,0.0225035161744023
"19462","chr16.53840000.53845000","chr16.53865000.53870000",25000,33,0.006284053,53840000,53865000,53845000,53870000,"chr16",584131,2,2,2,6,"chr16",1,0.0232067510548523
"19463","chr16.19585000.19590000","chr16.19905000.19910000",320000,18,3.726801e-09,19585000,19905000,19590000,19910000,"chr16",584143,10,25,25,60,"chr16",1,0.126582278481013
"19464","chr16.48290000.48295000","chr16.48350000.48355000",60000,21,0.002125293,48290000,48350000,48295000,48355000,"chr16",584191,1,6,4,11,"chr16",1,0.0270745428973277
"19465","chr16.30370000.30375000","chr16.30630000.30635000",260000,13,0.0002198109,30370000,30630000,30375000,30635000,"chr16",584246,5,15,16,36,"chr16",1,0.0548523206751055
"19466","chr16.67560000.67565000","chr16.68060000.68065000",500000,8,0.008582045,67560000,68060000,67565000,68065000,"chr16",584299,0,2,0,2,"chr16",1,0.00187529301453352
"19467","chr16.84770000.84775000","chr16.85010000.85015000",240000,15,1.86366e-05,84770000,85010000,84775000,85015000,"chr16",584318,4,10,17,31,"chr16",1,0.0545007032348805
"19468","chr16.30445000.30450000","chr16.30650000.30655000",205000,13,0.001218964,30445000,30650000,30450000,30655000,"chr16",584341,10,6,18,34,"chr16",1,0.0518049695264885
"19469","chr16.56135000.56140000","chr16.56220000.56225000",85000,20,0.0001747775,56135000,56220000,56140000,56225000,"chr16",584356,1,0,3,4,"chr16",1,0.00937646507266761
"19470","chr16.24735000.24740000","chr16.24845000.24850000",110000,18,0.00017114,24735000,24845000,24740000,24850000,"chr16",584362,2,18,19,39,"chr16",1,0.0822784810126582
"19471","chr16.71890000.71895000","chr16.71930000.71935000",40000,27,0.0006427282,71890000,71930000,71895000,71935000,"chr16",584392,6,16,13,35,"chr16",1,0.110759493670886
"19472","chr16.19770000.19775000","chr16.19850000.19855000",80000,24,2.383591e-06,19770000,19850000,19775000,19855000,"chr16",584398,5,5,7,17,"chr16",1,0.0478199718706048
"19473","chr16.84545000.84550000","chr16.84615000.84620000",70000,20,0.00119393,84545000,84615000,84550000,84620000,"chr16",584426,1,2,2,5,"chr16",1,0.0117205813408345
"19474","chr16.67015000.67020000","chr16.67155000.67160000",140000,35,5.58875e-19,67015000,67155000,67020000,67160000,"chr16",584435,3,7,3,13,"chr16",1,0.053328645100797
"19475","chr16.66980000.66985000","chr16.67055000.67060000",75000,27,9.657391e-08,66980000,67055000,66985000,67060000,"chr16",584444,2,11,7,20,"chr16",1,0.0632911392405063
"19476","chr16.53735000.53740000","chr16.53895000.53900000",160000,13,0.005695588,53735000,53895000,53740000,53900000,"chr16",584467,3,1,1,5,"chr16",1,0.00761837787154243
"19477","chr16.24070000.24075000","chr16.24495000.24500000",425000,14,7.303426e-07,24070000,24495000,24075000,24500000,"chr16",584513,7,13,22,42,"chr16",1,0.0689170182841069
"19478","chr16.19735000.19740000","chr16.19845000.19850000",110000,18,0.00017114,19735000,19845000,19740000,19850000,"chr16",584537,7,12,10,29,"chr16",1,0.0611814345991561
"19479","chr16.67015000.67020000","chr16.67150000.67155000",135000,20,1.786745e-06,67015000,67150000,67020000,67155000,"chr16",584575,3,9,8,20,"chr16",1,0.046882325363338
"19480","chr16.21985000.21990000","chr16.22350000.22355000",365000,9,0.009325723,21985000,22350000,21990000,22355000,"chr16",584589,1,6,2,9,"chr16",1,0.00949367088607595
"19481","chr16.75810000.75815000","chr16.76580000.76585000",770000,10,1.662037e-05,75810000,76580000,75815000,76585000,"chr16",584628,0,2,2,4,"chr16",1,0.0046882325363338
"19482","chr16.50210000.50215000","chr16.50250000.50255000",40000,26,0.001528327,50210000,50250000,50215000,50255000,"chr16",584635,2,6,5,13,"chr16",1,0.0396155649320206
"19483","chr16.48270000.48275000","chr16.48615000.48620000",345000,15,6.861326e-07,48270000,48615000,48275000,48620000,"chr16",584665,5,13,11,29,"chr16",1,0.0509845288326301
"19484","chr16.10180000.10185000","chr16.10215000.10220000",35000,29,0.0007397556,10180000,10215000,10185000,10220000,"chr16",584666,2,3,0,5,"chr16",1,0.01699484294421
"19485","chr16.27715000.27720000","chr16.27785000.27790000",70000,18,0.007698675,27715000,27785000,27720000,27790000,"chr16",584681,0,3,0,3,"chr16",1,0.00632911392405063
"19486","chr16.68905000.68910000","chr16.69060000.69065000",155000,13,0.006789433,68905000,69060000,68910000,69065000,"chr16",584705,8,21,16,45,"chr16",1,0.0685654008438819
"19487","chr16.75550000.75555000","chr16.75575000.75580000",25000,35,0.001657127,75550000,75575000,75555000,75580000,"chr16",584710,4,13,17,34,"chr16",1,0.139474917955931
"19488","chr16.52190000.52195000","chr16.53020000.53025000",830000,7,0.003757825,52190000,53020000,52195000,53025000,"chr16",584731,0,6,4,10,"chr16",1,0.00820440693858415
"19489","chr16.10730000.10735000","chr16.10760000.10765000",30000,32,0.0007615578,10730000,10760000,10735000,10765000,"chr16",584742,2,2,2,6,"chr16",1,0.0225035161744023
"19490","chr16.50065000.50070000","chr16.50245000.50250000",180000,13,0.002838356,50065000,50245000,50070000,50250000,"chr16",584746,1,4,3,8,"chr16",1,0.0121894045944679
"19491","chr16.67920000.67925000","chr16.68060000.68065000",140000,15,0.001223509,67920000,68060000,67925000,68065000,"chr16",584757,0,11,10,21,"chr16",1,0.0369198312236287
"19492","chr16.31125000.31130000","chr16.31455000.31460000",330000,15,1.022729e-06,31125000,31455000,31130000,31460000,"chr16",584765,0,2,1,3,"chr16",1,0.00527426160337553
"19493","chr16.19635000.19640000","chr16.19865000.19870000",230000,11,0.007287736,19635000,19865000,19640000,19870000,"chr16",584767,2,8,6,16,"chr16",1,0.0206282231598687
"19494","chr16.75230000.75235000","chr16.75430000.75435000",200000,17,4.205171e-06,75230000,75430000,75235000,75435000,"chr16",584769,9,21,26,56,"chr16",1,0.111579934364744
"19495","chr16.72270000.72275000","chr16.72500000.72505000",230000,19,2.72048e-08,72270000,72500000,72275000,72505000,"chr16",584776,0,2,0,2,"chr16",1,0.00445382090951711
"19496","chr16.30130000.30135000","chr16.30425000.30430000",295000,10,0.006766618,30130000,30425000,30135000,30430000,"chr16",584823,3,29,35,67,"chr16",1,0.0785278949835912
"19497","chr16.56630000.56635000","chr16.56735000.56740000",105000,25,1.250074e-08,56630000,56735000,56635000,56740000,"chr16",584833,1,6,4,11,"chr16",1,0.0322315986872949
"19498","chr16.66930000.66935000","chr16.66955000.66960000",25000,33,0.006284053,66930000,66955000,66935000,66960000,"chr16",584906,13,21,20,54,"chr16",1,0.208860759493671
"19499","chr16.84115000.84120000","chr16.84510000.84515000",395000,9,0.006521458,84115000,84510000,84120000,84515000,"chr16",584919,3,10,12,25,"chr16",1,0.0263713080168776
"19500","chr16.56985000.56990000","chr16.57090000.57095000",105000,15,0.006985546,56985000,57090000,56990000,57095000,"chr16",584936,2,10,5,17,"chr16",1,0.029887482419128
"19501","chr16.480000.485000","chr16.505000.510000",25000,47,4.560071e-08,480000,505000,485000,510000,"chr16",584947,4,17,15,36,"chr16",1,0.19831223628692
"19502","chr16.56555000.56560000","chr16.56765000.56770000",210000,15,6.027414e-05,56555000,56765000,56560000,56770000,"chr16",584953,0,2,4,6,"chr16",1,0.0105485232067511
"19503","chr16.30445000.30450000","chr16.30525000.30530000",80000,19,0.0009533379,30445000,30525000,30450000,30530000,"chr16",584958,1,10,15,26,"chr16",1,0.0578996718237225
"19504","chr16.15520000.15525000","chr16.15590000.15595000",70000,18,0.007698675,15520000,15590000,15525000,15595000,"chr16",584968,0,3,4,7,"chr16",1,0.0147679324894515
"19505","chr16.89410000.89415000","chr16.89560000.89565000",150000,17,5.67064e-05,89410000,89560000,89415000,89565000,"chr16",585001,6,4,11,21,"chr16",1,0.0418424753867792
"19506","chr16.15505000.15510000","chr16.15640000.15645000",135000,16,0.0004578839,15505000,15640000,15510000,15645000,"chr16",585013,1,3,12,16,"chr16",1,0.0300046882325363
"19507","chr16.81545000.81550000","chr16.81655000.81660000",110000,15,0.00520277,81545000,81655000,81550000,81660000,"chr16",585052,0,1,1,2,"chr16",1,0.00351617440225035
"19508","chr16.21595000.21600000","chr16.21615000.21620000",20000,43,2.204103e-05,21595000,21615000,21600000,21620000,"chr16",585097,3,8,11,22,"chr16",1,0.110876699484294
"19509","chr16.4330000.4335000","chr16.4360000.4365000",30000,43,1.83929e-08,4330000,4360000,4335000,4365000,"chr16",585192,5,7,6,18,"chr16",1,0.0907172995780591
"19510","chr16.89310000.89315000","chr16.89555000.89560000",245000,12,0.001404086,89310000,89555000,89315000,89560000,"chr16",585193,1,4,3,8,"chr16",1,0.0112517580872011
"19511","chr16.67025000.67030000","chr16.67155000.67160000",130000,21,5.491804e-07,67025000,67155000,67030000,67160000,"chr16",585227,3,7,3,13,"chr16",1,0.0319971870604782
"19512","chr16.52125000.52130000","chr16.53050000.53055000",925000,7,0.002053159,52125000,53050000,52130000,53055000,"chr16",585228,2,1,3,6,"chr16",1,0.00492264416315049
"19513","chr16.75230000.75235000","chr16.75465000.75470000",235000,11,0.006524708,75230000,75465000,75235000,75470000,"chr16",585264,10,29,26,65,"chr16",1,0.0838021565869667
"19514","chr16.71865000.71870000","chr16.71930000.71935000",65000,21,0.0009347052,71865000,71930000,71870000,71935000,"chr16",585284,3,8,13,24,"chr16",1,0.0590717299578059
"19515","chr16.23505000.23510000","chr16.23525000.23530000",20000,36,0.003855657,23505000,23525000,23510000,23530000,"chr16",585293,6,20,13,39,"chr16",1,0.164556962025316
"19516","chr16.56460000.56465000","chr16.56485000.56490000",25000,43,2.339673e-06,56460000,56485000,56465000,56490000,"chr16",585310,2,14,6,22,"chr16",1,0.110876699484294
"19517","chr16.89440000.89445000","chr16.89530000.89535000",90000,16,0.007362843,89440000,89530000,89445000,89535000,"chr16",585322,3,7,10,20,"chr16",1,0.0375058602906704
"19518","chr16.67100000.67105000","chr16.67155000.67160000",55000,22,0.002068492,67100000,67155000,67105000,67160000,"chr16",585360,2,4,3,9,"chr16",1,0.0232067510548523
"19519","chr16.58365000.58370000","chr16.58660000.58665000",295000,11,0.001744005,58365000,58660000,58370000,58665000,"chr16",585363,5,7,2,14,"chr16",1,0.0180496952648851
"19520","chr16.66930000.66935000","chr16.66980000.66985000",50000,23,0.002116259,66930000,66980000,66935000,66985000,"chr16",585380,9,14,20,43,"chr16",1,0.115916549460853
"19521","chr16.14425000.14430000","chr16.14630000.14635000",205000,16,1.623345e-05,14425000,14630000,14430000,14635000,"chr16",585401,6,13,13,32,"chr16",1,0.0600093764650727
"19522","chr16.8990000.8995000","chr16.9090000.9095000",100000,16,0.003511948,8990000,9090000,8995000,9095000,"chr16",585403,1,2,10,13,"chr16",1,0.0243788091889358
"19523","chr16.82580000.82585000","chr16.83175000.83180000",595000,8,0.003589638,82580000,83175000,82585000,83180000,"chr16",585444,0,2,2,4,"chr16",1,0.00375058602906704
"19524","chr16.18800000.18805000","chr16.19085000.19090000",285000,10,0.007886236,18800000,19085000,18805000,19090000,"chr16",585473,7,20,21,48,"chr16",1,0.0562587904360056
"19525","chr16.18980000.18985000","chr16.19520000.19525000",540000,8,0.005899128,18980000,19520000,18985000,19525000,"chr16",585496,2,6,4,12,"chr16",1,0.0112517580872011
"19526","chr16.30445000.30450000","chr16.30570000.30575000",125000,20,3.66726e-06,30445000,30570000,30450000,30575000,"chr16",585517,2,16,10,28,"chr16",1,0.0656352555086732
"19527","chr16.51275000.51280000","chr16.51540000.51545000",265000,11,0.00326571,51275000,51540000,51280000,51545000,"chr16",585523,1,2,3,6,"chr16",1,0.00773558368495077
"19528","chr16.69185000.69190000","chr16.69310000.69315000",125000,17,0.0002220355,69185000,69310000,69190000,69315000,"chr16",585539,0,17,5,22,"chr16",1,0.0438349742147211
"19529","chr16.4480000.4485000","chr16.4520000.4525000",40000,24,0.007287736,4480000,4520000,4485000,4525000,"chr16",585557,2,9,14,25,"chr16",1,0.070323488045007
"19530","chr16.30840000.30845000","chr16.30875000.30880000",35000,28,0.00165672,30840000,30875000,30845000,30880000,"chr16",585559,3,8,13,24,"chr16",1,0.0787623066104079
"19531","chr16.56460000.56465000","chr16.56725000.56730000",265000,15,7.524554e-06,56460000,56725000,56465000,56730000,"chr16",585570,2,17,6,25,"chr16",1,0.0439521800281294
"19532","chr16.66995000.67000000","chr16.67150000.67155000",155000,14,0.002140424,66995000,67150000,6.7e+07,67155000,"chr16",585572,3,9,8,20,"chr16",1,0.0328176277543366
"19533","chr16.25050000.25055000","chr16.25110000.25115000",60000,21,0.002125293,25050000,25110000,25055000,25115000,"chr16",585580,3,14,5,22,"chr16",1,0.0541490857946554
"19534","chr16.69085000.69090000","chr16.69105000.69110000",20000,35,0.007147375,69085000,69105000,69090000,69110000,"chr16",585596,0,3,6,9,"chr16",1,0.0369198312236287
"19535","chr16.67055000.67060000","chr16.67185000.67190000",130000,26,1.298441e-10,67055000,67185000,67060000,67190000,"chr16",585602,0,7,3,10,"chr16",1,0.0304735114861697
"19536","chr16.27710000.27715000","chr16.27755000.27760000",45000,24,0.002355765,27710000,27755000,27715000,27760000,"chr16",585665,4,13,15,32,"chr16",1,0.090014064697609
"19537","chr16.4570000.4575000","chr16.4665000.4670000",95000,23,9.827602e-07,4570000,4665000,4575000,4670000,"chr16",585689,3,18,17,38,"chr16",1,0.102437880918894
"19538","chr16.12065000.12070000","chr16.12160000.12165000",95000,20,5.512014e-05,12065000,12160000,12070000,12165000,"chr16",585690,0,5,3,8,"chr16",1,0.0187529301453352
"19539","chr16.89395000.89400000","chr16.89560000.89565000",165000,24,2.0876e-10,89395000,89560000,89400000,89565000,"chr16",585712,8,16,11,35,"chr16",1,0.0984528832630098
"19540","chr16.30445000.30450000","chr16.30625000.30630000",180000,12,0.009034139,30445000,30625000,30450000,30630000,"chr16",585736,8,27,25,60,"chr16",1,0.0843881856540084
"19541","chr16.19705000.19710000","chr16.19860000.19865000",155000,16,0.0001747775,19705000,19860000,19710000,19865000,"chr16",585740,2,1,2,5,"chr16",1,0.00937646507266761
"19542","chr16.58365000.58370000","chr16.58685000.58690000",320000,12,0.0002398717,58365000,58685000,58370000,58690000,"chr16",585742,4,7,2,13,"chr16",1,0.0182841068917018
"19543","chr16.69795000.69800000","chr16.69815000.69820000",20000,42,5.030701e-05,69795000,69815000,69800000,69820000,"chr16",585771,3,9,13,25,"chr16",1,0.123066104078762
"19544","chr16.31125000.31130000","chr16.31450000.31455000",325000,11,0.0009921198,31125000,31450000,31130000,31455000,"chr16",585792,0,11,7,18,"chr16",1,0.0232067510548523
"19545","chr16.19555000.19560000","chr16.19905000.19910000",350000,11,0.0006525356,19555000,19905000,19560000,19910000,"chr16",585801,1,20,2,23,"chr16",1,0.0296530707923113
"19546","chr16.67530000.67535000","chr16.67670000.67675000",140000,15,0.001223509,67530000,67670000,67535000,67675000,"chr16",585810,6,12,20,38,"chr16",1,0.0668073136427567
"19547","chr16.89440000.89445000","chr16.89535000.89540000",95000,19,0.000188706,89440000,89535000,89445000,89540000,"chr16",585812,3,7,10,20,"chr16",1,0.0445382090951711
"19548","chr16.23120000.23125000","chr16.23435000.23440000",315000,11,0.001200367,23120000,23435000,23125000,23440000,"chr16",585826,4,4,5,13,"chr16",1,0.0167604313173933
"19549","chr16.48290000.48295000","chr16.48330000.48335000",40000,30,3.782234e-05,48290000,48330000,48295000,48335000,"chr16",585842,1,6,6,13,"chr16",1,0.0457102672292546
"19550","chr16.74745000.74750000","chr16.74895000.74900000",150000,13,0.007907488,74745000,74895000,74750000,74900000,"chr16",585843,1,5,8,14,"chr16",1,0.0213314580403188
"19551","chr16.89320000.89325000","chr16.89560000.89565000",240000,13,0.0003950427,89320000,89560000,89325000,89565000,"chr16",585848,3,9,6,18,"chr16",1,0.0274261603375527
"19552","chr16.23800000.23805000","chr16.24040000.24045000",240000,16,3.591498e-06,23800000,24040000,23805000,24045000,"chr16",585882,2,9,7,18,"chr16",1,0.0337552742616034
"19553","chr16.56600000.56605000","chr16.56735000.56740000",135000,14,0.004738125,56600000,56735000,56605000,56740000,"chr16",585914,1,6,4,11,"chr16",1,0.0180496952648851
"19554","chr16.69060000.69065000","chr16.69105000.69110000",45000,25,0.0009921198,69060000,69105000,69065000,69110000,"chr16",585947,0,3,6,9,"chr16",1,0.0263713080168776
"19555","chr16.28240000.28245000","chr16.28275000.28280000",35000,28,0.00165672,28240000,28275000,28245000,28280000,"chr16",585967,7,28,19,54,"chr16",1,0.177215189873418
"19556","chr16.19770000.19775000","chr16.19880000.19885000",110000,18,0.00017114,19770000,19880000,19775000,19885000,"chr16",585998,4,5,7,16,"chr16",1,0.0337552742616034
"19557","chr16.19735000.19740000","chr16.19850000.19855000",115000,21,1.909011e-06,19735000,19850000,19740000,19855000,"chr16",586006,5,12,12,29,"chr16",1,0.0713783403656821
"19558","chr16.12555000.12560000","chr16.12810000.12815000",255000,12,0.001058448,12555000,12810000,12560000,12815000,"chr16",586009,4,12,13,29,"chr16",1,0.0407876230661041
"19559","chr16.19785000.19790000","chr16.19850000.19855000",65000,25,1.148594e-05,19785000,19850000,19790000,19855000,"chr16",586019,5,12,13,30,"chr16",1,0.0879043600562588
"19560","chr16.66740000.66745000","chr16.66865000.66870000",125000,21,8.168385e-07,66740000,66865000,66745000,66870000,"chr16",586032,4,11,10,25,"chr16",1,0.0615330520393812
"19561","chr16.66675000.66680000","chr16.66865000.66870000",190000,13,0.002020718,66675000,66865000,66680000,66870000,"chr16",586039,4,12,12,28,"chr16",1,0.0426629160806376
"19562","chr16.71930000.71935000","chr16.72125000.72130000",195000,13,0.00170678,71930000,72125000,71935000,72130000,"chr16",586054,3,0,6,9,"chr16",1,0.0137130801687764
"19563","chr16.31085000.31090000","chr16.31455000.31460000",370000,10,0.002129323,31085000,31455000,31090000,31460000,"chr16",586056,1,2,1,4,"chr16",1,0.0046882325363338
"19564","chr16.48385000.48390000","chr16.48630000.48635000",245000,11,0.005111756,48385000,48630000,48390000,48635000,"chr16",586060,3,7,11,21,"chr16",1,0.0270745428973277
"19565","chr16.69385000.69390000","chr16.69795000.69800000",410000,12,4.439479e-05,69385000,69795000,69390000,69800000,"chr16",586082,3,9,13,25,"chr16",1,0.0351617440225035
"19566","chr16.71845000.71850000","chr16.71890000.71895000",45000,25,0.0009921198,71845000,71890000,71850000,71895000,"chr16",586104,1,4,2,7,"chr16",1,0.0205110173464604
"19567","chr16.67370000.67375000","chr16.67405000.67410000",35000,28,0.00165672,67370000,67405000,67375000,67410000,"chr16",586142,5,5,15,25,"chr16",1,0.0820440693858415
"19568","chr16.89505000.89510000","chr16.89530000.89535000",25000,36,0.0008186653,89505000,89530000,89510000,89535000,"chr16",586159,6,32,32,70,"chr16",1,0.29535864978903
"19569","chr16.75470000.75475000","chr16.75490000.75495000",20000,64,3.429264e-15,75470000,75490000,75475000,75495000,"chr16",586191,3,20,18,41,"chr16",1,0.307548054383497
"19570","chr16.66685000.66690000","chr16.66865000.66870000",180000,17,1.182742e-05,66685000,66865000,66690000,66870000,"chr16",586220,4,12,12,28,"chr16",1,0.0557899671823722
"19571","chr16.67125000.67130000","chr16.67155000.67160000",30000,30,0.003383739,67125000,67155000,67130000,67160000,"chr16",586234,0,5,3,8,"chr16",1,0.0281293952180028
"19572","chr16.75515000.75520000","chr16.75810000.75815000",295000,10,0.006766618,75515000,75810000,75520000,75815000,"chr16",586242,0,9,9,18,"chr16",1,0.0210970464135021
"19573","chr16.4780000.4785000","chr16.5090000.5095000",310000,11,0.001316445,4780000,5090000,4785000,5095000,"chr16",586264,4,23,17,44,"chr16",1,0.056727613689639
"19574","chr16.67025000.67030000","chr16.67055000.67060000",30000,30,0.003383739,67025000,67055000,67030000,67060000,"chr16",586285,2,11,7,20,"chr16",1,0.070323488045007
"19575","chr16.71845000.71850000","chr16.71930000.71935000",85000,22,1.50955e-05,71845000,71930000,71850000,71935000,"chr16",586287,1,4,2,7,"chr16",1,0.0180496952648851
"19576","chr16.67530000.67535000","chr16.68080000.68085000",550000,9,0.001071346,67530000,68080000,67535000,68085000,"chr16",586299,4,6,13,23,"chr16",1,0.0242616033755274
"19577","chr16.30060000.30065000","chr16.30405000.30410000",345000,11,0.0007162002,30060000,30405000,30065000,30410000,"chr16",586301,1,12,11,24,"chr16",1,0.0309423347398031
"19578","chr16.56485000.56490000","chr16.56545000.56550000",60000,20,0.005216722,56485000,56545000,56490000,56550000,"chr16",586330,2,5,6,13,"chr16",1,0.0304735114861697
"19579","chr16.85320000.85325000","chr16.85340000.85345000",20000,52,4.367181e-09,85320000,85340000,85325000,85345000,"chr16",586350,9,18,8,35,"chr16",1,0.213314580403188
"19580","chr16.29685000.29690000","chr16.30050000.30055000",365000,9,0.009325723,29685000,30050000,29690000,30055000,"chr16",586389,11,22,21,54,"chr16",1,0.0569620253164557
"19581","chr16.23920000.23925000","chr16.23950000.23955000",30000,34,0.0001447311,23920000,23950000,23925000,23955000,"chr16",586444,0,2,1,3,"chr16",1,0.0119549929676512
"19582","chr16.75250000.75255000","chr16.75430000.75435000",180000,15,0.000217839,75250000,75430000,75255000,75435000,"chr16",586453,0,3,3,6,"chr16",1,0.0105485232067511
"19583","chr16.68905000.68910000","chr16.69150000.69155000",245000,12,0.001404086,68905000,69150000,68910000,69155000,"chr16",586505,5,16,16,37,"chr16",1,0.0520393811533052
"19584","chr16.19770000.19775000","chr16.19845000.19850000",75000,28,2.336672e-08,19770000,19845000,19775000,19850000,"chr16",586536,7,5,7,19,"chr16",1,0.0623534927332396
"19585","chr16.89380000.89385000","chr16.89560000.89565000",180000,12,0.009034139,89380000,89560000,89385000,89565000,"chr16",586550,7,18,11,36,"chr16",1,0.0506329113924051
"19586","chr16.30840000.30845000","chr16.30920000.30925000",80000,28,8.028942e-09,30840000,30920000,30845000,30925000,"chr16",586591,3,8,13,24,"chr16",1,0.0787623066104079
"19587","chr16.47205000.47210000","chr16.48135000.48140000",930000,7,0.001996279,47205000,48135000,47210000,48140000,"chr16",586616,0,3,6,9,"chr16",1,0.00738396624472574
"19588","chr16.30075000.30080000","chr16.30130000.30135000",55000,21,0.004984849,30075000,30130000,30080000,30135000,"chr16",586660,4,15,8,27,"chr16",1,0.0664556962025316
"19589","chr16.69845000.69850000","chr16.70295000.70300000",450000,11,0.0001284623,69845000,70295000,69850000,70300000,"chr16",586677,10,41,40,91,"chr16",1,0.117323019221753
"19590","chr16.66975000.66980000","chr16.67170000.67175000",195000,12,0.005750317,66975000,67170000,66980000,67175000,"chr16",586678,3,11,11,25,"chr16",1,0.0351617440225035
"19591","chr16.67840000.67845000","chr16.68060000.68065000",220000,11,0.009396117,67840000,68060000,67845000,68065000,"chr16",586679,0,4,5,9,"chr16",1,0.0116033755274262
"19592","chr16.19735000.19740000","chr16.19815000.19820000",80000,17,0.00687557,19735000,19815000,19740000,19820000,"chr16",586682,6,13,12,31,"chr16",1,0.0617674636661978
"19593","chr16.66980000.66985000","chr16.67125000.67130000",145000,18,1.839602e-05,66980000,67125000,66985000,67130000,"chr16",586685,0,5,4,9,"chr16",1,0.0189873417721519
"19594","chr16.69835000.69840000","chr16.69885000.69890000",50000,48,4.699298e-18,69835000,69885000,69840000,69890000,"chr16",586689,10,8,15,33,"chr16",1,0.185654008438819
"19595","chr16.83145000.83150000","chr16.83175000.83180000",30000,29,0.006792525,83145000,83175000,83150000,83180000,"chr16",586697,0,4,6,10,"chr16",1,0.0339896858884201
"19596","chr16.75300000.75305000","chr16.75495000.75500000",195000,12,0.005750317,75300000,75495000,75305000,75500000,"chr16",586721,3,7,4,14,"chr16",1,0.019690576652602
"19597","chr16.75555000.75560000","chr16.75575000.75580000",20000,49,9.194442e-08,75555000,75575000,75560000,75580000,"chr16",586730,4,13,17,34,"chr16",1,0.195264885138303
"19598","chr16.4360000.4365000","chr16.4460000.4465000",100000,15,0.009543218,4360000,4460000,4365000,4465000,"chr16",586744,5,21,15,41,"chr16",1,0.0720815752461322
"19599","chr16.29710000.29715000","chr16.30050000.30055000",340000,14,5.042057e-06,29710000,30050000,29715000,30055000,"chr16",586746,2,10,6,18,"chr16",1,0.029535864978903
"19600","chr16.23800000.23805000","chr16.24035000.24040000",235000,11,0.006524708,23800000,24035000,23805000,24040000,"chr16",586753,2,13,11,26,"chr16",1,0.0335208626347867
"19601","chr16.69390000.69395000","chr16.69770000.69775000",380000,11,0.000396116,69390000,69770000,69395000,69775000,"chr16",586782,7,19,16,42,"chr16",1,0.0541490857946554
"19602","chr16.31115000.31120000","chr16.31450000.31455000",335000,10,0.003560016,31115000,31450000,31120000,31455000,"chr16",586793,13,21,33,67,"chr16",1,0.0785278949835912
"19603","chr16.66865000.66870000","chr16.66895000.66900000",30000,53,7.13623e-14,66865000,66895000,66870000,66900000,"chr16",586820,4,21,12,37,"chr16",1,0.229840600093765
"19604","chr16.22205000.22210000","chr16.22295000.22300000",90000,25,1.127897e-07,22205000,22295000,22210000,22300000,"chr16",586844,7,12,13,32,"chr16",1,0.093764650726676
"19605","chr16.78155000.78160000","chr16.78500000.78505000",345000,11,0.0007162002,78155000,78500000,78160000,78505000,"chr16",586862,0,7,5,12,"chr16",1,0.0154711673699015
"19606","chr16.69835000.69840000","chr16.69890000.69895000",55000,48,2.569251e-19,69835000,69890000,69840000,69895000,"chr16",586889,5,8,15,28,"chr16",1,0.157524613220816
"19607","chr16.31005000.31010000","chr16.31440000.31445000",435000,9,0.003989425,31005000,31440000,31010000,31445000,"chr16",586903,2,3,5,10,"chr16",1,0.0105485232067511
"19608","chr16.69835000.69840000","chr16.69880000.69885000",45000,36,4.661933e-09,69835000,69880000,69840000,69885000,"chr16",586907,2,8,11,21,"chr16",1,0.0886075949367089
"19609","chr16.56585000.56590000","chr16.56625000.56630000",40000,26,0.001528327,56585000,56625000,56590000,56630000,"chr16",586935,4,24,26,54,"chr16",1,0.164556962025316
"19610","chr16.78155000.78160000","chr16.78770000.78775000",615000,9,0.0005511975,78155000,78770000,78160000,78775000,"chr16",586942,0,7,5,12,"chr16",1,0.0126582278481013
"19611","chr16.18815000.18820000","chr16.18965000.18970000",150000,14,0.002622682,18815000,18965000,18820000,18970000,"chr16",586943,13,30,15,58,"chr16",1,0.0951711204875762
"19612","chr16.70330000.70335000","chr16.70380000.70385000",50000,36,6.686718e-10,70330000,70380000,70335000,70385000,"chr16",586956,0,18,14,32,"chr16",1,0.135021097046413
"19613","chr16.58380000.58385000","chr16.58515000.58520000",135000,14,0.004738125,58380000,58515000,58385000,58520000,"chr16",586988,0,1,4,5,"chr16",1,0.00820440693858415
"19614","chr16.83310000.83315000","chr16.83345000.83350000",35000,29,0.0007397556,83310000,83345000,83315000,83350000,"chr16",587013,0,3,1,4,"chr16",1,0.013595874355368
"19615","chr16.6085000.6090000","chr16.6695000.6700000",610000,8,0.00318429,6085000,6695000,6090000,6700000,"chr16",587039,0,2,2,4,"chr16",1,0.00375058602906704
"19616","chr16.25055000.25060000","chr16.25110000.25115000",55000,21,0.004984849,25055000,25110000,25060000,25115000,"chr16",587045,3,14,5,22,"chr16",1,0.0541490857946554
"19617","chr16.9135000.9140000","chr16.9155000.9160000",20000,50,3.439553e-08,9135000,9155000,9140000,9160000,"chr16",587088,7,30,28,65,"chr16",1,0.380918893577121
"19618","chr16.19780000.19785000","chr16.19835000.19840000",55000,27,1.256208e-05,19780000,19835000,19785000,19840000,"chr16",587111,4,11,12,27,"chr16",1,0.0854430379746835
"19619","chr16.56555000.56560000","chr16.56660000.56665000",105000,16,0.002460549,56555000,56660000,56560000,56665000,"chr16",587124,4,9,13,26,"chr16",1,0.0487576183778715
"19620","chr16.22640000.22645000","chr16.22705000.22710000",65000,20,0.002419056,22640000,22705000,22645000,22710000,"chr16",587126,1,4,3,8,"chr16",1,0.0187529301453352
"19621","chr16.68890000.68895000","chr16.69150000.69155000",260000,11,0.003620202,68890000,69150000,68895000,69155000,"chr16",587142,1,16,17,34,"chr16",1,0.0438349742147211
"19622","chr16.24830000.24835000","chr16.25030000.25035000",200000,12,0.004984849,24830000,25030000,24835000,25035000,"chr16",587173,2,6,8,16,"chr16",1,0.0225035161744023
"19623","chr16.75260000.75265000","chr16.75430000.75435000",170000,17,1.976532e-05,75260000,75430000,75265000,75435000,"chr16",587184,0,2,1,3,"chr16",1,0.0059774964838256
"19624","chr16.3730000.3735000","chr16.4350000.4355000",620000,9,0.0005224245,3730000,4350000,3735000,4355000,"chr16",587191,2,7,5,14,"chr16",1,0.0147679324894515
"19625","chr16.19585000.19590000","chr16.19665000.19670000",80000,18,0.002622682,19585000,19665000,19590000,19670000,"chr16",587197,7,15,14,36,"chr16",1,0.0759493670886076
"19626","chr16.5005000.5010000","chr16.5070000.5075000",65000,33,2.078623e-10,5005000,5070000,5010000,5075000,"chr16",587204,4,5,7,16,"chr16",1,0.0618846694796062
"19627","chr16.74995000.75000000","chr16.75250000.75255000",255000,12,0.001058448,74995000,75250000,7.5e+07,75255000,"chr16",587214,0,3,3,6,"chr16",1,0.00843881856540084
"19628","chr16.30390000.30395000","chr16.30415000.30420000",25000,45,3.38268e-07,30390000,30415000,30395000,30420000,"chr16",587237,9,18,15,42,"chr16",1,0.221518987341772
"19629","chr16.56505000.56510000","chr16.56730000.56735000",225000,12,0.002390808,56505000,56730000,56510000,56735000,"chr16",587244,2,3,1,6,"chr16",1,0.00843881856540084
"19630","chr16.58365000.58370000","chr16.58510000.58515000",145000,13,0.009543218,58365000,58510000,58370000,58515000,"chr16",587245,1,4,2,7,"chr16",1,0.0106657290201594
"19631","chr16.56550000.56555000","chr16.56730000.56735000",180000,14,0.0008267645,56550000,56730000,56555000,56735000,"chr16",587251,3,3,1,7,"chr16",1,0.0114861697140178
"19632","chr16.81400000.81405000","chr16.81745000.81750000",345000,12,0.0001447311,81400000,81745000,81405000,81750000,"chr16",587261,3,9,14,26,"chr16",1,0.0365682137834037
"19633","chr16.56460000.56465000","chr16.56555000.56560000",95000,18,0.0006102297,56460000,56555000,56465000,56560000,"chr16",587317,2,17,6,25,"chr16",1,0.0527426160337553
"19634","chr16.66930000.66935000","chr16.66960000.66965000",30000,52,2.766306e-13,66930000,66960000,66935000,66965000,"chr16",587334,10,11,15,36,"chr16",1,0.219409282700422
"19635","chr16.2190000.2195000","chr16.2295000.2300000",105000,15,0.006985546,2190000,2295000,2195000,2300000,"chr16",587338,1,3,2,6,"chr16",1,0.0105485232067511
"19636","chr16.14335000.14340000","chr16.14625000.14630000",290000,15,3.325095e-06,14335000,14625000,14340000,14630000,"chr16",587378,3,7,11,21,"chr16",1,0.0369198312236287
"19637","chr16.20845000.20850000","chr16.21155000.21160000",310000,11,0.001316445,20845000,21155000,20850000,21160000,"chr16",587380,1,2,4,7,"chr16",1,0.00902484763244257
"19638","chr16.74520000.74525000","chr16.74605000.74610000",85000,21,5.251119e-05,74520000,74605000,74525000,74610000,"chr16",587382,0,5,5,10,"chr16",1,0.0246132208157525
"19639","chr16.67715000.67720000","chr16.68040000.68045000",325000,11,0.0009921198,67715000,68040000,67720000,68045000,"chr16",587396,2,10,15,27,"chr16",1,0.0348101265822785
"19640","chr16.30950000.30955000","chr16.31460000.31465000",510000,8,0.007716874,30950000,31460000,30955000,31465000,"chr16",587398,6,7,8,21,"chr16",1,0.019690576652602
"19641","chr16.23070000.23075000","chr16.23450000.23455000",380000,11,0.000396116,23070000,23450000,23075000,23455000,"chr16",587410,0,0,6,6,"chr16",1,0.00773558368495077
"19642","chr16.19585000.19590000","chr16.19885000.19890000",300000,21,1.39654e-11,19585000,19885000,19590000,19890000,"chr16",587416,8,26,30,64,"chr16",1,0.157524613220816
"19643","chr16.8790000.8795000","chr16.9330000.9335000",540000,8,0.005899128,8790000,9330000,8795000,9335000,"chr16",587422,2,10,9,21,"chr16",1,0.019690576652602
"19644","chr16.89395000.89400000","chr16.89565000.89570000",170000,21,3.151853e-08,89395000,89565000,89400000,89570000,"chr16",587440,9,16,13,38,"chr16",1,0.0935302390998594
"19645","chr16.19585000.19590000","chr16.19735000.19740000",150000,16,0.0002221557,19585000,19735000,19590000,19740000,"chr16",587512,8,13,12,33,"chr16",1,0.0618846694796062
"19646","chr16.27700000.27705000","chr16.28085000.28090000",385000,15,2.538579e-07,27700000,28085000,27705000,28090000,"chr16",587528,5,8,14,27,"chr16",1,0.0474683544303797
"19647","chr16.27710000.27715000","chr16.27865000.27870000",155000,13,0.006789433,27710000,27865000,27715000,27870000,"chr16",587534,1,5,3,9,"chr16",1,0.0137130801687764
"19648","chr16.27630000.27635000","chr16.28010000.28015000",380000,9,0.007688005,27630000,28010000,27635000,28015000,"chr16",587540,4,2,5,11,"chr16",1,0.0116033755274262
"19649","chr16.66980000.66985000","chr16.67155000.67160000",175000,14,0.0009921198,66980000,67155000,66985000,67160000,"chr16",587552,3,7,3,13,"chr16",1,0.0213314580403188
"19650","chr16.30445000.30450000","chr16.30605000.30610000",160000,18,7.732798e-06,30445000,30605000,30450000,30610000,"chr16",587567,5,23,19,47,"chr16",1,0.0991561181434599
"19651","chr16.27645000.27650000","chr16.28090000.28095000",445000,9,0.003560016,27645000,28090000,27650000,28095000,"chr16",587577,9,14,18,41,"chr16",1,0.0432489451476793
"19652","chr16.71930000.71935000","chr16.71960000.71965000",30000,48,4.917881e-11,71930000,71960000,71935000,71965000,"chr16",587585,6,16,13,35,"chr16",1,0.19690576652602
"19653","chr17.27740000.27745000","chr17.27880000.27885000",140000,16,0.001330375,27740000,27880000,27745000,27885000,"chr17",587617,4,7,10,21,"chr17",1,0.0393811533052039
"19654","chr17.32545000.32550000","chr17.32625000.32630000",80000,19,0.003777533,32545000,32625000,32550000,32630000,"chr17",587642,2,5,7,14,"chr17",1,0.0311767463666198
"19655","chr17.8125000.8130000","chr17.8185000.8190000",60000,25,0.0001893671,8125000,8185000,8130000,8190000,"chr17",587682,0,2,0,2,"chr17",1,0.00586029067041725
"19656","chr17.38255000.38260000","chr17.38320000.38325000",65000,21,0.003580214,38255000,38320000,38260000,38325000,"chr17",587739,2,10,4,16,"chr17",1,0.0393811533052039
"19657","chr17.34960000.34965000","chr17.35705000.35710000",745000,11,3.576123e-06,34960000,35705000,34965000,35710000,"chr17",587758,0,0,4,4,"chr17",1,0.00515705578996718
"19658","chr17.19765000.19770000","chr17.19855000.19860000",90000,17,0.009638929,19765000,19855000,19770000,19860000,"chr17",587781,1,20,10,31,"chr17",1,0.0617674636661978
"19659","chr17.4100000.4105000","chr17.4210000.4215000",110000,21,2.141896e-05,4100000,4210000,4105000,4215000,"chr17",587791,7,9,16,32,"chr17",1,0.0787623066104079
"19660","chr17.74095000.74100000","chr17.74280000.74285000",185000,13,0.006044125,74095000,74280000,74100000,74285000,"chr17",587795,2,3,0,5,"chr17",1,0.00761837787154243
"19661","chr17.17385000.17390000","chr17.17500000.17505000",115000,16,0.004751828,17385000,17500000,17390000,17505000,"chr17",587819,2,7,1,10,"chr17",1,0.0187529301453352
"19662","chr17.78425000.78430000","chr17.78840000.78845000",415000,13,1.318025e-05,78425000,78840000,78430000,78845000,"chr17",587821,0,2,3,5,"chr17",1,0.00761837787154243
"19663","chr17.57780000.57785000","chr17.58030000.58035000",250000,13,0.0006966348,57780000,58030000,57785000,58035000,"chr17",587832,0,6,2,8,"chr17",1,0.0121894045944679
"19664","chr17.17180000.17185000","chr17.17205000.17210000",25000,47,4.854473e-07,17180000,17205000,17185000,17210000,"chr17",587836,0,0,2,2,"chr17",1,0.0110173464603844
"19665","chr17.27970000.27975000","chr17.28010000.28015000",40000,32,3.697434e-05,27970000,28010000,27975000,28015000,"chr17",587881,4,10,10,24,"chr17",1,0.090014064697609
"19666","chr17.57780000.57785000","chr17.57975000.57980000",195000,13,0.004215649,57780000,57975000,57785000,57980000,"chr17",587891,0,6,2,8,"chr17",1,0.0121894045944679
"19667","chr17.57830000.57835000","chr17.58110000.58115000",280000,13,0.0002942227,57830000,58110000,57835000,58115000,"chr17",587917,1,5,5,11,"chr17",1,0.0167604313173933
"19668","chr17.66950000.66955000","chr17.67240000.67245000",290000,18,4.295774e-08,66950000,67240000,66955000,67245000,"chr17",587980,0,2,0,2,"chr17",1,0.00421940928270042
"19669","chr17.65155000.65160000","chr17.65175000.65180000",20000,38,0.005053586,65155000,65175000,65160000,65180000,"chr17",588009,1,2,3,6,"chr17",1,0.0267229254571027
"19670","chr17.255000.260000","chr17.680000.685000",425000,13,1.0607e-05,255000,680000,260000,685000,"chr17",588065,4,9,5,18,"chr17",1,0.0274261603375527
"19671","chr17.74325000.74330000","chr17.74360000.74365000",35000,32,0.000295732,74325000,74360000,74330000,74365000,"chr17",588069,0,5,2,7,"chr17",1,0.0262541022034693
"19672","chr17.35600000.35605000","chr17.35730000.35735000",130000,19,5.999442e-05,35600000,35730000,35605000,35735000,"chr17",588074,0,7,6,13,"chr17",1,0.0289498359118612
"19673","chr17.57830000.57835000","chr17.57915000.57920000",85000,34,4.088606e-12,57830000,57915000,57835000,57920000,"chr17",588079,1,5,3,9,"chr17",1,0.0358649789029536
"19674","chr17.64300000.64305000","chr17.64410000.64415000",110000,17,0.002322693,64300000,64410000,64305000,64415000,"chr17",588089,1,13,9,23,"chr17",1,0.0458274730426629
"19675","chr17.31505000.31510000","chr17.31530000.31535000",25000,36,0.003283814,31505000,31530000,31510000,31535000,"chr17",588096,1,1,1,3,"chr17",1,0.0126582278481013
"19676","chr17.28660000.28665000","chr17.28915000.28920000",255000,12,0.002316699,28660000,28915000,28665000,28920000,"chr17",588100,0,7,4,11,"chr17",1,0.0154711673699015
"19677","chr17.40165000.40170000","chr17.40305000.40310000",140000,21,1.905402e-06,40165000,40305000,40170000,40310000,"chr17",588131,3,4,5,12,"chr17",1,0.029535864978903
"19678","chr17.66255000.66260000","chr17.66430000.66435000",175000,34,1.888486e-18,66255000,66430000,66260000,66435000,"chr17",588180,1,2,0,3,"chr17",1,0.0119549929676512
"19679","chr17.8150000.8155000","chr17.8185000.8190000",35000,30,0.001475334,8150000,8185000,8155000,8190000,"chr17",588201,0,2,0,2,"chr17",1,0.0070323488045007
"19680","chr17.1625000.1630000","chr17.1685000.1690000",60000,26,6.782354e-05,1625000,1685000,1630000,1690000,"chr17",588232,0,1,0,1,"chr17",1,0.00304735114861697
"19681","chr17.57830000.57835000","chr17.57910000.57915000",80000,30,6.194769e-09,57830000,57910000,57835000,57915000,"chr17",588240,4,5,5,14,"chr17",1,0.0492264416315049
"19682","chr17.43715000.43720000","chr17.43935000.43940000",220000,16,2.814025e-05,43715000,43935000,43720000,43940000,"chr17",588287,0,6,7,13,"chr17",1,0.0243788091889358
"19683","chr17.43710000.43715000","chr17.44360000.44365000",650000,9,0.0005377586,43710000,44360000,43715000,44365000,"chr17",588310,0,2,1,3,"chr17",1,0.00316455696202532
"19684","chr17.8040000.8045000","chr17.8075000.8080000",35000,32,0.000295732,8040000,8075000,8045000,8080000,"chr17",588315,0,12,7,19,"chr17",1,0.0712611345522738
"19685","chr17.27470000.27475000","chr17.27535000.27540000",65000,28,2.304802e-06,27470000,27535000,27475000,27540000,"chr17",588327,1,2,1,4,"chr17",1,0.0131270511017346
"19686","chr17.40490000.40495000","chr17.40645000.40650000",155000,20,2.823257e-06,40490000,40645000,40495000,40650000,"chr17",588344,0,0,4,4,"chr17",1,0.00937646507266761
"19687","chr17.4805000.4810000","chr17.4885000.4890000",80000,25,5.412887e-06,4805000,4885000,4810000,4890000,"chr17",588385,0,8,3,11,"chr17",1,0.0322315986872949
"19688","chr17.43980000.43985000","chr17.44020000.44025000",40000,26,0.006199316,43980000,44020000,43985000,44025000,"chr17",588387,0,4,0,4,"chr17",1,0.0121894045944679
"19689","chr17.29155000.29160000","chr17.29640000.29645000",485000,9,0.003283814,29155000,29640000,29160000,29645000,"chr17",588393,2,5,1,8,"chr17",1,0.00843881856540084
"19690","chr17.4140000.4145000","chr17.4255000.4260000",115000,21,1.373981e-05,4140000,4255000,4145000,4260000,"chr17",588500,1,7,8,16,"chr17",1,0.0393811533052039
"19691","chr17.61210000.61215000","chr17.61260000.61265000",50000,29,3.257849e-05,61210000,61260000,61215000,61265000,"chr17",588506,0,6,2,8,"chr17",1,0.0271917487107361
"19692","chr17.42140000.42145000","chr17.42220000.42225000",80000,18,0.009228529,42140000,42220000,42145000,42225000,"chr17",588511,4,5,6,15,"chr17",1,0.0316455696202532
"19693","chr17.7390000.7395000","chr17.7445000.7450000",55000,28,2.564122e-05,7390000,7445000,7395000,7450000,"chr17",588512,1,3,3,7,"chr17",1,0.0229723394280356
"19694","chr17.2000000.2005000","chr17.2120000.2125000",120000,16,0.003580214,2e+06,2120000,2005000,2125000,"chr17",588525,6,11,13,30,"chr17",1,0.0562587904360056
"19695","chr17.2390000.2395000","chr17.2610000.2615000",220000,12,0.006177371,2390000,2610000,2395000,2615000,"chr17",588574,4,15,10,29,"chr17",1,0.0407876230661041
"19696","chr17.57855000.57860000","chr17.57905000.57910000",50000,34,1.169825e-07,57855000,57905000,57860000,57910000,"chr17",588585,4,10,9,23,"chr17",1,0.0916549460853258
"19697","chr17.19345000.19350000","chr17.19670000.19675000",325000,10,0.007255421,19345000,19670000,19350000,19675000,"chr17",588586,3,2,7,12,"chr17",1,0.0140646976090014
"19698","chr17.64300000.64305000","chr17.64495000.64500000",195000,25,2.343723e-11,64300000,64495000,64305000,64500000,"chr17",588602,3,8,4,15,"chr17",1,0.0439521800281294
"19699","chr17.74055000.74060000","chr17.74280000.74285000",225000,12,0.005288901,74055000,74280000,74060000,74285000,"chr17",588613,1,1,3,5,"chr17",1,0.0070323488045007
"19700","chr17.8040000.8045000","chr17.8195000.8200000",155000,19,1.206398e-05,8040000,8195000,8045000,8200000,"chr17",588634,0,16,10,26,"chr17",1,0.0578996718237225
"19701","chr17.29155000.29160000","chr17.29685000.29690000",530000,8,0.00886668,29155000,29685000,29160000,29690000,"chr17",588636,2,5,1,8,"chr17",1,0.00750117205813408
"19702","chr17.17375000.17380000","chr17.17475000.17480000",100000,18,0.001669024,17375000,17475000,17380000,17480000,"chr17",588643,3,7,5,15,"chr17",1,0.0316455696202532
"19703","chr17.38980000.38985000","chr17.39700000.39705000",720000,12,5.468218e-07,38980000,39700000,38985000,39705000,"chr17",588676,3,8,8,19,"chr17",1,0.0267229254571027
"19704","chr17.38795000.38800000","chr17.39715000.39720000",920000,7,0.002255753,38795000,39715000,38800000,39720000,"chr17",588694,2,6,4,12,"chr17",1,0.00984528832630099
"19705","chr17.61210000.61215000","chr17.61235000.61240000",25000,46,1.220588e-06,61210000,61235000,61215000,61240000,"chr17",588713,3,9,16,28,"chr17",1,0.150961087669948
"19706","chr17.57830000.57835000","chr17.57945000.57950000",115000,21,1.373981e-05,57830000,57945000,57835000,57950000,"chr17",588749,2,5,0,7,"chr17",1,0.0172292545710267
"19707","chr17.38380000.38385000","chr17.38430000.38435000",50000,25,0.001456867,38380000,38430000,38385000,38435000,"chr17",588764,5,11,14,30,"chr17",1,0.0879043600562588
"19708","chr17.43125000.43130000","chr17.43165000.43170000",40000,40,5.629944e-09,43125000,43165000,43130000,43170000,"chr17",588777,2,4,9,15,"chr17",1,0.070323488045007
"19709","chr17.29645000.29650000","chr17.29690000.29695000",45000,54,3.838968e-19,29645000,29690000,29650000,29695000,"chr17",588800,2,17,14,33,"chr17",1,0.208860759493671
"19710","chr17.74870000.74875000","chr17.75055000.75060000",185000,14,0.001864322,74870000,75055000,74875000,75060000,"chr17",588810,3,10,6,19,"chr17",1,0.0311767463666198
"19711","chr17.79335000.79340000","chr17.79475000.79480000",140000,19,3.146631e-05,79335000,79475000,79340000,79480000,"chr17",588844,2,3,5,10,"chr17",1,0.0222691045475856
"19712","chr17.55385000.55390000","chr17.55415000.55420000",30000,47,2.626943e-09,55385000,55415000,55390000,55420000,"chr17",588933,0,6,3,9,"chr17",1,0.04957805907173
"19713","chr17.66565000.66570000","chr17.66715000.66720000",150000,15,0.002566533,66565000,66715000,66570000,66720000,"chr17",588967,0,5,6,11,"chr17",1,0.0193389592123769
"19714","chr17.19270000.19275000","chr17.19670000.19675000",400000,11,0.0005232533,19270000,19670000,19275000,19675000,"chr17",588972,3,8,8,19,"chr17",1,0.0244960150023441
"19715","chr17.47650000.47655000","chr17.47840000.47845000",190000,14,0.001532736,47650000,47840000,47655000,47845000,"chr17",588975,1,4,1,6,"chr17",1,0.00984528832630099
"19716","chr17.78760000.78765000","chr17.78780000.78785000",20000,44,8.309867e-05,78760000,78780000,78765000,78785000,"chr17",588976,2,8,10,20,"chr17",1,0.103141115799344
"19717","chr17.1735000.1740000","chr17.2120000.2125000",385000,10,0.002968499,1735000,2120000,1740000,2125000,"chr17",588989,1,9,7,17,"chr17",1,0.0199249882794187
"19718","chr17.8075000.8080000","chr17.8200000.8205000",125000,23,3.406872e-07,8075000,8200000,8080000,8205000,"chr17",589002,1,12,7,20,"chr17",1,0.0539146741678387
"19719","chr17.45190000.45195000","chr17.45260000.45265000",70000,23,0.0002514607,45190000,45260000,45195000,45265000,"chr17",589025,4,5,4,13,"chr17",1,0.0350445382090952
"19720","chr17.7305000.7310000","chr17.7475000.7480000",170000,17,8.129997e-05,7305000,7475000,7310000,7480000,"chr17",589095,6,10,2,18,"chr17",1,0.0358649789029536
"19721","chr17.10085000.10090000","chr17.10115000.10120000",30000,35,0.0003135319,10085000,10115000,10090000,10120000,"chr17",589142,0,4,0,4,"chr17",1,0.0164088138771683
"19722","chr17.44135000.44140000","chr17.44315000.44320000",180000,16,0.0001864275,44135000,44315000,44140000,44320000,"chr17",589198,0,6,6,12,"chr17",1,0.0225035161744023
"19723","chr17.10070000.10075000","chr17.10115000.10120000",45000,24,0.008636132,10070000,10115000,10075000,10120000,"chr17",589199,0,3,0,3,"chr17",1,0.00843881856540084
"19724","chr17.11550000.11555000","chr17.11825000.11830000",275000,11,0.005073532,11550000,11825000,11555000,11830000,"chr17",589202,0,3,2,5,"chr17",1,0.00644631973745898
"19725","chr17.78115000.78120000","chr17.78230000.78235000",115000,16,0.004751828,78115000,78230000,78120000,78235000,"chr17",589233,4,4,12,20,"chr17",1,0.0375058602906704
"19726","chr17.7330000.7335000","chr17.7390000.7395000",60000,23,0.001330375,7330000,7390000,7335000,7395000,"chr17",589285,1,3,3,7,"chr17",1,0.0188701359587436
"19727","chr17.55355000.55360000","chr17.55510000.55515000",155000,16,0.000632367,55355000,55510000,55360000,55515000,"chr17",589289,1,1,1,3,"chr17",1,0.00562587904360056
"19728","chr17.66740000.66745000","chr17.67150000.67155000",410000,9,0.008384213,66740000,67150000,66745000,67155000,"chr17",589354,0,2,1,3,"chr17",1,0.00316455696202532
"19729","chr17.75620000.75625000","chr17.75665000.75670000",45000,24,0.008636132,75620000,75665000,75625000,75670000,"chr17",589360,0,7,1,8,"chr17",1,0.0225035161744023
"19730","chr17.43720000.43725000","chr17.43940000.43945000",220000,13,0.001798254,43720000,43940000,43725000,43945000,"chr17",589379,0,1,0,1,"chr17",1,0.00152367557430849
"19731","chr17.28160000.28165000","chr17.29060000.29065000",900000,7,0.002671315,28160000,29060000,28165000,29065000,"chr17",589381,7,10,18,35,"chr17",1,0.0287154242850445
"19732","chr17.5615000.5620000","chr17.6195000.6200000",580000,10,0.0001926085,5615000,6195000,5620000,6200000,"chr17",589405,0,2,3,5,"chr17",1,0.00586029067041725
"19733","chr17.16985000.16990000","chr17.17160000.17165000",175000,14,0.002807183,16985000,17160000,16990000,17165000,"chr17",589427,0,1,1,2,"chr17",1,0.00328176277543366
"19734","chr17.4700000.4705000","chr17.4805000.4810000",105000,20,0.0001178513,4700000,4805000,4705000,4810000,"chr17",589434,5,13,4,22,"chr17",1,0.0515705578996718
"19735","chr17.57900000.57905000","chr17.57935000.57940000",35000,34,5.052679e-05,57900000,57935000,57905000,57940000,"chr17",589443,3,14,10,27,"chr17",1,0.107594936708861
"19736","chr17.8090000.8095000","chr17.8190000.8195000",100000,20,0.0001864275,8090000,8190000,8095000,8195000,"chr17",589445,1,13,10,24,"chr17",1,0.0562587904360056
"19737","chr17.27295000.27300000","chr17.27445000.27450000",150000,21,9.149042e-07,27295000,27445000,27300000,27450000,"chr17",589456,3,8,15,26,"chr17",1,0.0639943741209564
"19738","chr17.17765000.17770000","chr17.17925000.17930000",160000,14,0.005053586,17765000,17925000,17770000,17930000,"chr17",589469,4,5,4,13,"chr17",1,0.0213314580403188
"19739","chr17.8200000.8205000","chr17.8225000.8230000",25000,35,0.006199316,8200000,8225000,8205000,8230000,"chr17",589480,0,9,4,13,"chr17",1,0.053328645100797
"19740","chr17.2390000.2395000","chr17.2580000.2585000",190000,13,0.005053586,2390000,2580000,2395000,2585000,"chr17",589509,4,15,10,29,"chr17",1,0.0441865916549461
"19741","chr17.66895000.66900000","chr17.67220000.67225000",325000,19,1.508645e-09,66895000,67220000,66900000,67225000,"chr17",589511,0,4,6,10,"chr17",1,0.0222691045475856
"19742","chr17.73290000.73295000","chr17.73310000.73315000",20000,53,3.190124e-08,73290000,73310000,73295000,73315000,"chr17",589541,2,4,4,10,"chr17",1,0.0621190811064229
"19743","chr17.49405000.49410000","chr17.49665000.49670000",260000,11,0.007112204,49405000,49665000,49410000,49670000,"chr17",589554,1,6,22,29,"chr17",1,0.0373886544772621
"19744","chr17.75075000.75080000","chr17.75270000.75275000",195000,14,0.001297715,75075000,75270000,75080000,75275000,"chr17",589582,5,7,6,18,"chr17",1,0.029535864978903
"19745","chr17.1160000.1165000","chr17.1455000.1460000",295000,11,0.003353606,1160000,1455000,1165000,1460000,"chr17",589602,4,23,35,62,"chr17",1,0.0799343647444913
"19746","chr17.29640000.29645000","chr17.29685000.29690000",45000,27,0.0007755452,29640000,29685000,29645000,29690000,"chr17",589615,5,17,22,44,"chr17",1,0.139240506329114
"19747","chr17.28810000.28815000","chr17.29120000.29125000",310000,10,0.009176202,28810000,29120000,28815000,29125000,"chr17",589616,1,3,10,14,"chr17",1,0.0164088138771683
"19748","chr17.76865000.76870000","chr17.76910000.76915000",45000,24,0.008636132,76865000,76910000,76870000,76915000,"chr17",589622,1,2,3,6,"chr17",1,0.0168776371308017
"19749","chr17.240000.245000","chr17.645000.650000",405000,11,0.0004817665,240000,645000,245000,650000,"chr17",589663,0,1,1,2,"chr17",1,0.00257852789498359
"19750","chr17.45740000.45745000","chr17.45825000.45830000",85000,21,0.0002956377,45740000,45825000,45745000,45830000,"chr17",589664,1,2,1,4,"chr17",1,0.00984528832630099
"19751","chr17.44135000.44140000","chr17.44195000.44200000",60000,31,2.054305e-07,44135000,44195000,44140000,44200000,"chr17",589687,1,3,2,6,"chr17",1,0.0218002812939522
"19752","chr17.47645000.47650000","chr17.47785000.47790000",140000,37,4.77501e-19,47645000,47785000,47650000,47790000,"chr17",589718,6,23,23,52,"chr17",1,0.225503984997656
"19753","chr17.73910000.73915000","chr17.74335000.74340000",425000,12,6.345905e-05,73910000,74335000,73915000,74340000,"chr17",589931,3,3,3,9,"chr17",1,0.0126582278481013
"19754","chr17.80475000.80480000","chr17.80500000.80505000",25000,35,0.006199316,80475000,80500000,80480000,80505000,"chr17",589938,0,0,8,8,"chr17",1,0.0328176277543366
"19755","chr17.40540000.40545000","chr17.40610000.40615000",70000,25,2.835169e-05,40540000,40610000,40545000,40615000,"chr17",589956,2,5,7,14,"chr17",1,0.0410220346929208
"19756","chr17.66810000.66815000","chr17.67065000.67070000",255000,14,0.0001422003,66810000,67065000,66815000,67070000,"chr17",589963,2,9,16,27,"chr17",1,0.0443037974683544
"19757","chr17.4160000.4165000","chr17.4255000.4260000",95000,17,0.006604669,4160000,4255000,4165000,4260000,"chr17",589966,1,2,3,6,"chr17",1,0.0119549929676512
"19758","chr17.67175000.67180000","chr17.67220000.67225000",45000,28,0.0003174977,67175000,67220000,67180000,67225000,"chr17",589972,3,4,7,14,"chr17",1,0.0459446788560713
"19759","chr17.20120000.20125000","chr17.20155000.20160000",35000,28,0.006465994,20120000,20155000,20125000,20160000,"chr17",590024,3,6,7,16,"chr17",1,0.0525082044069386
"19760","chr17.57860000.57865000","chr17.57905000.57910000",45000,42,2.906486e-11,57860000,57905000,57865000,57910000,"chr17",590035,4,10,9,23,"chr17",1,0.113220815752461
"19761","chr17.17990000.17995000","chr17.18085000.18090000",95000,17,0.006604669,17990000,18085000,17995000,18090000,"chr17",590042,5,8,10,23,"chr17",1,0.0458274730426629
"19762","chr17.4215000.4220000","chr17.4255000.4260000",40000,41,1.619389e-09,4215000,4255000,4220000,4260000,"chr17",590052,1,7,3,11,"chr17",1,0.0528598218471636
"19763","chr17.41960000.41965000","chr17.41985000.41990000",25000,37,0.001677404,41960000,41985000,41965000,41990000,"chr17",590098,5,13,17,35,"chr17",1,0.151781528363807
"19764","chr17.1265000.1270000","chr17.1420000.1425000",155000,20,2.823257e-06,1265000,1420000,1270000,1425000,"chr17",590119,2,14,12,28,"chr17",1,0.0656352555086732
"19765","chr17.40165000.40170000","chr17.40265000.40270000",100000,22,1.644486e-05,40165000,40265000,40170000,40270000,"chr17",590126,8,16,19,43,"chr17",1,0.110876699484294
"19766","chr17.1275000.1280000","chr17.1350000.1355000",75000,30,1.777707e-08,1275000,1350000,1280000,1355000,"chr17",590139,3,14,19,36,"chr17",1,0.126582278481013
"19767","chr17.78430000.78435000","chr17.78840000.78845000",410000,12,8.40812e-05,78430000,78840000,78435000,78845000,"chr17",590162,1,5,6,12,"chr17",1,0.0168776371308017
"19768","chr17.20070000.20075000","chr17.20115000.20120000",45000,37,1.929903e-08,20070000,20115000,20075000,20120000,"chr17",590172,6,5,6,17,"chr17",1,0.073722456633849
"19769","chr17.8080000.8085000","chr17.8190000.8195000",110000,17,0.002322693,8080000,8190000,8085000,8195000,"chr17",590178,0,6,6,12,"chr17",1,0.0239099859353024
"19770","chr17.76420000.76425000","chr17.76450000.76455000",30000,32,0.003008376,76420000,76450000,76425000,76455000,"chr17",590180,1,5,4,10,"chr17",1,0.0375058602906704
"19771","chr17.2745000.2750000","chr17.2890000.2895000",145000,16,0.001035113,2745000,2890000,2750000,2895000,"chr17",590182,0,10,10,20,"chr17",1,0.0375058602906704
"19772","chr17.8080000.8085000","chr17.8125000.8130000",45000,28,0.0003174977,8080000,8125000,8085000,8130000,"chr17",590209,0,6,6,12,"chr17",1,0.0393811533052039
"19773","chr17.40110000.40115000","chr17.40155000.40160000",45000,47,2.244207e-14,40110000,40155000,40115000,40160000,"chr17",590258,0,2,5,7,"chr17",1,0.0385607126113455
"19774","chr17.43710000.43715000","chr17.44345000.44350000",635000,11,1.399163e-05,43710000,44345000,43715000,44350000,"chr17",590289,1,2,1,4,"chr17",1,0.00515705578996718
"19775","chr17.10035000.10040000","chr17.10115000.10120000",80000,21,0.0005315089,10035000,10115000,10040000,10120000,"chr17",590312,0,4,0,4,"chr17",1,0.00984528832630099
"19776","chr17.64300000.64305000","chr17.64505000.64510000",205000,18,2.709556e-06,64300000,64505000,64305000,64510000,"chr17",590318,2,4,6,12,"chr17",1,0.0253164556962025
"19777","chr17.67565000.67570000","chr17.68170000.68175000",605000,8,0.004423662,67565000,68170000,67570000,68175000,"chr17",590335,2,9,8,19,"chr17",1,0.0178152836380684
"19778","chr17.57695000.57700000","chr17.58155000.58160000",460000,12,3.277209e-05,57695000,58155000,57700000,58160000,"chr17",590336,0,1,0,1,"chr17",1,0.00140646976090014
"19779","chr17.57870000.57875000","chr17.57910000.57915000",40000,30,0.0002378979,57870000,57910000,57875000,57915000,"chr17",590338,1,6,3,10,"chr17",1,0.0351617440225035
"19780","chr17.38380000.38385000","chr17.38440000.38445000",60000,28,7.503136e-06,38380000,38440000,38385000,38445000,"chr17",590344,4,10,4,18,"chr17",1,0.0590717299578059
"19781","chr17.28810000.28815000","chr17.29130000.29135000",320000,10,0.00782802,28810000,29130000,28815000,29135000,"chr17",590372,1,6,2,9,"chr17",1,0.0105485232067511
"19782","chr17.8015000.8020000","chr17.8200000.8205000",185000,29,2.191646e-14,8015000,8200000,8020000,8205000,"chr17",590438,1,4,4,9,"chr17",1,0.0305907172995781
"19783","chr17.67975000.67980000","chr17.68015000.68020000",40000,26,0.006199316,67975000,68015000,67980000,68020000,"chr17",590447,6,23,22,51,"chr17",1,0.155414908579466
"19784","chr17.19350000.19355000","chr17.19405000.19410000",55000,40,5.129758e-12,19350000,19405000,19355000,19410000,"chr17",590466,5,11,13,29,"chr17",1,0.13595874355368
"19785","chr17.47790000.47795000","chr17.47830000.47835000",40000,28,0.001330375,47790000,47830000,47795000,47835000,"chr17",590472,4,8,12,24,"chr17",1,0.0787623066104079
"19786","chr17.80480000.80485000","chr17.80525000.80530000",45000,27,0.0007755452,80480000,80525000,80485000,80530000,"chr17",590568,2,4,1,7,"chr17",1,0.0221518987341772
"19787","chr17.38295000.38300000","chr17.38320000.38325000",25000,59,1.13575e-12,38295000,38320000,38300000,38325000,"chr17",590590,2,10,4,16,"chr17",1,0.110642287857478
"19788","chr17.45310000.45315000","chr17.45370000.45375000",60000,34,3.968091e-09,45310000,45370000,45315000,45375000,"chr17",590622,4,12,5,21,"chr17",1,0.0836849507735584
"19789","chr17.74340000.74345000","chr17.74450000.74455000",110000,17,0.002322693,74340000,74450000,74345000,74455000,"chr17",590639,0,3,0,3,"chr17",1,0.0059774964838256
"19790","chr17.45260000.45265000","chr17.45740000.45745000",480000,10,0.0007309901,45260000,45740000,45265000,45745000,"chr17",590670,1,5,1,7,"chr17",1,0.00820440693858415
"19791","chr17.3635000.3640000","chr17.3720000.3725000",85000,26,6.696078e-07,3635000,3720000,3640000,3725000,"chr17",590705,1,7,5,13,"chr17",1,0.0396155649320206
"19792","chr17.40120000.40125000","chr17.40165000.40170000",45000,31,1.722114e-05,40120000,40165000,40125000,40170000,"chr17",590759,4,8,3,15,"chr17",1,0.0545007032348805
"19793","chr17.8015000.8020000","chr17.8185000.8190000",170000,14,0.003384381,8015000,8185000,8020000,8190000,"chr17",590762,0,2,0,2,"chr17",1,0.00328176277543366
"19794","chr17.6830000.6835000","chr17.6870000.6875000",40000,33,1.381299e-05,6830000,6870000,6835000,6875000,"chr17",590794,2,6,7,15,"chr17",1,0.0580168776371308
"19795","chr17.66255000.66260000","chr17.66455000.66460000",200000,39,5.400272e-25,66255000,66455000,66260000,66460000,"chr17",590819,1,12,6,19,"chr17",1,0.0868495077355837
"19796","chr17.76710000.76715000","chr17.76745000.76750000",35000,30,0.001475334,76710000,76745000,76715000,76750000,"chr17",590876,4,16,13,33,"chr17",1,0.116033755274262
"19797","chr17.19955000.19960000","chr17.19975000.19980000",20000,50,5.48174e-07,19955000,19975000,19960000,19980000,"chr17",590944,2,16,13,31,"chr17",1,0.181669010782935
"19798","chr17.1995000.2000000","chr17.2015000.2020000",20000,41,0.0007264823,1995000,2015000,2e+06,2020000,"chr17",590965,0,2,0,2,"chr17",1,0.00961087669948429
"19799","chr17.75785000.75790000","chr17.75975000.75980000",190000,15,0.000439262,75785000,75975000,75790000,75980000,"chr17",590970,1,12,8,21,"chr17",1,0.0369198312236287
"19800","chr17.42085000.42090000","chr17.42140000.42145000",55000,26,0.0001996797,42085000,42140000,42090000,42145000,"chr17",590979,5,15,7,27,"chr17",1,0.0822784810126582
"19801","chr17.29645000.29650000","chr17.29685000.29690000",40000,28,0.001330375,29645000,29685000,29650000,29690000,"chr17",591030,6,17,22,45,"chr17",1,0.147679324894515
"19802","chr17.7995000.8000000","chr17.8200000.8205000",205000,26,1.327181e-12,7995000,8200000,8e+06,8205000,"chr17",591054,2,16,6,24,"chr17",1,0.0731364275668073
"19803","chr17.76240000.76245000","chr17.76415000.76420000",175000,16,0.0002378979,76240000,76415000,76245000,76420000,"chr17",591062,0,4,6,10,"chr17",1,0.0187529301453352
"19804","chr17.75520000.75525000","chr17.76010000.76015000",490000,9,0.003127184,75520000,76010000,75525000,76015000,"chr17",591095,1,6,5,12,"chr17",1,0.0126582278481013
"19805","chr17.45245000.45250000","chr17.45395000.45400000",150000,14,0.007438127,45245000,45395000,45250000,45400000,"chr17",591116,0,0,1,1,"chr17",1,0.00164088138771683
"19806","chr17.67365000.67370000","chr17.67475000.67480000",110000,18,0.0007858251,67365000,67475000,67370000,67480000,"chr17",591118,9,12,15,36,"chr17",1,0.0759493670886076
"19807","chr17.28140000.28145000","chr17.28250000.28255000",110000,30,2.724852e-11,28140000,28250000,28145000,28255000,"chr17",591123,0,1,1,2,"chr17",1,0.0070323488045007
"19808","chr17.66905000.66910000","chr17.67220000.67225000",315000,13,0.0001195859,66905000,67220000,66910000,67225000,"chr17",591153,1,4,1,6,"chr17",1,0.00914205344585091
"19809","chr17.10045000.10050000","chr17.10120000.10125000",75000,19,0.006265362,10045000,10120000,10050000,10125000,"chr17",591180,1,7,3,11,"chr17",1,0.0244960150023441
"19810","chr17.70550000.70555000","chr17.70620000.70625000",70000,20,0.004561686,70550000,70620000,70555000,70625000,"chr17",591207,0,1,0,1,"chr17",1,0.0023441162681669
"19811","chr17.66525000.66530000","chr17.67240000.67245000",715000,10,4.085538e-05,66525000,67240000,66530000,67245000,"chr17",591302,0,2,0,2,"chr17",1,0.0023441162681669
"19812","chr17.76485000.76490000","chr17.76840000.76845000",355000,10,0.004598869,76485000,76840000,76490000,76845000,"chr17",591316,5,21,20,46,"chr17",1,0.0539146741678387
"19813","chr17.67560000.67565000","chr17.68535000.68540000",975000,13,7.238213e-10,67560000,68535000,67565000,68540000,"chr17",591383,2,1,2,5,"chr17",1,0.00761837787154243
"19814","chr17.48940000.48945000","chr17.49225000.49230000",285000,16,1.992907e-06,48940000,49225000,48945000,49230000,"chr17",591397,4,12,15,31,"chr17",1,0.0581340834505391
"19815","chr17.29040000.29045000","chr17.29155000.29160000",115000,24,2.054305e-07,29040000,29155000,29045000,29160000,"chr17",591424,2,5,1,8,"chr17",1,0.0225035161744023
"19816","chr17.8070000.8075000","chr17.8200000.8205000",130000,22,9.653708e-07,8070000,8200000,8075000,8205000,"chr17",591438,1,3,0,4,"chr17",1,0.0103141115799344
"19817","chr17.4175000.4180000","chr17.4260000.4265000",85000,19,0.002322693,4175000,4260000,4180000,4265000,"chr17",591584,3,2,2,7,"chr17",1,0.0155883731833099
"19818","chr17.76465000.76470000","chr17.76715000.76720000",250000,11,0.008964847,76465000,76715000,76470000,76720000,"chr17",591617,3,9,13,25,"chr17",1,0.0322315986872949
"19819","chr17.43990000.43995000","chr17.44010000.44015000",20000,40,0.001440905,43990000,44010000,43995000,44015000,"chr17",591627,5,21,20,46,"chr17",1,0.215658696671355
"19820","chr17.50860000.50865000","chr17.50890000.50895000",30000,31,0.005977364,50860000,50890000,50865000,50895000,"chr17",591629,3,4,3,10,"chr17",1,0.036333802156587
"19821","chr17.29155000.29160000","chr17.29585000.29590000",430000,15,2.032684e-07,29155000,29585000,29160000,29590000,"chr17",591638,0,0,1,1,"chr17",1,0.00175808720112518
"19822","chr17.66535000.66540000","chr17.66715000.66720000",180000,15,0.0006837759,66535000,66715000,66540000,66720000,"chr17",591661,1,3,7,11,"chr17",1,0.0193389592123769
"19823","chr17.27575000.27580000","chr17.27595000.27600000",20000,41,0.0007264823,27575000,27595000,27580000,27600000,"chr17",591697,1,1,0,2,"chr17",1,0.00961087669948429
"19824","chr17.62550000.62555000","chr17.62600000.62605000",50000,25,0.001456867,62550000,62600000,62555000,62605000,"chr17",591710,3,8,11,22,"chr17",1,0.0644631973745898
"19825","chr17.19270000.19275000","chr17.19340000.19345000",70000,21,0.001803429,19270000,19340000,19275000,19345000,"chr17",591711,0,6,3,9,"chr17",1,0.0221518987341772
"19826","chr17.9925000.9930000","chr17.10025000.10030000",100000,23,4.475317e-06,9925000,10025000,9930000,10030000,"chr17",591741,1,2,9,12,"chr17",1,0.0323488045007032
"19827","chr17.65155000.65160000","chr17.65200000.65205000",45000,24,0.008636132,65155000,65200000,65160000,65205000,"chr17",591773,3,8,6,17,"chr17",1,0.0478199718706048
"19828","chr17.28815000.28820000","chr17.29060000.29065000",245000,12,0.003021162,28815000,29060000,28820000,29065000,"chr17",591794,4,25,29,58,"chr17",1,0.0815752461322082
"19829","chr17.4700000.4705000","chr17.4785000.4790000",85000,45,1.042488e-20,4700000,4785000,4705000,4790000,"chr17",591810,4,6,4,14,"chr17",1,0.0738396624472574
"19830","chr17.45170000.45175000","chr17.45195000.45200000",25000,46,1.220588e-06,45170000,45195000,45175000,45200000,"chr17",591893,5,15,25,45,"chr17",1,0.242616033755274
"19831","chr17.40475000.40480000","chr17.40530000.40535000",55000,31,8.778478e-07,40475000,40530000,40480000,40535000,"chr17",591906,1,0,0,1,"chr17",1,0.0036333802156587
"19832","chr17.20010000.20015000","chr17.20120000.20125000",110000,18,0.0007858251,20010000,20120000,20015000,20125000,"chr17",591937,0,6,7,13,"chr17",1,0.0274261603375527
"19833","chr17.43715000.43720000","chr17.43900000.43905000",185000,19,1.816352e-06,43715000,43900000,43720000,43905000,"chr17",591942,0,3,3,6,"chr17",1,0.0133614627285513
"19834","chr17.27290000.27295000","chr17.27435000.27440000",145000,19,2.283675e-05,27290000,27435000,27295000,27440000,"chr17",591947,2,15,10,27,"chr17",1,0.060126582278481
"19835","chr17.50085000.50090000","chr17.50115000.50120000",30000,38,2.463395e-05,50085000,50115000,50090000,50120000,"chr17",591961,0,4,3,7,"chr17",1,0.0311767463666198
"19836","chr17.40120000.40125000","chr17.40155000.40160000",35000,37,2.802612e-06,40120000,40155000,40125000,40160000,"chr17",591993,4,8,3,15,"chr17",1,0.0650492264416315
"19837","chr17.58155000.58160000","chr17.58655000.58660000",500000,9,0.002781809,58155000,58655000,58160000,58660000,"chr17",592011,0,1,0,1,"chr17",1,0.00105485232067511
"19838","chr17.40165000.40170000","chr17.40300000.40305000",135000,16,0.001669024,40165000,40300000,40170000,40305000,"chr17",592039,2,12,6,20,"chr17",1,0.0375058602906704
"19839","chr17.66255000.66260000","chr17.67220000.67225000",965000,7,0.001454294,66255000,67220000,66260000,67225000,"chr17",592051,1,4,12,17,"chr17",1,0.0139474917955931
"19840","chr17.42155000.42160000","chr17.42175000.42180000",20000,37,0.009020766,42155000,42175000,42160000,42180000,"chr17",592094,10,16,10,36,"chr17",1,0.156118143459916
"19841","chr17.49450000.49455000","chr17.49615000.49620000",165000,19,6.407419e-06,49450000,49615000,49455000,49620000,"chr17",592096,7,17,9,33,"chr17",1,0.0734880450070323
"19842","chr17.1930000.1935000","chr17.2180000.2185000",250000,14,0.0001700854,1930000,2180000,1935000,2185000,"chr17",592097,1,7,7,15,"chr17",1,0.0246132208157525
"19843","chr17.27575000.27580000","chr17.27880000.27885000",305000,11,0.002782725,27575000,27880000,27580000,27885000,"chr17",592156,1,1,0,2,"chr17",1,0.00257852789498359
"19844","chr17.4160000.4165000","chr17.4215000.4220000",55000,23,0.003138651,4160000,4215000,4165000,4220000,"chr17",592157,2,2,3,7,"chr17",1,0.0188701359587436
"19845","chr17.19405000.19410000","chr17.19670000.19675000",265000,17,7.562591e-07,19405000,19670000,19410000,19675000,"chr17",592159,3,8,8,19,"chr17",1,0.0378574777308955
"19846","chr17.38320000.38325000","chr17.38440000.38445000",120000,16,0.003580214,38320000,38440000,38325000,38445000,"chr17",592165,2,10,4,16,"chr17",1,0.0300046882325363
"19847","chr17.4700000.4705000","chr17.4790000.4795000",90000,25,1.178319e-06,4700000,4790000,4705000,4795000,"chr17",592186,2,13,4,19,"chr17",1,0.0556727613689639
"19848","chr17.67685000.67690000","chr17.68260000.68265000",575000,8,0.005857299,67685000,68260000,67690000,68265000,"chr17",592195,0,5,5,10,"chr17",1,0.00937646507266761
"19849","chr17.77855000.77860000","chr17.77940000.77945000",85000,21,0.0002956377,77855000,77940000,77860000,77945000,"chr17",592220,0,3,2,5,"chr17",1,0.0123066104078762
"19850","chr17.76865000.76870000","chr17.76930000.76935000",65000,23,0.0005604358,76865000,76930000,76870000,76935000,"chr17",592222,1,2,5,8,"chr17",1,0.0215658696671355
"19851","chr17.29215000.29220000","chr17.29690000.29695000",475000,10,0.0007869394,29215000,29690000,29220000,29695000,"chr17",592234,2,8,10,20,"chr17",1,0.023441162681669
"19852","chr17.38595000.38600000","chr17.38715000.38720000",120000,25,2.602302e-08,38595000,38715000,38600000,38720000,"chr17",592249,0,1,1,2,"chr17",1,0.00586029067041725
"19853","chr17.47490000.47495000","chr17.47785000.47790000",295000,14,4.085843e-05,47490000,47785000,47495000,47790000,"chr17",592252,5,23,23,51,"chr17",1,0.0836849507735584
"19854","chr17.72975000.72980000","chr17.73155000.73160000",180000,15,0.0006837759,72975000,73155000,72980000,73160000,"chr17",592261,1,5,3,9,"chr17",1,0.0158227848101266
"19855","chr17.45305000.45310000","chr17.45385000.45390000",80000,23,5.934798e-05,45305000,45385000,45310000,45390000,"chr17",592279,0,3,7,10,"chr17",1,0.0269573370839194
"19856","chr17.57865000.57870000","chr17.57905000.57910000",40000,52,4.001814e-16,57865000,57905000,57870000,57910000,"chr17",592288,0,2,1,3,"chr17",1,0.0182841068917018
"19857","chr17.66255000.66260000","chr17.66755000.66760000",500000,22,1.812275e-15,66255000,66755000,66260000,66760000,"chr17",592295,0,3,10,13,"chr17",1,0.0335208626347867
"19858","chr17.42995000.43000000","chr17.43165000.43170000",170000,15,0.00105831,42995000,43165000,4.3e+07,43170000,"chr17",592297,2,4,9,15,"chr17",1,0.0263713080168776
"19859","chr17.43715000.43720000","chr17.43915000.43920000",200000,13,0.003554552,43715000,43915000,43720000,43920000,"chr17",592301,0,6,10,16,"chr17",1,0.0243788091889358
"19860","chr17.27470000.27475000","chr17.27815000.27820000",345000,10,0.005353383,27470000,27815000,27475000,27820000,"chr17",592414,4,6,5,15,"chr17",1,0.0175808720112518
"19861","chr17.42180000.42185000","chr17.42245000.42250000",65000,27,7.516738e-06,42180000,42245000,42185000,42250000,"chr17",592452,2,7,2,11,"chr17",1,0.0348101265822785
"19862","chr17.19250000.19255000","chr17.19340000.19345000",90000,22,5.19916e-05,19250000,19340000,19255000,19345000,"chr17",592457,0,6,3,9,"chr17",1,0.0232067510548523
"19863","chr17.74295000.74300000","chr17.74370000.74375000",75000,20,0.002565106,74295000,74370000,74300000,74375000,"chr17",592471,1,2,4,7,"chr17",1,0.0164088138771683
"19864","chr17.17255000.17260000","chr17.17375000.17380000",120000,15,0.009692374,17255000,17375000,17260000,17380000,"chr17",592499,3,7,5,15,"chr17",1,0.0263713080168776
"19865","chr17.8090000.8095000","chr17.8195000.8200000",105000,28,1.56232e-09,8090000,8195000,8095000,8200000,"chr17",592517,1,13,10,24,"chr17",1,0.0787623066104079
"19866","chr17.41665000.41670000","chr17.41710000.41715000",45000,28,0.0003174977,41665000,41710000,41670000,41715000,"chr17",592545,0,4,3,7,"chr17",1,0.0229723394280356
"19867","chr17.17320000.17325000","chr17.17550000.17555000",230000,13,0.001330375,17320000,17550000,17325000,17555000,"chr17",592587,0,9,5,14,"chr17",1,0.0213314580403188
"19868","chr17.2015000.2020000","chr17.2120000.2125000",105000,17,0.003221243,2015000,2120000,2020000,2125000,"chr17",592627,0,2,0,2,"chr17",1,0.00398499765588373
"19869","chr17.43415000.43420000","chr17.43440000.43445000",25000,35,0.006199316,43415000,43440000,43420000,43445000,"chr17",592636,8,12,23,43,"chr17",1,0.176394749179559
"19870","chr17.27290000.27295000","chr17.27595000.27600000",305000,11,0.002782725,27290000,27595000,27295000,27600000,"chr17",592643,2,5,3,10,"chr17",1,0.012892639474918
"19871","chr17.18090000.18095000","chr17.18160000.18165000",70000,22,0.0006966348,18090000,18160000,18095000,18165000,"chr17",592646,1,2,3,6,"chr17",1,0.0154711673699015
"19872","chr17.17235000.17240000","chr17.17550000.17555000",315000,10,0.008495702,17235000,17550000,17240000,17555000,"chr17",592681,0,9,5,14,"chr17",1,0.0164088138771683
"19873","chr17.27510000.27515000","chr17.27535000.27540000",25000,38,0.0008488783,27510000,27535000,27515000,27540000,"chr17",592682,1,2,1,4,"chr17",1,0.0178152836380684
"19874","chr17.39955000.39960000","chr17.40155000.40160000",200000,14,0.001055259,39955000,40155000,39960000,40160000,"chr17",592683,9,22,26,57,"chr17",1,0.0935302390998594
"19875","chr17.49395000.49400000","chr17.49615000.49620000",220000,20,3.858974e-08,49395000,49615000,49400000,49620000,"chr17",592729,13,17,24,54,"chr17",1,0.126582278481013
"19876","chr17.76545000.76550000","chr17.76695000.76700000",150000,14,0.007438127,76545000,76695000,76550000,76700000,"chr17",592737,1,2,2,5,"chr17",1,0.00820440693858415
"19877","chr17.67525000.67530000","chr17.68045000.68050000",520000,9,0.002179314,67525000,68045000,67530000,68050000,"chr17",592745,3,13,9,25,"chr17",1,0.0263713080168776
"19878","chr17.43690000.43695000","chr17.44305000.44310000",615000,87,7.343396e-123,43690000,44305000,43695000,44310000,"chr17",592752,1,5,4,10,"chr17",1,0.10196905766526
"19879","chr17.67005000.67010000","chr17.67065000.67070000",60000,22,0.003186159,67005000,67065000,67010000,67070000,"chr17",592786,4,3,3,10,"chr17",1,0.0257852789498359
"19880","chr17.73770000.73775000","chr17.73865000.73870000",95000,18,0.0025599,73770000,73865000,73775000,73870000,"chr17",592805,0,5,2,7,"chr17",1,0.0147679324894515
"19881","chr17.75075000.75080000","chr17.75225000.75230000",150000,22,1.971042e-07,75075000,75225000,75080000,75230000,"chr17",592813,1,1,0,2,"chr17",1,0.00515705578996718
"19882","chr17.31095000.31100000","chr17.31250000.31255000",155000,14,0.006199316,31095000,31250000,31100000,31255000,"chr17",592817,1,0,1,2,"chr17",1,0.00328176277543366
"19883","chr17.76370000.76375000","chr17.76715000.76720000",345000,10,0.005353383,76370000,76715000,76375000,76720000,"chr17",592869,5,13,11,29,"chr17",1,0.0339896858884201
"19884","chr17.56890000.56895000","chr17.56975000.56980000",85000,19,0.002322693,56890000,56975000,56895000,56980000,"chr17",592873,1,1,2,4,"chr17",1,0.00890764181903422
"19885","chr17.74175000.74180000","chr17.74275000.74280000",100000,19,0.0005767508,74175000,74275000,74180000,74280000,"chr17",592888,1,5,4,10,"chr17",1,0.0222691045475856
"19886","chr17.8055000.8060000","chr17.8200000.8205000",145000,14,0.009049365,8055000,8200000,8060000,8205000,"chr17",592930,2,11,6,19,"chr17",1,0.0311767463666198
"19887","chr17.1760000.1765000","chr17.2190000.2195000",430000,11,0.0003117744,1760000,2190000,1765000,2195000,"chr17",592957,0,8,8,16,"chr17",1,0.0206282231598687
"19888","chr17.27295000.27300000","chr17.27390000.27395000",95000,44,3.226837e-21,27295000,27390000,27300000,27395000,"chr17",592996,1,1,8,10,"chr17",1,0.0515705578996718
"19889","chr17.76010000.76015000","chr17.76070000.76075000",60000,26,6.782354e-05,76010000,76070000,76015000,76075000,"chr17",593020,1,6,7,14,"chr17",1,0.0426629160806376
"19890","chr17.17135000.17140000","chr17.17180000.17185000",45000,37,1.929903e-08,17135000,17180000,17140000,17185000,"chr17",593100,0,0,1,1,"chr17",1,0.00433661509610877
"19891","chr17.57600000.57605000","chr17.57935000.57940000",335000,10,0.006206957,57600000,57935000,57605000,57940000,"chr17",593114,0,2,3,5,"chr17",1,0.00586029067041725
"19892","chr17.38345000.38350000","chr17.38440000.38445000",95000,21,9.549038e-05,38345000,38440000,38350000,38445000,"chr17",593125,4,10,4,18,"chr17",1,0.0443037974683544
"19893","chr17.58755000.58760000","chr17.59310000.59315000",555000,9,0.001456867,58755000,59310000,58760000,59315000,"chr17",593153,1,11,10,22,"chr17",1,0.0232067510548523
"19894","chr17.8300000.8305000","chr17.8660000.8665000",360000,11,0.001035018,8300000,8660000,8305000,8665000,"chr17",593239,3,8,3,14,"chr17",1,0.0180496952648851
"19895","chr17.67585000.67590000","chr17.68520000.68525000",935000,7,0.001943106,67585000,68520000,67590000,68525000,"chr17",593265,2,4,0,6,"chr17",1,0.00492264416315049
"19896","chr17.17990000.17995000","chr17.18215000.18220000",225000,12,0.005288901,17990000,18215000,17995000,18220000,"chr17",593286,5,8,10,23,"chr17",1,0.0323488045007032
"19897","chr17.4175000.4180000","chr17.4300000.4305000",125000,15,0.007686624,4175000,4300000,4180000,4305000,"chr17",593318,3,2,2,7,"chr17",1,0.0123066104078762
"19898","chr17.4100000.4105000","chr17.4300000.4305000",200000,14,0.001055259,4100000,4300000,4105000,4305000,"chr17",593319,7,9,16,32,"chr17",1,0.0525082044069386
"19899","chr17.78730000.78735000","chr17.78795000.78800000",65000,23,0.0005604358,78730000,78795000,78735000,78800000,"chr17",593363,2,0,2,4,"chr17",1,0.0107829348335677
"19900","chr17.29130000.29135000","chr17.29155000.29160000",25000,35,0.006199316,29130000,29155000,29135000,29160000,"chr17",593369,1,5,1,7,"chr17",1,0.0287154242850445
"19901","chr17.55340000.55345000","chr17.55510000.55515000",170000,15,0.00105831,55340000,55510000,55345000,55515000,"chr17",593379,1,1,1,3,"chr17",1,0.00527426160337553
"19902","chr17.67065000.67070000","chr17.67220000.67225000",155000,18,4.830293e-05,67065000,67220000,67070000,67225000,"chr17",593386,3,4,12,19,"chr17",1,0.040084388185654
"19903","chr17.76240000.76245000","chr17.76330000.76335000",90000,18,0.003838454,76240000,76330000,76245000,76335000,"chr17",593394,0,9,8,17,"chr17",1,0.0358649789029536
"19904","chr17.56715000.56720000","chr17.57090000.57095000",375000,15,8.469976e-07,56715000,57090000,56720000,57095000,"chr17",593410,4,1,1,6,"chr17",1,0.0105485232067511
"19905","chr17.28710000.28715000","chr17.29040000.29045000",330000,11,0.001716313,28710000,29040000,28715000,29045000,"chr17",593434,6,13,13,32,"chr17",1,0.0412564463197375
"19906","chr17.8375000.8380000","chr17.8530000.8535000",155000,14,0.006199316,8375000,8530000,8380000,8535000,"chr17",593514,3,1,5,9,"chr17",1,0.0147679324894515
"19907","chr17.59230000.59235000","chr17.59310000.59315000",80000,19,0.003777533,59230000,59310000,59235000,59315000,"chr17",593570,1,6,18,25,"chr17",1,0.0556727613689639
"19908","chr17.27965000.27970000","chr17.28140000.28145000",175000,17,6.17513e-05,27965000,28140000,27970000,28145000,"chr17",593596,0,1,1,2,"chr17",1,0.00398499765588373
"19909","chr17.44185000.44190000","chr17.44220000.44225000",35000,43,3.827743e-09,44185000,44220000,44190000,44225000,"chr17",593607,6,16,8,30,"chr17",1,0.151195499296765
"19910","chr17.55385000.55390000","chr17.55460000.55465000",75000,19,0.006265362,55385000,55460000,55390000,55465000,"chr17",593623,0,10,3,13,"chr17",1,0.0289498359118612
"19911","chr17.19460000.19465000","chr17.19510000.19515000",50000,23,0.007407055,19460000,19510000,19465000,19515000,"chr17",593624,4,13,10,27,"chr17",1,0.0727848101265823
"19912","chr17.46775000.46780000","chr17.47100000.47105000",325000,10,0.007255421,46775000,47100000,46780000,47105000,"chr17",593696,1,8,8,17,"chr17",1,0.0199249882794187
"19913","chr17.43710000.43715000","chr17.43915000.43920000",205000,14,0.0008606318,43710000,43915000,43715000,43920000,"chr17",593720,1,2,1,4,"chr17",1,0.00656352555086732
"19914","chr17.27445000.27450000","chr17.27595000.27600000",150000,15,0.002566533,27445000,27595000,27450000,27600000,"chr17",593748,2,5,3,10,"chr17",1,0.0175808720112518
"19915","chr17.28010000.28015000","chr17.28250000.28255000",240000,17,2.304802e-06,28010000,28250000,28015000,28255000,"chr17",593749,4,10,12,26,"chr17",1,0.0518049695264885
"19916","chr17.76880000.76885000","chr17.76915000.76920000",35000,28,0.006465994,76880000,76915000,76885000,76920000,"chr17",593923,3,6,12,21,"chr17",1,0.0689170182841069
"19917","chr17.75075000.75080000","chr17.75245000.75250000",170000,19,4.652388e-06,75075000,75245000,75080000,75250000,"chr17",593924,2,11,8,21,"chr17",1,0.0467651195499297
"19918","chr17.2490000.2495000","chr17.2610000.2615000",120000,19,0.0001191501,2490000,2610000,2495000,2615000,"chr17",593936,3,21,22,46,"chr17",1,0.102437880918894
"19919","chr17.8155000.8160000","chr17.8200000.8205000",45000,52,9.620519e-18,8155000,8200000,8160000,8205000,"chr17",593937,2,15,8,25,"chr17",1,0.152367557430849
"19920","chr17.19405000.19410000","chr17.19765000.19770000",360000,10,0.004255345,19405000,19765000,19410000,19770000,"chr17",593938,1,11,10,22,"chr17",1,0.0257852789498359
"19921","chr17.29585000.29590000","chr17.29690000.29695000",105000,16,0.008528693,29585000,29690000,29590000,29695000,"chr17",593951,0,0,5,5,"chr17",1,0.00937646507266761
"19922","chr17.66455000.66460000","chr17.67240000.67245000",785000,13,2.072303e-08,66455000,67240000,66460000,67245000,"chr17",593975,0,2,0,2,"chr17",1,0.00304735114861697
"19923","chr17.28160000.28165000","chr17.28190000.28195000",30000,32,0.003008376,28160000,28190000,28165000,28195000,"chr17",593998,4,2,5,11,"chr17",1,0.0412564463197375
"19924","chr17.9925000.9930000","chr17.10095000.10100000",170000,21,2.102283e-07,9925000,10095000,9930000,10100000,"chr17",593999,1,2,9,12,"chr17",1,0.029535864978903
"19925","chr17.57600000.57605000","chr17.57910000.57915000",310000,10,0.009176202,57600000,57910000,57605000,57915000,"chr17",594028,0,2,3,5,"chr17",1,0.00586029067041725
"19926","chr17.43720000.43725000","chr17.43935000.43940000",215000,12,0.007097885,43720000,43935000,43725000,43940000,"chr17",594056,3,1,3,7,"chr17",1,0.00984528832630099
"19927","chr17.40155000.40160000","chr17.40305000.40310000",150000,16,0.0008042565,40155000,40305000,40160000,40310000,"chr17",594060,3,4,5,12,"chr17",1,0.0225035161744023
"19928","chr17.4830000.4835000","chr17.4950000.4955000",120000,18,0.000396224,4830000,4950000,4835000,4955000,"chr17",594064,0,9,14,23,"chr17",1,0.0485232067510548
"19929","chr17.42515000.42520000","chr17.42535000.42540000",20000,39,0.00274559,42515000,42535000,42520000,42540000,"chr17",594068,0,7,4,11,"chr17",1,0.05028129395218
"19930","chr17.55310000.55315000","chr17.55525000.55530000",215000,12,0.007097885,55310000,55525000,55315000,55530000,"chr17",594090,3,5,13,21,"chr17",1,0.029535864978903
"19931","chr17.19765000.19770000","chr17.19835000.19840000",70000,20,0.004561686,19765000,19835000,19770000,19840000,"chr17",594123,1,20,10,31,"chr17",1,0.0726676043131739
"19932","chr17.57375000.57380000","chr17.57560000.57565000",185000,15,0.0005481914,57375000,57560000,57380000,57565000,"chr17",594136,0,2,0,2,"chr17",1,0.00351617440225035
"19933","chr17.7650000.7655000","chr17.7685000.7690000",35000,32,0.000295732,7650000,7685000,7655000,7690000,"chr17",594176,0,4,4,8,"chr17",1,0.0300046882325363
"19934","chr17.50860000.50865000","chr17.50880000.50885000",20000,38,0.005053586,50860000,50880000,50865000,50885000,"chr17",594187,3,4,3,10,"chr17",1,0.0445382090951711
"19935","chr17.57745000.57750000","chr17.57905000.57910000",160000,15,0.001633505,57745000,57905000,57750000,57910000,"chr17",594192,0,0,3,3,"chr17",1,0.00527426160337553
"19936","chr17.8055000.8060000","chr17.8150000.8155000",95000,19,0.0008994793,8055000,8150000,8060000,8155000,"chr17",594197,0,6,4,10,"chr17",1,0.0222691045475856
"19937","chr17.57695000.57700000","chr17.57910000.57915000",215000,15,0.0001511474,57695000,57910000,57700000,57915000,"chr17",594200,2,1,2,5,"chr17",1,0.00879043600562588
"19938","chr17.29225000.29230000","chr17.29530000.29535000",305000,10,0.009980133,29225000,29530000,29230000,29535000,"chr17",594234,4,24,23,51,"chr17",1,0.059774964838256
"19939","chr17.44200000.44205000","chr17.44220000.44225000",20000,49,1.321553e-06,44200000,44220000,44205000,44225000,"chr17",594236,1,10,8,19,"chr17",1,0.109118612283169
"19940","chr17.73425000.73430000","chr17.73480000.73485000",55000,22,0.007097885,73425000,73480000,73430000,73485000,"chr17",594262,1,8,3,12,"chr17",1,0.0309423347398031
"19941","chr17.55260000.55265000","chr17.55295000.55300000",35000,35,1.986817e-05,55260000,55295000,55265000,55300000,"chr17",594301,1,7,7,15,"chr17",1,0.0615330520393812
"19942","chr17.8155000.8160000","chr17.8190000.8195000",35000,36,7.561078e-06,8155000,8190000,8160000,8195000,"chr17",594370,2,15,8,25,"chr17",1,0.105485232067511
"19943","chr17.74325000.74330000","chr17.74370000.74375000",45000,28,0.0003174977,74325000,74370000,74330000,74375000,"chr17",594379,0,2,2,4,"chr17",1,0.0131270511017346
"19944","chr17.8055000.8060000","chr17.8090000.8095000",35000,56,1.130977e-16,8055000,8090000,8060000,8095000,"chr17",594381,1,11,6,18,"chr17",1,0.118143459915612
"19945","chr17.2015000.2020000","chr17.2040000.2045000",25000,51,8.945005e-09,2015000,2040000,2020000,2045000,"chr17",594397,0,2,0,2,"chr17",1,0.0119549929676512
"19946","chr17.1275000.1280000","chr17.1455000.1460000",180000,13,0.007112204,1275000,1455000,1280000,1460000,"chr17",594534,3,14,19,36,"chr17",1,0.0548523206751055
"19947","chr17.76415000.76420000","chr17.76695000.76700000",280000,12,0.001236176,76415000,76695000,76420000,76700000,"chr17",594542,3,4,5,12,"chr17",1,0.0168776371308017
"19948","chr17.66520000.66525000","chr17.66980000.66985000",460000,9,0.004494737,66520000,66980000,66525000,66985000,"chr17",594558,5,9,6,20,"chr17",1,0.0210970464135021
"19949","chr17.37135000.37140000","chr17.37320000.37325000",185000,23,2.22557e-09,37135000,37320000,37140000,37325000,"chr17",594560,1,3,1,5,"chr17",1,0.0134786685419597
"19950","chr17.17780000.17785000","chr17.17935000.17940000",155000,17,0.0001821149,17780000,17935000,17785000,17940000,"chr17",594587,0,1,2,3,"chr17",1,0.0059774964838256
"19951","chr17.7550000.7555000","chr17.7585000.7590000",35000,32,0.000295732,7550000,7585000,7555000,7590000,"chr17",594594,0,4,2,6,"chr17",1,0.0225035161744023
"19952","chr17.8040000.8045000","chr17.8200000.8205000",160000,24,3.18967e-09,8040000,8200000,8045000,8205000,"chr17",594606,0,16,10,26,"chr17",1,0.0731364275668073
"19953","chr17.78730000.78735000","chr17.78840000.78845000",110000,16,0.00630077,78730000,78840000,78735000,78845000,"chr17",594638,1,5,6,12,"chr17",1,0.0225035161744023
"19954","chr17.49410000.49415000","chr17.49615000.49620000",205000,20,9.978735e-08,49410000,49615000,49415000,49620000,"chr17",594693,7,15,12,34,"chr17",1,0.0796999531176746
"19955","chr17.57110000.57115000","chr17.57130000.57135000",20000,42,0.0003625072,57110000,57130000,57115000,57135000,"chr17",594705,0,4,3,7,"chr17",1,0.0344585091420534
"19956","chr17.42020000.42025000","chr17.42245000.42250000",225000,16,2.246959e-05,42020000,42245000,42025000,42250000,"chr17",594713,1,6,4,11,"chr17",1,0.0206282231598687
"19957","chr17.34960000.34965000","chr17.35585000.35590000",625000,8,0.003689493,34960000,35585000,34965000,35590000,"chr17",594718,0,0,4,4,"chr17",1,0.00375058602906704
"19958","chr17.2400000.2405000","chr17.2580000.2585000",180000,18,1.116935e-05,2400000,2580000,2405000,2585000,"chr17",594728,0,4,3,7,"chr17",1,0.0147679324894515
"19959","chr17.66645000.66650000","chr17.67240000.67245000",595000,9,0.0009411755,66645000,67240000,66650000,67245000,"chr17",594729,0,2,0,2,"chr17",1,0.00210970464135021
"19960","chr17.44120000.44125000","chr17.44195000.44200000",75000,22,0.0003495807,44120000,44195000,44125000,44200000,"chr17",594801,1,3,2,6,"chr17",1,0.0154711673699015
"19961","chr17.57600000.57605000","chr17.57905000.57910000",305000,12,0.0006859043,57600000,57905000,57605000,57910000,"chr17",594811,0,2,3,5,"chr17",1,0.0070323488045007
"19962","chr17.20060000.20065000","chr17.20125000.20130000",65000,46,3.436408e-18,20060000,20125000,20065000,20130000,"chr17",594882,3,7,11,21,"chr17",1,0.113220815752461
"19963","chr17.59715000.59720000","chr17.60415000.60420000",700000,8,0.001989094,59715000,60415000,59720000,60420000,"chr17",594900,5,7,18,30,"chr17",1,0.0281293952180028
"19964","chr17.47785000.47790000","chr17.47925000.47930000",140000,17,0.0004053829,47785000,47925000,47790000,47930000,"chr17",594936,6,11,11,28,"chr17",1,0.0557899671823722
"19965","chr17.57855000.57860000","chr17.57940000.57945000",85000,18,0.006024578,57855000,57940000,57860000,57945000,"chr17",594938,1,8,4,13,"chr17",1,0.0274261603375527
"19966","chr17.28660000.28665000","chr17.29025000.29030000",365000,10,0.003958271,28660000,29025000,28665000,29030000,"chr17",594947,3,16,7,26,"chr17",1,0.0304735114861697
"19967","chr17.17010000.17015000","chr17.17135000.17140000",125000,17,0.0009204409,17010000,17135000,17015000,17140000,"chr17",594967,0,2,1,3,"chr17",1,0.0059774964838256
"19968","chr17.16285000.16290000","chr17.16425000.16430000",140000,27,1.185225e-10,16285000,16425000,16290000,16430000,"chr17",594975,0,4,0,4,"chr17",1,0.0126582278481013
"19969","chr17.8115000.8120000","chr17.8200000.8205000",85000,32,1.032112e-10,8115000,8200000,8120000,8205000,"chr17",594978,0,1,0,1,"chr17",1,0.00375058602906704
"19970","chr17.48940000.48945000","chr17.49190000.49195000",250000,14,0.0001700854,48940000,49190000,48945000,49195000,"chr17",595010,5,9,8,22,"chr17",1,0.0360993905297703
"19971","chr17.19905000.19910000","chr17.20125000.20130000",220000,12,0.006177371,19905000,20125000,19910000,20130000,"chr17",595041,3,7,11,21,"chr17",1,0.029535864978903
"19972","chr17.42890000.42895000","chr17.42935000.42940000",45000,24,0.008636132,42890000,42935000,42895000,42940000,"chr17",595047,6,27,21,54,"chr17",1,0.151898734177215
"19973","chr17.67390000.67395000","chr17.67525000.67530000",135000,15,0.004963891,67390000,67525000,67395000,67530000,"chr17",595052,3,11,8,22,"chr17",1,0.0386779184247539
"19974","chr17.76915000.76920000","chr17.76970000.76975000",55000,23,0.003138651,76915000,76970000,76920000,76975000,"chr17",595070,0,1,2,3,"chr17",1,0.00808720112517581
"19975","chr17.75110000.75115000","chr17.75215000.75220000",105000,19,0.0003774324,75110000,75215000,75115000,75220000,"chr17",595111,14,32,43,89,"chr17",1,0.198195030473511
"19976","chr17.42655000.42660000","chr17.42675000.42680000",20000,44,8.309867e-05,42655000,42675000,42660000,42680000,"chr17",595174,1,0,0,1,"chr17",1,0.00515705578996718
"19977","chr17.4030000.4035000","chr17.4275000.4280000",245000,12,0.003021162,4030000,4275000,4035000,4280000,"chr17",595177,2,15,15,32,"chr17",1,0.0450070323488045
"19978","chr17.2335000.2340000","chr17.2890000.2895000",555000,8,0.006989075,2335000,2890000,2340000,2895000,"chr17",595204,0,7,4,11,"chr17",1,0.0103141115799344
"19979","chr17.76865000.76870000","chr17.76965000.76970000",100000,30,1.379874e-10,76865000,76965000,76870000,76970000,"chr17",595212,1,2,5,8,"chr17",1,0.0281293952180028
"19980","chr17.16285000.16290000","chr17.16435000.16440000",150000,22,1.971042e-07,16285000,16435000,16290000,16440000,"chr17",595236,1,4,3,8,"chr17",1,0.0206282231598687
"19981","chr17.49435000.49440000","chr17.49615000.49620000",180000,19,2.488992e-06,49435000,49615000,49440000,49620000,"chr17",595249,1,1,3,5,"chr17",1,0.0111345522737928
"19982","chr17.45310000.45315000","chr17.45385000.45390000",75000,20,0.002565106,45310000,45385000,45315000,45390000,"chr17",595262,0,3,5,8,"chr17",1,0.0187529301453352
"19983","chr17.68015000.68020000","chr17.68035000.68040000",20000,44,8.309867e-05,68015000,68035000,68020000,68040000,"chr17",595272,6,17,20,43,"chr17",1,0.221753398968589
"19984","chr17.50785000.50790000","chr17.51260000.51265000",475000,9,0.003706677,50785000,51260000,50790000,51265000,"chr17",595273,4,15,17,36,"chr17",1,0.0379746835443038
"19985","chr17.66255000.66260000","chr17.66370000.66375000",115000,21,1.373981e-05,66255000,66370000,66260000,66375000,"chr17",595309,1,18,13,32,"chr17",1,0.0787623066104079
"19986","chr17.38865000.38870000","chr17.38885000.38890000",20000,43,0.000176468,38865000,38885000,38870000,38890000,"chr17",595313,4,5,4,13,"chr17",1,0.0655180496952649
"19987","chr17.4710000.4715000","chr17.4730000.4735000",20000,46,1.69784e-05,4710000,4730000,4715000,4735000,"chr17",595337,6,25,27,58,"chr17",1,0.312705110173465
"19988","chr17.45280000.45285000","chr17.45370000.45375000",90000,17,0.009638929,45280000,45370000,45285000,45375000,"chr17",595355,5,24,24,53,"chr17",1,0.105602437880919
"19989","chr17.73345000.73350000","chr17.73370000.73375000",25000,58,3.714439e-12,73345000,73370000,73350000,73375000,"chr17",595406,1,10,7,18,"chr17",1,0.122362869198312
"19990","chr17.37445000.37450000","chr17.37525000.37530000",80000,19,0.003777533,37445000,37525000,37450000,37530000,"chr17",595464,2,12,13,27,"chr17",1,0.060126582278481
"19991","chr17.79270000.79275000","chr17.79555000.79560000",285000,17,3.406872e-07,79270000,79555000,79275000,79560000,"chr17",595478,0,2,3,5,"chr17",1,0.00996249413970933
"19992","chr17.28660000.28665000","chr17.28720000.28725000",60000,25,0.0001893671,28660000,28720000,28665000,28725000,"chr17",595485,3,13,7,23,"chr17",1,0.0673933427097984
"19993","chr17.45195000.45200000","chr17.45260000.45265000",65000,26,2.354887e-05,45195000,45260000,45200000,45265000,"chr17",595616,4,5,4,13,"chr17",1,0.0396155649320206
"19994","chr17.40105000.40110000","chr17.40155000.40160000",50000,29,3.257849e-05,40105000,40155000,40110000,40160000,"chr17",595692,2,7,6,15,"chr17",1,0.0509845288326301
"19995","chr17.66535000.66540000","chr17.66740000.66745000",205000,12,0.00945475,66535000,66740000,66540000,66745000,"chr17",595700,0,2,1,3,"chr17",1,0.00421940928270042
"19996","chr17.17810000.17815000","chr17.17935000.17940000",125000,19,8.395866e-05,17810000,17935000,17815000,17940000,"chr17",595712,3,4,5,12,"chr17",1,0.0267229254571027
"19997","chr17.10045000.10050000","chr17.10115000.10120000",70000,20,0.004561686,10045000,10115000,10050000,10120000,"chr17",595801,0,4,0,4,"chr17",1,0.00937646507266761
"19998","chr17.40475000.40480000","chr17.40540000.40545000",65000,40,8.670652e-14,40475000,40540000,40480000,40545000,"chr17",595853,2,5,3,10,"chr17",1,0.046882325363338
"19999","chr17.28625000.28630000","chr17.28710000.28715000",85000,20,0.0008488783,28625000,28710000,28630000,28715000,"chr17",595864,6,13,14,33,"chr17",1,0.0773558368495077
"20000","chr17.10035000.10040000","chr17.10070000.10075000",35000,30,0.001475334,10035000,10070000,10040000,10075000,"chr17",595872,1,3,2,6,"chr17",1,0.0210970464135021
"20001","chr17.47905000.47910000","chr17.47925000.47930000",20000,42,0.0003625072,47905000,47925000,47910000,47930000,"chr17",595894,3,11,11,25,"chr17",1,0.123066104078762
"20002","chr17.19905000.19910000","chr17.20100000.20105000",195000,14,0.001297715,19905000,20100000,19910000,20105000,"chr17",595909,0,2,1,3,"chr17",1,0.00492264416315049
"20003","chr17.27510000.27515000","chr17.27595000.27600000",85000,21,0.0002956377,27510000,27595000,27515000,27600000,"chr17",595916,2,5,3,10,"chr17",1,0.0246132208157525
"20004","chr17.66900000.66905000","chr17.66950000.66955000",50000,24,0.003353606,66900000,66950000,66905000,66955000,"chr17",595931,2,6,5,13,"chr17",1,0.0365682137834037
"20005","chr17.66640000.66645000","chr17.67040000.67045000",400000,9,0.009430808,66640000,67040000,66645000,67045000,"chr17",595984,0,3,0,3,"chr17",1,0.00316455696202532
"20006","chr17.20095000.20100000","chr17.20125000.20130000",30000,38,2.463395e-05,20095000,20125000,20100000,20130000,"chr17",596004,0,1,1,2,"chr17",1,0.00890764181903422
"20007","chr17.76695000.76700000","chr17.76745000.76750000",50000,24,0.003353606,76695000,76745000,76700000,76750000,"chr17",596052,5,10,5,20,"chr17",1,0.0562587904360056
"20008","chr17.1755000.1760000","chr17.1995000.2000000",240000,14,0.0002378979,1755000,1995000,1760000,2e+06,"chr17",596149,0,6,4,10,"chr17",1,0.0164088138771683
"20009","chr17.20095000.20100000","chr17.20120000.20125000",25000,81,8.009213e-26,20095000,20120000,20100000,20125000,"chr17",596160,0,1,1,2,"chr17",1,0.0189873417721519
"20010","chr17.59715000.59720000","chr17.60290000.60295000",575000,8,0.005857299,59715000,60290000,59720000,60295000,"chr17",596191,1,0,1,2,"chr17",1,0.00187529301453352
"20011","chr17.76500000.76505000","chr17.76745000.76750000",245000,13,0.0008087704,76500000,76745000,76505000,76750000,"chr17",596204,5,18,13,36,"chr17",1,0.0548523206751055
"20012","chr17.78820000.78825000","chr17.78840000.78845000",20000,37,0.009020766,78820000,78840000,78825000,78845000,"chr17",596210,1,8,6,15,"chr17",1,0.0650492264416315
"20013","chr17.66255000.66260000","chr17.66520000.66525000",265000,13,0.000446511,66255000,66520000,66260000,66525000,"chr17",596212,1,9,6,16,"chr17",1,0.0243788091889358
"20014","chr17.28625000.28630000","chr17.28660000.28665000",35000,32,0.000295732,28625000,28660000,28630000,28665000,"chr17",596240,3,17,7,27,"chr17",1,0.10126582278481
"20015","chr17.7390000.7395000","chr17.7455000.7460000",65000,24,0.0002029063,7390000,7455000,7395000,7460000,"chr17",596243,1,3,3,7,"chr17",1,0.019690576652602
"20016","chr17.76520000.76525000","chr17.76695000.76700000",175000,13,0.008475646,76520000,76695000,76525000,76700000,"chr17",596260,4,10,5,19,"chr17",1,0.0289498359118612
"20017","chr17.67020000.67025000","chr17.67220000.67225000",200000,16,7.172136e-05,67020000,67220000,67025000,67225000,"chr17",596293,2,4,6,12,"chr17",1,0.0225035161744023
"20018","chr17.42515000.42520000","chr17.42550000.42555000",35000,36,7.561078e-06,42515000,42550000,42520000,42555000,"chr17",596299,0,7,4,11,"chr17",1,0.0464135021097046
"20019","chr17.5500000.5505000","chr17.6305000.6310000",805000,13,1.555096e-08,5500000,6305000,5505000,6310000,"chr17",596310,0,2,0,2,"chr17",1,0.00304735114861697
"20020","chr17.8125000.8130000","chr17.8200000.8205000",75000,59,2.030909e-31,8125000,8200000,8130000,8205000,"chr17",596318,2,19,15,36,"chr17",1,0.248945147679325
"20021","chr17.55260000.55265000","chr17.55310000.55315000",50000,24,0.003353606,55260000,55310000,55265000,55315000,"chr17",596355,1,5,7,13,"chr17",1,0.0365682137834037
"20022","chr17.68200000.68205000","chr17.68520000.68525000",320000,10,0.00782802,68200000,68520000,68205000,68525000,"chr17",596384,2,4,0,6,"chr17",1,0.0070323488045007
"20023","chr17.40555000.40560000","chr17.40610000.40615000",55000,50,5.930822e-19,40555000,40610000,40560000,40615000,"chr17",596396,2,2,7,11,"chr17",1,0.0644631973745898
"20024","chr17.27990000.27995000","chr17.28140000.28145000",150000,16,0.0008042565,27990000,28140000,27995000,28145000,"chr17",596415,0,1,1,2,"chr17",1,0.00375058602906704
"20025","chr17.1295000.1300000","chr17.1350000.1355000",55000,31,8.778478e-07,1295000,1350000,1300000,1355000,"chr17",596444,1,17,9,27,"chr17",1,0.0981012658227848
"20026","chr17.76445000.76450000","chr17.76705000.76710000",260000,11,0.007112204,76445000,76705000,76450000,76710000,"chr17",596483,1,1,1,3,"chr17",1,0.00386779184247539
"20027","chr17.28725000.28730000","chr17.28750000.28755000",25000,35,0.006199316,28725000,28750000,28730000,28755000,"chr17",596484,1,13,8,22,"chr17",1,0.0902484763244257
"20028","chr17.29120000.29125000","chr17.29690000.29695000",570000,8,0.006129513,29120000,29690000,29125000,29695000,"chr17",596515,2,3,10,15,"chr17",1,0.0140646976090014
"20029","chr17.27290000.27295000","chr17.27445000.27450000",155000,29,5.934218e-13,27290000,27445000,27295000,27450000,"chr17",596546,2,8,10,20,"chr17",1,0.0679793717768401
"20030","chr17.8070000.8075000","chr17.8125000.8130000",55000,32,2.629624e-07,8070000,8125000,8075000,8130000,"chr17",596633,1,3,0,4,"chr17",1,0.0150023441162682
"20031","chr17.28815000.28820000","chr17.29040000.29045000",225000,14,0.0004082044,28815000,29040000,28820000,29045000,"chr17",596640,4,22,13,39,"chr17",1,0.0639943741209564
"20032","chr17.49490000.49495000","chr17.49570000.49575000",80000,20,0.001456867,49490000,49570000,49495000,49575000,"chr17",596656,0,3,1,4,"chr17",1,0.00937646507266761
"20033","chr17.58785000.58790000","chr17.59440000.59445000",655000,9,0.0005165312,58785000,59440000,58790000,59445000,"chr17",596678,2,3,13,18,"chr17",1,0.0189873417721519
"20034","chr17.10070000.10075000","chr17.10095000.10100000",25000,39,0.000411434,10070000,10095000,10075000,10100000,"chr17",596700,1,3,2,6,"chr17",1,0.0274261603375527
"20035","chr17.3645000.3650000","chr17.3695000.3700000",50000,35,3.374142e-08,3645000,3695000,3650000,3700000,"chr17",596753,5,10,12,27,"chr17",1,0.110759493670886
"20036","chr17.76705000.76710000","chr17.76725000.76730000",20000,42,0.0003625072,76705000,76725000,76710000,76730000,"chr17",596759,1,1,1,3,"chr17",1,0.0147679324894515
"20037","chr17.55340000.55345000","chr17.55415000.55420000",75000,20,0.002565106,55340000,55415000,55345000,55420000,"chr17",596786,1,4,6,11,"chr17",1,0.0257852789498359
"20038","chr17.58155000.58160000","chr17.58510000.58515000",355000,13,4.830293e-05,58155000,58510000,58160000,58515000,"chr17",596828,0,1,0,1,"chr17",1,0.00152367557430849
"20039","chr17.75865000.75870000","chr17.76010000.76015000",145000,18,8.684018e-05,75865000,76010000,75870000,76015000,"chr17",596834,1,6,7,14,"chr17",1,0.029535864978903
"20040","chr17.2735000.2740000","chr17.2890000.2895000",155000,14,0.006199316,2735000,2890000,2740000,2895000,"chr17",596863,1,15,12,28,"chr17",1,0.0459446788560713
"20041","chr17.42220000.42225000","chr17.42405000.42410000",185000,17,3.628504e-05,42220000,42405000,42225000,42410000,"chr17",596865,4,5,6,15,"chr17",1,0.029887482419128
"20042","chr17.2015000.2020000","chr17.2035000.2040000",20000,37,0.009020766,2015000,2035000,2020000,2040000,"chr17",596901,0,1,0,1,"chr17",1,0.00433661509610877
"20043","chr17.66905000.66910000","chr17.66950000.66955000",45000,33,2.073195e-06,66905000,66950000,66910000,66955000,"chr17",596935,1,8,1,10,"chr17",1,0.0386779184247539
"20044","chr17.57830000.57835000","chr17.57955000.57960000",125000,20,2.288512e-05,57830000,57955000,57835000,57960000,"chr17",596976,4,5,5,14,"chr17",1,0.0328176277543366
"20045","chr17.28250000.28255000","chr17.29040000.29045000",790000,9,0.0001467829,28250000,29040000,28255000,29045000,"chr17",596992,9,21,13,43,"chr17",1,0.0453586497890295
"20046","chr17.73060000.73065000","chr17.73155000.73160000",95000,25,5.774335e-07,73060000,73155000,73065000,73160000,"chr17",597001,3,5,3,11,"chr17",1,0.0322315986872949
"20047","chr17.74335000.74340000","chr17.74370000.74375000",35000,29,0.003186159,74335000,74370000,74340000,74375000,"chr17",597025,1,2,3,6,"chr17",1,0.020393811533052
"20048","chr17.73290000.73295000","chr17.73425000.73430000",135000,15,0.004963891,73290000,73425000,73295000,73430000,"chr17",597054,1,8,5,14,"chr17",1,0.0246132208157525
"20049","chr17.17255000.17260000","chr17.17320000.17325000",65000,22,0.001456867,17255000,17320000,17260000,17325000,"chr17",597071,2,13,12,27,"chr17",1,0.069620253164557
"20050","chr17.76260000.76265000","chr17.76415000.76420000",155000,17,0.0001821149,76260000,76415000,76265000,76420000,"chr17",597087,3,4,6,13,"chr17",1,0.0259024847632443
"20051","chr17.27975000.27980000","chr17.28250000.28255000",275000,14,7.508717e-05,27975000,28250000,27980000,28255000,"chr17",597153,3,7,8,18,"chr17",1,0.029535864978903
"20052","chr17.4175000.4180000","chr17.4200000.4205000",25000,47,4.854473e-07,4175000,4200000,4180000,4205000,"chr17",597176,3,2,2,7,"chr17",1,0.0385607126113455
"20053","chr17.28660000.28665000","chr17.29040000.29045000",380000,10,0.003186159,28660000,29040000,28665000,29045000,"chr17",597187,3,17,7,27,"chr17",1,0.0316455696202532
"20054","chr17.57855000.57860000","chr17.57880000.57885000",25000,35,0.006199316,57855000,57880000,57860000,57885000,"chr17",597258,3,11,8,22,"chr17",1,0.0902484763244257
"20055","chr17.45740000.45745000","chr17.45865000.45870000",125000,22,1.444296e-06,45740000,45865000,45745000,45870000,"chr17",597262,1,5,1,7,"chr17",1,0.0180496952648851
"20056","chr17.75515000.75520000","chr17.75895000.75900000",380000,12,0.0001510278,75515000,75895000,75520000,75900000,"chr17",597301,0,1,0,1,"chr17",1,0.00140646976090014
"20057","chr17.8200000.8205000","chr17.8285000.8290000",85000,19,0.002322693,8200000,8285000,8205000,8290000,"chr17",597304,2,6,6,14,"chr17",1,0.0311767463666198
"20058","chr17.28140000.28145000","chr17.28190000.28195000",50000,42,2.554311e-12,28140000,28190000,28145000,28195000,"chr17",597305,0,1,1,2,"chr17",1,0.00984528832630099
"20059","chr17.38380000.38385000","chr17.38400000.38405000",20000,50,5.48174e-07,38380000,38400000,38385000,38405000,"chr17",597346,0,1,0,1,"chr17",1,0.00586029067041725
"20060","chr17.8185000.8190000","chr17.8200000.8205000",15000,40,0.001440905,8185000,8200000,8190000,8205000,"chr17",597384,0,2,0,2,"chr17",1,0.00937646507266761
"20061","chr17.57375000.57380000","chr17.57935000.57940000",560000,10,0.0002486082,57375000,57935000,57380000,57940000,"chr17",597390,0,14,10,24,"chr17",1,0.0281293952180028
"20062","chr17.75150000.75155000","chr17.75180000.75185000",30000,31,0.005977364,75150000,75180000,75155000,75185000,"chr17",597509,0,9,8,17,"chr17",1,0.0617674636661978
"20063","chr17.78340000.78345000","chr17.78840000.78845000",500000,10,0.0005584793,78340000,78840000,78345000,78845000,"chr17",597537,0,3,2,5,"chr17",1,0.00586029067041725
"20064","chr17.27965000.27970000","chr17.28250000.28255000",285000,17,3.406872e-07,27965000,28250000,27970000,28255000,"chr17",597587,4,14,24,42,"chr17",1,0.0836849507735584
"20065","chr17.10025000.10030000","chr17.10120000.10125000",95000,22,2.874006e-05,10025000,10120000,10030000,10125000,"chr17",597610,1,7,6,14,"chr17",1,0.0360993905297703
"20066","chr17.29040000.29045000","chr17.29060000.29065000",20000,47,7.494493e-06,29040000,29060000,29045000,29065000,"chr17",597636,8,22,13,43,"chr17",1,0.236872948898265
"20067","chr17.17740000.17745000","chr17.17935000.17940000",195000,15,0.0003528323,17740000,17935000,17745000,17940000,"chr17",597645,3,3,5,11,"chr17",1,0.0193389592123769
"20068","chr17.27515000.27520000","chr17.27880000.27885000",365000,11,0.0009433344,27515000,27880000,27520000,27885000,"chr17",597648,0,4,10,14,"chr17",1,0.0180496952648851
"20069","chr17.27815000.27820000","chr17.28635000.28640000",820000,8,0.0007848214,27815000,28635000,27820000,28640000,"chr17",597670,4,6,5,15,"chr17",1,0.0140646976090014
"20070","chr17.62940000.62945000","chr17.63135000.63140000",195000,18,4.726144e-06,62940000,63135000,62945000,63140000,"chr17",597678,2,4,3,9,"chr17",1,0.0189873417721519
"20071","chr17.19905000.19910000","chr17.20010000.20015000",105000,19,0.0003774324,19905000,20010000,19910000,20015000,"chr17",597695,0,12,10,22,"chr17",1,0.0489920300046882
"20072","chr17.9935000.9940000","chr17.10025000.10030000",90000,26,3.030176e-07,9935000,10025000,9940000,10030000,"chr17",597731,2,6,4,12,"chr17",1,0.0365682137834037
"20073","chr17.46775000.46780000","chr17.46840000.46845000",65000,22,0.001456867,46775000,46840000,46780000,46845000,"chr17",597734,1,8,8,17,"chr17",1,0.0438349742147211
"20074","chr17.66515000.66520000","chr17.66755000.66760000",240000,13,0.0009486344,66515000,66755000,66520000,66760000,"chr17",597764,0,3,4,7,"chr17",1,0.0106657290201594
"20075","chr17.40110000.40115000","chr17.40165000.40170000",55000,43,5.558807e-14,40110000,40165000,40115000,40170000,"chr17",597778,0,2,5,7,"chr17",1,0.0352789498359119
"20076","chr17.57455000.57460000","chr17.57515000.57520000",60000,24,0.0005165312,57455000,57515000,57460000,57520000,"chr17",597805,0,5,2,7,"chr17",1,0.019690576652602
"20077","chr17.55310000.55315000","chr17.55750000.55755000",440000,9,0.005813824,55310000,55750000,55315000,55755000,"chr17",597806,1,1,7,9,"chr17",1,0.00949367088607595
"20078","chr17.8135000.8140000","chr17.8190000.8195000",55000,26,0.0001996797,8135000,8190000,8140000,8195000,"chr17",597807,5,14,13,32,"chr17",1,0.0975152367557431
"20079","chr17.50085000.50090000","chr17.50605000.50610000",520000,8,0.009692374,50085000,50605000,50090000,50610000,"chr17",597808,0,1,1,2,"chr17",1,0.00187529301453352
"20080","chr17.43720000.43725000","chr17.43900000.43905000",180000,13,0.007112204,43720000,43900000,43725000,43905000,"chr17",597820,1,1,3,5,"chr17",1,0.00761837787154243
"20081","chr17.67020000.67025000","chr17.67065000.67070000",45000,28,0.0003174977,67020000,67065000,67025000,67070000,"chr17",597858,2,4,6,12,"chr17",1,0.0393811533052039
"20082","chr17.43015000.43020000","chr17.43035000.43040000",20000,43,0.000176468,43015000,43035000,43020000,43040000,"chr17",597860,4,6,5,15,"chr17",1,0.0755977496483826
"20083","chr17.76505000.76510000","chr17.76695000.76700000",190000,13,0.005053586,76505000,76695000,76510000,76700000,"chr17",597868,5,10,5,20,"chr17",1,0.0304735114861697
"20084","chr17.2000000.2005000","chr17.2040000.2045000",40000,28,0.001330375,2e+06,2040000,2005000,2045000,"chr17",597869,3,3,4,10,"chr17",1,0.0328176277543366
"20085","chr17.45190000.45195000","chr17.45715000.45720000",525000,8,0.009228529,45190000,45715000,45195000,45720000,"chr17",597878,6,6,8,20,"chr17",1,0.0187529301453352
"20086","chr17.7685000.7690000","chr17.7995000.8000000",310000,10,0.009176202,7685000,7995000,7690000,8e+06,"chr17",597896,0,4,4,8,"chr17",1,0.00937646507266761
"20087","chr17.75180000.75185000","chr17.75205000.75210000",25000,36,0.003283814,75180000,75205000,75185000,75210000,"chr17",597898,0,9,8,17,"chr17",1,0.0717299578059072
"20088","chr17.65135000.65140000","chr17.65155000.65160000",20000,39,0.00274559,65135000,65155000,65140000,65160000,"chr17",597981,2,2,5,9,"chr17",1,0.0411392405063291
"20089","chr17.43980000.43985000","chr17.44005000.44010000",25000,41,8.911254e-05,43980000,44005000,43985000,44010000,"chr17",598005,2,0,2,4,"chr17",1,0.0192217533989686
"20090","chr17.42285000.42290000","chr17.42420000.42425000",135000,26,1.105922e-09,42285000,42420000,42290000,42425000,"chr17",598049,0,3,1,4,"chr17",1,0.0121894045944679
"20091","chr17.29240000.29245000","chr17.29530000.29535000",290000,12,0.0009571807,29240000,29530000,29245000,29535000,"chr17",598068,3,1,7,11,"chr17",1,0.0154711673699015
"20092","chr17.75130000.75135000","chr17.75215000.75220000",85000,20,0.0008488783,75130000,75215000,75135000,75220000,"chr17",598071,5,18,19,42,"chr17",1,0.0984528832630098
"20093","chr17.58110000.58115000","chr17.58510000.58515000",400000,9,0.009430808,58110000,58510000,58115000,58515000,"chr17",598099,1,13,10,24,"chr17",1,0.0253164556962025
"20094","chr17.20100000.20105000","chr17.20120000.20125000",20000,84,5.693044e-25,20100000,20120000,20105000,20125000,"chr17",598134,0,2,1,3,"chr17",1,0.029535864978903
"20095","chr17.43125000.43130000","chr17.43170000.43175000",45000,28,0.0003174977,43125000,43170000,43130000,43175000,"chr17",598137,2,4,14,20,"chr17",1,0.0656352555086732
"20096","chr17.42840000.42845000","chr17.42960000.42965000",120000,22,2.256172e-06,42840000,42960000,42845000,42965000,"chr17",598160,0,9,8,17,"chr17",1,0.0438349742147211
"20097","chr17.4200000.4205000","chr17.4255000.4260000",55000,27,7.387463e-05,4200000,4255000,4205000,4260000,"chr17",598259,1,6,6,13,"chr17",1,0.0411392405063291
"20098","chr17.31450000.31455000","chr17.31530000.31535000",80000,18,0.009228529,31450000,31530000,31455000,31535000,"chr17",598270,1,1,1,3,"chr17",1,0.00632911392405063
"20099","chr17.47645000.47650000","chr17.47790000.47795000",145000,14,0.009049365,47645000,47790000,47650000,47795000,"chr17",598287,4,8,12,24,"chr17",1,0.0393811533052039
"20100","chr17.29640000.29645000","chr17.29690000.29695000",50000,28,8.911254e-05,29640000,29690000,29645000,29695000,"chr17",598294,2,17,14,33,"chr17",1,0.108298171589311
"20101","chr17.27490000.27495000","chr17.27595000.27600000",105000,16,0.008528693,27490000,27595000,27495000,27600000,"chr17",598323,1,5,3,9,"chr17",1,0.0168776371308017
"20102","chr17.80615000.80620000","chr17.80715000.80720000",100000,22,1.644486e-05,80615000,80715000,80620000,80720000,"chr17",598349,0,7,3,10,"chr17",1,0.0257852789498359
"20103","chr17.40165000.40170000","chr17.40270000.40275000",105000,16,0.008528693,40165000,40270000,40170000,40275000,"chr17",598372,8,16,15,39,"chr17",1,0.0731364275668073
"20104","chr17.67565000.67570000","chr17.68535000.68540000",970000,12,1.199192e-08,67565000,68535000,67570000,68540000,"chr17",598435,2,1,2,5,"chr17",1,0.0070323488045007
"20105","chr17.72965000.72970000","chr17.72985000.72990000",20000,47,7.494493e-06,72965000,72985000,72970000,72990000,"chr17",598449,1,0,2,3,"chr17",1,0.0165260196905767
"20106","chr17.64240000.64245000","chr17.64660000.64665000",420000,9,0.007339258,64240000,64660000,64245000,64665000,"chr17",598457,3,2,6,11,"chr17",1,0.0116033755274262
"20107","chr17.27295000.27300000","chr17.27435000.27440000",140000,22,4.349533e-07,27295000,27435000,27300000,27440000,"chr17",598465,9,12,16,37,"chr17",1,0.0954055321143929
"20108","chr17.27990000.27995000","chr17.28010000.28015000",20000,42,0.0003625072,27990000,28010000,27995000,28015000,"chr17",598467,4,2,2,8,"chr17",1,0.0393811533052039
"20109","chr17.80425000.80430000","chr17.80590000.80595000",165000,14,0.004127752,80425000,80590000,80430000,80595000,"chr17",598517,1,0,4,5,"chr17",1,0.00820440693858415
"20110","chr17.67585000.67590000","chr17.68035000.68040000",450000,9,0.005053586,67585000,68035000,67590000,68040000,"chr17",598596,4,11,6,21,"chr17",1,0.0221518987341772
"20111","chr17.2390000.2395000","chr17.2415000.2420000",25000,38,0.0008488783,2390000,2415000,2395000,2420000,"chr17",598614,0,4,4,8,"chr17",1,0.0356305672761369
"20112","chr17.49400000.49405000","chr17.49615000.49620000",215000,14,0.0005922925,49400000,49615000,49405000,49620000,"chr17",598638,3,4,3,10,"chr17",1,0.0164088138771683
"20113","chr17.4175000.4180000","chr17.4255000.4260000",80000,23,5.934798e-05,4175000,4255000,4180000,4260000,"chr17",598649,1,2,2,5,"chr17",1,0.0134786685419597
"20114","chr17.77825000.77830000","chr17.77940000.77945000",115000,23,8.778478e-07,77825000,77940000,77830000,77945000,"chr17",598653,0,1,2,3,"chr17",1,0.00808720112517581
"20115","chr17.44165000.44170000","chr17.44220000.44225000",55000,27,7.387463e-05,44165000,44220000,44170000,44225000,"chr17",598684,6,16,8,30,"chr17",1,0.0949367088607595
"20116","chr17.44135000.44140000","chr17.44305000.44310000",170000,15,0.00105831,44135000,44305000,44140000,44310000,"chr17",598720,1,11,6,18,"chr17",1,0.0316455696202532
"20117","chr17.43715000.43720000","chr17.43905000.43910000",190000,52,7.299757e-39,43715000,43905000,43720000,43910000,"chr17",598793,0,3,3,6,"chr17",1,0.0365682137834037
"20118","chr17.16340000.16345000","chr17.16435000.16440000",95000,26,1.415584e-07,16340000,16435000,16345000,16440000,"chr17",598815,1,4,3,8,"chr17",1,0.0243788091889358
"20119","chr17.8150000.8155000","chr17.8200000.8205000",50000,43,5.934218e-13,8150000,8200000,8155000,8205000,"chr17",598824,0,6,4,10,"chr17",1,0.0503984997655884
"20120","chr17.44135000.44140000","chr17.44220000.44225000",85000,29,9.838648e-09,44135000,44220000,44140000,44225000,"chr17",598828,5,16,8,29,"chr17",1,0.0985700890764182
"20121","chr17.66810000.66815000","chr17.66900000.66905000",90000,17,0.009638929,66810000,66900000,66815000,66905000,"chr17",598843,2,6,5,13,"chr17",1,0.0259024847632443
"20122","chr17.29155000.29160000","chr17.29695000.29700000",540000,9,0.001708001,29155000,29695000,29160000,29700000,"chr17",598857,2,5,1,8,"chr17",1,0.00843881856540084
"20123","chr17.74040000.74045000","chr17.74335000.74340000",295000,15,7.844544e-06,74040000,74335000,74045000,74340000,"chr17",598868,0,3,0,3,"chr17",1,0.00527426160337553
"20124","chr17.43710000.43715000","chr17.43900000.43905000",190000,15,0.000439262,43710000,43900000,43715000,43905000,"chr17",598892,1,2,1,4,"chr17",1,0.0070323488045007
"20125","chr17.45715000.45720000","chr17.45865000.45870000",150000,15,0.002566533,45715000,45865000,45720000,45870000,"chr17",598911,6,6,8,20,"chr17",1,0.0351617440225035
"20126","chr17.79335000.79340000","chr17.79565000.79570000",230000,12,0.004598869,79335000,79565000,79340000,79570000,"chr17",598926,2,4,1,7,"chr17",1,0.00984528832630099
"20127","chr17.72970000.72975000","chr17.73155000.73160000",185000,14,0.001864322,72970000,73155000,72975000,73160000,"chr17",598966,2,2,2,6,"chr17",1,0.00984528832630099
"20128","chr17.8075000.8080000","chr17.8125000.8130000",50000,28,8.911254e-05,8075000,8125000,8080000,8130000,"chr17",598972,1,12,7,20,"chr17",1,0.0656352555086732
"20129","chr17.8125000.8130000","chr17.8150000.8155000",25000,70,7.621764e-19,8125000,8150000,8130000,8155000,"chr17",599027,0,6,4,10,"chr17",1,0.0820440693858415
"20130","chr17.7250000.7255000","chr17.7305000.7310000",55000,27,7.387463e-05,7250000,7305000,7255000,7310000,"chr17",599028,0,1,0,1,"chr17",1,0.00316455696202532
"20131","chr17.76330000.76335000","chr17.76395000.76400000",65000,20,0.00843862,76330000,76395000,76335000,76400000,"chr17",599048,1,5,11,17,"chr17",1,0.0398499765588373
"20132","chr17.41985000.41990000","chr17.42140000.42145000",155000,16,0.000632367,41985000,42140000,41990000,42145000,"chr17",599063,5,13,7,25,"chr17",1,0.046882325363338
"20133","chr17.2390000.2395000","chr17.2490000.2495000",100000,24,1.17537e-06,2390000,2490000,2395000,2495000,"chr17",599105,3,15,10,28,"chr17",1,0.0787623066104079
"20134","chr17.57880000.57885000","chr17.57905000.57910000",25000,64,2.275044e-15,57880000,57905000,57885000,57910000,"chr17",599112,3,10,8,21,"chr17",1,0.157524613220816
"20135","chr17.38595000.38600000","chr17.38660000.38665000",65000,20,0.00843862,38595000,38660000,38600000,38665000,"chr17",599117,0,1,1,2,"chr17",1,0.0046882325363338
"20136","chr17.28595000.28600000","chr17.28810000.28815000",215000,17,7.637552e-06,28595000,28810000,28600000,28815000,"chr17",599180,1,7,12,20,"chr17",1,0.0398499765588373
"20137","chr17.78780000.78785000","chr17.78840000.78845000",60000,25,0.0001893671,78780000,78840000,78785000,78845000,"chr17",599190,1,8,6,15,"chr17",1,0.0439521800281294
"20138","chr17.66510000.66515000","chr17.66755000.66760000",245000,12,0.003021162,66510000,66755000,66515000,66760000,"chr17",599198,0,3,7,10,"chr17",1,0.0140646976090014
"20139","chr17.58785000.58790000","chr17.59505000.59510000",720000,7,0.0089975,58785000,59505000,58790000,59510000,"chr17",599205,2,3,1,6,"chr17",1,0.00492264416315049
"20140","chr17.1275000.1280000","chr17.1420000.1425000",145000,20,5.69136e-06,1275000,1420000,1280000,1425000,"chr17",599209,3,14,12,29,"chr17",1,0.0679793717768401
"20141","chr17.28250000.28255000","chr17.29155000.29160000",905000,7,0.002565106,28250000,29155000,28255000,29160000,"chr17",599232,2,5,1,8,"chr17",1,0.00656352555086732
"20142","chr17.27470000.27475000","chr17.27510000.27515000",40000,30,0.0002378979,27470000,27510000,27475000,27515000,"chr17",599259,2,7,11,20,"chr17",1,0.070323488045007
"20143","chr17.66530000.66535000","chr17.67240000.67245000",710000,9,0.0003038909,66530000,67240000,66535000,67245000,"chr17",599263,0,2,0,2,"chr17",1,0.00210970464135021
"20144","chr17.66535000.66540000","chr17.66755000.66760000",220000,18,1.19537e-06,66535000,66755000,66540000,66760000,"chr17",599283,0,3,7,10,"chr17",1,0.0210970464135021
"20145","chr17.59210000.59215000","chr17.59325000.59330000",115000,17,0.001669024,59210000,59325000,59215000,59330000,"chr17",599300,0,7,4,11,"chr17",1,0.0219174871073605
"20146","chr17.66255000.66260000","chr17.66395000.66400000",140000,33,1.621426e-15,66255000,66395000,66260000,66400000,"chr17",599306,1,15,13,29,"chr17",1,0.112165963431786
"20147","chr17.27295000.27300000","chr17.27885000.27890000",590000,9,0.0009929895,27295000,27885000,27300000,27890000,"chr17",599357,3,4,4,11,"chr17",1,0.0116033755274262
"20148","chr17.9935000.9940000","chr17.10095000.10100000",160000,16,0.0005015926,9935000,10095000,9940000,10100000,"chr17",599422,2,5,4,11,"chr17",1,0.0206282231598687
"20149","chr17.27515000.27520000","chr17.27805000.27810000",290000,12,0.0009571807,27515000,27805000,27520000,27810000,"chr17",599429,0,1,3,4,"chr17",1,0.00562587904360056
"20150","chr17.37145000.37150000","chr17.37320000.37325000",175000,19,3.381721e-06,37145000,37320000,37150000,37325000,"chr17",599432,2,18,13,33,"chr17",1,0.0734880450070323
"20151","chr17.17590000.17595000","chr17.17935000.17940000",345000,24,9.501539e-15,17590000,17935000,17595000,17940000,"chr17",599449,0,4,2,6,"chr17",1,0.0168776371308017
"20152","chr17.2335000.2340000","chr17.2375000.2380000",40000,26,0.006199316,2335000,2375000,2340000,2380000,"chr17",599537,0,7,4,11,"chr17",1,0.0335208626347867
"20153","chr17.1980000.1985000","chr17.2000000.2005000",20000,38,0.005053586,1980000,2e+06,1985000,2005000,"chr17",599549,7,11,28,46,"chr17",1,0.204875761837787
"20154","chr17.57880000.57885000","chr17.57900000.57905000",20000,57,5.525468e-10,57880000,57900000,57885000,57905000,"chr17",599594,3,15,8,26,"chr17",1,0.173699015471167
"20155","chr17.20060000.20065000","chr17.20100000.20105000",40000,29,0.0005677106,20060000,20100000,20065000,20105000,"chr17",599596,0,2,1,3,"chr17",1,0.010196905766526
"20156","chr17.2040000.2045000","chr17.2120000.2125000",80000,20,0.001456867,2040000,2120000,2045000,2125000,"chr17",599618,3,3,4,10,"chr17",1,0.023441162681669
"20157","chr17.3645000.3650000","chr17.3730000.3735000",85000,21,0.0002956377,3645000,3730000,3650000,3735000,"chr17",599669,3,10,4,17,"chr17",1,0.0418424753867792
"20158","chr17.57870000.57875000","chr17.57905000.57910000",35000,39,3.520281e-07,57870000,57905000,57875000,57910000,"chr17",599675,1,6,3,10,"chr17",1,0.0457102672292546
"20159","chr17.28710000.28715000","chr17.28810000.28815000",100000,19,0.0005767508,28710000,28810000,28715000,28815000,"chr17",599755,1,7,12,20,"chr17",1,0.0445382090951711
"20160","chr17.73155000.73160000","chr17.73425000.73430000",270000,12,0.0015391,73155000,73425000,73160000,73430000,"chr17",599771,1,5,3,9,"chr17",1,0.0126582278481013
"20161","chr17.64240000.64245000","chr17.64920000.64925000",680000,8,0.002346541,64240000,64920000,64245000,64925000,"chr17",599833,3,6,7,16,"chr17",1,0.0150023441162682
"20162","chr17.67525000.67530000","chr17.67565000.67570000",40000,29,0.0005677106,67525000,67565000,67530000,67570000,"chr17",599851,2,9,8,19,"chr17",1,0.0645804031879981
"20163","chr17.75515000.75520000","chr17.76010000.76015000",495000,10,0.0005957527,75515000,76010000,75520000,76015000,"chr17",599870,0,2,0,2,"chr17",1,0.0023441162681669
"20164","chr17.66755000.66760000","chr17.67175000.67180000",420000,9,0.007339258,66755000,67175000,66760000,67180000,"chr17",599891,0,3,7,10,"chr17",1,0.0105485232067511
"20165","chr17.30790000.30795000","chr17.31095000.31100000",305000,12,0.0006859043,30790000,31095000,30795000,31100000,"chr17",599895,1,13,13,27,"chr17",1,0.0379746835443038
"20166","chr17.66755000.66760000","chr17.67220000.67225000",465000,14,6.533867e-07,66755000,67220000,66760000,67225000,"chr17",599957,0,3,10,13,"chr17",1,0.0213314580403188
"20167","chr17.66915000.66920000","chr17.67220000.67225000",305000,13,0.0001527412,66915000,67220000,66920000,67225000,"chr17",599966,1,2,2,5,"chr17",1,0.00761837787154243
"20168","chr17.2210000.2215000","chr17.2230000.2235000",20000,51,2.146824e-07,2210000,2230000,2215000,2235000,"chr17",599972,4,13,14,31,"chr17",1,0.185302390998594
"20169","chr17.20020000.20025000","chr17.20125000.20130000",105000,27,7.471279e-09,20020000,20125000,20025000,20130000,"chr17",600044,0,4,9,13,"chr17",1,0.0411392405063291
"20170","chr17.42520000.42525000","chr17.42550000.42555000",30000,34,0.0006898779,42520000,42550000,42525000,42555000,"chr17",600066,0,2,3,5,"chr17",1,0.0199249882794187
"20171","chr17.73155000.73160000","chr17.73705000.73710000",550000,10,0.0002867245,73155000,73705000,73160000,73710000,"chr17",600068,0,2,1,3,"chr17",1,0.00351617440225035
"20172","chr17.19270000.19275000","chr17.19350000.19355000",80000,44,3.811586e-19,19270000,19350000,19275000,19355000,"chr17",600096,4,10,9,23,"chr17",1,0.118612283169245
"20173","chr17.8015000.8020000","chr17.8190000.8195000",175000,15,0.0008488783,8015000,8190000,8020000,8195000,"chr17",600122,1,4,4,9,"chr17",1,0.0158227848101266
"20174","chr17.68260000.68265000","chr17.68535000.68540000",275000,12,0.001386616,68260000,68535000,68265000,68540000,"chr17",600123,3,1,2,6,"chr17",1,0.00843881856540084
"20175","chr17.19905000.19910000","chr17.20120000.20125000",215000,14,0.0005922925,19905000,20120000,19910000,20125000,"chr17",600125,3,6,7,16,"chr17",1,0.0262541022034693
"20176","chr17.43310000.43315000","chr17.43710000.43715000",400000,9,0.009430808,43310000,43710000,43315000,43715000,"chr17",600174,1,2,1,4,"chr17",1,0.00421940928270042
"20177","chr17.40110000.40115000","chr17.40265000.40270000",155000,17,0.0001821149,40110000,40265000,40115000,40270000,"chr17",600217,0,2,5,7,"chr17",1,0.0139474917955931
"20178","chr17.40490000.40495000","chr17.40555000.40560000",65000,24,0.0002029063,40490000,40555000,40495000,40560000,"chr17",600277,2,2,7,11,"chr17",1,0.0309423347398031
"20179","chr17.4100000.4105000","chr17.4255000.4260000",155000,19,1.206398e-05,4100000,4255000,4105000,4260000,"chr17",600279,1,7,10,18,"chr17",1,0.040084388185654
"20180","chr17.76500000.76505000","chr17.76710000.76715000",210000,13,0.002565106,76500000,76710000,76505000,76715000,"chr17",600294,4,16,13,33,"chr17",1,0.05028129395218
"20181","chr17.34960000.34965000","chr17.35565000.35570000",605000,10,0.0001418449,34960000,35565000,34965000,35570000,"chr17",600304,0,0,4,4,"chr17",1,0.0046882325363338
"20182","chr17.8135000.8140000","chr17.8175000.8180000",40000,26,0.006199316,8135000,8175000,8140000,8180000,"chr17",600338,5,14,13,32,"chr17",1,0.0975152367557431
"20183","chr17.73290000.73295000","chr17.73370000.73375000",80000,22,0.0001821149,73290000,73370000,73295000,73375000,"chr17",600355,2,8,5,15,"chr17",1,0.0386779184247539
"20184","chr17.7350000.7355000","chr17.7390000.7395000",40000,28,0.001330375,7350000,7390000,7355000,7395000,"chr17",600388,0,2,1,3,"chr17",1,0.00984528832630099
"20185","chr17.4210000.4215000","chr17.4260000.4265000",50000,26,0.0005976299,4210000,4260000,4215000,4265000,"chr17",600457,9,9,23,41,"chr17",1,0.124941397093296
"20186","chr17.4225000.4230000","chr17.4255000.4260000",30000,41,1.473046e-06,4225000,4255000,4230000,4260000,"chr17",600478,1,7,10,18,"chr17",1,0.0864978902953586
"20187","chr17.44145000.44150000","chr17.44220000.44225000",75000,22,0.0003495807,44145000,44220000,44150000,44225000,"chr17",600520,6,16,8,30,"chr17",1,0.0773558368495077
"20188","chr17.3695000.3700000","chr17.3720000.3725000",25000,48,1.862634e-07,3695000,3720000,3700000,3725000,"chr17",600547,5,18,7,30,"chr17",1,0.168776371308017
"20189","chr17.75075000.75080000","chr17.75235000.75240000",160000,17,0.0001385107,75075000,75235000,75080000,75240000,"chr17",600548,4,7,7,18,"chr17",1,0.0358649789029536
"20190","chr17.4885000.4890000","chr17.4905000.4910000",20000,37,0.009020766,4885000,4905000,4890000,4910000,"chr17",600551,0,8,3,11,"chr17",1,0.0477027660571964
"20191","chr17.4275000.4280000","chr17.4300000.4305000",25000,36,0.003283814,4275000,4300000,4280000,4305000,"chr17",600558,2,17,20,39,"chr17",1,0.164556962025316
"20192","chr17.40175000.40180000","chr17.40265000.40270000",90000,33,6.934867e-12,40175000,40265000,40180000,40270000,"chr17",600561,1,8,13,22,"chr17",1,0.0850914205344585
"20193","chr17.2015000.2020000","chr17.2180000.2185000",165000,16,0.000386748,2015000,2180000,2020000,2185000,"chr17",600572,0,2,0,2,"chr17",1,0.00375058602906704
"20194","chr17.40110000.40115000","chr17.40270000.40275000",160000,15,0.001633505,40110000,40270000,40115000,40275000,"chr17",600592,0,2,5,7,"chr17",1,0.0123066104078762
"20195","chr17.67565000.67570000","chr17.68100000.68105000",535000,12,8.584015e-06,67565000,68100000,67570000,68105000,"chr17",600656,2,2,2,6,"chr17",1,0.00843881856540084
"20196","chr17.80480000.80485000","chr17.80500000.80505000",20000,66,2.004843e-14,80480000,80500000,80485000,80505000,"chr17",600679,0,0,1,1,"chr17",1,0.00773558368495077
"20197","chr17.66810000.66815000","chr17.66950000.66955000",140000,17,0.0004053829,66810000,66950000,66815000,66955000,"chr17",600693,2,8,11,21,"chr17",1,0.0418424753867792
"20198","chr17.28625000.28630000","chr17.29150000.29155000",525000,8,0.009228529,28625000,29150000,28630000,29155000,"chr17",600717,9,19,18,46,"chr17",1,0.043131739334271
"20199","chr17.17140000.17145000","chr17.17180000.17185000",40000,29,0.0005677106,17140000,17180000,17145000,17185000,"chr17",600718,0,0,1,1,"chr17",1,0.00339896858884201
"20200","chr17.2890000.2895000","chr17.3555000.3560000",665000,9,0.0004664641,2890000,3555000,2895000,3560000,"chr17",600726,1,7,7,15,"chr17",1,0.0158227848101266
"20201","chr17.39070000.39075000","chr17.39700000.39705000",630000,9,0.0006583402,39070000,39700000,39075000,39705000,"chr17",600730,3,8,8,19,"chr17",1,0.020042194092827
"20202","chr17.43980000.43985000","chr17.44015000.44020000",35000,38,1.00806e-06,43980000,44015000,43985000,44020000,"chr17",600732,6,21,23,50,"chr17",1,0.222691045475856
"20203","chr17.6550000.6555000","chr17.6910000.6915000",360000,10,0.004255345,6550000,6910000,6555000,6915000,"chr17",600754,2,4,2,8,"chr17",1,0.00937646507266761
"20204","chr17.57875000.57880000","chr17.57905000.57910000",30000,48,8.33688e-10,57875000,57905000,57880000,57910000,"chr17",600756,4,10,9,23,"chr17",1,0.129395218002813
"20205","chr17.27970000.27975000","chr17.28250000.28255000",280000,21,1.856026e-10,27970000,28250000,27975000,28255000,"chr17",600766,7,19,10,36,"chr17",1,0.0886075949367089
"20206","chr17.45170000.45175000","chr17.45275000.45280000",105000,16,0.008528693,45170000,45275000,45175000,45280000,"chr17",600785,1,15,16,32,"chr17",1,0.0600093764650727
"20207","chr17.20070000.20075000","chr17.20125000.20130000",55000,41,1.161765e-12,20070000,20125000,20075000,20130000,"chr17",600812,6,5,11,22,"chr17",1,0.105719643694327
"20208","chr17.28715000.28720000","chr17.29120000.29125000",405000,10,0.002189673,28715000,29120000,28720000,29125000,"chr17",600822,3,3,8,14,"chr17",1,0.0164088138771683
"20209","chr17.29645000.29650000","chr17.29695000.29700000",50000,33,3.911995e-07,29645000,29695000,29650000,29700000,"chr17",600833,6,14,22,42,"chr17",1,0.162447257383966
"20210","chr17.70200000.70205000","chr17.70310000.70315000",110000,17,0.002322693,70200000,70310000,70205000,70315000,"chr17",600856,0,0,1,1,"chr17",1,0.00199249882794187
"20211","chr17.75525000.75530000","chr17.76010000.76015000",485000,9,0.003283814,75525000,76010000,75530000,76015000,"chr17",600869,1,6,7,14,"chr17",1,0.0147679324894515
"20212","chr17.55395000.55400000","chr17.55415000.55420000",20000,43,0.000176468,55395000,55415000,55400000,55420000,"chr17",600896,1,6,3,10,"chr17",1,0.0503984997655884
"20213","chr17.17755000.17760000","chr17.17935000.17940000",180000,13,0.007112204,17755000,17935000,17760000,17940000,"chr17",600923,0,2,2,4,"chr17",1,0.00609470229723394
"20214","chr17.40475000.40480000","chr17.40610000.40615000",135000,16,0.001669024,40475000,40610000,40480000,40615000,"chr17",600936,3,6,3,12,"chr17",1,0.0225035161744023
"20215","chr17.4100000.4105000","chr17.4275000.4280000",175000,14,0.002807183,4100000,4275000,4105000,4280000,"chr17",600955,2,9,16,27,"chr17",1,0.0443037974683544
"20216","chr17.44120000.44125000","chr17.44220000.44225000",100000,20,0.0001864275,44120000,44220000,44125000,44225000,"chr17",600969,4,7,7,18,"chr17",1,0.0421940928270042
"20217","chr17.44065000.44070000","chr17.44220000.44225000",155000,15,0.00204636,44065000,44220000,44070000,44225000,"chr17",600972,4,16,8,28,"chr17",1,0.0492264416315049
"20218","chr17.1275000.1280000","chr17.1295000.1300000",20000,75,1.967913e-19,1275000,1295000,1280000,1300000,"chr17",600976,1,14,9,24,"chr17",1,0.210970464135021
"20219","chr17.75785000.75790000","chr17.76005000.76010000",220000,12,0.006177371,75785000,76005000,75790000,76010000,"chr17",601007,5,5,3,13,"chr17",1,0.0182841068917018
"20220","chr17.75515000.75520000","chr17.75825000.75830000",310000,10,0.009176202,75515000,75825000,75520000,75830000,"chr17",601013,0,2,0,2,"chr17",1,0.0023441162681669
"20221","chr17.29330000.29335000","chr17.29645000.29650000",315000,12,0.0005514773,29330000,29645000,29335000,29650000,"chr17",601051,5,17,22,44,"chr17",1,0.0618846694796062
"20222","chr17.38460000.38465000","chr17.38510000.38515000",50000,34,1.169825e-07,38460000,38510000,38465000,38515000,"chr17",601075,0,7,3,10,"chr17",1,0.0398499765588373
"20223","chr17.66370000.66375000","chr17.66395000.66400000",25000,37,0.001677404,66370000,66395000,66375000,66400000,"chr17",601123,6,15,21,42,"chr17",1,0.182137834036568
"20224","chr17.1645000.1650000","chr17.1735000.1740000",90000,19,0.001440905,1645000,1735000,1650000,1740000,"chr17",601129,0,2,1,3,"chr17",1,0.00668073136427567
"20225","chr17.40355000.40360000","chr17.40540000.40545000",185000,13,0.006044125,40355000,40540000,40360000,40545000,"chr17",601197,2,4,5,11,"chr17",1,0.0167604313173933
"20226","chr17.27510000.27515000","chr17.27885000.27890000",375000,12,0.000167586,27510000,27885000,27515000,27890000,"chr17",601216,2,4,4,10,"chr17",1,0.0140646976090014
"20227","chr17.42020000.42025000","chr17.42120000.42125000",100000,25,2.909201e-07,42020000,42120000,42025000,42125000,"chr17",601219,1,6,4,11,"chr17",1,0.0322315986872949
"20228","chr17.42275000.42280000","chr17.42420000.42425000",145000,14,0.009049365,42275000,42420000,42280000,42425000,"chr17",601233,6,19,20,45,"chr17",1,0.0738396624472574
"20229","chr17.17255000.17260000","chr17.17400000.17405000",145000,14,0.009049365,17255000,17400000,17260000,17405000,"chr17",601294,4,1,8,13,"chr17",1,0.0213314580403188
"20230","chr17.28625000.28630000","chr17.29060000.29065000",435000,10,0.001420714,28625000,29060000,28630000,29065000,"chr17",601306,8,25,31,64,"chr17",1,0.0750117205813408
"20231","chr17.45190000.45195000","chr17.45245000.45250000",55000,34,2.08708e-08,45190000,45245000,45195000,45250000,"chr17",601319,1,0,1,2,"chr17",1,0.00796999531176746
"20232","chr17.37120000.37125000","chr17.37355000.37360000",235000,12,0.003958271,37120000,37355000,37125000,37360000,"chr17",601381,0,8,11,19,"chr17",1,0.0267229254571027
"20233","chr17.29640000.29645000","chr17.29695000.29700000",55000,37,3.793983e-10,29640000,29695000,29645000,29700000,"chr17",601387,5,14,23,42,"chr17",1,0.182137834036568
"20234","chr17.76830000.76835000","chr17.76930000.76935000",100000,17,0.004598869,76830000,76930000,76835000,76935000,"chr17",601392,2,7,6,15,"chr17",1,0.029887482419128
"20235","chr17.28140000.28145000","chr17.28160000.28165000",20000,49,1.321553e-06,28140000,28160000,28145000,28165000,"chr17",601412,0,1,1,2,"chr17",1,0.0114861697140178
"20236","chr17.8090000.8095000","chr17.8125000.8130000",35000,121,1.953614e-71,8090000,8125000,8095000,8130000,"chr17",601440,1,13,10,24,"chr17",1,0.340365682137834
"20237","chr17.35765000.35770000","chr17.35965000.35970000",200000,15,0.0002872587,35765000,35965000,35770000,35970000,"chr17",601473,0,3,1,4,"chr17",1,0.0070323488045007
"20238","chr17.43710000.43715000","chr17.43905000.43910000",195000,32,1.193208e-17,43710000,43905000,43715000,43910000,"chr17",601484,1,2,1,4,"chr17",1,0.0150023441162682
"20239","chr17.4830000.4835000","chr17.4885000.4890000",55000,34,2.08708e-08,4830000,4885000,4835000,4890000,"chr17",601504,0,8,3,11,"chr17",1,0.0438349742147211
"20240","chr17.66300000.66305000","chr17.66370000.66375000",70000,26,8.778591e-06,66300000,66370000,66305000,66375000,"chr17",601505,0,2,2,4,"chr17",1,0.0121894045944679
"20241","chr17.67625000.67630000","chr17.68045000.68050000",420000,12,7.000626e-05,67625000,68045000,67630000,68050000,"chr17",601533,1,13,10,24,"chr17",1,0.0337552742616034
"20242","chr17.42995000.43000000","chr17.43170000.43175000",175000,15,0.0008488783,42995000,43170000,4.3e+07,43175000,"chr17",601555,5,10,17,32,"chr17",1,0.0562587904360056
"20243","chr17.67375000.67380000","chr17.67390000.67395000",15000,40,0.001440905,67375000,67390000,67380000,67395000,"chr17",601579,3,9,2,14,"chr17",1,0.0656352555086732
"20244","chr17.20060000.20065000","chr17.20120000.20125000",60000,37,5.778535e-11,20060000,20120000,20065000,20125000,"chr17",601668,3,6,7,16,"chr17",1,0.0693858415377403
"20245","chr17.58785000.58790000","chr17.59310000.59315000",525000,10,0.0003961648,58785000,59310000,58790000,59315000,"chr17",601674,2,3,13,18,"chr17",1,0.0210970464135021
"20246","chr17.17810000.17815000","chr17.17925000.17930000",115000,17,0.001669024,17810000,17925000,17815000,17930000,"chr17",601682,3,12,11,26,"chr17",1,0.0518049695264885
"20247","chr17.17040000.17045000","chr17.17135000.17140000",95000,18,0.0025599,17040000,17135000,17045000,17140000,"chr17",601691,0,1,1,2,"chr17",1,0.00421940928270042
"20248","chr17.38565000.38570000","chr17.38725000.38730000",160000,15,0.001633505,38565000,38725000,38570000,38730000,"chr17",601716,0,3,2,5,"chr17",1,0.00879043600562588
"20249","chr17.41960000.41965000","chr17.42020000.42025000",60000,29,2.349217e-06,41960000,42020000,41965000,42025000,"chr17",601784,1,6,4,11,"chr17",1,0.0373886544772621
"20250","chr17.17590000.17595000","chr17.17735000.17740000",145000,15,0.003186159,17590000,17735000,17595000,17740000,"chr17",601795,0,4,2,6,"chr17",1,0.0105485232067511
"20251","chr17.27595000.27600000","chr17.27880000.27885000",285000,19,7.820664e-09,27595000,27880000,27600000,27885000,"chr17",601812,2,5,3,10,"chr17",1,0.0222691045475856
"20252","chr17.45305000.45310000","chr17.45395000.45400000",90000,39,1.926446e-16,45305000,45395000,45310000,45400000,"chr17",601826,0,3,2,5,"chr17",1,0.0228551336146273
"20253","chr17.30340000.30345000","chr17.30475000.30480000",135000,15,0.004963891,30340000,30475000,30345000,30480000,"chr17",601840,1,6,3,10,"chr17",1,0.0175808720112518
"20254","chr17.42525000.42530000","chr17.42550000.42555000",25000,35,0.006199316,42525000,42550000,42530000,42555000,"chr17",601842,6,13,14,33,"chr17",1,0.135372714486639
"20255","chr17.48805000.48810000","chr17.49155000.49160000",350000,10,0.004984483,48805000,49155000,48810000,49160000,"chr17",601864,6,30,29,65,"chr17",1,0.0761837787154243
"20256","chr17.20125000.20130000","chr17.20225000.20230000",100000,18,0.001669024,20125000,20225000,20130000,20230000,"chr17",601885,7,7,11,25,"chr17",1,0.0527426160337553
"20257","chr17.28660000.28665000","chr17.29145000.29150000",485000,9,0.003283814,28660000,29145000,28665000,29150000,"chr17",601891,3,14,7,24,"chr17",1,0.0253164556962025
"20258","chr17.17590000.17595000","chr17.17810000.17815000",220000,14,0.0004996366,17590000,17810000,17595000,17815000,"chr17",601972,0,6,2,8,"chr17",1,0.0131270511017346
"20259","chr17.37445000.37450000","chr17.37505000.37510000",60000,21,0.00733689,37445000,37505000,37450000,37510000,"chr17",602000,9,12,32,53,"chr17",1,0.130450070323488
"20260","chr17.7995000.8000000","chr17.8015000.8020000",20000,51,2.146824e-07,7995000,8015000,8e+06,8020000,"chr17",602002,1,4,4,9,"chr17",1,0.0537974683544304
"20261","chr17.80375000.80380000","chr17.80480000.80485000",105000,16,0.008528693,80375000,80480000,80380000,80485000,"chr17",602043,2,4,1,7,"chr17",1,0.0131270511017346
"20262","chr17.73425000.73430000","chr17.73560000.73565000",135000,18,0.0001574677,73425000,73560000,73430000,73565000,"chr17",602048,1,8,16,25,"chr17",1,0.0527426160337553
"20263","chr17.4710000.4715000","chr17.4785000.4790000",75000,45,3.503791e-19,4710000,4785000,4715000,4790000,"chr17",602051,4,6,14,24,"chr17",1,0.126582278481013
"20264","chr17.45300000.45305000","chr17.45370000.45375000",70000,26,8.778591e-06,45300000,45370000,45305000,45375000,"chr17",602061,5,24,14,43,"chr17",1,0.13103609939053
"20265","chr17.57865000.57870000","chr17.57910000.57915000",45000,33,2.073195e-06,57865000,57910000,57870000,57915000,"chr17",602072,0,2,1,3,"chr17",1,0.0116033755274262
"20266","chr17.7280000.7285000","chr17.7390000.7395000",110000,16,0.00630077,7280000,7390000,7285000,7395000,"chr17",602075,0,1,2,3,"chr17",1,0.00562587904360056
"20267","chr17.47645000.47650000","chr17.47840000.47845000",195000,22,6.055845e-09,47645000,47840000,47650000,47845000,"chr17",602080,2,4,4,10,"chr17",1,0.0257852789498359
"20268","chr17.18160000.18165000","chr17.18215000.18220000",55000,37,3.793983e-10,18160000,18215000,18165000,18220000,"chr17",602088,1,2,3,6,"chr17",1,0.0260196905766526
"20269","chr17.67685000.67690000","chr17.68535000.68540000",850000,7,0.0038401,67685000,68535000,67690000,68540000,"chr17",602162,0,1,2,3,"chr17",1,0.00246132208157525
"20270","chr17.4230000.4235000","chr17.4255000.4260000",25000,39,0.000411434,4230000,4255000,4235000,4260000,"chr17",602226,1,4,5,10,"chr17",1,0.0457102672292546
"20271","chr17.73340000.73345000","chr17.73370000.73375000",30000,31,0.005977364,73340000,73370000,73345000,73375000,"chr17",602234,4,5,6,15,"chr17",1,0.0545007032348805
"20272","chr17.12085000.12090000","chr17.12890000.12895000",805000,8,0.0008796358,12085000,12890000,12090000,12895000,"chr17",602286,0,2,3,5,"chr17",1,0.0046882325363338
"20273","chr17.1460000.1465000","chr17.1530000.1535000",70000,20,0.004561686,1460000,1530000,1465000,1535000,"chr17",602291,3,8,13,24,"chr17",1,0.0562587904360056
"20274","chr17.57830000.57835000","chr17.57935000.57940000",105000,37,2.207572e-16,57830000,57935000,57835000,57940000,"chr17",602349,4,5,5,14,"chr17",1,0.0607126113455227
"20275","chr17.19445000.19450000","chr17.19715000.19720000",270000,12,0.0015391,19445000,19715000,19450000,19720000,"chr17",602356,0,2,1,3,"chr17",1,0.00421940928270042
"20276","chr17.28140000.28145000","chr17.28370000.28375000",230000,16,1.785946e-05,28140000,28370000,28145000,28375000,"chr17",602516,0,1,1,2,"chr17",1,0.00375058602906704
"20277","chr17.27470000.27475000","chr17.27515000.27520000",45000,33,2.073195e-06,27470000,27515000,27475000,27520000,"chr17",602567,0,4,11,15,"chr17",1,0.0580168776371308
"20278","chr17.58215000.58220000","chr17.58510000.58515000",295000,14,4.085843e-05,58215000,58510000,58220000,58515000,"chr17",602580,4,7,13,24,"chr17",1,0.0393811533052039
"20279","chr17.27595000.27600000","chr17.27890000.27895000",295000,11,0.003353606,27595000,27890000,27600000,27895000,"chr17",602585,2,0,0,2,"chr17",1,0.00257852789498359
"20280","chr17.29140000.29145000","chr17.29690000.29695000",550000,8,0.007308464,29140000,29690000,29145000,29695000,"chr17",602655,1,6,13,20,"chr17",1,0.0187529301453352
"20281","chr17.45170000.45175000","chr17.45260000.45265000",90000,18,0.003838454,45170000,45260000,45175000,45265000,"chr17",602670,4,5,4,13,"chr17",1,0.0274261603375527
"20282","chr17.76330000.76335000","chr17.76350000.76355000",20000,40,0.001440905,76330000,76350000,76335000,76355000,"chr17",602700,5,9,23,37,"chr17",1,0.173464603844351
"20283","chr17.75105000.75110000","chr17.75180000.75185000",75000,22,0.0003495807,75105000,75180000,75110000,75185000,"chr17",602748,0,9,8,17,"chr17",1,0.0438349742147211
"20284","chr17.45305000.45310000","chr17.45370000.45375000",65000,37,9.63717e-12,45305000,45370000,45310000,45375000,"chr17",602787,5,17,24,46,"chr17",1,0.199484294421003
"20285","chr17.76550000.76555000","chr17.76695000.76700000",145000,18,8.684018e-05,76550000,76695000,76555000,76700000,"chr17",602809,3,7,5,15,"chr17",1,0.0316455696202532
"20286","chr17.17990000.17995000","chr17.18090000.18095000",100000,18,0.001669024,17990000,18090000,17995000,18095000,"chr17",602813,5,8,9,22,"chr17",1,0.0464135021097046
"20287","chr17.79270000.79275000","chr17.79355000.79360000",85000,19,0.002322693,79270000,79355000,79275000,79360000,"chr17",602861,0,4,3,7,"chr17",1,0.0155883731833099
"20288","chr17.3695000.3700000","chr17.3715000.3720000",20000,59,6.418663e-11,3695000,3715000,3700000,3720000,"chr17",602879,4,18,11,33,"chr17",1,0.228199718706048
"20289","chr17.4200000.4205000","chr17.4260000.4265000",60000,26,6.782354e-05,4200000,4260000,4205000,4265000,"chr17",602892,4,6,6,16,"chr17",1,0.0487576183778715
"20290","chr17.76715000.76720000","chr17.76745000.76750000",30000,40,3.899165e-06,76715000,76745000,76720000,76750000,"chr17",603001,8,16,15,39,"chr17",1,0.182841068917018
"20291","chr17.66950000.66955000","chr17.67220000.67225000",270000,17,6.203082e-07,66950000,67220000,66955000,67225000,"chr17",603015,2,4,11,17,"chr17",1,0.0338724800750117
"20292","chr17.75075000.75080000","chr17.75215000.75220000",140000,17,0.0004053829,75075000,75215000,75080000,75220000,"chr17",603027,8,18,23,49,"chr17",1,0.0976324425691514
"20293","chr17.2400000.2405000","chr17.2490000.2495000",90000,29,3.909841e-09,2400000,2490000,2405000,2495000,"chr17",603046,0,4,3,7,"chr17",1,0.023792780121894
"20294","chr17.29240000.29245000","chr17.29685000.29690000",445000,15,1.390916e-07,29240000,29685000,29245000,29690000,"chr17",603055,3,1,7,11,"chr17",1,0.0193389592123769
"20295","chr17.49850000.49855000","chr17.50180000.50185000",330000,11,0.001716313,49850000,50180000,49855000,50185000,"chr17",603057,0,3,4,7,"chr17",1,0.00902484763244257
"20296","chr17.76840000.76845000","chr17.76965000.76970000",125000,15,0.007686624,76840000,76965000,76845000,76970000,"chr17",603121,2,12,5,19,"chr17",1,0.0334036568213783
"20297","chr17.40075000.40080000","chr17.40165000.40170000",90000,18,0.003838454,40075000,40165000,40080000,40170000,"chr17",603163,4,13,7,24,"chr17",1,0.0506329113924051
"20298","chr17.32520000.32525000","chr17.32670000.32675000",150000,14,0.007438127,32520000,32670000,32525000,32675000,"chr17",603165,3,18,12,33,"chr17",1,0.0541490857946554
"20299","chr17.73955000.73960000","chr17.74335000.74340000",380000,12,0.0001510278,73955000,74335000,73960000,74340000,"chr17",603210,3,3,2,8,"chr17",1,0.0112517580872011
"20300","chr17.43670000.43675000","chr17.44330000.44335000",660000,9,0.0004933038,43670000,44330000,43675000,44335000,"chr17",603221,5,9,2,16,"chr17",1,0.0168776371308017
"20301","chr17.57695000.57700000","chr17.57905000.57910000",210000,13,0.002565106,57695000,57905000,57700000,57910000,"chr17",603242,2,1,2,5,"chr17",1,0.00761837787154243
"20302","chr17.44200000.44205000","chr17.45195000.45200000",995000,6,0.006943139,44200000,45195000,44205000,45200000,"chr17",603288,1,10,11,22,"chr17",1,0.0154711673699015
"20303","chr17.27515000.27520000","chr17.27595000.27600000",80000,22,0.0001821149,27515000,27595000,27520000,27600000,"chr17",603290,0,4,3,7,"chr17",1,0.0180496952648851
"20304","chr17.76500000.76505000","chr17.76695000.76700000",195000,24,1.562484e-10,76500000,76695000,76505000,76700000,"chr17",603310,5,10,5,20,"chr17",1,0.0562587904360056
"20305","chr17.76865000.76870000","chr17.76915000.76920000",50000,26,0.0005976299,76865000,76915000,76870000,76920000,"chr17",603390,1,2,5,8,"chr17",1,0.0243788091889358
"20306","chr17.67565000.67570000","chr17.68205000.68210000",640000,13,1.862634e-07,67565000,68205000,67570000,68210000,"chr17",603421,0,6,7,13,"chr17",1,0.0198077824660103
"20307","chr17.71790000.71795000","chr17.72175000.72180000",385000,10,0.002968499,71790000,72175000,71795000,72180000,"chr17",603432,0,1,0,1,"chr17",1,0.00117205813408345
"20308","chr17.67365000.67370000","chr17.67390000.67395000",25000,40,0.0001942061,67365000,67390000,67370000,67395000,"chr17",603460,5,11,8,24,"chr17",1,0.112517580872011
"20309","chr17.39065000.39070000","chr17.39510000.39515000",445000,10,0.001236176,39065000,39510000,39070000,39515000,"chr17",603473,8,9,10,27,"chr17",1,0.0316455696202532
"20310","chr17.76745000.76750000","chr17.76775000.76780000",30000,32,0.003008376,76745000,76775000,76750000,76780000,"chr17",603483,8,18,15,41,"chr17",1,0.153774027191749
"20311","chr17.27350000.27355000","chr17.27390000.27395000",40000,26,0.006199316,27350000,27390000,27355000,27395000,"chr17",603553,1,1,8,10,"chr17",1,0.0304735114861697
"20312","chr17.20070000.20075000","chr17.20100000.20105000",30000,37,5.96656e-05,20070000,20100000,20075000,20105000,"chr17",603562,0,2,1,3,"chr17",1,0.0130098452883263
"20313","chr17.57830000.57835000","chr17.57900000.57905000",70000,27,2.669765e-06,57830000,57900000,57835000,57905000,"chr17",603563,3,5,5,13,"chr17",1,0.0411392405063291
"20314","chr17.76880000.76885000","chr17.76965000.76970000",85000,21,0.0002956377,76880000,76965000,76885000,76970000,"chr17",603564,2,12,5,19,"chr17",1,0.0467651195499297
"20315","chr17.44135000.44140000","chr17.44200000.44205000",65000,29,6.724801e-07,44135000,44200000,44140000,44205000,"chr17",603577,1,10,11,22,"chr17",1,0.0747773089545241
"20316","chr17.27470000.27475000","chr17.27880000.27885000",410000,9,0.008384213,27470000,27880000,27475000,27885000,"chr17",603590,4,14,10,28,"chr17",1,0.029535864978903
"20317","chr17.43670000.43675000","chr17.44325000.44330000",655000,94,1.81293e-138,43670000,44325000,43675000,44330000,"chr17",603611,4,9,2,15,"chr17",1,0.165260196905767
"20318","chr17.3645000.3650000","chr17.3720000.3725000",75000,26,3.558981e-06,3645000,3720000,3650000,3725000,"chr17",603637,5,10,7,22,"chr17",1,0.0670417252695734
"20319","chr17.75105000.75110000","chr17.75130000.75135000",25000,35,0.006199316,75105000,75130000,75110000,75135000,"chr17",603649,5,18,19,42,"chr17",1,0.172292545710267
"20320","chr17.76165000.76170000","chr17.76240000.76245000",75000,25,1.206398e-05,76165000,76240000,76170000,76245000,"chr17",603668,0,9,8,17,"chr17",1,0.0498124706985466
"20321","chr17.70200000.70205000","chr17.70245000.70250000",45000,25,0.004030408,70200000,70245000,70205000,70250000,"chr17",603693,1,0,8,9,"chr17",1,0.0263713080168776
"20322","chr17.78485000.78490000","chr17.78890000.78895000",405000,9,0.008895296,78485000,78890000,78490000,78895000,"chr17",603697,0,2,0,2,"chr17",1,0.00210970464135021
"20323","chr17.8115000.8120000","chr17.8155000.8160000",40000,29,0.0005677106,8115000,8155000,8120000,8160000,"chr17",603797,0,1,0,1,"chr17",1,0.00339896858884201
"20324","chr17.39065000.39070000","chr17.39730000.39735000",665000,9,0.0004664641,39065000,39730000,39070000,39735000,"chr17",603829,8,9,10,27,"chr17",1,0.0284810126582278
"20325","chr17.47790000.47795000","chr17.47840000.47845000",50000,29,3.257849e-05,47790000,47840000,47795000,47845000,"chr17",603830,2,4,4,10,"chr17",1,0.0339896858884201
"20326","chr17.66905000.66910000","chr17.67240000.67245000",335000,10,0.006206957,66905000,67240000,66910000,67245000,"chr17",603862,0,2,0,2,"chr17",1,0.0023441162681669
"20327","chr17.64240000.64245000","chr17.64420000.64425000",180000,14,0.002316699,64240000,64420000,64245000,64425000,"chr17",603901,3,6,7,16,"chr17",1,0.0262541022034693
"20328","chr17.17255000.17260000","chr17.17535000.17540000",280000,15,1.284557e-05,17255000,17535000,17260000,17540000,"chr17",603936,5,8,19,32,"chr17",1,0.0562587904360056
"20329","chr17.18090000.18095000","chr17.18215000.18220000",125000,22,1.444296e-06,18090000,18215000,18095000,18220000,"chr17",603946,8,18,9,35,"chr17",1,0.0902484763244257
"20330","chr17.76480000.76485000","chr17.76725000.76730000",245000,12,0.003021162,76480000,76725000,76485000,76730000,"chr17",603959,8,18,27,53,"chr17",1,0.0745428973277075
"20331","chr17.66900000.66905000","chr17.67220000.67225000",320000,10,0.00782802,66900000,67220000,66905000,67225000,"chr17",603993,3,4,5,12,"chr17",1,0.0140646976090014
"20332","chr17.75775000.75780000","chr17.76010000.76015000",235000,13,0.001122314,75775000,76010000,75780000,76015000,"chr17",604000,1,6,6,13,"chr17",1,0.0198077824660103
"20333","chr17.79475000.79480000","chr17.79565000.79570000",90000,20,0.0005098598,79475000,79565000,79480000,79570000,"chr17",604051,2,3,1,6,"chr17",1,0.0140646976090014
"20334","chr17.76710000.76715000","chr17.76775000.76780000",65000,28,2.304802e-06,76710000,76775000,76715000,76780000,"chr17",604078,4,16,13,33,"chr17",1,0.108298171589311
"20335","chr17.42220000.42225000","chr17.42245000.42250000",25000,36,0.003283814,42220000,42245000,42225000,42250000,"chr17",604111,4,5,6,15,"chr17",1,0.0632911392405063
"20336","chr17.80620000.80625000","chr17.80715000.80720000",95000,20,0.0003038909,80620000,80715000,80625000,80720000,"chr17",604119,0,7,3,10,"chr17",1,0.023441162681669
"20337","chr17.67565000.67570000","chr17.68430000.68435000",865000,7,0.003443632,67565000,68430000,67570000,68435000,"chr17",604154,2,7,4,13,"chr17",1,0.0106657290201594
"20338","chr17.49815000.49820000","chr17.50345000.50350000",530000,8,0.00886668,49815000,50345000,49820000,50350000,"chr17",604191,2,8,4,14,"chr17",1,0.0131270511017346
"20339","chr17.75105000.75110000","chr17.75225000.75230000",120000,21,8.800182e-06,75105000,75225000,75110000,75230000,"chr17",604194,1,1,0,2,"chr17",1,0.00492264416315049
"20340","chr17.8315000.8320000","chr17.8655000.8660000",340000,17,4.92734e-08,8315000,8655000,8320000,8660000,"chr17",604212,4,5,9,18,"chr17",1,0.0358649789029536
"20341","chr17.45260000.45265000","chr17.45720000.45725000",460000,11,0.0001891962,45260000,45720000,45265000,45725000,"chr17",604229,4,5,3,12,"chr17",1,0.0154711673699015
"20342","chr17.29565000.29570000","chr17.29685000.29690000",120000,18,0.000396224,29565000,29685000,29570000,29690000,"chr17",604275,3,6,5,14,"chr17",1,0.029535864978903
"20343","chr17.57860000.57865000","chr17.57935000.57940000",75000,31,4.313751e-09,57860000,57935000,57865000,57940000,"chr17",604276,7,14,10,31,"chr17",1,0.11263478668542
"20344","chr17.4105000.4110000","chr17.4310000.4315000",205000,21,1.747187e-08,4105000,4310000,4110000,4315000,"chr17",604293,0,3,3,6,"chr17",1,0.0147679324894515
"20345","chr17.4675000.4680000","chr17.4785000.4790000",110000,17,0.002322693,4675000,4785000,4680000,4790000,"chr17",604322,4,6,13,23,"chr17",1,0.0458274730426629
"20346","chr17.5465000.5470000","chr17.6305000.6310000",840000,12,1.093995e-07,5465000,6305000,5470000,6310000,"chr17",604324,0,2,0,2,"chr17",1,0.00281293952180028
"20347","chr17.73155000.73160000","chr17.73185000.73190000",30000,33,0.001456867,73155000,73185000,73160000,73190000,"chr17",604330,3,5,3,11,"chr17",1,0.0425457102672293
"20348","chr17.4710000.4715000","chr17.4805000.4810000",95000,29,1.597286e-09,4710000,4805000,4715000,4810000,"chr17",604351,5,13,11,29,"chr17",1,0.0985700890764182
"20349","chr17.7355000.7360000","chr17.7380000.7385000",25000,36,0.003283814,7355000,7380000,7360000,7385000,"chr17",604355,0,3,1,4,"chr17",1,0.0168776371308017
"20350","chr17.75765000.75770000","chr17.76010000.76015000",245000,15,4.528624e-05,75765000,76010000,75770000,76015000,"chr17",604359,1,6,7,14,"chr17",1,0.0246132208157525
"20351","chr17.76725000.76730000","chr17.76745000.76750000",20000,38,0.005053586,76725000,76745000,76730000,76750000,"chr17",604442,8,18,15,41,"chr17",1,0.182606657290202
"20352","chr17.7820000.7825000","chr17.7895000.7900000",75000,19,0.006265362,7820000,7895000,7825000,7900000,"chr17",604468,2,10,6,18,"chr17",1,0.040084388185654
"20353","chr17.78430000.78435000","chr17.78730000.78735000",300000,13,0.0001742697,78430000,78730000,78435000,78735000,"chr17",604515,2,5,7,14,"chr17",1,0.0213314580403188
"20354","chr17.76485000.76490000","chr17.76695000.76700000",210000,12,0.00819977,76485000,76695000,76490000,76700000,"chr17",604540,5,10,5,20,"chr17",1,0.0281293952180028
"20355","chr17.43720000.43725000","chr17.43905000.43910000",185000,33,4.463464e-18,43720000,43905000,43725000,43910000,"chr17",604584,2,1,3,6,"chr17",1,0.0232067510548523
"20356","chr17.67020000.67025000","chr17.67040000.67045000",20000,50,5.48174e-07,67020000,67040000,67025000,67045000,"chr17",604633,0,3,0,3,"chr17",1,0.0175808720112518
"20357","chr17.61135000.61140000","chr17.61210000.61215000",75000,20,0.002565106,61135000,61210000,61140000,61215000,"chr17",604665,1,5,2,8,"chr17",1,0.0187529301453352
"20358","chr17.40120000.40125000","chr17.40140000.40145000",20000,49,1.321553e-06,40120000,40140000,40125000,40145000,"chr17",604781,4,8,3,15,"chr17",1,0.0861462728551336
"20359","chr17.3635000.3640000","chr17.3715000.3720000",80000,19,0.003777533,3635000,3715000,3640000,3720000,"chr17",604809,1,7,5,13,"chr17",1,0.0289498359118612
"20360","chr17.76180000.76185000","chr17.76240000.76245000",60000,32,5.712505e-08,76180000,76240000,76185000,76245000,"chr17",604833,0,9,8,17,"chr17",1,0.0637599624941397
"20361","chr17.20100000.20105000","chr17.20125000.20130000",25000,55,1.185225e-10,20100000,20125000,20105000,20130000,"chr17",604862,0,2,1,3,"chr17",1,0.0193389592123769
"20362","chr17.1295000.1300000","chr17.1365000.1370000",70000,22,0.0006966348,1295000,1365000,1300000,1370000,"chr17",604931,1,17,9,27,"chr17",1,0.069620253164557
"20363","chr17.43905000.43910000","chr17.44015000.44020000",110000,16,0.00630077,43905000,44015000,43910000,44020000,"chr17",604933,2,3,3,8,"chr17",1,0.0150023441162682
"20364","chr17.10035000.10040000","chr17.10610000.10615000",575000,8,0.005857299,10035000,10610000,10040000,10615000,"chr17",604953,0,2,6,8,"chr17",1,0.00750117205813408
"20365","chr17.27510000.27515000","chr17.27575000.27580000",65000,23,0.0005604358,27510000,27575000,27515000,27580000,"chr17",604957,1,1,0,2,"chr17",1,0.00539146741678387
"20366","chr17.42140000.42145000","chr17.42200000.42205000",60000,33,1.530063e-08,42140000,42200000,42145000,42205000,"chr17",604968,1,7,3,11,"chr17",1,0.0425457102672293
"20367","chr17.5625000.5630000","chr17.6305000.6310000",680000,8,0.002346541,5625000,6305000,5630000,6310000,"chr17",605013,0,2,0,2,"chr17",1,0.00187529301453352
"20368","chr17.42985000.42990000","chr17.43170000.43175000",185000,14,0.001864322,42985000,43170000,42990000,43175000,"chr17",605022,5,10,17,32,"chr17",1,0.0525082044069386
"20369","chr17.72295000.72300000","chr17.72360000.72365000",65000,31,5.125993e-08,72295000,72360000,72300000,72365000,"chr17",605061,0,3,1,4,"chr17",1,0.0145335208626348
"20370","chr17.67600000.67605000","chr17.68535000.68540000",935000,9,3.224473e-05,67600000,68535000,67605000,68540000,"chr17",605092,3,1,2,6,"chr17",1,0.00632911392405063
"20371","chr17.28040000.28045000","chr17.28250000.28255000",210000,12,0.00819977,28040000,28250000,28045000,28255000,"chr17",605122,4,3,7,14,"chr17",1,0.019690576652602
"20372","chr17.67585000.67590000","chr17.68045000.68050000",460000,15,9.458071e-08,67585000,68045000,67590000,68050000,"chr17",605142,4,11,6,21,"chr17",1,0.0369198312236287
"20373","chr17.76840000.76845000","chr17.76905000.76910000",65000,22,0.001456867,76840000,76905000,76845000,76910000,"chr17",605205,2,16,8,26,"chr17",1,0.0670417252695734
"20374","chr17.42840000.42845000","chr17.42935000.42940000",95000,21,9.549038e-05,42840000,42935000,42845000,42940000,"chr17",605219,0,9,8,17,"chr17",1,0.0418424753867792
"20375","chr17.76350000.76355000","chr17.76415000.76420000",65000,23,0.0005604358,76350000,76415000,76355000,76420000,"chr17",605284,3,4,6,13,"chr17",1,0.0350445382090952
"20376","chr17.28190000.28195000","chr17.28250000.28255000",60000,47,6.700719e-18,28190000,28250000,28195000,28255000,"chr17",605340,4,2,5,11,"chr17",1,0.0605954055321144
"20377","chr17.7585000.7590000","chr17.8090000.8095000",505000,9,0.00261315,7585000,8090000,7590000,8095000,"chr17",605362,0,4,2,6,"chr17",1,0.00632911392405063
"20378","chr17.74775000.74780000","chr17.75075000.75080000",300000,13,0.0001742697,74775000,75075000,74780000,75080000,"chr17",605373,3,11,6,20,"chr17",1,0.0304735114861697
"20379","chr17.8300000.8305000","chr17.8625000.8630000",325000,10,0.007255421,8300000,8625000,8305000,8630000,"chr17",605380,1,3,2,6,"chr17",1,0.0070323488045007
"20380","chr17.8055000.8060000","chr17.8125000.8130000",70000,30,5.584983e-08,8055000,8125000,8060000,8130000,"chr17",605393,3,11,6,20,"chr17",1,0.070323488045007
"20381","chr17.8075000.8080000","chr17.8190000.8195000",115000,18,0.0005557501,8075000,8190000,8080000,8195000,"chr17",605419,1,12,7,20,"chr17",1,0.0421940928270042
"20382","chr17.17285000.17290000","chr17.17400000.17405000",115000,17,0.001669024,17285000,17400000,17290000,17405000,"chr17",605438,4,1,8,13,"chr17",1,0.0259024847632443
"20383","chr17.28710000.28715000","chr17.29695000.29700000",985000,6,0.007644498,28710000,29695000,28715000,29700000,"chr17",605447,6,13,14,33,"chr17",1,0.0232067510548523
"20384","chr17.76745000.76750000","chr17.76915000.76920000",170000,17,8.129997e-05,76745000,76915000,76750000,76920000,"chr17",605501,3,6,12,21,"chr17",1,0.0418424753867792
"20385","chr17.28355000.28360000","chr17.28595000.28600000",240000,12,0.003432932,28355000,28595000,28360000,28600000,"chr17",605534,0,5,4,9,"chr17",1,0.0126582278481013
"20386","chr17.76865000.76870000","chr17.76955000.76960000",90000,24,4.353199e-06,76865000,76955000,76870000,76960000,"chr17",605580,1,2,5,8,"chr17",1,0.0225035161744023
"20387","chr17.27515000.27520000","chr17.27535000.27540000",20000,46,1.69784e-05,27515000,27535000,27520000,27540000,"chr17",605592,0,2,1,3,"chr17",1,0.0161744022503516
"20388","chr17.39055000.39060000","chr17.39450000.39455000",395000,13,2.013063e-05,39055000,39450000,39060000,39455000,"chr17",605605,9,23,25,57,"chr17",1,0.0868495077355837
"20389","chr17.76875000.76880000","chr17.76910000.76915000",35000,29,0.003186159,76875000,76910000,76880000,76915000,"chr17",605621,1,2,3,6,"chr17",1,0.020393811533052
"20390","chr17.42275000.42280000","chr17.42405000.42410000",130000,22,9.653708e-07,42275000,42405000,42280000,42410000,"chr17",605666,5,12,16,33,"chr17",1,0.0850914205344585
"20391","chr17.78320000.78325000","chr17.78340000.78345000",20000,39,0.00274559,78320000,78340000,78325000,78345000,"chr17",605672,0,3,2,5,"chr17",1,0.0228551336146273
"20392","chr17.4830000.4835000","chr17.5190000.5195000",360000,10,0.004255345,4830000,5190000,4835000,5195000,"chr17",605684,7,28,17,52,"chr17",1,0.0609470229723394
"20393","chr17.49570000.49575000","chr17.49615000.49620000",45000,27,0.0007755452,49570000,49615000,49575000,49620000,"chr17",605695,2,3,1,6,"chr17",1,0.0189873417721519
"20394","chr17.10045000.10050000","chr17.10070000.10075000",25000,36,0.003283814,10045000,10070000,10050000,10075000,"chr17",605699,1,3,2,6,"chr17",1,0.0253164556962025
"20395","chr17.29690000.29695000","chr17.30330000.30335000",640000,8,0.003244559,29690000,30330000,29695000,30335000,"chr17",605716,1,8,14,23,"chr17",1,0.0215658696671355
"20396","chr17.49415000.49420000","chr17.49435000.49440000",20000,44,8.309867e-05,49415000,49435000,49420000,49440000,"chr17",605723,1,1,3,5,"chr17",1,0.0257852789498359
"20397","chr17.68045000.68050000","chr17.68100000.68105000",55000,22,0.007097885,68045000,68100000,68050000,68105000,"chr17",605738,2,2,2,6,"chr17",1,0.0154711673699015
"20398","chr17.41695000.41700000","chr17.41735000.41740000",40000,28,0.001330375,41695000,41735000,41700000,41740000,"chr17",605771,5,25,15,45,"chr17",1,0.147679324894515
"20399","chr17.29035000.29040000","chr17.29155000.29160000",120000,20,3.361123e-05,29035000,29155000,29040000,29160000,"chr17",605776,2,5,1,8,"chr17",1,0.0187529301453352
"20400","chr17.17590000.17595000","chr17.17800000.17805000",210000,12,0.00819977,17590000,17800000,17595000,17805000,"chr17",605799,0,6,2,8,"chr17",1,0.0112517580872011
"20401","chr17.4105000.4110000","chr17.4255000.4260000",150000,17,0.0002378979,4105000,4255000,4110000,4260000,"chr17",605863,0,6,3,9,"chr17",1,0.0179324894514768
"20402","chr17.66525000.66530000","chr17.66715000.66720000",190000,14,0.001532736,66525000,66715000,66530000,66720000,"chr17",605869,0,4,0,4,"chr17",1,0.00656352555086732
"20403","chr17.17320000.17325000","chr17.17375000.17380000",55000,29,8.620775e-06,17320000,17375000,17325000,17380000,"chr17",605906,2,7,5,14,"chr17",1,0.0475855602437881
"20404","chr17.57855000.57860000","chr17.57935000.57940000",80000,22,0.0001821149,57855000,57935000,57860000,57940000,"chr17",605914,5,11,10,26,"chr17",1,0.0670417252695734
"20405","chr17.8125000.8130000","chr17.8190000.8195000",65000,47,5.930822e-19,8125000,8190000,8130000,8195000,"chr17",605920,8,24,15,47,"chr17",1,0.258907641819034
"20406","chr17.17160000.17165000","chr17.17180000.17185000",20000,47,7.494493e-06,17160000,17180000,17165000,17185000,"chr17",605932,0,0,1,1,"chr17",1,0.00550867323019222
"20407","chr17.40490000.40495000","chr17.40610000.40615000",120000,16,0.003580214,40490000,40610000,40495000,40615000,"chr17",606016,5,6,7,18,"chr17",1,0.0337552742616034
"20408","chr17.38595000.38600000","chr17.38725000.38730000",130000,16,0.00214982,38595000,38725000,38600000,38730000,"chr17",606031,0,1,1,2,"chr17",1,0.00375058602906704
"20409","chr17.80590000.80595000","chr17.80715000.80720000",125000,16,0.002782725,80590000,80715000,80595000,80720000,"chr17",606052,0,4,3,7,"chr17",1,0.0131270511017346
"20410","chr17.17590000.17595000","chr17.17925000.17930000",335000,10,0.006206957,17590000,17925000,17595000,17930000,"chr17",606053,0,6,2,8,"chr17",1,0.00937646507266761
"20411","chr17.27295000.27300000","chr17.27510000.27515000",215000,13,0.00214982,27295000,27510000,27300000,27515000,"chr17",606063,2,7,11,20,"chr17",1,0.0304735114861697
"20412","chr17.66255000.66260000","chr17.67240000.67245000",985000,11,1.171995e-07,66255000,67240000,66260000,67245000,"chr17",606069,0,2,0,2,"chr17",1,0.00257852789498359
"20413","chr17.39115000.39120000","chr17.39545000.39550000",430000,10,0.001497275,39115000,39545000,39120000,39550000,"chr17",606095,1,7,4,12,"chr17",1,0.0140646976090014
"20414","chr17.9815000.9820000","chr17.10225000.10230000",410000,10,0.002026927,9815000,10225000,9820000,10230000,"chr17",606123,0,9,5,14,"chr17",1,0.0164088138771683
"20415","chr17.43980000.43985000","chr17.44010000.44015000",30000,42,5.584827e-07,43980000,44010000,43985000,44015000,"chr17",606161,5,21,20,46,"chr17",1,0.226441631504923
"20416","chr17.37505000.37510000","chr17.37525000.37530000",20000,39,0.00274559,37505000,37525000,37510000,37530000,"chr17",606175,2,13,13,28,"chr17",1,0.127988748241913
"20417","chr17.57830000.57835000","chr17.57940000.57945000",110000,20,7.593876e-05,57830000,57940000,57835000,57945000,"chr17",606195,1,5,4,10,"chr17",1,0.023441162681669
"20418","chr17.20095000.20100000","chr17.20115000.20120000",20000,48,3.162399e-06,20095000,20115000,20100000,20120000,"chr17",606214,0,1,1,2,"chr17",1,0.0112517580872011
"20419","chr17.57935000.57940000","chr17.57955000.57960000",20000,56,1.568494e-09,57935000,57955000,57940000,57960000,"chr17",606222,4,14,10,28,"chr17",1,0.183778715424285
"20420","chr17.20120000.20125000","chr17.20225000.20230000",105000,17,0.003221243,20120000,20225000,20125000,20230000,"chr17",606231,3,6,7,16,"chr17",1,0.0318799812470699
"20421","chr17.27295000.27300000","chr17.27515000.27520000",220000,15,0.0001222665,27295000,27515000,27300000,27520000,"chr17",606245,0,4,11,15,"chr17",1,0.0263713080168776
"20422","chr17.57905000.57910000","chr17.57975000.57980000",70000,22,0.0006966348,57905000,57975000,57910000,57980000,"chr17",606247,4,10,5,19,"chr17",1,0.0489920300046882
"20423","chr17.57850000.57855000","chr17.57905000.57910000",55000,33,7.508063e-08,57850000,57905000,57855000,57910000,"chr17",606283,4,10,9,23,"chr17",1,0.0889592123769339
"20424","chr17.41985000.41990000","chr17.42405000.42410000",420000,9,0.007339258,41985000,42405000,41990000,42410000,"chr17",606338,5,12,16,33,"chr17",1,0.0348101265822785
"20425","chr17.57905000.57910000","chr17.57925000.57930000",20000,39,0.00274559,57905000,57925000,57910000,57930000,"chr17",606378,3,10,9,22,"chr17",1,0.10056258790436
"20426","chr17.40620000.40625000","chr17.40645000.40650000",25000,43,1.722114e-05,40620000,40645000,40625000,40650000,"chr17",606422,0,0,4,4,"chr17",1,0.0201593999062353
"20427","chr17.41985000.41990000","chr17.42180000.42185000",195000,14,0.001297715,41985000,42180000,41990000,42185000,"chr17",606461,2,7,2,11,"chr17",1,0.0180496952648851
"20428","chr17.66255000.66260000","chr17.66435000.66440000",180000,28,2.759258e-13,66255000,66435000,66260000,66440000,"chr17",606560,0,2,1,3,"chr17",1,0.00984528832630099
"20429","chr17.70610000.70615000","chr17.70655000.70660000",45000,24,0.008636132,70610000,70655000,70615000,70660000,"chr17",606573,0,3,0,3,"chr17",1,0.00843881856540084
"20430","chr17.74040000.74045000","chr17.74325000.74330000",285000,19,7.820664e-09,74040000,74325000,74045000,74330000,"chr17",606583,0,4,0,4,"chr17",1,0.00890764181903422
"20431","chr17.17780000.17785000","chr17.17850000.17855000",70000,20,0.004561686,17780000,17850000,17785000,17855000,"chr17",606628,0,1,2,3,"chr17",1,0.0070323488045007
"20432","chr17.66715000.66720000","chr17.66740000.66745000",25000,38,0.0008488783,66715000,66740000,66720000,66745000,"chr17",606647,0,2,1,3,"chr17",1,0.0133614627285513
"20433","chr17.6545000.6550000","chr17.6910000.6915000",365000,13,3.86687e-05,6545000,6910000,6550000,6915000,"chr17",606666,0,4,2,6,"chr17",1,0.00914205344585091
"20434","chr17.27295000.27300000","chr17.27595000.27600000",300000,11,0.00305652,27295000,27595000,27300000,27600000,"chr17",606682,2,5,3,10,"chr17",1,0.012892639474918
"20435","chr17.4100000.4105000","chr17.4310000.4315000",210000,28,1.35125e-14,4100000,4310000,4105000,4315000,"chr17",606690,5,3,11,19,"chr17",1,0.0623534927332396
"20436","chr17.76875000.76880000","chr17.76965000.76970000",90000,20,0.0005098598,76875000,76965000,76880000,76970000,"chr17",606708,1,2,3,6,"chr17",1,0.0140646976090014
"20437","chr17.41665000.41670000","chr17.41735000.41740000",70000,23,0.0002514607,41665000,41735000,41670000,41740000,"chr17",606728,0,4,3,7,"chr17",1,0.0188701359587436
"20438","chr17.67585000.67590000","chr17.68260000.68265000",675000,8,0.002462342,67585000,68260000,67590000,68265000,"chr17",606733,4,10,6,20,"chr17",1,0.0187529301453352
"20439","chr17.57905000.57910000","chr17.57935000.57940000",30000,32,0.003008376,57905000,57935000,57910000,57940000,"chr17",606760,4,10,9,23,"chr17",1,0.086263478668542
"20440","chr17.74175000.74180000","chr17.74240000.74245000",65000,22,0.001456867,74175000,74240000,74180000,74245000,"chr17",606766,1,5,4,10,"chr17",1,0.0257852789498359
"20441","chr17.8040000.8045000","chr17.8090000.8095000",50000,25,0.001456867,8040000,8090000,8045000,8095000,"chr17",606855,0,13,10,23,"chr17",1,0.0673933427097984
"20442","chr17.47650000.47655000","chr17.47785000.47790000",135000,25,5.804113e-09,47650000,47785000,47655000,47790000,"chr17",606867,1,4,1,6,"chr17",1,0.0175808720112518
"20443","chr17.2420000.2425000","chr17.2490000.2495000",70000,38,3.736644e-13,2420000,2490000,2425000,2495000,"chr17",606871,3,12,21,36,"chr17",1,0.160337552742616
"20444","chr17.73060000.73065000","chr17.73190000.73195000",130000,18,0.0002101683,73060000,73190000,73065000,73195000,"chr17",606886,3,6,7,16,"chr17",1,0.0337552742616034
"20445","chr17.17850000.17855000","chr17.17935000.17940000",85000,20,0.0008488783,17850000,17935000,17855000,17940000,"chr17",606931,3,4,3,10,"chr17",1,0.023441162681669
"20446","chr17.27965000.27970000","chr17.27990000.27995000",25000,41,8.911254e-05,27965000,27990000,27970000,27995000,"chr17",606947,4,2,2,8,"chr17",1,0.0384435067979372
"20447","chr17.38350000.38355000","chr17.38450000.38455000",100000,18,0.001669024,38350000,38450000,38355000,38455000,"chr17",606948,1,1,1,3,"chr17",1,0.00632911392405063
"20448","chr17.28160000.28165000","chr17.28250000.28255000",90000,21,0.0001680253,28160000,28250000,28165000,28255000,"chr17",606986,7,10,18,35,"chr17",1,0.0861462728551336
"20449","chr17.29060000.29065000","chr17.29155000.29160000",95000,26,1.415584e-07,29060000,29155000,29065000,29160000,"chr17",607034,2,5,1,8,"chr17",1,0.0243788091889358
"20450","chr17.66740000.66745000","chr17.67240000.67245000",500000,10,0.0005584793,66740000,67240000,66745000,67245000,"chr17",607038,0,2,0,2,"chr17",1,0.0023441162681669
"20451","chr17.4255000.4260000","chr17.4300000.4305000",45000,27,0.0007755452,4255000,4300000,4260000,4305000,"chr17",607068,1,7,10,18,"chr17",1,0.0569620253164557
"20452","chr17.57780000.57785000","chr17.58155000.58160000",375000,15,8.469976e-07,57780000,58155000,57785000,58160000,"chr17",607098,0,1,0,1,"chr17",1,0.00175808720112518
"20453","chr17.46265000.46270000","chr17.46840000.46845000",575000,9,0.001178932,46265000,46840000,46270000,46845000,"chr17",607113,3,10,14,27,"chr17",1,0.0284810126582278
"20454","chr17.75180000.75185000","chr17.75245000.75250000",65000,22,0.001456867,75180000,75245000,75185000,75250000,"chr17",607154,0,9,8,17,"chr17",1,0.0438349742147211
"20455","chr17.16985000.16990000","chr17.17095000.17100000",110000,18,0.0007858251,16985000,17095000,16990000,17100000,"chr17",607167,3,1,4,8,"chr17",1,0.0168776371308017
"20456","chr17.9935000.9940000","chr17.10035000.10040000",100000,18,0.001669024,9935000,10035000,9940000,10040000,"chr17",607187,2,6,4,12,"chr17",1,0.0253164556962025
"20457","chr17.17590000.17595000","chr17.17765000.17770000",175000,16,0.0002378979,17590000,17765000,17595000,17770000,"chr17",607263,0,5,2,7,"chr17",1,0.0131270511017346
"20458","chr17.57785000.57790000","chr17.57905000.57910000",120000,15,0.009692374,57785000,57905000,57790000,57910000,"chr17",607272,0,3,0,3,"chr17",1,0.00527426160337553
"20459","chr17.75030000.75035000","chr17.75515000.75520000",485000,9,0.003283814,75030000,75515000,75035000,75520000,"chr17",607274,0,2,0,2,"chr17",1,0.00210970464135021
"20460","chr17.38565000.38570000","chr17.38675000.38680000",110000,21,2.141896e-05,38565000,38675000,38570000,38680000,"chr17",607298,4,5,9,18,"chr17",1,0.0443037974683544
"20461","chr17.8150000.8155000","chr17.8190000.8195000",40000,39,1.861678e-08,8150000,8190000,8155000,8195000,"chr17",607300,0,6,4,10,"chr17",1,0.0457102672292546
"20462","chr17.76450000.76455000","chr17.76710000.76715000",260000,15,2.567541e-05,76450000,76710000,76455000,76715000,"chr17",607309,1,5,4,10,"chr17",1,0.0175808720112518
"20463","chr17.73155000.73160000","chr17.73190000.73195000",35000,33,0.0001238291,73155000,73190000,73160000,73195000,"chr17",607341,3,5,3,11,"chr17",1,0.0425457102672293
"20464","chr17.47185000.47190000","chr17.47205000.47210000",20000,41,0.0007264823,47185000,47205000,47190000,47210000,"chr17",607380,1,1,1,3,"chr17",1,0.0144163150492264
"20465","chr17.57560000.57565000","chr17.57620000.57625000",60000,27,2.288512e-05,57560000,57620000,57565000,57625000,"chr17",607404,0,2,0,2,"chr17",1,0.00632911392405063
"20466","chr17.49155000.49160000","chr17.49190000.49195000",35000,39,3.520281e-07,49155000,49190000,49160000,49195000,"chr17",607413,5,9,8,22,"chr17",1,0.10056258790436
"20467","chr17.39115000.39120000","chr17.39450000.39455000",335000,10,0.006206957,39115000,39450000,39120000,39455000,"chr17",607421,6,7,4,17,"chr17",1,0.0199249882794187
"20468","chr17.76715000.76720000","chr17.76775000.76780000",60000,46,3.736035e-17,76715000,76775000,76720000,76780000,"chr17",607461,8,16,15,39,"chr17",1,0.210267229254571
"20469","chr17.8135000.8140000","chr17.8200000.8205000",65000,49,1.593897e-20,8135000,8200000,8140000,8205000,"chr17",607463,2,14,13,29,"chr17",1,0.166549460853258
"20470","chr17.39015000.39020000","chr17.39715000.39720000",700000,8,0.001989094,39015000,39715000,39020000,39720000,"chr17",607490,2,14,5,21,"chr17",1,0.019690576652602
"20471","chr17.8090000.8095000","chr17.8200000.8205000",110000,37,7.876439e-17,8090000,8200000,8095000,8205000,"chr17",607532,1,13,10,24,"chr17",1,0.10407876230661
"20472","chr17.8080000.8085000","chr17.8200000.8205000",120000,17,0.001253284,8080000,8200000,8085000,8205000,"chr17",607586,0,6,6,12,"chr17",1,0.0239099859353024
"20473","chr17.7305000.7310000","chr17.7380000.7385000",75000,23,0.0001195859,7305000,7380000,7310000,7385000,"chr17",607604,0,3,1,4,"chr17",1,0.0107829348335677
"20474","chr17.66540000.66545000","chr17.66715000.66720000",175000,13,0.008475646,66540000,66715000,66545000,66720000,"chr17",607623,1,5,2,8,"chr17",1,0.0121894045944679
"20475","chr17.57440000.57445000","chr17.57515000.57520000",75000,23,0.0001195859,57440000,57515000,57445000,57520000,"chr17",607625,0,4,2,6,"chr17",1,0.0161744022503516
"20476","chr17.66530000.66535000","chr17.66755000.66760000",225000,19,1.687233e-07,66530000,66755000,66535000,66760000,"chr17",607659,0,2,5,7,"chr17",1,0.0155883731833099
"20477","chr17.38460000.38465000","chr17.38595000.38600000",135000,15,0.004963891,38460000,38595000,38465000,38600000,"chr17",607728,0,1,1,2,"chr17",1,0.00351617440225035
"20478","chr17.1980000.1985000","chr17.2015000.2020000",35000,33,0.0001238291,1980000,2015000,1985000,2020000,"chr17",607803,0,2,0,2,"chr17",1,0.00773558368495077
"20479","chr17.29210000.29215000","chr17.29530000.29535000",320000,16,6.218611e-07,29210000,29530000,29215000,29535000,"chr17",607812,4,9,9,22,"chr17",1,0.0412564463197375
"20480","chr17.8150000.8155000","chr17.8195000.8200000",45000,48,4.942369e-15,8150000,8195000,8155000,8200000,"chr17",607813,0,6,4,10,"chr17",1,0.0562587904360056
"20481","chr17.1980000.1985000","chr17.2120000.2125000",140000,20,7.924415e-06,1980000,2120000,1985000,2125000,"chr17",607815,6,13,13,32,"chr17",1,0.0750117205813408
"20482","chr17.9935000.9940000","chr17.10120000.10125000",185000,14,0.001864322,9935000,10120000,9940000,10125000,"chr17",607859,1,6,4,11,"chr17",1,0.0180496952648851
"20483","chr17.76480000.76485000","chr17.76710000.76715000",230000,16,1.785946e-05,76480000,76710000,76485000,76715000,"chr17",607882,4,16,13,33,"chr17",1,0.0618846694796062
"20484","chr17.44195000.44200000","chr17.44220000.44225000",25000,63,8.137968e-15,44195000,44220000,44200000,44225000,"chr17",607905,1,3,2,6,"chr17",1,0.0443037974683544
"20485","chr17.8315000.8320000","chr17.8660000.8665000",345000,10,0.005353383,8315000,8660000,8320000,8665000,"chr17",607937,4,8,3,15,"chr17",1,0.0175808720112518
"20486","chr17.27970000.27975000","chr17.27990000.27995000",20000,55,4.349236e-09,27970000,27990000,27975000,27995000,"chr17",608013,4,2,2,8,"chr17",1,0.0515705578996718
"20487","chr17.18090000.18095000","chr17.18195000.18200000",105000,16,0.008528693,18090000,18195000,18095000,18200000,"chr17",608022,5,9,9,23,"chr17",1,0.043131739334271
"20488","chr17.40215000.40220000","chr17.40265000.40270000",50000,24,0.003353606,40215000,40265000,40220000,40270000,"chr17",608035,11,29,43,83,"chr17",1,0.233473980309423
"20489","chr17.40540000.40545000","chr17.40555000.40560000",15000,50,5.48174e-07,40540000,40555000,40545000,40560000,"chr17",608044,2,2,7,11,"chr17",1,0.0644631973745898
"20490","chr17.5485000.5490000","chr17.6375000.6380000",890000,11,6.040158e-07,5485000,6375000,5490000,6380000,"chr17",608108,0,6,6,12,"chr17",1,0.0154711673699015
"20491","chr17.76500000.76505000","chr17.76705000.76710000",205000,22,2.934269e-09,76500000,76705000,76505000,76710000,"chr17",608125,1,1,1,3,"chr17",1,0.00773558368495077
"20492","chr17.29565000.29570000","chr17.29690000.29695000",125000,18,0.0002894653,29565000,29690000,29570000,29695000,"chr17",608131,2,6,5,13,"chr17",1,0.0274261603375527
"20493","chr17.8295000.8300000","chr17.8655000.8660000",360000,13,4.332758e-05,8295000,8655000,8300000,8660000,"chr17",608153,3,5,9,17,"chr17",1,0.0259024847632443
"20494","chr17.67020000.67025000","chr17.67150000.67155000",130000,15,0.006199316,67020000,67150000,67025000,67155000,"chr17",608161,2,2,2,6,"chr17",1,0.0105485232067511
"20495","chr17.76450000.76455000","chr17.76715000.76720000",265000,14,0.0001016838,76450000,76715000,76455000,76720000,"chr17",608170,1,5,4,10,"chr17",1,0.0164088138771683
"20496","chr17.255000.260000","chr17.595000.600000",340000,17,4.92734e-08,255000,595000,260000,6e+05,"chr17",608203,4,9,5,18,"chr17",1,0.0358649789029536
"20497","chr17.17285000.17290000","chr17.17320000.17325000",35000,32,0.000295732,17285000,17320000,17290000,17325000,"chr17",608230,2,13,12,27,"chr17",1,0.10126582278481
"20498","chr17.66300000.66305000","chr17.66395000.66400000",95000,19,0.0008994793,66300000,66395000,66305000,66400000,"chr17",608256,0,2,2,4,"chr17",1,0.00890764181903422
"20499","chr17.46965000.46970000","chr17.47490000.47495000",525000,8,0.009228529,46965000,47490000,46970000,47495000,"chr17",608264,5,8,15,28,"chr17",1,0.0262541022034693
"20500","chr17.10035000.10040000","chr17.10055000.10060000",20000,37,0.009020766,10035000,10055000,10040000,10060000,"chr17",608291,2,8,7,17,"chr17",1,0.073722456633849
"20501","chr17.19405000.19410000","chr17.19705000.19710000",300000,11,0.00305652,19405000,19705000,19410000,19710000,"chr17",608326,1,3,0,4,"chr17",1,0.00515705578996718
"20502","chr17.62650000.62655000","chr17.62720000.62725000",70000,22,0.0006966348,62650000,62720000,62655000,62725000,"chr17",608347,0,3,2,5,"chr17",1,0.012892639474918
"20503","chr17.39115000.39120000","chr17.39685000.39690000",570000,8,0.006129513,39115000,39685000,39120000,39690000,"chr17",608366,3,7,4,14,"chr17",1,0.0131270511017346
"20504","chr17.17205000.17210000","chr17.17810000.17815000",605000,8,0.004423662,17205000,17810000,17210000,17815000,"chr17",608385,3,12,11,26,"chr17",1,0.0243788091889358
"20505","chr17.19920000.19925000","chr17.20005000.20010000",85000,21,0.0002956377,19920000,20005000,19925000,20010000,"chr17",608414,4,12,20,36,"chr17",1,0.0886075949367089
"20506","chr17.7955000.7960000","chr17.8200000.8205000",245000,12,0.003021162,7955000,8200000,7960000,8205000,"chr17",608431,2,11,13,26,"chr17",1,0.0365682137834037
"20507","chr17.37445000.37450000","chr17.37480000.37485000",35000,29,0.003186159,37445000,37480000,37450000,37485000,"chr17",608457,3,12,4,19,"chr17",1,0.0645804031879981
"20508","chr17.55390000.55395000","chr17.55435000.55440000",45000,33,2.073195e-06,55390000,55435000,55395000,55440000,"chr17",608557,0,1,0,1,"chr17",1,0.00386779184247539
"20509","chr17.40105000.40110000","chr17.40180000.40185000",75000,19,0.006265362,40105000,40180000,40110000,40185000,"chr17",608614,1,7,6,14,"chr17",1,0.0311767463666198
"20510","chr17.76500000.76505000","chr17.76775000.76780000",275000,11,0.005073532,76500000,76775000,76505000,76780000,"chr17",608651,5,18,13,36,"chr17",1,0.0464135021097046
"20511","chr17.38625000.38630000","chr17.38725000.38730000",100000,17,0.004598869,38625000,38725000,38630000,38730000,"chr17",608653,0,3,2,5,"chr17",1,0.00996249413970933
"20512","chr17.76500000.76505000","chr17.76830000.76835000",330000,11,0.001716313,76500000,76830000,76505000,76835000,"chr17",608656,5,13,7,25,"chr17",1,0.0322315986872949
"20513","chr17.4140000.4145000","chr17.4200000.4205000",60000,24,0.0005165312,4140000,4200000,4145000,4205000,"chr17",608679,1,6,6,13,"chr17",1,0.0365682137834037
"20514","chr17.10035000.10040000","chr17.10110000.10115000",75000,20,0.002565106,10035000,10110000,10040000,10115000,"chr17",608700,2,8,7,17,"chr17",1,0.0398499765588373
"20515","chr17.29775000.29780000","chr17.29805000.29810000",30000,34,0.0006898779,29775000,29805000,29780000,29810000,"chr17",608706,3,13,12,28,"chr17",1,0.111579934364744
"20516","chr17.74175000.74180000","chr17.74280000.74285000",105000,19,0.0003774324,74175000,74280000,74180000,74285000,"chr17",608759,1,5,4,10,"chr17",1,0.0222691045475856
"20517","chr17.57695000.57700000","chr17.57780000.57785000",85000,51,5.618183e-26,57695000,57780000,57700000,57785000,"chr17",608775,0,1,2,3,"chr17",1,0.0179324894514768
"20518","chr17.1350000.1355000","chr17.1455000.1460000",105000,17,0.003221243,1350000,1455000,1355000,1460000,"chr17",608784,4,23,34,61,"chr17",1,0.121542428504454
"20519","chr17.1265000.1270000","chr17.1350000.1355000",85000,21,0.0002956377,1265000,1350000,1270000,1355000,"chr17",608844,2,14,19,35,"chr17",1,0.0861462728551336
"20520","chr17.57865000.57870000","chr17.57935000.57940000",70000,23,0.0002514607,57865000,57935000,57870000,57940000,"chr17",608921,0,2,1,3,"chr17",1,0.00808720112517581
"20521","chr17.39070000.39075000","chr17.39715000.39720000",645000,8,0.003138651,39070000,39715000,39075000,39720000,"chr17",608926,2,8,5,15,"chr17",1,0.0140646976090014
"20522","chr17.40075000.40080000","chr17.40305000.40310000",230000,13,0.001330375,40075000,40305000,40080000,40310000,"chr17",608974,3,4,5,12,"chr17",1,0.0182841068917018
"20523","chr17.42985000.42990000","chr17.43195000.43200000",210000,13,0.002565106,42985000,43195000,42990000,43200000,"chr17",609043,6,21,27,54,"chr17",1,0.0822784810126582
"20524","chr17.29330000.29335000","chr17.29690000.29695000",360000,13,4.332758e-05,29330000,29690000,29335000,29695000,"chr17",609063,2,17,14,33,"chr17",1,0.05028129395218
"20525","chr17.19350000.19355000","chr17.19670000.19675000",320000,19,1.805453e-09,19350000,19670000,19355000,19675000,"chr17",609073,3,8,8,19,"chr17",1,0.0423112986404126
"20526","chr17.8015000.8020000","chr17.8195000.8200000",180000,18,1.116935e-05,8015000,8195000,8020000,8200000,"chr17",609078,1,4,4,9,"chr17",1,0.0189873417721519
"20527","chr17.17765000.17770000","chr17.17935000.17940000",170000,15,0.00105831,17765000,17935000,17770000,17940000,"chr17",609079,3,4,4,11,"chr17",1,0.0193389592123769
"20528","chr17.28740000.28745000","chr17.28915000.28920000",175000,13,0.008475646,28740000,28915000,28745000,28920000,"chr17",609082,0,7,4,11,"chr17",1,0.0167604313173933
"20529","chr17.67565000.67570000","chr17.68520000.68525000",955000,7,0.001597045,67565000,68520000,67570000,68525000,"chr17",609104,2,4,0,6,"chr17",1,0.00492264416315049
"20530","chr17.8070000.8075000","chr17.8190000.8195000",120000,18,0.000396224,8070000,8190000,8075000,8195000,"chr17",609107,1,3,0,4,"chr17",1,0.00843881856540084
"20531","chr17.9875000.9880000","chr17.10120000.10125000",245000,12,0.003021162,9875000,10120000,9880000,10125000,"chr17",609138,1,5,6,12,"chr17",1,0.0168776371308017
"20532","chr17.27970000.27975000","chr17.28190000.28195000",220000,17,6.028281e-06,27970000,28190000,27975000,28195000,"chr17",609145,4,2,5,11,"chr17",1,0.0219174871073605
"20533","chr17.2015000.2020000","chr17.2190000.2195000",175000,21,1.46315e-07,2015000,2190000,2020000,2195000,"chr17",609203,0,2,0,2,"chr17",1,0.00492264416315049
"20534","chr17.29370000.29375000","chr17.29690000.29695000",320000,10,0.00782802,29370000,29690000,29375000,29695000,"chr17",609251,2,17,14,33,"chr17",1,0.0386779184247539
"20535","chr17.2490000.2495000","chr17.2510000.2515000",20000,41,0.0007264823,2490000,2510000,2495000,2515000,"chr17",609262,3,12,16,31,"chr17",1,0.148968588842007
"20536","chr17.67560000.67565000","chr17.68100000.68105000",540000,8,0.008031519,67560000,68100000,67565000,68105000,"chr17",609291,2,2,2,6,"chr17",1,0.00562587904360056
"20537","chr17.20020000.20025000","chr17.20120000.20125000",100000,18,0.001669024,20020000,20120000,20025000,20125000,"chr17",609333,0,4,7,11,"chr17",1,0.0232067510548523
"20538","chr17.42275000.42280000","chr17.42385000.42390000",110000,21,2.141896e-05,42275000,42385000,42280000,42390000,"chr17",609358,3,8,9,20,"chr17",1,0.0492264416315049
"20539","chr17.28370000.28375000","chr17.29180000.29185000",810000,8,0.0008488783,28370000,29180000,28375000,29185000,"chr17",609369,2,16,7,25,"chr17",1,0.023441162681669
"20540","chr17.78170000.78175000","chr17.78840000.78845000",670000,8,0.002565106,78170000,78840000,78175000,78845000,"chr17",609386,1,8,4,13,"chr17",1,0.0121894045944679
"20541","chr17.19270000.19275000","chr17.19345000.19350000",75000,23,0.0001195859,19270000,19345000,19275000,19350000,"chr17",609422,3,2,7,12,"chr17",1,0.0323488045007032
"20542","chr17.5410000.5415000","chr17.6370000.6375000",960000,7,0.001511975,5410000,6370000,5415000,6375000,"chr17",609440,4,19,17,40,"chr17",1,0.0328176277543366
"20543","chr17.1055000.1060000","chr17.1075000.1080000",20000,38,0.005053586,1055000,1075000,1060000,1080000,"chr17",609465,1,6,4,11,"chr17",1,0.0489920300046882
"20544","chr17.75620000.75625000","chr17.76010000.76015000",390000,12,0.0001237086,75620000,76010000,75625000,76015000,"chr17",609478,0,6,1,7,"chr17",1,0.00984528832630099
"20545","chr17.35600000.35605000","chr17.35705000.35710000",105000,16,0.008528693,35600000,35705000,35605000,35710000,"chr17",609553,0,15,8,23,"chr17",1,0.043131739334271
"20546","chr17.17550000.17555000","chr17.17810000.17815000",260000,14,0.0001202894,17550000,17810000,17555000,17815000,"chr17",609568,0,9,5,14,"chr17",1,0.0229723394280356
"20547","chr17.57955000.57960000","chr17.58350000.58355000",395000,11,0.0005648487,57955000,58350000,57960000,58355000,"chr17",609657,4,10,8,22,"chr17",1,0.0283638068448195
"20548","chr17.46775000.46780000","chr17.46955000.46960000",180000,17,4.758552e-05,46775000,46955000,46780000,46960000,"chr17",609659,1,4,4,9,"chr17",1,0.0179324894514768
"20549","chr17.76330000.76335000","chr17.76415000.76420000",85000,27,1.727259e-07,76330000,76415000,76335000,76420000,"chr17",609740,3,4,6,13,"chr17",1,0.0411392405063291
"20550","chr17.1160000.1165000","chr17.1295000.1300000",135000,17,0.0005322899,1160000,1295000,1165000,1300000,"chr17",609746,1,17,9,27,"chr17",1,0.0537974683544304
"20551","chr17.4210000.4215000","chr17.4275000.4280000",65000,22,0.001456867,4210000,4275000,4215000,4280000,"chr17",609763,2,17,24,43,"chr17",1,0.110876699484294
"20552","chr17.10035000.10040000","chr17.10060000.10065000",25000,41,8.911254e-05,10035000,10060000,10040000,10065000,"chr17",609777,2,8,0,10,"chr17",1,0.0480543834974215
"20553","chr17.45245000.45250000","chr17.45715000.45720000",470000,12,2.720387e-05,45245000,45715000,45250000,45720000,"chr17",609802,1,0,1,2,"chr17",1,0.00281293952180028
"20554","chr17.30340000.30345000","chr17.30445000.30450000",105000,18,0.001149457,30340000,30445000,30345000,30450000,"chr17",609819,1,8,3,12,"chr17",1,0.0253164556962025
"20555","chr17.4105000.4110000","chr17.4200000.4205000",95000,18,0.0025599,4105000,4200000,4110000,4205000,"chr17",609877,0,6,3,9,"chr17",1,0.0189873417721519
"20556","chr17.59210000.59215000","chr17.59230000.59235000",20000,38,0.005053586,59210000,59230000,59215000,59235000,"chr17",609925,1,6,4,11,"chr17",1,0.0489920300046882
"20557","chr17.1790000.1795000","chr17.2170000.2175000",380000,11,0.0007264823,1790000,2170000,1795000,2175000,"chr17",609966,4,10,11,25,"chr17",1,0.0322315986872949
"20558","chr17.17880000.17885000","chr17.17935000.17940000",55000,25,0.0005289971,17880000,17935000,17885000,17940000,"chr17",610005,0,0,3,3,"chr17",1,0.00879043600562588
"20559","chr17.17250000.17255000","chr17.17550000.17555000",300000,14,3.581227e-05,17250000,17550000,17255000,17555000,"chr17",610099,0,9,5,14,"chr17",1,0.0229723394280356
"20560","chr17.39950000.39955000","chr17.40215000.40220000",265000,11,0.006318801,39950000,40215000,39955000,40220000,"chr17",610107,1,13,4,18,"chr17",1,0.0232067510548523
"20561","chr17.49390000.49395000","chr17.49615000.49620000",225000,16,2.246959e-05,49390000,49615000,49395000,49620000,"chr17",610145,6,17,24,47,"chr17",1,0.0881387716830755
"20562","chr17.4160000.4165000","chr17.4200000.4205000",40000,28,0.001330375,4160000,4200000,4165000,4205000,"chr17",610149,2,2,3,7,"chr17",1,0.0229723394280356
"20563","chr17.4730000.4735000","chr17.4785000.4790000",55000,28,2.564122e-05,4730000,4785000,4735000,4790000,"chr17",610175,4,6,14,24,"chr17",1,0.0787623066104079
"20564","chr17.30330000.30335000","chr17.30475000.30480000",145000,16,0.001035113,30330000,30475000,30335000,30480000,"chr17",610197,1,6,11,18,"chr17",1,0.0337552742616034
"20565","chr17.20060000.20065000","chr17.20115000.20120000",55000,26,0.0001996797,20060000,20115000,20065000,20120000,"chr17",610243,3,7,6,16,"chr17",1,0.0487576183778715
"20566","chr17.29330000.29335000","chr17.29530000.29535000",200000,16,7.172136e-05,29330000,29530000,29335000,29535000,"chr17",610265,4,24,23,51,"chr17",1,0.0956399437412096
"20567","chr17.55355000.55360000","chr17.55420000.55425000",65000,26,2.354887e-05,55355000,55420000,55360000,55425000,"chr17",610284,1,4,5,10,"chr17",1,0.0304735114861697
"20568","chr17.19905000.19910000","chr17.20005000.20010000",100000,35,2.581415e-14,19905000,20005000,19910000,20010000,"chr17",610386,3,12,12,27,"chr17",1,0.110759493670886
"20569","chr17.45215000.45220000","chr17.45245000.45250000",30000,36,0.0001390274,45215000,45245000,45220000,45250000,"chr17",610396,1,0,1,2,"chr17",1,0.00843881856540084
"20570","chr17.28405000.28410000","chr17.29195000.29200000",790000,7,0.005835858,28405000,29195000,28410000,29200000,"chr17",610424,2,2,1,5,"chr17",1,0.00410220346929208
"20571","chr17.47785000.47790000","chr17.47840000.47845000",55000,56,1.383491e-23,47785000,47840000,47790000,47845000,"chr17",610452,2,4,4,10,"chr17",1,0.0656352555086732
"20572","chr17.27295000.27300000","chr17.27575000.27580000",280000,12,0.001236176,27295000,27575000,27300000,27580000,"chr17",610455,1,1,0,2,"chr17",1,0.00281293952180028
"20573","chr17.37035000.37040000","chr17.37105000.37110000",70000,20,0.004561686,37035000,37105000,37040000,37110000,"chr17",610465,2,16,9,27,"chr17",1,0.0632911392405063
"20574","chr17.40285000.40290000","chr17.40305000.40310000",20000,43,0.000176468,40285000,40305000,40290000,40310000,"chr17",610570,3,4,5,12,"chr17",1,0.060478199718706
"20575","chr17.39955000.39960000","chr17.40105000.40110000",150000,16,0.0008042565,39955000,40105000,39960000,40110000,"chr17",610620,2,7,6,15,"chr17",1,0.0281293952180028
"20576","chr17.76370000.76375000","chr17.76705000.76710000",335000,14,1.419675e-05,76370000,76705000,76375000,76710000,"chr17",610663,1,1,1,3,"chr17",1,0.00492264416315049
"20577","chr17.29645000.29650000","chr17.29805000.29810000",160000,14,0.005053586,29645000,29805000,29650000,29810000,"chr17",610717,3,13,12,28,"chr17",1,0.0459446788560713
"20578","chr17.20070000.20075000","chr17.20095000.20100000",25000,41,8.911254e-05,20070000,20095000,20075000,20100000,"chr17",610724,0,1,1,2,"chr17",1,0.00961087669948429
"20579","chr17.75425000.75430000","chr17.75485000.75490000",60000,38,1.311289e-11,75425000,75485000,75430000,75490000,"chr17",610777,0,2,2,4,"chr17",1,0.0178152836380684
"20580","chr17.64300000.64305000","chr17.64420000.64425000",120000,21,8.800182e-06,64300000,64420000,64305000,64425000,"chr17",610783,8,17,13,38,"chr17",1,0.0935302390998594
"20581","chr17.75105000.75110000","chr17.75245000.75250000",140000,20,7.924415e-06,75105000,75245000,75110000,75250000,"chr17",610804,2,11,8,21,"chr17",1,0.0492264416315049
"20582","chr17.4140000.4145000","chr17.4185000.4190000",45000,25,0.004030408,4140000,4185000,4145000,4190000,"chr17",610809,1,10,8,19,"chr17",1,0.0556727613689639
"20583","chr17.40475000.40480000","chr17.40555000.40560000",80000,80,3.504206e-54,40475000,40555000,40480000,40560000,"chr17",610852,2,2,3,7,"chr17",1,0.0656352555086732
"20584","chr17.76865000.76870000","chr17.76905000.76910000",40000,31,9.483421e-05,76865000,76905000,76870000,76910000,"chr17",610862,1,2,5,8,"chr17",1,0.0290670417252696
"20585","chr17.41645000.41650000","chr17.41810000.41815000",165000,16,0.000386748,41645000,41810000,41650000,41815000,"chr17",610869,3,10,5,18,"chr17",1,0.0337552742616034
"20586","chr17.40440000.40445000","chr17.40555000.40560000",115000,24,2.054305e-07,40440000,40555000,40445000,40560000,"chr17",610875,2,2,7,11,"chr17",1,0.0309423347398031
"20587","chr17.20005000.20010000","chr17.20120000.20125000",115000,17,0.001669024,20005000,20120000,20010000,20125000,"chr17",610924,3,6,7,16,"chr17",1,0.0318799812470699
"20588","chr17.29530000.29535000","chr17.29690000.29695000",160000,18,3.610605e-05,29530000,29690000,29535000,29695000,"chr17",610928,2,17,14,33,"chr17",1,0.069620253164557
"20589","chr17.42995000.43000000","chr17.43120000.43125000",125000,24,7.37643e-08,42995000,43120000,4.3e+07,43125000,"chr17",610939,7,12,22,41,"chr17",1,0.115330520393812
"20590","chr17.10055000.10060000","chr17.10110000.10115000",55000,23,0.003138651,10055000,10110000,10060000,10115000,"chr17",610975,4,11,10,25,"chr17",1,0.0673933427097984
"20591","chr17.28710000.28715000","chr17.29120000.29125000",410000,10,0.002026927,28710000,29120000,28715000,29125000,"chr17",611013,3,3,10,16,"chr17",1,0.0187529301453352
"20592","chr17.11090000.11095000","chr17.11880000.11885000",790000,7,0.005835858,11090000,11880000,11095000,11885000,"chr17",611027,0,3,0,3,"chr17",1,0.00246132208157525
"20593","chr17.8040000.8045000","chr17.8125000.8130000",85000,25,2.488992e-06,8040000,8125000,8045000,8130000,"chr17",611032,0,16,10,26,"chr17",1,0.0761837787154243
"20594","chr17.62555000.62560000","chr17.62600000.62605000",45000,36,6.613531e-08,62555000,62600000,62560000,62605000,"chr17",611055,5,10,13,28,"chr17",1,0.118143459915612
"20595","chr17.38585000.38590000","chr17.38665000.38670000",80000,18,0.009228529,38585000,38665000,38590000,38670000,"chr17",611063,0,2,1,3,"chr17",1,0.00632911392405063
"20596","chr17.20005000.20010000","chr17.20125000.20130000",120000,16,0.003580214,20005000,20125000,20010000,20130000,"chr17",611085,4,7,11,22,"chr17",1,0.0412564463197375
"20597","chr17.16340000.16345000","chr17.16485000.16490000",145000,14,0.009049365,16340000,16485000,16345000,16490000,"chr17",611109,1,5,6,12,"chr17",1,0.019690576652602
"20598","chr17.1530000.1535000","chr17.2210000.2215000",680000,8,0.002346541,1530000,2210000,1535000,2215000,"chr17",611147,3,8,13,24,"chr17",1,0.0225035161744023
"20599","chr17.1470000.1475000","chr17.1530000.1535000",60000,25,0.0001893671,1470000,1530000,1475000,1535000,"chr17",611188,0,6,3,9,"chr17",1,0.0263713080168776
"20600","chr17.7390000.7395000","chr17.7585000.7590000",195000,18,4.726144e-06,7390000,7585000,7395000,7590000,"chr17",611211,0,3,2,5,"chr17",1,0.0105485232067511
"20601","chr17.45300000.45305000","chr17.45395000.45400000",95000,19,0.0008994793,45300000,45395000,45305000,45400000,"chr17",611217,0,3,2,5,"chr17",1,0.0111345522737928
"20602","chr17.49820000.49825000","chr17.50085000.50090000",265000,11,0.006318801,49820000,50085000,49825000,50090000,"chr17",611229,0,7,3,10,"chr17",1,0.012892639474918
"20603","chr17.74325000.74330000","chr17.74375000.74380000",50000,24,0.003353606,74325000,74375000,74330000,74380000,"chr17",611247,0,5,2,7,"chr17",1,0.019690576652602
"20604","chr17.45310000.45315000","chr17.45395000.45400000",85000,20,0.0008488783,45310000,45395000,45315000,45400000,"chr17",611276,0,3,2,5,"chr17",1,0.0117205813408345
"20605","chr17.17850000.17855000","chr17.17925000.17930000",75000,20,0.002565106,17850000,17925000,17855000,17930000,"chr17",611300,3,5,3,11,"chr17",1,0.0257852789498359
"20606","chr17.55355000.55360000","chr17.55435000.55440000",80000,19,0.003777533,55355000,55435000,55360000,55440000,"chr17",611328,0,1,5,6,"chr17",1,0.0133614627285513
"20607","chr17.57745000.57750000","chr17.57780000.57785000",35000,28,0.006465994,57745000,57780000,57750000,57785000,"chr17",611387,0,0,2,2,"chr17",1,0.00656352555086732
"20608","chr17.58215000.58220000","chr17.58515000.58520000",300000,21,6.743206e-11,58215000,58515000,58220000,58520000,"chr17",611478,3,3,7,13,"chr17",1,0.0319971870604782
"20609","chr17.20115000.20120000","chr17.20905000.20910000",790000,7,0.005835858,20115000,20905000,20120000,20910000,"chr17",611520,4,9,6,19,"chr17",1,0.0155883731833099
"20610","chr17.1635000.1640000","chr17.2190000.2195000",555000,8,0.006989075,1635000,2190000,1640000,2195000,"chr17",611530,3,8,5,16,"chr17",1,0.0150023441162682
"20611","chr17.59210000.59215000","chr17.59440000.59445000",230000,16,1.785946e-05,59210000,59440000,59215000,59445000,"chr17",611545,1,7,4,12,"chr17",1,0.0225035161744023
"20612","chr17.8200000.8205000","chr17.8220000.8225000",20000,40,0.001440905,8200000,8220000,8205000,8225000,"chr17",611615,2,19,14,35,"chr17",1,0.164088138771683
"20613","chr17.2385000.2390000","chr17.2490000.2495000",105000,22,9.471475e-06,2385000,2490000,2390000,2495000,"chr17",611628,0,2,1,3,"chr17",1,0.00773558368495077
"20614","chr17.49695000.49700000","chr17.50180000.50185000",485000,10,0.0006898779,49695000,50180000,49700000,50185000,"chr17",611636,0,3,4,7,"chr17",1,0.00820440693858415
"20615","chr17.38380000.38385000","chr17.38425000.38430000",45000,27,0.0007755452,38380000,38425000,38385000,38430000,"chr17",611669,1,5,2,8,"chr17",1,0.0253164556962025
"20616","chr17.30325000.30330000","chr17.30475000.30480000",150000,14,0.007438127,30325000,30475000,30330000,30480000,"chr17",611686,2,6,11,19,"chr17",1,0.0311767463666198
"20617","chr17.18150000.18155000","chr17.18215000.18220000",65000,24,0.0002029063,18150000,18215000,18155000,18220000,"chr17",611714,1,6,5,12,"chr17",1,0.0337552742616034
"20618","chr17.19185000.19190000","chr17.19350000.19355000",165000,14,0.004127752,19185000,19350000,19190000,19355000,"chr17",611762,8,27,31,66,"chr17",1,0.108298171589311
"20619","chr17.57830000.57835000","chr17.57925000.57930000",95000,24,2.232339e-06,57830000,57925000,57835000,57930000,"chr17",611767,3,5,5,13,"chr17",1,0.0365682137834037
"20620","chr17.45245000.45250000","chr17.45370000.45375000",125000,23,3.406872e-07,45245000,45370000,45250000,45375000,"chr17",611775,1,0,1,2,"chr17",1,0.00539146741678387
"20621","chr17.57695000.57700000","chr17.57785000.57790000",90000,31,1.786527e-10,57695000,57785000,57700000,57790000,"chr17",611823,0,1,0,1,"chr17",1,0.0036333802156587
"20622","chr17.1825000.1830000","chr17.1905000.1910000",80000,20,0.001456867,1825000,1905000,1830000,1910000,"chr17",611826,0,2,0,2,"chr17",1,0.0046882325363338
"20623","chr17.39055000.39060000","chr17.39700000.39705000",645000,20,3.780978e-15,39055000,39700000,39060000,39705000,"chr17",611828,3,8,8,19,"chr17",1,0.0445382090951711
"20624","chr17.74780000.74785000","chr17.75055000.75060000",275000,11,0.005073532,74780000,75055000,74785000,75060000,"chr17",611833,1,16,11,28,"chr17",1,0.0360993905297703
"20625","chr17.9925000.9930000","chr17.10115000.10120000",190000,14,0.001532736,9925000,10115000,9930000,10120000,"chr17",611844,0,2,0,2,"chr17",1,0.00328176277543366
"20626","chr17.32135000.32140000","chr17.32160000.32165000",25000,43,1.722114e-05,32135000,32160000,32140000,32165000,"chr17",611858,2,19,10,31,"chr17",1,0.156235349273324
"20627","chr17.17590000.17595000","chr17.17665000.17670000",75000,26,3.558981e-06,17590000,17665000,17595000,17670000,"chr17",611899,0,6,2,8,"chr17",1,0.0243788091889358
"20628","chr17.27295000.27300000","chr17.27470000.27475000",175000,18,1.503166e-05,27295000,27470000,27300000,27475000,"chr17",611904,7,12,16,35,"chr17",1,0.0738396624472574
"20629","chr17.2000000.2005000","chr17.2190000.2195000",190000,13,0.005053586,2e+06,2190000,2005000,2195000,"chr17",611910,3,8,9,20,"chr17",1,0.0304735114861697
"20630","chr17.74780000.74785000","chr17.75585000.75590000",805000,7,0.005223507,74780000,75585000,74785000,75590000,"chr17",611938,1,7,11,19,"chr17",1,0.0155883731833099
"20631","chr17.79485000.79490000","chr17.79565000.79570000",80000,21,0.0005315089,79485000,79565000,79490000,79570000,"chr17",612031,2,4,1,7,"chr17",1,0.0172292545710267
"20632","chr17.66810000.66815000","chr17.67020000.67025000",210000,12,0.00819977,66810000,67020000,66815000,67025000,"chr17",612085,2,4,6,12,"chr17",1,0.0168776371308017
"20633","chr17.27965000.27970000","chr17.28370000.28375000",405000,9,0.008895296,27965000,28370000,27970000,28375000,"chr17",612104,2,14,11,27,"chr17",1,0.0284810126582278
"20634","chr17.9875000.9880000","chr17.10095000.10100000",220000,13,0.001798254,9875000,10095000,9880000,10100000,"chr17",612107,3,5,10,18,"chr17",1,0.0274261603375527
"20635","chr17.37105000.37110000","chr17.37300000.37305000",195000,13,0.004215649,37105000,37300000,37110000,37305000,"chr17",612233,2,16,9,27,"chr17",1,0.0411392405063291
"20636","chr17.76905000.76910000","chr17.76930000.76935000",25000,39,0.000411434,76905000,76930000,76910000,76935000,"chr17",612238,2,7,6,15,"chr17",1,0.0685654008438819
"20637","chr17.55340000.55345000","chr17.55750000.55755000",410000,10,0.002026927,55340000,55750000,55345000,55755000,"chr17",612293,1,1,7,9,"chr17",1,0.0105485232067511
"20638","chr17.57785000.57790000","chr17.57830000.57835000",45000,24,0.008636132,57785000,57830000,57790000,57835000,"chr17",612314,0,3,0,3,"chr17",1,0.00843881856540084
"20639","chr17.76710000.76715000","chr17.76965000.76970000",255000,11,0.007968579,76710000,76965000,76715000,76970000,"chr17",612327,2,12,5,19,"chr17",1,0.0244960150023441
"20640","chr17.58350000.58355000","chr17.58415000.58420000",65000,20,0.00843862,58350000,58415000,58355000,58420000,"chr17",612381,3,9,8,20,"chr17",1,0.046882325363338
"20641","chr17.57860000.57865000","chr17.57880000.57885000",20000,41,0.0007264823,57860000,57880000,57865000,57885000,"chr17",612389,3,14,8,25,"chr17",1,0.120135958743554
"20642","chr17.17255000.17260000","chr17.17475000.17480000",220000,15,0.0001222665,17255000,17475000,17260000,17480000,"chr17",612427,6,10,15,31,"chr17",1,0.0545007032348805
"20643","chr17.38460000.38465000","chr17.38505000.38510000",45000,47,2.244207e-14,38460000,38505000,38465000,38510000,"chr17",612459,0,7,3,10,"chr17",1,0.0550867323019222
"20644","chr17.55415000.55420000","chr17.55435000.55440000",20000,58,1.907309e-10,55415000,55435000,55420000,55440000,"chr17",612466,0,1,6,7,"chr17",1,0.0475855602437881
"20645","chr17.42565000.42570000","chr17.42740000.42745000",175000,17,6.17513e-05,42565000,42740000,42570000,42745000,"chr17",612483,0,0,3,3,"chr17",1,0.0059774964838256
"20646","chr17.66810000.66815000","chr17.67240000.67245000",430000,14,1.44421e-06,66810000,67240000,66815000,67245000,"chr17",612488,0,2,0,2,"chr17",1,0.00328176277543366
"20647","chr17.4840000.4845000","chr17.4885000.4890000",45000,26,0.001798254,4840000,4885000,4845000,4890000,"chr17",612511,0,4,3,7,"chr17",1,0.0213314580403188
"20648","chr17.57860000.57865000","chr17.57910000.57915000",50000,23,0.007407055,57860000,57910000,57865000,57915000,"chr17",612515,7,14,11,32,"chr17",1,0.086263478668542
"20649","chr17.37105000.37110000","chr17.37475000.37480000",370000,11,0.0008606318,37105000,37475000,37110000,37480000,"chr17",612550,2,8,4,14,"chr17",1,0.0180496952648851
"20650","chr17.29060000.29065000","chr17.29145000.29150000",85000,18,0.006024578,29060000,29145000,29065000,29150000,"chr17",612552,6,14,10,30,"chr17",1,0.0632911392405063
"20651","chr17.55390000.55395000","chr17.55415000.55420000",25000,37,0.001677404,55390000,55415000,55395000,55420000,"chr17",612608,0,4,0,4,"chr17",1,0.0173464603844351
"20652","chr17.29870000.29875000","chr17.30160000.30165000",290000,11,0.003706677,29870000,30160000,29875000,30165000,"chr17",612620,4,6,5,15,"chr17",1,0.0193389592123769
"20653","chr17.34960000.34965000","chr17.35730000.35735000",770000,11,2.690931e-06,34960000,35730000,34965000,35735000,"chr17",612635,0,0,4,4,"chr17",1,0.00515705578996718
"20654","chr17.29620000.29625000","chr17.29645000.29650000",25000,48,1.862634e-07,29620000,29645000,29625000,29650000,"chr17",612683,2,5,3,10,"chr17",1,0.0562587904360056
"20655","chr17.44140000.44145000","chr17.44220000.44225000",80000,20,0.001456867,44140000,44220000,44145000,44225000,"chr17",612692,6,16,8,30,"chr17",1,0.070323488045007
"20656","chr17.78705000.78710000","chr17.78840000.78845000",135000,16,0.001669024,78705000,78840000,78710000,78845000,"chr17",612729,0,4,1,5,"chr17",1,0.00937646507266761
"20657","chr17.57375000.57380000","chr17.57905000.57910000",530000,13,1.274496e-06,57375000,57905000,57380000,57910000,"chr17",612742,0,10,9,19,"chr17",1,0.0289498359118612
"20658","chr17.38450000.38455000","chr17.38505000.38510000",55000,22,0.007097885,38450000,38505000,38455000,38510000,"chr17",612782,1,1,1,3,"chr17",1,0.00773558368495077
"20659","chr17.42555000.42560000","chr17.42740000.42745000",185000,13,0.006044125,42555000,42740000,42560000,42745000,"chr17",612831,9,27,21,57,"chr17",1,0.0868495077355837
"20660","chr17.28720000.28725000","chr17.28810000.28815000",90000,17,0.009638929,28720000,28810000,28725000,28815000,"chr17",612833,1,7,10,18,"chr17",1,0.0358649789029536
"20661","chr17.30785000.30790000","chr17.31095000.31100000",310000,19,2.705206e-09,30785000,31095000,30790000,31100000,"chr17",612835,1,13,8,22,"chr17",1,0.0489920300046882
"20662","chr17.76930000.76935000","chr17.76965000.76970000",35000,28,0.006465994,76930000,76965000,76935000,76970000,"chr17",612962,2,7,5,14,"chr17",1,0.0459446788560713
"20663","chr17.16285000.16290000","chr17.16340000.16345000",55000,67,7.062576e-33,16285000,16340000,16290000,16345000,"chr17",612969,3,14,8,25,"chr17",1,0.196319737458978
"20664","chr17.57375000.57380000","chr17.57525000.57530000",150000,21,9.149042e-07,57375000,57525000,57380000,57530000,"chr17",612972,0,6,6,12,"chr17",1,0.029535864978903
"20665","chr17.5485000.5490000","chr17.6305000.6310000",820000,13,1.250631e-08,5485000,6305000,5490000,6310000,"chr17",612974,0,2,0,2,"chr17",1,0.00304735114861697
"20666","chr17.34960000.34965000","chr17.35930000.35935000",970000,6,0.008810089,34960000,35930000,34965000,35935000,"chr17",612983,0,0,4,4,"chr17",1,0.00281293952180028
"20667","chr17.37480000.37485000","chr17.37505000.37510000",25000,35,0.006199316,37480000,37505000,37485000,37510000,"chr17",612989,3,15,4,22,"chr17",1,0.0902484763244257
"20668","chr17.39115000.39120000","chr17.39135000.39140000",20000,43,0.000176468,39115000,39135000,39120000,39140000,"chr17",613039,3,7,4,14,"chr17",1,0.0705578996718237
"20669","chr17.38400000.38405000","chr17.38425000.38430000",25000,45,3.015417e-06,38400000,38425000,38405000,38430000,"chr17",613043,0,1,0,1,"chr17",1,0.00527426160337553
"20670","chr17.40305000.40310000","chr17.40540000.40545000",235000,14,0.0002872587,40305000,40540000,40310000,40545000,"chr17",613063,2,4,5,11,"chr17",1,0.0180496952648851
"20671","chr17.1455000.1460000","chr17.1530000.1535000",75000,21,0.0009641365,1455000,1530000,1460000,1535000,"chr17",613073,3,8,13,24,"chr17",1,0.0590717299578059
"20672","chr17.57830000.57835000","chr17.57860000.57865000",30000,34,0.0006898779,57830000,57860000,57835000,57865000,"chr17",613140,4,5,5,14,"chr17",1,0.0557899671823722
"20673","chr17.58515000.58520000","chr17.58655000.58660000",140000,17,0.0004053829,58515000,58655000,58520000,58660000,"chr17",613157,3,3,7,13,"chr17",1,0.0259024847632443
"20674","chr17.6375000.6380000","chr17.6550000.6555000",175000,14,0.002807183,6375000,6550000,6380000,6555000,"chr17",613174,0,6,6,12,"chr17",1,0.019690576652602
"20675","chr17.3635000.3640000","chr17.3695000.3700000",60000,22,0.003186159,3635000,3695000,3640000,3700000,"chr17",613185,1,7,5,13,"chr17",1,0.0335208626347867
"20676","chr17.40305000.40310000","chr17.40555000.40560000",250000,16,7.618559e-06,40305000,40555000,40310000,40560000,"chr17",613247,2,2,5,9,"chr17",1,0.0168776371308017
"20677","chr17.47615000.47620000","chr17.47790000.47795000",175000,14,0.002807183,47615000,47790000,47620000,47795000,"chr17",613259,4,8,12,24,"chr17",1,0.0393811533052039
"20678","chr17.66990000.66995000","chr17.67020000.67025000",30000,31,0.005977364,66990000,67020000,66995000,67025000,"chr17",613275,1,3,5,9,"chr17",1,0.0327004219409283
"20679","chr17.49190000.49195000","chr17.49225000.49230000",35000,30,0.001475334,49190000,49225000,49195000,49230000,"chr17",613283,4,9,8,21,"chr17",1,0.0738396624472574
"20680","chr17.1455000.1460000","chr17.1735000.1740000",280000,11,0.004598869,1455000,1735000,1460000,1740000,"chr17",613286,1,9,7,17,"chr17",1,0.0219174871073605
"20681","chr17.57745000.57750000","chr17.58030000.58035000",285000,15,1.086049e-05,57745000,58030000,57750000,58035000,"chr17",613342,0,0,3,3,"chr17",1,0.00527426160337553
"20682","chr17.73345000.73350000","chr17.73365000.73370000",20000,39,0.00274559,73345000,73365000,73350000,73370000,"chr17",613347,1,6,7,14,"chr17",1,0.0639943741209564
"20683","chr17.55345000.55350000","chr17.55525000.55530000",180000,13,0.007112204,55345000,55525000,55350000,55530000,"chr17",613358,0,2,2,4,"chr17",1,0.00609470229723394
"20684","chr17.35310000.35315000","chr17.35765000.35770000",455000,11,0.000203985,35310000,35765000,35315000,35770000,"chr17",613383,0,2,1,3,"chr17",1,0.00386779184247539
"20685","chr17.59505000.59510000","chr17.59650000.59655000",145000,15,0.003186159,59505000,59650000,59510000,59655000,"chr17",613462,2,7,1,10,"chr17",1,0.0175808720112518
"20686","chr17.255000.260000","chr17.605000.610000",350000,21,7.611766e-12,255000,605000,260000,610000,"chr17",613503,1,1,2,4,"chr17",1,0.00984528832630099
"20687","chr17.78535000.78540000","chr17.78985000.78990000",450000,9,0.005053586,78535000,78985000,78540000,78990000,"chr17",613525,1,11,10,22,"chr17",1,0.0232067510548523
"20688","chr17.1265000.1270000","chr17.1295000.1300000",30000,51,2.343723e-11,1265000,1295000,1270000,1300000,"chr17",613574,1,14,9,24,"chr17",1,0.143459915611814
"20689","chr17.4840000.4845000","chr17.4875000.4880000",35000,31,0.0006807858,4840000,4875000,4845000,4880000,"chr17",613627,0,4,6,10,"chr17",1,0.036333802156587
"20690","chr17.42285000.42290000","chr17.42405000.42410000",120000,21,8.800182e-06,42285000,42405000,42290000,42410000,"chr17",613642,0,3,1,4,"chr17",1,0.00984528832630099
"20691","chr17.17250000.17255000","chr17.17500000.17505000",250000,11,0.008964847,17250000,17500000,17255000,17505000,"chr17",613653,2,7,1,10,"chr17",1,0.012892639474918
"20692","chr17.8155000.8160000","chr17.8185000.8190000",30000,34,0.0006898779,8155000,8185000,8160000,8190000,"chr17",613705,0,2,0,2,"chr17",1,0.00796999531176746
"20693","chr17.19745000.19750000","chr17.19765000.19770000",20000,43,0.000176468,19745000,19765000,19750000,19770000,"chr17",613790,0,2,1,3,"chr17",1,0.0151195499296765
"20694","chr17.7475000.7480000","chr17.7585000.7590000",110000,25,8.086083e-08,7475000,7585000,7480000,7590000,"chr17",613792,0,4,2,6,"chr17",1,0.0175808720112518
"20695","chr17.3645000.3650000","chr17.3715000.3720000",70000,25,2.835169e-05,3645000,3715000,3650000,3720000,"chr17",613831,4,10,11,25,"chr17",1,0.0732536333802157
"20696","chr17.20070000.20075000","chr17.20120000.20125000",50000,33,3.911995e-07,20070000,20120000,20075000,20125000,"chr17",613833,3,5,7,15,"chr17",1,0.0580168776371308
"20697","chr17.57830000.57835000","chr17.57905000.57910000",75000,44,2.189744e-18,57830000,57905000,57835000,57910000,"chr17",613873,4,5,5,14,"chr17",1,0.0721987810595406
"20698","chr17.76865000.76870000","chr17.76970000.76975000",105000,25,1.511352e-07,76865000,76970000,76870000,76975000,"chr17",613895,0,1,2,3,"chr17",1,0.00879043600562588
"20699","chr17.27990000.27995000","chr17.28250000.28255000",260000,15,2.567541e-05,27990000,28250000,27995000,28255000,"chr17",613897,4,2,2,8,"chr17",1,0.0140646976090014
"20700","chr17.80425000.80430000","chr17.80445000.80450000",20000,38,0.005053586,80425000,80445000,80430000,80450000,"chr17",613926,1,0,0,1,"chr17",1,0.00445382090951711
"20701","chr17.19405000.19410000","chr17.19645000.19650000",240000,13,0.0009486344,19405000,19645000,19410000,19650000,"chr17",613936,4,6,5,15,"chr17",1,0.0228551336146273
"20702","chr17.16285000.16290000","chr17.16485000.16490000",200000,18,3.558981e-06,16285000,16485000,16290000,16490000,"chr17",613968,1,5,6,12,"chr17",1,0.0253164556962025
"20703","chr17.27965000.27970000","chr17.28010000.28015000",45000,32,6.121019e-06,27965000,28010000,27970000,28015000,"chr17",613998,4,10,12,26,"chr17",1,0.0975152367557431
"20704","chr17.66755000.66760000","chr17.67240000.67245000",485000,22,3.194418e-15,66755000,67240000,66760000,67245000,"chr17",614018,0,2,0,2,"chr17",1,0.00515705578996718
"20705","chr17.50065000.50070000","chr17.50090000.50095000",25000,37,0.001677404,50065000,50090000,50070000,50095000,"chr17",614069,2,6,6,14,"chr17",1,0.0607126113455227
"20706","chr17.76480000.76485000","chr17.76695000.76700000",215000,15,0.0001511474,76480000,76695000,76485000,76700000,"chr17",614074,5,10,5,20,"chr17",1,0.0351617440225035
"20707","chr17.50065000.50070000","chr17.50085000.50090000",20000,48,3.162399e-06,50065000,50085000,50070000,50090000,"chr17",614107,0,10,3,13,"chr17",1,0.0731364275668073
"20708","chr17.28810000.28815000","chr17.29015000.29020000",205000,12,0.00945475,28810000,29015000,28815000,29020000,"chr17",614243,1,7,12,20,"chr17",1,0.0281293952180028
"20709","chr17.4210000.4215000","chr17.4255000.4260000",45000,30,4.77768e-05,4210000,4255000,4215000,4260000,"chr17",614294,1,7,10,18,"chr17",1,0.0632911392405063
"20710","chr17.5415000.5420000","chr17.5465000.5470000",50000,24,0.003353606,5415000,5465000,5420000,5470000,"chr17",614309,0,2,1,3,"chr17",1,0.00843881856540084
"20711","chr17.28010000.28015000","chr17.28190000.28195000",180000,13,0.007112204,28010000,28190000,28015000,28195000,"chr17",614311,4,2,5,11,"chr17",1,0.0167604313173933
"20712","chr17.19955000.19960000","chr17.20005000.20010000",50000,27,0.0002378979,19955000,20005000,19960000,20010000,"chr17",614374,4,12,13,29,"chr17",1,0.0917721518987342
"20713","chr17.39065000.39070000","chr17.39700000.39705000",635000,21,3.134362e-16,39065000,39700000,39070000,39705000,"chr17",614387,3,8,8,19,"chr17",1,0.0467651195499297
"20714","chr17.4175000.4180000","chr17.4230000.4235000",55000,23,0.003138651,4175000,4230000,4180000,4235000,"chr17",614394,3,2,2,7,"chr17",1,0.0188701359587436
"20715","chr17.74335000.74340000","chr17.74775000.74780000",440000,9,0.005813824,74335000,74775000,74340000,74780000,"chr17",614425,3,3,3,9,"chr17",1,0.00949367088607595
"20716","chr17.62600000.62605000","chr17.62625000.62630000",25000,38,0.0008488783,62600000,62625000,62605000,62630000,"chr17",614438,3,4,2,9,"chr17",1,0.040084388185654
"20717","chr17.32495000.32500000","chr17.32670000.32675000",175000,15,0.0008488783,32495000,32670000,32500000,32675000,"chr17",614441,3,18,12,33,"chr17",1,0.0580168776371308
"20718","chr17.9875000.9880000","chr17.10035000.10040000",160000,15,0.001633505,9875000,10035000,9880000,10040000,"chr17",614472,2,5,7,14,"chr17",1,0.0246132208157525
"20719","chr17.27295000.27300000","chr17.27500000.27505000",205000,12,0.00945475,27295000,27500000,27300000,27505000,"chr17",614487,2,12,16,30,"chr17",1,0.0421940928270042
"20720","chr17.62550000.62555000","chr17.62595000.62600000",45000,24,0.008636132,62550000,62595000,62555000,62600000,"chr17",614535,1,8,8,17,"chr17",1,0.0478199718706048
"20721","chr17.17400000.17405000","chr17.17935000.17940000",535000,8,0.00845347,17400000,17935000,17405000,17940000,"chr17",614563,3,1,5,9,"chr17",1,0.00843881856540084
"20722","chr17.40215000.40220000","chr17.40610000.40615000",395000,11,0.0005648487,40215000,40610000,40220000,40615000,"chr17",614569,5,6,7,18,"chr17",1,0.0232067510548523
"20723","chr17.60740000.60745000","chr17.61260000.61265000",520000,8,0.009692374,60740000,61260000,60745000,61265000,"chr17",614572,0,4,2,6,"chr17",1,0.00562587904360056
"20724","chr17.2415000.2420000","chr17.2490000.2495000",75000,28,2.773072e-07,2415000,2490000,2420000,2495000,"chr17",614576,0,4,4,8,"chr17",1,0.0262541022034693
"20725","chr17.47490000.47495000","chr17.47645000.47650000",155000,14,0.006199316,47490000,47645000,47495000,47650000,"chr17",614592,5,26,35,66,"chr17",1,0.108298171589311
"20726","chr17.78840000.78845000","chr17.78890000.78895000",50000,23,0.007407055,78840000,78890000,78845000,78895000,"chr17",614613,0,3,0,3,"chr17",1,0.00808720112517581
"20727","chr17.55235000.55240000","chr17.55750000.55755000",515000,9,0.002322693,55235000,55750000,55240000,55755000,"chr17",614722,1,1,1,3,"chr17",1,0.00316455696202532
"20728","chr17.59505000.59510000","chr17.59620000.59625000",115000,21,1.373981e-05,59505000,59620000,59510000,59625000,"chr17",614737,2,3,1,6,"chr17",1,0.0147679324894515
"20729","chr17.8300000.8305000","chr17.8630000.8635000",330000,10,0.006688623,8300000,8630000,8305000,8635000,"chr17",614741,1,7,7,15,"chr17",1,0.0175808720112518
"20730","chr17.66810000.66815000","chr17.67220000.67225000",410000,15,3.406872e-07,66810000,67220000,66815000,67225000,"chr17",614747,2,4,12,18,"chr17",1,0.0316455696202532
"20731","chr17.17590000.17595000","chr17.17755000.17760000",165000,23,1.13965e-08,17590000,17755000,17595000,17760000,"chr17",614750,0,2,2,4,"chr17",1,0.0107829348335677
"20732","chr17.57855000.57860000","chr17.57900000.57905000",45000,28,0.0003174977,57855000,57900000,57860000,57905000,"chr17",614761,3,11,15,29,"chr17",1,0.0951711204875762
"20733","chr17.66740000.66745000","chr17.67220000.67225000",480000,9,0.003488352,66740000,67220000,66745000,67225000,"chr17",614770,0,2,1,3,"chr17",1,0.00316455696202532
"20734","chr17.8090000.8095000","chr17.8150000.8155000",60000,24,0.0005165312,8090000,8150000,8095000,8155000,"chr17",614779,0,6,4,10,"chr17",1,0.0281293952180028
"20735","chr17.4215000.4220000","chr17.4260000.4265000",45000,34,6.773414e-07,4215000,4260000,4220000,4265000,"chr17",614801,4,9,3,16,"chr17",1,0.0637599624941397
"20736","chr17.40300000.40305000","chr17.40650000.40655000",350000,11,0.001241031,40300000,40650000,40305000,40655000,"chr17",614874,2,12,6,20,"chr17",1,0.0257852789498359
"20737","chr17.57375000.57380000","chr17.57515000.57520000",140000,25,3.634168e-09,57375000,57515000,57380000,57520000,"chr17",614886,0,5,2,7,"chr17",1,0.0205110173464604
"20738","chr17.37475000.37480000","chr17.37525000.37530000",50000,29,3.257849e-05,37475000,37525000,37480000,37530000,"chr17",614889,2,8,4,14,"chr17",1,0.0475855602437881
"20739","chr17.8125000.8130000","chr17.8195000.8200000",70000,33,8.256687e-10,8125000,8195000,8130000,8200000,"chr17",614938,5,24,15,44,"chr17",1,0.170182841068917
"20740","chr18.21485000.21490000","chr18.21505000.21510000",20000,36,0.006582485,21485000,21505000,21490000,21510000,"chr18",615011,0,3,2,5,"chr18",1,0.0210970464135021
"20741","chr18.50695000.50700000","chr18.50820000.50825000",125000,14,0.00908001,50695000,50820000,50700000,50825000,"chr18",615022,0,3,5,8,"chr18",1,0.0131270511017346
"20742","chr18.3260000.3265000","chr18.3280000.3285000",20000,45,7.860895e-06,3260000,3280000,3265000,3285000,"chr18",615030,1,6,7,14,"chr18",1,0.0738396624472574
"20743","chr18.13555000.13560000","chr18.13655000.13660000",100000,19,0.0001380708,13555000,13655000,13560000,13660000,"chr18",615067,1,4,3,8,"chr18",1,0.0178152836380684
"20744","chr18.8705000.8710000","chr18.9475000.9480000",770000,9,0.0004632959,8705000,9475000,8710000,9480000,"chr18",615095,3,2,2,7,"chr18",1,0.00738396624472574
"20745","chr18.3395000.3400000","chr18.3585000.3590000",190000,16,4.608878e-05,3395000,3585000,3400000,3590000,"chr18",615168,10,27,22,59,"chr18",1,0.110642287857478
"20746","chr18.11040000.11045000","chr18.11115000.11120000",75000,26,4.055395e-07,11040000,11115000,11045000,11120000,"chr18",615190,1,4,4,9,"chr18",1,0.0274261603375527
"20747","chr18.9710000.9715000","chr18.9940000.9945000",230000,12,0.003113714,9710000,9940000,9715000,9945000,"chr18",615229,0,1,3,4,"chr18",1,0.00562587904360056
"20748","chr18.57730000.57735000","chr18.58205000.58210000",475000,10,0.001229981,57730000,58205000,57735000,58210000,"chr18",615275,1,10,12,23,"chr18",1,0.0269573370839194
"20749","chr18.57660000.57665000","chr18.58220000.58225000",560000,12,1.251054e-05,57660000,58220000,57665000,58225000,"chr18",615277,1,3,0,4,"chr18",1,0.00562587904360056
"20750","chr18.330000.335000","chr18.445000.450000",115000,15,0.005020386,330000,445000,335000,450000,"chr18",615307,2,2,4,8,"chr18",1,0.0140646976090014
"20751","chr18.11070000.11075000","chr18.11115000.11120000",45000,25,0.001282808,11070000,11115000,11075000,11120000,"chr18",615327,0,3,0,3,"chr18",1,0.00879043600562588
"20752","chr18.740000.745000","chr18.835000.840000",95000,19,0.0002243362,740000,835000,745000,840000,"chr18",615351,3,7,8,18,"chr18",1,0.040084388185654
"20753","chr18.57665000.57670000","chr18.58215000.58220000",550000,13,1.92005e-06,57665000,58215000,57670000,58220000,"chr18",615392,3,7,5,15,"chr18",1,0.0228551336146273
"20754","chr18.8695000.8700000","chr18.8975000.8980000",280000,13,0.0002057491,8695000,8975000,8700000,8980000,"chr18",615438,1,11,12,24,"chr18",1,0.0365682137834037
"20755","chr18.330000.335000","chr18.615000.620000",285000,12,0.0008494746,330000,615000,335000,620000,"chr18",615466,0,4,2,6,"chr18",1,0.00843881856540084
"20756","chr18.46660000.46665000","chr18.46755000.46760000",95000,17,0.002241046,46660000,46755000,46665000,46760000,"chr18",615485,0,1,3,4,"chr18",1,0.00796999531176746
"20757","chr18.615000.620000","chr18.830000.835000",215000,13,0.001282808,615000,830000,620000,835000,"chr18",615498,0,4,2,6,"chr18",1,0.00914205344585091
"20758","chr18.57640000.57645000","chr18.58265000.58270000",625000,8,0.007338353,57640000,58265000,57645000,58270000,"chr18",615516,1,1,4,6,"chr18",1,0.00562587904360056
"20759","chr18.3135000.3140000","chr18.3245000.3250000",110000,19,5.771493e-05,3135000,3245000,3140000,3250000,"chr18",615552,3,5,2,10,"chr18",1,0.0222691045475856
"20760","chr18.5455000.5460000","chr18.5515000.5520000",60000,21,0.002459267,5455000,5515000,5460000,5520000,"chr18",615603,1,2,0,3,"chr18",1,0.00738396624472574
"20761","chr18.8695000.8700000","chr18.8985000.8990000",290000,15,5.770546e-06,8695000,8985000,8700000,8990000,"chr18",615608,1,11,12,24,"chr18",1,0.0421940928270042
"20762","chr18.3125000.3130000","chr18.3245000.3250000",120000,19,2.69309e-05,3125000,3245000,3130000,3250000,"chr18",615620,2,7,2,11,"chr18",1,0.0244960150023441
"20763","chr18.10850000.10855000","chr18.11135000.11140000",285000,20,4.051138e-10,10850000,11135000,10855000,11140000,"chr18",615632,2,2,4,8,"chr18",1,0.0187529301453352
"20764","chr18.13265000.13270000","chr18.13435000.13440000",170000,16,0.0001156822,13265000,13435000,13270000,13440000,"chr18",615643,3,2,0,5,"chr18",1,0.00937646507266761
"20765","chr18.58995000.59000000","chr18.59070000.59075000",75000,20,0.0007033075,58995000,59070000,5.9e+07,59075000,"chr18",615717,7,11,19,37,"chr18",1,0.0867323019221753
"20766","chr18.12375000.12380000","chr18.12405000.12410000",30000,35,8.4627e-05,12375000,12405000,12380000,12410000,"chr18",615722,5,5,11,21,"chr18",1,0.0861462728551336
"20767","chr18.62155000.62160000","chr18.63130000.63135000",975000,7,0.004207492,62155000,63130000,62160000,63135000,"chr18",615830,1,2,1,4,"chr18",1,0.00328176277543366
"20768","chr18.37335000.37340000","chr18.37780000.37785000",445000,9,0.007417877,37335000,37780000,37340000,37785000,"chr18",615835,1,1,1,3,"chr18",1,0.00316455696202532
"20769","chr18.3445000.3450000","chr18.3605000.3610000",160000,15,0.0007066494,3445000,3605000,3450000,3610000,"chr18",615836,0,3,6,9,"chr18",1,0.0158227848101266
"20770","chr18.9115000.9120000","chr18.9330000.9335000",215000,21,2.12063e-09,9115000,9330000,9120000,9335000,"chr18",615859,0,5,3,8,"chr18",1,0.019690576652602
"20771","chr18.2970000.2975000","chr18.2995000.3000000",25000,38,0.0002627198,2970000,2995000,2975000,3e+06,"chr18",615864,0,3,4,7,"chr18",1,0.0311767463666198
"20772","chr18.56485000.56490000","chr18.56690000.56695000",205000,16,2.374414e-05,56485000,56690000,56490000,56695000,"chr18",615867,2,6,0,8,"chr18",1,0.0150023441162682
"20773","chr18.13235000.13240000","chr18.13265000.13270000",30000,50,4.880015e-12,13235000,13265000,13240000,13270000,"chr18",615869,0,4,3,7,"chr18",1,0.0410220346929208
"20774","chr18.10030000.10035000","chr18.10525000.10530000",495000,10,0.001002513,10030000,10525000,10035000,10530000,"chr18",615885,0,3,3,6,"chr18",1,0.0070323488045007
"20775","chr18.710000.715000","chr18.835000.840000",125000,18,7.52779e-05,710000,835000,715000,840000,"chr18",615948,3,7,8,18,"chr18",1,0.0379746835443038
"20776","chr18.8650000.8655000","chr18.9070000.9075000",420000,11,0.0004716402,8650000,9070000,8655000,9075000,"chr18",615984,2,14,18,34,"chr18",1,0.0438349742147211
"20777","chr18.11050000.11055000","chr18.11120000.11125000",70000,19,0.003608949,11050000,11120000,11055000,11125000,"chr18",616023,3,10,4,17,"chr18",1,0.0378574777308955
"20778","chr18.9070000.9075000","chr18.9135000.9140000",65000,44,1.244126e-18,9070000,9135000,9075000,9140000,"chr18",616038,2,3,4,9,"chr18",1,0.0464135021097046
"20779","chr18.13415000.13420000","chr18.13435000.13440000",20000,40,0.0004458534,13415000,13435000,13420000,13440000,"chr18",616056,3,2,0,5,"chr18",1,0.023441162681669
"20780","chr18.13555000.13560000","chr18.13680000.13685000",125000,24,7.699014e-09,13555000,13680000,13560000,13685000,"chr18",616062,1,4,3,8,"chr18",1,0.0225035161744023
"20781","chr18.9615000.9620000","chr18.9715000.9720000",100000,20,3.896364e-05,9615000,9715000,9620000,9720000,"chr18",616079,3,5,9,17,"chr18",1,0.0398499765588373
"20782","chr18.9710000.9715000","chr18.9735000.9740000",25000,57,7.015559e-13,9710000,9735000,9715000,9740000,"chr18",616089,4,8,11,23,"chr18",1,0.15365682137834
"20783","chr18.57665000.57670000","chr18.58205000.58210000",540000,11,0.0001051644,57665000,58205000,57670000,58210000,"chr18",616130,1,10,8,19,"chr18",1,0.0244960150023441
"20784","chr18.48340000.48345000","chr18.48575000.48580000",235000,28,1.654611e-16,48340000,48575000,48345000,48580000,"chr18",616148,0,3,5,8,"chr18",1,0.0262541022034693
"20785","chr18.9615000.9620000","chr18.9670000.9675000",55000,23,0.000966907,9615000,9670000,9620000,9675000,"chr18",616306,3,5,15,23,"chr18",1,0.0620018752930145
"20786","chr18.52905000.52910000","chr18.53535000.53540000",630000,8,0.007053212,52905000,53535000,52910000,53540000,"chr18",616308,0,0,4,4,"chr18",1,0.00375058602906704
"20787","chr18.31685000.31690000","chr18.32660000.32665000",975000,7,0.004207492,31685000,32660000,31690000,32665000,"chr18",616382,1,2,0,3,"chr18",1,0.00246132208157525
"20788","chr18.5875000.5880000","chr18.6480000.6485000",605000,12,6.968978e-06,5875000,6480000,5880000,6485000,"chr18",616402,4,5,9,18,"chr18",1,0.0253164556962025
"20789","chr18.60090000.60095000","chr18.60370000.60375000",280000,14,4.196263e-05,60090000,60370000,60095000,60375000,"chr18",616463,2,3,2,7,"chr18",1,0.0114861697140178
"20790","chr18.57630000.57635000","chr18.58205000.58210000",575000,9,0.002303015,57630000,58205000,57635000,58210000,"chr18",616497,1,12,12,25,"chr18",1,0.0263713080168776
"20791","chr18.640000.645000","chr18.705000.710000",65000,21,0.001052627,640000,705000,645000,710000,"chr18",616511,2,6,8,16,"chr18",1,0.0393811533052039
"20792","chr18.24010000.24015000","chr18.24215000.24220000",205000,14,0.0004586232,24010000,24215000,24015000,24220000,"chr18",616536,3,4,9,16,"chr18",1,0.0262541022034693
"20793","chr18.5450000.5455000","chr18.5545000.5550000",95000,26,1.149709e-08,5450000,5545000,5455000,5550000,"chr18",616562,0,3,3,6,"chr18",1,0.0182841068917018
"20794","chr18.57640000.57645000","chr18.58205000.58210000",565000,15,2.008483e-08,57640000,58205000,57645000,58210000,"chr18",616635,1,12,12,25,"chr18",1,0.0439521800281294
"20795","chr18.3010000.3015000","chr18.3135000.3140000",125000,16,0.0009835455,3010000,3135000,3015000,3140000,"chr18",616660,4,5,8,17,"chr18",1,0.0318799812470699
"20796","chr18.8700000.8705000","chr18.8980000.8985000",280000,19,3.979102e-09,8700000,8980000,8705000,8985000,"chr18",616686,3,8,12,23,"chr18",1,0.0512189404594468
"20797","chr18.9795000.9800000","chr18.9940000.9945000",145000,23,7.868111e-09,9795000,9940000,9800000,9945000,"chr18",616694,0,1,3,4,"chr18",1,0.0107829348335677
"20798","chr18.8730000.8735000","chr18.8975000.8980000",245000,12,0.002121276,8730000,8975000,8735000,8980000,"chr18",616765,4,15,14,33,"chr18",1,0.0464135021097046
"20799","chr18.9075000.9080000","chr18.9135000.9140000",60000,24,0.0001168961,9075000,9135000,9080000,9140000,"chr18",616766,4,3,4,11,"chr18",1,0.0309423347398031
"20800","chr18.3845000.3850000","chr18.3890000.3895000",45000,23,0.006842379,3845000,3890000,3850000,3895000,"chr18",616792,2,0,1,3,"chr18",1,0.00808720112517581
"20801","chr18.46750000.46755000","chr18.46770000.46775000",20000,38,0.00184737,46750000,46770000,46755000,46775000,"chr18",616844,0,2,6,8,"chr18",1,0.0356305672761369
"20802","chr18.56575000.56580000","chr18.56690000.56695000",115000,18,0.0001452457,56575000,56690000,56580000,56695000,"chr18",616905,0,3,2,5,"chr18",1,0.0105485232067511
"20803","chr18.13555000.13560000","chr18.13610000.13615000",55000,42,6.646396e-15,13555000,13610000,13560000,13615000,"chr18",616933,0,2,3,5,"chr18",1,0.0246132208157525
"20804","chr18.57655000.57660000","chr18.58220000.58225000",565000,18,1.651e-11,57655000,58220000,57660000,58225000,"chr18",616958,1,3,0,4,"chr18",1,0.00843881856540084
"20805","chr18.12550000.12555000","chr18.12650000.12655000",100000,29,3.318264e-11,12550000,12650000,12555000,12655000,"chr18",616971,2,3,8,13,"chr18",1,0.0441865916549461
"20806","chr18.10850000.10855000","chr18.11120000.11125000",270000,23,1.344438e-12,10850000,11120000,10855000,11125000,"chr18",616989,2,2,4,8,"chr18",1,0.0215658696671355
"20807","chr18.445000.450000","chr18.595000.600000",150000,14,0.003539362,445000,595000,450000,6e+05,"chr18",616998,0,2,4,6,"chr18",1,0.00984528832630099
"20808","chr18.3295000.3300000","chr18.3440000.3445000",145000,15,0.00130368,3295000,3440000,3300000,3445000,"chr18",617011,3,4,6,13,"chr18",1,0.0228551336146273
"20809","chr18.9940000.9945000","chr18.10525000.10530000",585000,11,6.197206e-05,9940000,10525000,9945000,10530000,"chr18",617024,0,1,3,4,"chr18",1,0.00515705578996718
"20810","chr18.11050000.11055000","chr18.11115000.11120000",65000,33,1.718928e-10,11050000,11115000,11055000,11120000,"chr18",617049,1,5,4,10,"chr18",1,0.0386779184247539
"20811","chr18.320000.325000","chr18.445000.450000",125000,14,0.00908001,320000,445000,325000,450000,"chr18",617115,0,2,4,6,"chr18",1,0.00984528832630099
"20812","chr18.11730000.11735000","chr18.11935000.11940000",205000,12,0.006107264,11730000,11935000,11735000,11940000,"chr18",617136,3,11,15,29,"chr18",1,0.0407876230661041
"20813","chr18.13565000.13570000","chr18.13610000.13615000",45000,23,0.006842379,13565000,13610000,13570000,13615000,"chr18",617151,0,2,3,5,"chr18",1,0.0134786685419597
"20814","chr18.3280000.3285000","chr18.3790000.3795000",510000,11,0.0001515011,3280000,3790000,3285000,3795000,"chr18",617168,1,6,5,12,"chr18",1,0.0154711673699015
"20815","chr18.10850000.10855000","chr18.11050000.11055000",200000,20,3.523672e-08,10850000,11050000,10855000,11055000,"chr18",617173,2,2,4,8,"chr18",1,0.0187529301453352
"20816","chr18.58315000.58320000","chr18.58335000.58340000",20000,36,0.006582485,58315000,58335000,58320000,58340000,"chr18",617175,1,4,2,7,"chr18",1,0.029535864978903
"20817","chr18.11070000.11075000","chr18.11120000.11125000",50000,25,0.0004073095,11070000,11120000,11075000,11125000,"chr18",617177,0,3,0,3,"chr18",1,0.00879043600562588
"20818","chr18.3525000.3530000","chr18.3590000.3595000",65000,25,1.221089e-05,3525000,3590000,3530000,3595000,"chr18",617237,2,9,7,18,"chr18",1,0.0527426160337553
"20819","chr18.375000.380000","chr18.455000.460000",80000,19,0.001104955,375000,455000,380000,460000,"chr18",617247,3,5,7,15,"chr18",1,0.0334036568213783
"20820","chr18.8695000.8700000","chr18.8980000.8985000",285000,16,1.12226e-06,8695000,8980000,8700000,8985000,"chr18",617272,1,8,12,21,"chr18",1,0.0393811533052039
"20821","chr18.46070000.46075000","chr18.46095000.46100000",25000,36,0.00119084,46070000,46095000,46075000,46100000,"chr18",617275,1,7,2,10,"chr18",1,0.0421940928270042
"20822","chr18.52900000.52905000","chr18.53090000.53095000",190000,12,0.009202968,52900000,53090000,52905000,53095000,"chr18",617308,0,1,7,8,"chr18",1,0.0112517580872011
"20823","chr18.10050000.10055000","chr18.10440000.10445000",390000,17,9.223079e-09,10050000,10440000,10055000,10445000,"chr18",617314,0,1,1,2,"chr18",1,0.00398499765588373
"20824","chr18.8605000.8610000","chr18.9475000.9480000",870000,7,0.008053555,8605000,9475000,8610000,9480000,"chr18",617323,3,2,2,7,"chr18",1,0.00574308485700891
"20825","chr18.3440000.3445000","chr18.3525000.3530000",85000,18,0.00190673,3440000,3525000,3445000,3530000,"chr18",617342,2,9,7,18,"chr18",1,0.0379746835443038
"20826","chr18.3245000.3250000","chr18.3665000.3670000",420000,10,0.002278771,3245000,3665000,3250000,3670000,"chr18",617358,3,11,2,16,"chr18",1,0.0187529301453352
"20827","chr18.12685000.12690000","chr18.12930000.12935000",245000,12,0.002121276,12685000,12930000,12690000,12935000,"chr18",617369,3,9,6,18,"chr18",1,0.0253164556962025
"20828","chr18.12470000.12475000","chr18.12650000.12655000",180000,17,1.650785e-05,12470000,12650000,12475000,12655000,"chr18",617403,7,18,26,51,"chr18",1,0.101617440225035
"20829","chr18.37295000.37300000","chr18.37320000.37325000",25000,33,0.00908001,37295000,37320000,37300000,37325000,"chr18",617514,0,0,1,1,"chr18",1,0.00386779184247539
"20830","chr18.615000.620000","chr18.805000.810000",190000,13,0.002850487,615000,805000,620000,810000,"chr18",617545,0,4,2,6,"chr18",1,0.00914205344585091
"20831","chr18.12725000.12730000","chr18.12880000.12885000",155000,21,1.164768e-07,12725000,12880000,12730000,12885000,"chr18",617564,1,9,5,15,"chr18",1,0.0369198312236287
"20832","chr18.3010000.3015000","chr18.3060000.3065000",50000,30,1.718089e-06,3010000,3060000,3015000,3065000,"chr18",617582,4,7,8,19,"chr18",1,0.0668073136427567
"20833","chr18.58995000.59000000","chr18.59120000.59125000",125000,14,0.00908001,58995000,59120000,5.9e+07,59125000,"chr18",617589,3,9,9,21,"chr18",1,0.0344585091420534
"20834","chr18.12515000.12520000","chr18.12645000.12650000",130000,25,8.421002e-10,12515000,12645000,12520000,12650000,"chr18",617590,6,9,10,25,"chr18",1,0.0732536333802157
"20835","chr18.9795000.9800000","chr18.9950000.9955000",155000,16,0.0002310903,9795000,9950000,9800000,9955000,"chr18",617620,0,1,0,1,"chr18",1,0.00187529301453352
"20836","chr18.10565000.10570000","chr18.11150000.11155000",585000,8,0.009736461,10565000,11150000,10570000,11155000,"chr18",617621,2,4,0,6,"chr18",1,0.00562587904360056
"20837","chr18.2970000.2975000","chr18.3060000.3065000",90000,19,0.0003769466,2970000,3060000,2975000,3065000,"chr18",617637,0,3,4,7,"chr18",1,0.0155883731833099
"20838","chr18.10850000.10855000","chr18.11115000.11120000",265000,17,3.592299e-07,10850000,11115000,10855000,11120000,"chr18",617665,1,2,4,7,"chr18",1,0.0139474917955931
"20839","chr18.32070000.32075000","chr18.32170000.32175000",100000,18,0.0004693404,32070000,32170000,32075000,32175000,"chr18",617667,1,8,8,17,"chr18",1,0.0358649789029536
"20840","chr18.11730000.11735000","chr18.12035000.12040000",305000,16,6.03679e-07,11730000,12035000,11735000,12040000,"chr18",617669,1,11,11,23,"chr18",1,0.043131739334271
"20841","chr18.13265000.13270000","chr18.13460000.13465000",195000,13,0.002427213,13265000,13460000,13270000,13465000,"chr18",617695,3,2,5,10,"chr18",1,0.0152367557430849
"20842","chr18.655000.660000","chr18.705000.710000",50000,29,5.627854e-06,655000,705000,660000,710000,"chr18",617699,0,11,5,16,"chr18",1,0.0543834974214721
"20843","chr18.9070000.9075000","chr18.9115000.9120000",45000,30,8.471958e-06,9070000,9115000,9075000,9120000,"chr18",617708,0,8,3,11,"chr18",1,0.0386779184247539
"20844","chr18.3280000.3285000","chr18.3525000.3530000",245000,19,1.952658e-08,3280000,3525000,3285000,3530000,"chr18",617748,1,6,7,14,"chr18",1,0.0311767463666198
"20845","chr18.285000.290000","chr18.620000.625000",335000,27,3.638777e-18,285000,620000,290000,625000,"chr18",617754,2,13,11,26,"chr18",1,0.0822784810126582
"20846","chr18.8660000.8665000","chr18.8985000.8990000",325000,18,6.226432e-09,8660000,8985000,8665000,8990000,"chr18",617792,5,7,9,21,"chr18",1,0.0443037974683544
"20847","chr18.10030000.10035000","chr18.10440000.10445000",410000,16,4.867116e-08,10030000,10440000,10035000,10445000,"chr18",617800,0,3,3,6,"chr18",1,0.0112517580872011
"20848","chr18.8700000.8705000","chr18.9135000.9140000",435000,9,0.008191535,8700000,9135000,8705000,9140000,"chr18",617819,4,3,4,11,"chr18",1,0.0116033755274262
"20849","chr18.13235000.13240000","chr18.13335000.13340000",100000,16,0.004395273,13235000,13335000,13240000,13340000,"chr18",617857,0,3,2,5,"chr18",1,0.00937646507266761
"20850","chr18.9070000.9075000","chr18.9735000.9740000",665000,8,0.005560322,9070000,9735000,9075000,9740000,"chr18",617873,2,21,18,41,"chr18",1,0.0384435067979372
"20851","chr18.9950000.9955000","chr18.10520000.10525000",570000,13,1.423218e-06,9950000,10520000,9955000,10525000,"chr18",617874,0,1,0,1,"chr18",1,0.00152367557430849
"20852","chr18.12880000.12885000","chr18.12945000.12950000",65000,19,0.006926519,12880000,12945000,12885000,12950000,"chr18",617932,1,9,5,15,"chr18",1,0.0334036568213783
"20853","chr18.8705000.8710000","chr18.9135000.9140000",430000,9,0.008634614,8705000,9135000,8710000,9140000,"chr18",618006,3,3,4,10,"chr18",1,0.0105485232067511
"20854","chr18.13555000.13560000","chr18.13800000.13805000",245000,17,8.092418e-07,13555000,13800000,13560000,13805000,"chr18",618040,1,4,3,8,"chr18",1,0.0159399906235349
"20855","chr18.9715000.9720000","chr18.9795000.9800000",80000,21,0.0001156822,9715000,9795000,9720000,9800000,"chr18",618046,7,10,9,26,"chr18",1,0.0639943741209564
"20856","chr18.465000.470000","chr18.615000.620000",150000,14,0.003539362,465000,615000,470000,620000,"chr18",618069,0,4,2,6,"chr18",1,0.00984528832630099
"20857","chr18.23955000.23960000","chr18.24215000.24220000",260000,15,1.451751e-05,23955000,24215000,23960000,24220000,"chr18",618243,3,4,4,11,"chr18",1,0.0193389592123769
"20858","chr18.12470000.12475000","chr18.12550000.12555000",80000,24,2.561525e-06,12470000,12550000,12475000,12555000,"chr18",618267,2,3,8,13,"chr18",1,0.0365682137834037
"20859","chr18.435000.440000","chr18.465000.470000",30000,44,7.79832e-09,435000,465000,440000,470000,"chr18",618282,1,1,3,5,"chr18",1,0.0257852789498359
"20860","chr18.32070000.32075000","chr18.32175000.32180000",105000,16,0.003113714,32070000,32175000,32075000,32180000,"chr18",618294,3,3,4,10,"chr18",1,0.0187529301453352
"20861","chr18.8660000.8665000","chr18.8975000.8980000",315000,13,9.330347e-05,8660000,8975000,8665000,8980000,"chr18",618312,5,7,9,21,"chr18",1,0.0319971870604782
"20862","chr18.12390000.12395000","chr18.12700000.12705000",310000,11,0.002216772,12390000,12700000,12395000,12705000,"chr18",618326,2,10,13,25,"chr18",1,0.0322315986872949
"20863","chr18.59350000.59355000","chr18.59410000.59415000",60000,20,0.006107264,59350000,59410000,59355000,59415000,"chr18",618347,0,0,3,3,"chr18",1,0.0070323488045007
"20864","chr18.4105000.4110000","chr18.5055000.5060000",950000,14,6.201262e-10,4105000,5055000,4110000,5060000,"chr18",618361,0,0,1,1,"chr18",1,0.00164088138771683
"20865","chr18.3280000.3285000","chr18.3610000.3615000",330000,16,3.025991e-07,3280000,3610000,3285000,3615000,"chr18",618371,1,6,7,14,"chr18",1,0.0262541022034693
"20866","chr18.9615000.9620000","chr18.9680000.9685000",65000,20,0.002813692,9615000,9680000,9620000,9685000,"chr18",618394,2,3,0,5,"chr18",1,0.0117205813408345
"20867","chr18.46245000.46250000","chr18.46750000.46755000",505000,11,0.0001619716,46245000,46750000,46250000,46755000,"chr18",618465,0,4,11,15,"chr18",1,0.0193389592123769
"20868","chr18.12375000.12380000","chr18.12415000.12420000",40000,31,1.835724e-05,12375000,12415000,12380000,12420000,"chr18",618512,5,20,20,45,"chr18",1,0.163502109704641
"20869","chr18.11935000.11940000","chr18.12035000.12040000",100000,29,3.318264e-11,11935000,12035000,11940000,12040000,"chr18",618552,1,15,11,27,"chr18",1,0.0917721518987342
"20870","chr18.3440000.3445000","chr18.3665000.3670000",225000,27,3.645691e-15,3440000,3665000,3445000,3670000,"chr18",618564,5,14,16,35,"chr18",1,0.110759493670886
"20871","chr18.330000.335000","chr18.435000.440000",105000,17,0.001035393,330000,435000,335000,440000,"chr18",618573,2,1,3,6,"chr18",1,0.0119549929676512
"20872","chr18.54330000.54335000","chr18.55235000.55240000",905000,7,0.006553362,54330000,55235000,54335000,55240000,"chr18",618589,2,6,12,20,"chr18",1,0.0164088138771683
"20873","chr18.48340000.48345000","chr18.48465000.48470000",125000,17,0.0002830379,48340000,48465000,48345000,48470000,"chr18",618660,0,3,5,8,"chr18",1,0.0159399906235349
"20874","chr18.3295000.3300000","chr18.3585000.3590000",290000,12,0.0007575942,3295000,3585000,3300000,3590000,"chr18",618683,3,4,6,13,"chr18",1,0.0182841068917018
"20875","chr18.11850000.11855000","chr18.11905000.11910000",55000,23,0.000966907,11850000,11905000,11855000,11910000,"chr18",618684,0,8,2,10,"chr18",1,0.0269573370839194
"20876","chr18.10010000.10015000","chr18.10545000.10550000",535000,9,0.003277404,10010000,10545000,10015000,10550000,"chr18",618695,1,2,0,3,"chr18",1,0.00316455696202532
"20877","chr18.3280000.3285000","chr18.3480000.3485000",200000,14,0.0005505406,3280000,3480000,3285000,3485000,"chr18",618728,1,6,7,14,"chr18",1,0.0229723394280356
"20878","chr18.23970000.23975000","chr18.24560000.24565000",590000,8,0.009378659,23970000,24560000,23975000,24565000,"chr18",618785,0,2,2,4,"chr18",1,0.00375058602906704
"20879","chr18.9070000.9075000","chr18.9475000.9480000",405000,16,5.470401e-08,9070000,9475000,9075000,9480000,"chr18",618810,2,2,2,6,"chr18",1,0.0112517580872011
"20880","chr18.3395000.3400000","chr18.3445000.3450000",50000,32,1.449196e-07,3395000,3445000,3400000,3450000,"chr18",618825,0,3,7,10,"chr18",1,0.0375058602906704
"20881","chr18.57735000.57740000","chr18.58220000.58225000",485000,10,0.001103532,57735000,58220000,57740000,58225000,"chr18",618857,1,3,0,4,"chr18",1,0.0046882325363338
"20882","chr18.2995000.3000000","chr18.3245000.3250000",250000,15,2.017674e-05,2995000,3245000,3e+06,3250000,"chr18",618861,3,11,2,16,"chr18",1,0.0281293952180028
"20883","chr18.32460000.32465000","chr18.32575000.32580000",115000,15,0.005020386,32460000,32575000,32465000,32580000,"chr18",618886,0,3,0,3,"chr18",1,0.00527426160337553
"20884","chr18.9145000.9150000","chr18.9330000.9335000",185000,14,0.0009626055,9145000,9330000,9150000,9335000,"chr18",618921,6,5,5,16,"chr18",1,0.0262541022034693
"20885","chr18.9100000.9105000","chr18.9135000.9140000",35000,52,9.204976e-16,9100000,9135000,9105000,9140000,"chr18",618960,0,0,3,3,"chr18",1,0.0182841068917018
"20886","chr18.32460000.32465000","chr18.32660000.32665000",200000,13,0.002079076,32460000,32660000,32465000,32665000,"chr18",618985,1,2,2,5,"chr18",1,0.00761837787154243
"20887","chr18.11730000.11735000","chr18.11995000.12000000",265000,19,7.699014e-09,11730000,11995000,11735000,1.2e+07,"chr18",619013,2,0,2,4,"chr18",1,0.00890764181903422
"20888","chr18.10010000.10015000","chr18.10525000.10530000",515000,17,5.326514e-10,10010000,10525000,10015000,10530000,"chr18",619031,0,5,4,9,"chr18",1,0.0179324894514768
"20889","chr18.11040000.11045000","chr18.11150000.11155000",110000,30,1.086497e-12,11040000,11150000,11045000,11155000,"chr18",619062,2,4,0,6,"chr18",1,0.0210970464135021
"20890","chr18.8705000.8710000","chr18.9015000.9020000",310000,12,0.0005023841,8705000,9015000,8710000,9020000,"chr18",619084,3,3,9,15,"chr18",1,0.0210970464135021
"20891","chr18.3280000.3285000","chr18.3445000.3450000",165000,32,2.032637e-17,3280000,3445000,3285000,3450000,"chr18",619135,0,3,7,10,"chr18",1,0.0375058602906704
"20892","chr18.57655000.57660000","chr18.58205000.58210000",550000,19,1.956631e-12,57655000,58205000,57660000,58210000,"chr18",619143,1,12,12,25,"chr18",1,0.0556727613689639
"20893","chr18.9615000.9620000","chr18.9795000.9800000",180000,24,7.590671e-11,9615000,9795000,9620000,9800000,"chr18",619145,3,5,9,17,"chr18",1,0.0478199718706048
"20894","chr18.10780000.10785000","chr18.11135000.11140000",355000,10,0.004728956,10780000,11135000,10785000,11140000,"chr18",619155,3,8,2,13,"chr18",1,0.0152367557430849
"20895","chr18.56485000.56490000","chr18.56675000.56680000",190000,12,0.009202968,56485000,56675000,56490000,56680000,"chr18",619184,2,6,0,8,"chr18",1,0.0112517580872011
"20896","chr18.9075000.9080000","chr18.9475000.9480000",400000,13,2.035487e-05,9075000,9475000,9080000,9480000,"chr18",619194,3,2,2,7,"chr18",1,0.0106657290201594
"20897","chr18.3450000.3455000","chr18.3590000.3595000",140000,44,6.024459e-28,3450000,3590000,3455000,3595000,"chr18",619209,2,5,4,11,"chr18",1,0.056727613689639
"20898","chr18.11115000.11120000","chr18.11135000.11140000",20000,52,9.122217e-09,11115000,11135000,11120000,11140000,"chr18",619241,1,5,5,11,"chr18",1,0.0670417252695734
"20899","chr18.12405000.12410000","chr18.12455000.12460000",50000,41,4.024172e-13,12405000,12455000,12410000,12460000,"chr18",619247,3,3,11,17,"chr18",1,0.0816924519456165
"20900","chr18.3280000.3285000","chr18.3700000.3705000",420000,9,0.009378659,3280000,3700000,3285000,3705000,"chr18",619257,1,6,7,14,"chr18",1,0.0147679324894515
"20901","chr18.10440000.10445000","chr18.10525000.10530000",85000,17,0.005179938,10440000,10525000,10445000,10530000,"chr18",619297,0,3,3,6,"chr18",1,0.0119549929676512
"20902","chr18.9075000.9080000","chr18.9145000.9150000",70000,22,0.0001573046,9075000,9145000,9080000,9150000,"chr18",619333,10,13,13,36,"chr18",1,0.0928270042194093
"20903","chr18.12550000.12555000","chr18.12645000.12650000",95000,17,0.002241046,12550000,12645000,12555000,12650000,"chr18",619336,2,3,8,13,"chr18",1,0.0259024847632443
"20904","chr18.32460000.32465000","chr18.32710000.32715000",250000,17,6.538087e-07,32460000,32710000,32465000,32715000,"chr18",619449,2,2,2,6,"chr18",1,0.0119549929676512
"20905","chr18.3295000.3300000","chr18.3450000.3455000",155000,15,0.0008805387,3295000,3450000,3300000,3455000,"chr18",619458,2,4,4,10,"chr18",1,0.0175808720112518
"20906","chr18.8650000.8655000","chr18.8975000.8980000",325000,12,0.0003834266,8650000,8975000,8655000,8980000,"chr18",619469,7,14,15,36,"chr18",1,0.0506329113924051
"20907","chr18.31685000.31690000","chr18.31815000.31820000",130000,14,0.007416163,31685000,31815000,31690000,31820000,"chr18",619496,0,3,0,3,"chr18",1,0.00492264416315049
"20908","chr18.320000.325000","chr18.435000.440000",115000,22,5.125706e-07,320000,435000,325000,440000,"chr18",619538,0,1,3,4,"chr18",1,0.0103141115799344
"20909","chr18.285000.290000","chr18.615000.620000",330000,54,1.152538e-52,285000,615000,290000,620000,"chr18",619594,0,4,2,6,"chr18",1,0.0379746835443038
"20910","chr18.155000.160000","chr18.615000.620000",460000,10,0.001453165,155000,615000,160000,620000,"chr18",619620,0,4,2,6,"chr18",1,0.0070323488045007
"20911","chr18.285000.290000","chr18.685000.690000",400000,11,0.0006182989,285000,685000,290000,690000,"chr18",619621,2,7,10,19,"chr18",1,0.0244960150023441
"20912","chr18.3440000.3445000","chr18.3600000.3605000",160000,21,8.139321e-08,3440000,3600000,3445000,3605000,"chr18",619624,5,18,16,39,"chr18",1,0.0959915611814346
"20913","chr18.455000.460000","chr18.580000.585000",125000,16,0.0009835455,455000,580000,460000,585000,"chr18",619627,1,5,4,10,"chr18",1,0.0187529301453352
"20914","chr18.9680000.9685000","chr18.9940000.9945000",260000,16,2.617424e-06,9680000,9940000,9685000,9945000,"chr18",619662,0,1,0,1,"chr18",1,0.00187529301453352
"20915","chr18.59090000.59095000","chr18.59140000.59145000",50000,23,0.002588233,59090000,59140000,59095000,59145000,"chr18",619667,2,1,3,6,"chr18",1,0.0161744022503516
"20916","chr18.12700000.12705000","chr18.12945000.12950000",245000,18,1.294573e-07,12700000,12945000,12705000,12950000,"chr18",619684,2,10,13,25,"chr18",1,0.0527426160337553
"20917","chr18.6540000.6545000","chr18.6885000.6890000",345000,17,2.756576e-08,6540000,6885000,6545000,6890000,"chr18",619701,0,1,1,2,"chr18",1,0.00398499765588373
"20918","chr18.9610000.9615000","chr18.9770000.9775000",160000,14,0.002427213,9610000,9770000,9615000,9775000,"chr18",619715,0,2,4,6,"chr18",1,0.00984528832630099
"20919","chr18.12515000.12520000","chr18.12625000.12630000",110000,19,5.771493e-05,12515000,12625000,12520000,12630000,"chr18",619738,1,9,3,13,"chr18",1,0.0289498359118612
"20920","chr18.740000.745000","chr18.830000.835000",90000,41,3.904226e-20,740000,830000,745000,835000,"chr18",619802,1,4,5,10,"chr18",1,0.0480543834974215
"20921","chr18.12455000.12460000","chr18.12655000.12660000",200000,23,1.160066e-10,12455000,12655000,12460000,12660000,"chr18",619813,3,3,12,18,"chr18",1,0.0485232067510548
"20922","chr18.53090000.53095000","chr18.53220000.53225000",130000,15,0.002462955,53090000,53220000,53095000,53225000,"chr18",619842,0,3,1,4,"chr18",1,0.0070323488045007
"20923","chr18.32660000.32665000","chr18.32700000.32705000",40000,25,0.004693506,32660000,32700000,32665000,32705000,"chr18",619851,0,2,2,4,"chr18",1,0.0117205813408345
"20924","chr18.620000.625000","chr18.640000.645000",20000,41,0.0002071629,620000,640000,625000,645000,"chr18",619853,2,6,8,16,"chr18",1,0.0768870135958744
"20925","chr18.48630000.48635000","chr18.48900000.48905000",270000,11,0.004577219,48630000,48900000,48635000,48905000,"chr18",619861,1,2,1,4,"chr18",1,0.00515705578996718
"20926","chr18.13220000.13225000","chr18.13460000.13465000",240000,12,0.002410217,13220000,13460000,13225000,13465000,"chr18",619868,1,2,5,8,"chr18",1,0.0112517580872011
"20927","chr18.13220000.13225000","chr18.13610000.13615000",390000,11,0.0007084689,13220000,13610000,13225000,13615000,"chr18",619913,0,2,3,5,"chr18",1,0.00644631973745898
"20928","chr18.12470000.12475000","chr18.12625000.12630000",155000,16,0.0002310903,12470000,12625000,12475000,12630000,"chr18",619944,1,9,3,13,"chr18",1,0.0243788091889358
"20929","chr18.12515000.12520000","chr18.12650000.12655000",135000,25,5.256503e-10,12515000,12650000,12520000,12655000,"chr18",619957,7,18,25,50,"chr18",1,0.146507266760431
"20930","chr18.57655000.57660000","chr18.58215000.58220000",560000,25,1.688367e-19,57655000,58215000,57660000,58220000,"chr18",619969,3,7,5,15,"chr18",1,0.0439521800281294
"20931","chr18.48900000.48905000","chr18.48975000.48980000",75000,19,0.001994073,48900000,48975000,48905000,48980000,"chr18",619990,0,2,1,3,"chr18",1,0.00668073136427567
"20932","chr18.3245000.3250000","chr18.3450000.3455000",205000,14,0.0004586232,3245000,3450000,3250000,3455000,"chr18",620040,2,5,2,9,"chr18",1,0.0147679324894515
"20933","chr18.9680000.9685000","chr18.9715000.9720000",35000,30,0.000440433,9680000,9715000,9685000,9720000,"chr18",620060,2,3,0,5,"chr18",1,0.0175808720112518
"20934","chr18.12405000.12410000","chr18.12655000.12660000",250000,30,4.301147e-19,12405000,12655000,12410000,12660000,"chr18",620072,3,5,11,19,"chr18",1,0.0668073136427567
"20935","chr18.9710000.9715000","chr18.9770000.9775000",60000,21,0.002459267,9710000,9770000,9715000,9775000,"chr18",620078,3,2,4,9,"chr18",1,0.0221518987341772
"20936","chr18.24445000.24450000","chr18.24495000.24500000",50000,23,0.002588233,24445000,24495000,24450000,24500000,"chr18",620125,0,7,2,9,"chr18",1,0.0242616033755274
"20937","chr18.13220000.13225000","chr18.13435000.13440000",215000,12,0.004693506,13220000,13435000,13225000,13440000,"chr18",620147,1,2,0,3,"chr18",1,0.00421940928270042
"20938","chr18.3010000.3015000","chr18.3245000.3250000",235000,22,8.542054e-11,3010000,3245000,3015000,3250000,"chr18",620208,3,11,2,16,"chr18",1,0.0412564463197375
"20939","chr18.56595000.56600000","chr18.56690000.56695000",95000,17,0.002241046,56595000,56690000,56600000,56695000,"chr18",620220,1,8,13,22,"chr18",1,0.0438349742147211
"20940","chr18.3060000.3065000","chr18.3125000.3130000",65000,27,9.698614e-07,3060000,3125000,3065000,3130000,"chr18",620234,2,7,8,17,"chr18",1,0.0537974683544304
"20941","chr18.3280000.3285000","chr18.3665000.3670000",385000,148,7.545844e-220,3280000,3665000,3285000,3670000,"chr18",620235,1,6,7,14,"chr18",1,0.242850445382091
"20942","chr18.59030000.59035000","chr18.59140000.59145000",110000,17,0.0007258711,59030000,59140000,59035000,59145000,"chr18",620238,2,5,3,10,"chr18",1,0.0199249882794187
"20943","chr18.12455000.12460000","chr18.12645000.12650000",190000,21,1.063252e-08,12455000,12645000,12460000,12650000,"chr18",620254,3,3,10,16,"chr18",1,0.0393811533052039
"20944","chr18.10780000.10785000","chr18.11150000.11155000",370000,15,8.520835e-07,10780000,11150000,10785000,11155000,"chr18",620264,2,4,0,6,"chr18",1,0.0105485232067511
"20945","chr18.56575000.56580000","chr18.56595000.56600000",20000,45,7.860895e-06,56575000,56595000,56580000,56600000,"chr18",620294,0,3,2,5,"chr18",1,0.0263713080168776
"20946","chr18.12455000.12460000","chr18.12650000.12655000",195000,35,5.9809e-22,12455000,12650000,12460000,12655000,"chr18",620304,3,3,12,18,"chr18",1,0.0738396624472574
"20947","chr18.3445000.3450000","chr18.3600000.3605000",155000,25,8.900828e-11,3445000,3600000,3450000,3605000,"chr18",620307,0,3,7,10,"chr18",1,0.0293014533520863
"20948","chr18.9715000.9720000","chr18.10525000.10530000",810000,8,0.002144478,9715000,10525000,9720000,10530000,"chr18",620337,0,5,4,9,"chr18",1,0.00843881856540084
"20949","chr18.9615000.9620000","chr18.9650000.9655000",35000,28,0.002311637,9615000,9650000,9620000,9655000,"chr18",620356,3,5,11,19,"chr18",1,0.0623534927332396
"20950","chr18.21610000.21615000","chr18.21630000.21635000",20000,43,4.240724e-05,21610000,21630000,21615000,21635000,"chr18",620373,3,18,19,40,"chr18",1,0.201593999062353
"20951","chr18.58995000.59000000","chr18.59090000.59095000",95000,18,0.0007412993,58995000,59090000,5.9e+07,59095000,"chr18",620385,2,1,3,6,"chr18",1,0.0126582278481013
"20952","chr18.52900000.52905000","chr18.52975000.52980000",75000,18,0.005187717,52900000,52975000,52905000,52980000,"chr18",620449,0,1,2,3,"chr18",1,0.00632911392405063
"20953","chr18.3280000.3285000","chr18.3585000.3590000",305000,49,1.048962e-44,3280000,3585000,3285000,3590000,"chr18",620495,1,6,7,14,"chr18",1,0.0804031879981247
"20954","chr18.3295000.3300000","chr18.3600000.3605000",305000,12,0.0005556296,3295000,3600000,3300000,3605000,"chr18",620496,3,4,6,13,"chr18",1,0.0182841068917018
"20955","chr18.3395000.3400000","chr18.3590000.3595000",195000,34,6.152161e-21,3395000,3590000,3400000,3595000,"chr18",620497,4,12,11,27,"chr18",1,0.107594936708861
"20956","chr18.3395000.3400000","chr18.3440000.3445000",45000,33,2.533011e-07,3395000,3440000,3400000,3445000,"chr18",620505,8,24,16,48,"chr18",1,0.185654008438819
"20957","chr18.13110000.13115000","chr18.13555000.13560000",445000,10,0.001734134,13110000,13555000,13115000,13560000,"chr18",620532,0,3,1,4,"chr18",1,0.0046882325363338
"20958","chr18.3280000.3285000","chr18.3605000.3610000",325000,20,8.68073e-11,3280000,3605000,3285000,3610000,"chr18",620623,1,6,6,13,"chr18",1,0.0304735114861697
"20959","chr18.9070000.9075000","chr18.9100000.9105000",30000,39,1.843978e-06,9070000,9100000,9075000,9105000,"chr18",620648,0,0,3,3,"chr18",1,0.0137130801687764
"20960","chr18.58965000.58970000","chr18.59140000.59145000",175000,14,0.001367603,58965000,59140000,58970000,59145000,"chr18",620653,0,2,2,4,"chr18",1,0.00656352555086732
"20961","chr18.10850000.10855000","chr18.11150000.11155000",300000,47,8.808455e-42,10850000,11150000,10855000,11155000,"chr18",620660,2,2,0,4,"chr18",1,0.0220346929207689
"20962","chr18.32575000.32580000","chr18.32750000.32755000",175000,18,4.533677e-06,32575000,32750000,32580000,32755000,"chr18",620721,0,3,0,3,"chr18",1,0.00632911392405063
"20963","chr18.3260000.3265000","chr18.3600000.3605000",340000,16,2.351769e-07,3260000,3600000,3265000,3605000,"chr18",620725,3,8,8,19,"chr18",1,0.0356305672761369
"20964","chr18.5455000.5460000","chr18.5540000.5545000",85000,20,0.0002028107,5455000,5540000,5460000,5545000,"chr18",620805,1,11,5,17,"chr18",1,0.0398499765588373
"20965","chr18.9715000.9720000","chr18.9735000.9740000",20000,56,1.172078e-10,9715000,9735000,9720000,9740000,"chr18",620837,7,14,9,30,"chr18",1,0.19690576652602
"20966","chr18.62690000.62695000","chr18.63130000.63135000",440000,9,0.007812242,62690000,63130000,62695000,63135000,"chr18",620916,1,2,1,4,"chr18",1,0.00421940928270042
"20967","chr18.435000.440000","chr18.455000.460000",20000,49,1.904812e-07,435000,455000,440000,460000,"chr18",620932,2,1,3,6,"chr18",1,0.0344585091420534
"20968","chr18.9715000.9720000","chr18.9770000.9775000",55000,25,0.0001249918,9715000,9770000,9720000,9775000,"chr18",620960,3,2,4,9,"chr18",1,0.0263713080168776
"20969","chr18.3590000.3595000","chr18.3665000.3670000",75000,52,9.994354e-28,3590000,3665000,3595000,3670000,"chr18",620997,4,12,11,27,"chr18",1,0.164556962025316
"20970","chr18.46535000.46540000","chr18.46750000.46755000",215000,14,0.0003251112,46535000,46750000,46540000,46755000,"chr18",621028,0,4,8,12,"chr18",1,0.019690576652602
"20971","chr18.710000.715000","chr18.805000.810000",95000,17,0.002241046,710000,805000,715000,810000,"chr18",621039,5,16,16,37,"chr18",1,0.073722456633849
"20972","chr18.23970000.23975000","chr18.24210000.24215000",240000,11,0.008505224,23970000,24210000,23975000,24215000,"chr18",621103,2,3,5,10,"chr18",1,0.012892639474918
"20973","chr18.620000.625000","chr18.705000.710000",85000,24,1.15026e-06,620000,705000,625000,710000,"chr18",621194,4,18,17,39,"chr18",1,0.109704641350211
"20974","chr18.58780000.58785000","chr18.58965000.58970000",185000,19,5.063023e-07,58780000,58965000,58785000,58970000,"chr18",621196,0,2,2,4,"chr18",1,0.00890764181903422
"20975","chr18.9940000.9945000","chr18.10545000.10550000",605000,13,8.687554e-07,9940000,10545000,9945000,10550000,"chr18",621213,0,1,0,1,"chr18",1,0.00152367557430849
"20976","chr18.8705000.8710000","chr18.8765000.8770000",60000,23,0.0003484704,8705000,8765000,8710000,8770000,"chr18",621235,1,1,4,6,"chr18",1,0.0161744022503516
"20977","chr18.23660000.23665000","chr18.23790000.23795000",130000,17,0.0002113156,23660000,23790000,23665000,23795000,"chr18",621247,1,7,7,15,"chr18",1,0.029887482419128
"20978","chr18.13250000.13255000","chr18.13680000.13685000",430000,9,0.008634614,13250000,13680000,13255000,13685000,"chr18",621262,1,3,2,6,"chr18",1,0.00632911392405063
"20979","chr18.48465000.48470000","chr18.48575000.48580000",110000,16,0.002278771,48465000,48575000,48470000,48580000,"chr18",621280,5,10,8,23,"chr18",1,0.043131739334271
"20980","chr18.3665000.3670000","chr18.3995000.4000000",330000,15,2.024864e-06,3665000,3995000,3670000,4e+06,"chr18",621287,3,1,1,5,"chr18",1,0.00879043600562588
"20981","chr18.12390000.12395000","chr18.12655000.12660000",265000,29,1.51041e-18,12390000,12655000,12395000,12660000,"chr18",621290,3,14,18,35,"chr18",1,0.11896390060947
"20982","chr18.8650000.8655000","chr18.8980000.8985000",330000,21,8.029344e-12,8650000,8980000,8655000,8985000,"chr18",621313,3,8,12,23,"chr18",1,0.0566104078762307
"20983","chr18.9950000.9955000","chr18.10525000.10530000",575000,12,1.014434e-05,9950000,10525000,9955000,10530000,"chr18",621319,0,1,0,1,"chr18",1,0.00140646976090014
"20984","chr18.32830000.32835000","chr18.32920000.32925000",90000,18,0.001159158,32830000,32920000,32835000,32925000,"chr18",621322,0,0,5,5,"chr18",1,0.0105485232067511
"20985","chr18.11855000.11860000","chr18.11905000.11910000",50000,28,1.743752e-05,11855000,11905000,11860000,11910000,"chr18",621325,2,11,12,25,"chr18",1,0.0820440693858415
"20986","chr18.58310000.58315000","chr18.59140000.59145000",830000,7,0.009999325,58310000,59140000,58315000,59145000,"chr18",621381,1,5,3,9,"chr18",1,0.00738396624472574
"20987","chr18.10850000.10855000","chr18.11040000.11045000",190000,35,1.084429e-21,10850000,11040000,10855000,11045000,"chr18",621383,2,2,4,8,"chr18",1,0.0328176277543366
"20988","chr18.46070000.46075000","chr18.46100000.46105000",30000,31,0.002278771,46070000,46100000,46075000,46105000,"chr18",621429,1,7,2,10,"chr18",1,0.036333802156587
"20989","chr18.3525000.3530000","chr18.3665000.3670000",140000,16,0.0004693404,3525000,3665000,3530000,3670000,"chr18",621460,2,9,7,18,"chr18",1,0.0337552742616034
"20990","chr18.57655000.57660000","chr18.58315000.58320000",660000,8,0.005783294,57655000,58315000,57660000,58320000,"chr18",621462,3,5,3,11,"chr18",1,0.0103141115799344
"20991","chr18.57640000.57645000","chr18.58220000.58225000",580000,11,6.580666e-05,57640000,58220000,57645000,58225000,"chr18",621475,1,3,0,4,"chr18",1,0.00515705578996718
"20992","chr18.455000.460000","chr18.615000.620000",160000,18,1.029508e-05,455000,615000,460000,620000,"chr18",621477,0,4,2,6,"chr18",1,0.0126582278481013
"20993","chr18.74610000.74615000","chr18.74940000.74945000",330000,11,0.001609867,74610000,74940000,74615000,74945000,"chr18",621500,0,1,0,1,"chr18",1,0.0012892639474918
"20994","chr18.8705000.8710000","chr18.8980000.8985000",275000,14,4.754699e-05,8705000,8980000,8710000,8985000,"chr18",621518,3,3,9,15,"chr18",1,0.0246132208157525
"20995","chr18.46295000.46300000","chr18.46680000.46685000",385000,10,0.003379627,46295000,46680000,46300000,46685000,"chr18",621561,2,1,1,4,"chr18",1,0.0046882325363338
"20996","chr18.13235000.13240000","chr18.13680000.13685000",445000,10,0.001734134,13235000,13680000,13240000,13685000,"chr18",621603,0,4,3,7,"chr18",1,0.00820440693858415
"20997","chr18.7270000.7275000","chr18.7790000.7795000",520000,9,0.003733869,7270000,7790000,7275000,7795000,"chr18",621604,2,1,3,6,"chr18",1,0.00632911392405063
"20998","chr18.12740000.12745000","chr18.12945000.12950000",205000,16,2.374414e-05,12740000,12945000,12745000,12950000,"chr18",621622,5,11,14,30,"chr18",1,0.0562587904360056
"20999","chr18.13245000.13250000","chr18.13380000.13385000",135000,20,2.254697e-06,13245000,13380000,13250000,13385000,"chr18",621637,0,1,0,1,"chr18",1,0.0023441162681669
"21000","chr18.13220000.13225000","chr18.13555000.13560000",335000,23,6.660155e-14,13220000,13555000,13225000,13560000,"chr18",621638,1,3,3,7,"chr18",1,0.0188701359587436
"21001","chr18.13215000.13220000","chr18.13680000.13685000",465000,9,0.006145775,13215000,13680000,13220000,13685000,"chr18",621669,0,1,2,3,"chr18",1,0.00316455696202532
"21002","chr18.9115000.9120000","chr18.9475000.9480000",360000,12,0.0002128725,9115000,9475000,9120000,9480000,"chr18",621672,0,2,2,4,"chr18",1,0.00562587904360056
"21003","chr18.57665000.57670000","chr18.58220000.58225000",555000,11,8.865473e-05,57665000,58220000,57670000,58225000,"chr18",621673,1,3,0,4,"chr18",1,0.00515705578996718
"21004","chr18.3585000.3590000","chr18.3665000.3670000",80000,29,1.590592e-09,3585000,3665000,3590000,3670000,"chr18",621679,5,14,19,38,"chr18",1,0.129160806375996
"21005","chr18.72585000.72590000","chr18.72650000.72655000",65000,25,1.221089e-05,72585000,72650000,72590000,72655000,"chr18",621745,0,4,2,6,"chr18",1,0.0175808720112518
"21006","chr18.655000.660000","chr18.710000.715000",55000,40,1.734438e-13,655000,710000,660000,715000,"chr18",621755,0,11,5,16,"chr18",1,0.0750117205813408
"21007","chr18.12375000.12380000","chr18.12945000.12950000",570000,15,1.829659e-08,12375000,12945000,12380000,12950000,"chr18",621756,5,11,14,30,"chr18",1,0.0527426160337553
"21008","chr18.3445000.3450000","chr18.3585000.3590000",140000,27,8.353247e-12,3445000,3585000,3450000,3590000,"chr18",621764,0,3,7,10,"chr18",1,0.0316455696202532
"21009","chr18.9135000.9140000","chr18.9475000.9480000",340000,15,1.599392e-06,9135000,9475000,9140000,9480000,"chr18",621788,3,2,2,7,"chr18",1,0.0123066104078762
"21010","chr18.435000.440000","chr18.710000.715000",275000,16,1.538967e-06,435000,710000,440000,715000,"chr18",621792,2,1,3,6,"chr18",1,0.0112517580872011
"21011","chr18.4170000.4175000","chr18.5050000.5055000",880000,7,0.007570243,4170000,5050000,4175000,5055000,"chr18",621794,2,2,3,7,"chr18",1,0.00574308485700891
"21012","chr18.8665000.8670000","chr18.8975000.8980000",310000,12,0.0005023841,8665000,8975000,8670000,8980000,"chr18",621817,3,15,15,33,"chr18",1,0.0464135021097046
"21013","chr18.4105000.4110000","chr18.5050000.5055000",945000,16,2.888724e-12,4105000,5050000,4110000,5055000,"chr18",621818,0,0,2,2,"chr18",1,0.00375058602906704
"21014","chr18.685000.690000","chr18.710000.715000",25000,38,0.0002627198,685000,710000,690000,715000,"chr18",621995,2,7,10,19,"chr18",1,0.0846225972808251
"21015","chr18.8700000.8705000","chr18.8985000.8990000",285000,14,3.656312e-05,8700000,8985000,8705000,8990000,"chr18",622024,7,16,17,40,"chr18",1,0.0656352555086732
"21016","chr18.13235000.13240000","chr18.13630000.13635000",395000,12,0.0001261307,13235000,13630000,13240000,13635000,"chr18",622028,0,2,1,3,"chr18",1,0.00421940928270042
"21017","chr18.3450000.3455000","chr18.3605000.3610000",155000,18,1.371269e-05,3450000,3605000,3455000,3610000,"chr18",622052,2,5,4,11,"chr18",1,0.0232067510548523
"21018","chr18.9670000.9675000","chr18.9765000.9770000",95000,16,0.006162011,9670000,9765000,9675000,9770000,"chr18",622084,3,5,6,14,"chr18",1,0.0262541022034693
"21019","chr18.12470000.12475000","chr18.12645000.12650000",175000,19,9.0804e-07,12470000,12645000,12475000,12650000,"chr18",622110,6,9,10,25,"chr18",1,0.0556727613689639
"21020","chr18.7600000.7605000","chr18.7620000.7625000",20000,43,4.240724e-05,7600000,7620000,7605000,7625000,"chr18",622141,2,5,5,12,"chr18",1,0.060478199718706
"21021","chr18.13555000.13560000","chr18.13725000.13730000",170000,29,7.465212e-15,13555000,13725000,13560000,13730000,"chr18",622155,1,4,1,6,"chr18",1,0.020393811533052
"21022","chr18.3260000.3265000","chr18.3590000.3595000",330000,21,8.029344e-12,3260000,3590000,3265000,3595000,"chr18",622165,3,8,8,19,"chr18",1,0.0467651195499297
"21023","chr18.12625000.12630000","chr18.12645000.12650000",20000,39,0.0009356233,12625000,12645000,12630000,12650000,"chr18",622189,1,9,3,13,"chr18",1,0.0594233473980309
"21024","chr18.10030000.10035000","chr18.10520000.10525000",490000,19,8.49101e-12,10030000,10520000,10035000,10525000,"chr18",622211,1,1,3,5,"chr18",1,0.0111345522737928
"21025","chr18.9680000.9685000","chr18.9770000.9775000",90000,20,0.0001134064,9680000,9770000,9685000,9775000,"chr18",622290,2,2,0,4,"chr18",1,0.00937646507266761
"21026","chr18.9115000.9120000","chr18.9135000.9140000",20000,45,7.860895e-06,9115000,9135000,9120000,9140000,"chr18",622315,0,3,3,6,"chr18",1,0.0316455696202532
"21027","chr18.59665000.59670000","chr18.59695000.59700000",30000,29,0.009202968,59665000,59695000,59670000,59700000,"chr18",622344,0,4,3,7,"chr18",1,0.023792780121894
"21028","chr18.9795000.9800000","chr18.10525000.10530000",730000,10,9.537335e-05,9795000,10525000,9800000,10530000,"chr18",622379,0,5,4,9,"chr18",1,0.0105485232067511
"21029","chr18.9770000.9775000","chr18.9795000.9800000",25000,39,0.0001168961,9770000,9795000,9775000,9800000,"chr18",622432,3,2,4,9,"chr18",1,0.0411392405063291
"21030","chr18.11050000.11055000","chr18.11135000.11140000",85000,21,5.994598e-05,11050000,11135000,11055000,11140000,"chr18",622457,3,10,4,17,"chr18",1,0.0418424753867792
"21031","chr18.9340000.9345000","chr18.9475000.9480000",135000,19,1.007195e-05,9340000,9475000,9345000,9480000,"chr18",622476,3,2,2,7,"chr18",1,0.0155883731833099
"21032","chr18.46645000.46650000","chr18.46680000.46685000",35000,30,0.000440433,46645000,46680000,46650000,46685000,"chr18",622515,0,1,1,2,"chr18",1,0.0070323488045007
"21033","chr18.320000.325000","chr18.465000.470000",145000,17,9.722003e-05,320000,465000,325000,470000,"chr18",622517,0,12,7,19,"chr18",1,0.0378574777308955
"21034","chr18.3295000.3300000","chr18.3665000.3670000",370000,19,1.974897e-10,3295000,3665000,3300000,3670000,"chr18",622551,3,4,6,13,"chr18",1,0.0289498359118612
"21035","chr18.615000.620000","chr18.705000.710000",90000,16,0.00908001,615000,705000,620000,710000,"chr18",622566,0,4,2,6,"chr18",1,0.0112517580872011
"21036","chr18.70575000.70580000","chr18.71430000.71435000",855000,7,0.008786082,70575000,71430000,70580000,71435000,"chr18",622587,0,2,1,3,"chr18",1,0.00246132208157525
"21037","chr18.9070000.9075000","chr18.9145000.9150000",75000,61,1.328953e-36,9070000,9145000,9075000,9150000,"chr18",622607,2,13,13,28,"chr18",1,0.200187529301453
"21038","chr18.3280000.3285000","chr18.3650000.3655000",370000,13,3.416677e-05,3280000,3650000,3285000,3655000,"chr18",622610,1,6,7,14,"chr18",1,0.0213314580403188
"21039","chr18.8650000.8655000","chr18.9015000.9020000",365000,12,0.0002003369,8650000,9015000,8655000,9020000,"chr18",622612,8,14,15,37,"chr18",1,0.0520393811533052
"21040","chr18.32070000.32075000","chr18.32360000.32365000",290000,11,0.003113714,32070000,32360000,32075000,32365000,"chr18",622615,0,2,0,2,"chr18",1,0.00257852789498359
"21041","chr18.72555000.72560000","chr18.72650000.72655000",95000,18,0.0007412993,72555000,72650000,72560000,72655000,"chr18",622624,0,2,2,4,"chr18",1,0.00843881856540084
"21042","chr18.8660000.8665000","chr18.9145000.9150000",485000,9,0.005116998,8660000,9145000,8665000,9150000,"chr18",622669,5,7,9,21,"chr18",1,0.0221518987341772
"21043","chr18.710000.715000","chr18.830000.835000",120000,16,0.00126846,710000,830000,715000,835000,"chr18",622676,1,4,5,10,"chr18",1,0.0187529301453352
"21044","chr18.57790000.57795000","chr18.58220000.58225000",430000,9,0.008634614,57790000,58220000,57795000,58225000,"chr18",622735,1,3,0,4,"chr18",1,0.00421940928270042
"21045","chr18.46325000.46330000","chr18.46350000.46355000",25000,34,0.004750559,46325000,46350000,46330000,46355000,"chr18",622816,1,4,2,7,"chr18",1,0.0278949835911861
"21046","chr18.5070000.5075000","chr18.5545000.5550000",475000,12,4.012779e-05,5070000,5545000,5075000,5550000,"chr18",622817,0,3,3,6,"chr18",1,0.00843881856540084
"21047","chr18.3600000.3605000","chr18.3665000.3670000",65000,49,8.807074e-23,3600000,3665000,3605000,3670000,"chr18",622856,5,14,17,36,"chr18",1,0.206751054852321
"21048","chr18.12390000.12395000","chr18.12685000.12690000",295000,19,2.181707e-09,12390000,12685000,12395000,12690000,"chr18",622868,3,10,8,21,"chr18",1,0.0467651195499297
"21049","chr18.57735000.57740000","chr18.58205000.58210000",470000,9,0.005922499,57735000,58205000,57740000,58210000,"chr18",622869,1,12,12,25,"chr18",1,0.0263713080168776
"21050","chr18.9985000.9990000","chr18.10520000.10525000",535000,12,1.740073e-05,9985000,10520000,9990000,10525000,"chr18",622913,1,1,4,6,"chr18",1,0.00843881856540084
"21051","chr18.3280000.3285000","chr18.3590000.3595000",310000,45,1.478773e-39,3280000,3590000,3285000,3595000,"chr18",622921,1,6,7,14,"chr18",1,0.0738396624472574
"21052","chr18.58990000.58995000","chr18.59055000.59060000",65000,19,0.006926519,58990000,59055000,58995000,59060000,"chr18",622927,3,2,3,8,"chr18",1,0.0178152836380684
"21053","chr18.615000.620000","chr18.740000.745000",125000,14,0.00908001,615000,740000,620000,745000,"chr18",622936,0,4,2,6,"chr18",1,0.00984528832630099
"21054","chr18.3445000.3450000","chr18.3590000.3595000",145000,43,2.865312e-27,3445000,3590000,3450000,3595000,"chr18",622939,0,3,7,10,"chr18",1,0.0503984997655884
"21055","chr18.9650000.9655000","chr18.10520000.10525000",870000,7,0.008053555,9650000,10520000,9655000,10525000,"chr18",623020,1,1,4,6,"chr18",1,0.00492264416315049
"21056","chr18.8660000.8665000","chr18.9015000.9020000",355000,10,0.004728956,8660000,9015000,8665000,9020000,"chr18",623036,5,7,9,21,"chr18",1,0.0246132208157525
"21057","chr18.12625000.12630000","chr18.12650000.12655000",25000,40,5.07016e-05,12625000,12650000,12630000,12655000,"chr18",623059,1,9,3,13,"chr18",1,0.0609470229723394
"21058","chr18.3355000.3360000","chr18.3440000.3445000",85000,17,0.005179938,3355000,3440000,3360000,3445000,"chr18",623106,7,11,8,26,"chr18",1,0.0518049695264885
"21059","chr18.11855000.11860000","chr18.11900000.11905000",45000,33,2.533011e-07,11855000,11900000,11860000,11905000,"chr18",623140,2,15,13,30,"chr18",1,0.116033755274262
"21060","chr18.13265000.13270000","chr18.13380000.13385000",115000,22,5.125706e-07,13265000,13380000,13270000,13385000,"chr18",623149,3,2,4,9,"chr18",1,0.0232067510548523
"21061","chr18.3445000.3450000","chr18.3665000.3670000",220000,27,5.539587e-15,3445000,3665000,3450000,3670000,"chr18",623160,0,3,7,10,"chr18",1,0.0316455696202532
"21062","chr18.12375000.12380000","chr18.12700000.12705000",325000,18,6.226432e-09,12375000,12700000,12380000,12705000,"chr18",623161,2,10,13,25,"chr18",1,0.0527426160337553
"21063","chr18.13245000.13250000","chr18.13395000.13400000",150000,15,0.001056697,13245000,13395000,13250000,13400000,"chr18",623192,0,1,0,1,"chr18",1,0.00175808720112518
"21064","chr18.58760000.58765000","chr18.58995000.59000000",235000,12,0.002721831,58760000,58995000,58765000,5.9e+07,"chr18",623200,2,10,8,20,"chr18",1,0.0281293952180028
"21065","chr18.12420000.12425000","chr18.12645000.12650000",225000,18,3.338487e-07,12420000,12645000,12425000,12650000,"chr18",623212,3,7,10,20,"chr18",1,0.0421940928270042
"21066","chr18.210000.215000","chr18.615000.620000",405000,14,2.962113e-06,210000,615000,215000,620000,"chr18",623231,0,2,1,3,"chr18",1,0.00492264416315049
"21067","chr18.12405000.12410000","chr18.12945000.12950000",540000,9,0.003113714,12405000,12945000,12410000,12950000,"chr18",623235,5,5,11,21,"chr18",1,0.0221518987341772
"21068","chr18.9715000.9720000","chr18.9950000.9955000",235000,13,0.0007075558,9715000,9950000,9720000,9955000,"chr18",623283,0,1,0,1,"chr18",1,0.00152367557430849
"21069","chr18.3295000.3300000","chr18.3590000.3595000",295000,12,0.0006843922,3295000,3590000,3300000,3595000,"chr18",623307,3,4,6,13,"chr18",1,0.0182841068917018
"21070","chr18.59030000.59035000","chr18.59070000.59075000",40000,26,0.002079076,59030000,59070000,59035000,59075000,"chr18",623421,6,11,10,27,"chr18",1,0.0822784810126582
"21071","chr18.445000.450000","chr18.465000.470000",20000,47,1.27874e-06,445000,465000,450000,470000,"chr18",623518,1,2,4,7,"chr18",1,0.0385607126113455
"21072","chr18.5455000.5460000","chr18.5545000.5550000",90000,27,5.377947e-09,5455000,5545000,5460000,5550000,"chr18",623532,0,3,3,6,"chr18",1,0.0189873417721519
"21073","chr18.12740000.12745000","chr18.12930000.12935000",190000,32,1.203764e-18,12740000,12930000,12745000,12935000,"chr18",623538,3,9,6,18,"chr18",1,0.0675105485232067
"21074","chr18.10010000.10015000","chr18.10520000.10525000",510000,17,5.942872e-10,10010000,10520000,10015000,10525000,"chr18",623557,1,1,4,6,"chr18",1,0.0119549929676512
"21075","chr18.12375000.12380000","chr18.12650000.12655000",275000,29,7.56645e-19,12375000,12650000,12380000,12655000,"chr18",623558,7,18,26,51,"chr18",1,0.173347398030942
"21076","chr18.11730000.11735000","chr18.11855000.11860000",125000,16,0.0009835455,11730000,11855000,11735000,11860000,"chr18",623577,2,11,15,28,"chr18",1,0.0525082044069386
"21077","chr18.9615000.9620000","chr18.9765000.9770000",150000,16,0.0002976733,9615000,9765000,9620000,9770000,"chr18",623601,3,5,6,14,"chr18",1,0.0262541022034693
"21078","chr18.12415000.12420000","chr18.12650000.12655000",235000,27,1.652932e-15,12415000,12650000,12420000,12655000,"chr18",623661,5,18,20,43,"chr18",1,0.136075949367089
"21079","chr18.3245000.3250000","chr18.3600000.3605000",355000,14,7.570054e-06,3245000,3600000,3250000,3605000,"chr18",623670,3,11,2,16,"chr18",1,0.0262541022034693
"21080","chr18.11040000.11045000","chr18.11135000.11140000",95000,29,8.044924e-11,11040000,11135000,11045000,11140000,"chr18",623692,2,4,4,10,"chr18",1,0.0339896858884201
"21081","chr18.640000.645000","chr18.685000.690000",45000,27,0.0001967413,640000,685000,645000,690000,"chr18",623695,2,6,8,16,"chr18",1,0.0506329113924051
"21082","chr18.23135000.23140000","chr18.23190000.23195000",55000,21,0.005865284,23135000,23190000,23140000,23195000,"chr18",623708,0,4,1,5,"chr18",1,0.0123066104078762
"21083","chr18.3280000.3285000","chr18.3395000.3400000",115000,36,3.427206e-18,3280000,3395000,3285000,3400000,"chr18",623714,1,6,7,14,"chr18",1,0.0590717299578059
"21084","chr18.9710000.9715000","chr18.10520000.10525000",810000,10,4.624863e-05,9710000,10520000,9715000,10525000,"chr18",623777,1,1,4,6,"chr18",1,0.0070323488045007
"21085","chr18.21705000.21710000","chr18.21850000.21855000",145000,14,0.004271315,21705000,21850000,21710000,21855000,"chr18",623798,3,12,6,21,"chr18",1,0.0344585091420534
"21086","chr18.12415000.12420000","chr18.12645000.12650000",230000,25,2.123357e-13,12415000,12645000,12420000,12650000,"chr18",623847,5,9,10,24,"chr18",1,0.070323488045007
"21087","chr18.48740000.48745000","chr18.48900000.48905000",160000,13,0.007576968,48740000,48900000,48745000,48905000,"chr18",623857,0,2,1,3,"chr18",1,0.00457102672292546
"21088","chr18.3280000.3285000","chr18.3450000.3455000",170000,47,1.235863e-33,3280000,3450000,3285000,3455000,"chr18",623858,1,5,4,10,"chr18",1,0.0550867323019222
"21089","chr18.13215000.13220000","chr18.13630000.13635000",415000,10,0.002411078,13215000,13630000,13220000,13635000,"chr18",623920,0,1,1,2,"chr18",1,0.0023441162681669
"21090","chr18.58990000.58995000","chr18.59120000.59125000",130000,17,0.0002113156,58990000,59120000,58995000,59125000,"chr18",623924,3,6,3,12,"chr18",1,0.0239099859353024
"21091","chr18.285000.290000","chr18.595000.600000",310000,16,5.221215e-07,285000,595000,290000,6e+05,"chr18",623932,0,6,5,11,"chr18",1,0.0206282231598687
"21092","chr18.48615000.48620000","chr18.48925000.48930000",310000,10,0.008467114,48615000,48925000,48620000,48930000,"chr18",623989,1,0,1,2,"chr18",1,0.0023441162681669
"21093","chr18.62435000.62440000","chr18.63130000.63135000",695000,8,0.004610813,62435000,63130000,62440000,63135000,"chr18",624052,1,2,1,4,"chr18",1,0.00375058602906704
"21094","chr18.3280000.3285000","chr18.3495000.3500000",215000,12,0.004693506,3280000,3495000,3285000,3500000,"chr18",624092,0,3,0,3,"chr18",1,0.00421940928270042
"21095","chr18.37270000.37275000","chr18.37295000.37300000",25000,34,0.004750559,37270000,37295000,37275000,37300000,"chr18",624095,0,2,2,4,"chr18",1,0.0159399906235349
"21096","chr18.21125000.21130000","chr18.21705000.21710000",580000,9,0.002218956,21125000,21705000,21130000,21710000,"chr18",624113,3,13,6,22,"chr18",1,0.0232067510548523
"21097","chr18.12420000.12425000","chr18.12650000.12655000",230000,25,2.123357e-13,12420000,12650000,12425000,12655000,"chr18",624119,3,7,11,21,"chr18",1,0.0615330520393812
"21098","chr18.3450000.3455000","chr18.3665000.3670000",215000,30,9.673123e-18,3450000,3665000,3455000,3670000,"chr18",624159,2,5,4,11,"chr18",1,0.0386779184247539
"21099","chr18.13235000.13240000","chr18.13555000.13560000",320000,19,8.902999e-10,13235000,13555000,13240000,13560000,"chr18",624169,0,4,3,7,"chr18",1,0.0155883731833099
"21100","chr18.12725000.12730000","chr18.12930000.12935000",205000,50,6.643672e-40,12725000,12930000,12730000,12935000,"chr18",624175,3,9,6,18,"chr18",1,0.105485232067511
"21101","chr18.3260000.3265000","chr18.3665000.3670000",405000,27,1.878214e-19,3260000,3665000,3265000,3670000,"chr18",624178,3,8,8,19,"chr18",1,0.060126582278481
"21102","chr18.72580000.72585000","chr18.72650000.72655000",70000,18,0.00908001,72580000,72650000,72585000,72655000,"chr18",624180,0,2,0,2,"chr18",1,0.00421940928270042
"21103","chr18.57730000.57735000","chr18.58215000.58220000",485000,9,0.005116998,57730000,58215000,57735000,58220000,"chr18",624192,3,7,5,15,"chr18",1,0.0158227848101266
"21104","chr18.9735000.9740000","chr18.9795000.9800000",60000,24,0.0001168961,9735000,9795000,9740000,9800000,"chr18",624214,9,10,9,28,"chr18",1,0.0787623066104079
"21105","chr18.10010000.10015000","chr18.10440000.10445000",430000,16,3.128798e-08,10010000,10440000,10015000,10445000,"chr18",624223,0,3,3,6,"chr18",1,0.0112517580872011
"21106","chr18.32285000.32290000","chr18.32360000.32365000",75000,19,0.001994073,32285000,32360000,32290000,32365000,"chr18",624271,0,2,0,2,"chr18",1,0.00445382090951711
"21107","chr18.13470000.13475000","chr18.13555000.13560000",85000,21,5.994598e-05,13470000,13555000,13475000,13560000,"chr18",624277,1,1,0,2,"chr18",1,0.00492264416315049
"21108","chr18.9770000.9775000","chr18.9940000.9945000",170000,13,0.005448836,9770000,9940000,9775000,9945000,"chr18",624302,0,1,3,4,"chr18",1,0.00609470229723394
"21109","chr18.3890000.3895000","chr18.3915000.3920000",25000,35,0.002427213,3890000,3915000,3895000,3920000,"chr18",624362,1,4,8,13,"chr18",1,0.053328645100797
"21110","chr18.12405000.12410000","chr18.12645000.12650000",240000,16,5.602352e-06,12405000,12645000,12410000,12650000,"chr18",624372,5,5,10,20,"chr18",1,0.0375058602906704
"21111","chr18.13265000.13270000","chr18.13470000.13475000",205000,17,4.833784e-06,13265000,13470000,13270000,13475000,"chr18",624375,1,1,0,2,"chr18",1,0.00398499765588373
"21112","chr18.8610000.8615000","chr18.9475000.9480000",865000,8,0.00146767,8610000,9475000,8615000,9480000,"chr18",624376,3,2,2,7,"chr18",1,0.00656352555086732
"21113","chr18.50615000.50620000","chr18.50650000.50655000",35000,28,0.002311637,50615000,50650000,50620000,50655000,"chr18",624432,1,1,3,5,"chr18",1,0.0164088138771683
"21114","chr18.2970000.2975000","chr18.3210000.3215000",240000,13,0.0006077504,2970000,3210000,2975000,3215000,"chr18",624497,0,3,2,5,"chr18",1,0.00761837787154243
"21115","chr18.12405000.12410000","chr18.12650000.12655000",245000,40,3.415909e-30,12405000,12650000,12410000,12655000,"chr18",624557,5,5,11,21,"chr18",1,0.0984528832630098
"21116","chr18.13245000.13250000","chr18.13555000.13560000",310000,11,0.002216772,13245000,13555000,13250000,13560000,"chr18",624592,0,1,0,1,"chr18",1,0.0012892639474918
"21117","chr18.2915000.2920000","chr18.3135000.3140000",220000,12,0.004057248,2915000,3135000,2920000,3140000,"chr18",624595,0,2,0,2,"chr18",1,0.00281293952180028
"21118","chr18.3280000.3285000","chr18.4000000.4005000",720000,8,0.003868054,3280000,4e+06,3285000,4005000,"chr18",624655,1,1,1,3,"chr18",1,0.00281293952180028
"21119","chr18.12390000.12395000","chr18.12645000.12650000",255000,24,3.538189e-13,12390000,12645000,12395000,12650000,"chr18",624693,6,9,10,25,"chr18",1,0.070323488045007
"21120","chr18.13555000.13560000","chr18.13810000.13815000",255000,11,0.00611177,13555000,13810000,13560000,13815000,"chr18",624702,1,4,3,8,"chr18",1,0.0103141115799344
"21121","chr18.285000.290000","chr18.640000.645000",355000,14,7.570054e-06,285000,640000,290000,645000,"chr18",624746,2,6,8,16,"chr18",1,0.0262541022034693
"21122","chr18.74115000.74120000","chr18.74410000.74415000",295000,12,0.0006843922,74115000,74410000,74120000,74415000,"chr18",624780,1,2,2,5,"chr18",1,0.0070323488045007
"21123","chr18.9330000.9335000","chr18.9475000.9480000",145000,32,2.104583e-16,9330000,9475000,9335000,9480000,"chr18",624801,3,2,2,7,"chr18",1,0.0262541022034693
"21124","chr18.640000.645000","chr18.710000.715000",70000,25,4.181376e-06,640000,710000,645000,715000,"chr18",624812,2,6,8,16,"chr18",1,0.046882325363338
"21125","chr18.3280000.3285000","chr18.3625000.3630000",345000,16,2.089111e-07,3280000,3625000,3285000,3630000,"chr18",624864,1,6,7,14,"chr18",1,0.0262541022034693
"21126","chr18.3245000.3250000","chr18.3590000.3595000",345000,14,9.075336e-06,3245000,3590000,3250000,3595000,"chr18",624896,3,11,2,16,"chr18",1,0.0262541022034693
"21127","chr18.5875000.5880000","chr18.6215000.6220000",340000,12,0.00029855,5875000,6215000,5880000,6220000,"chr18",624918,4,5,9,18,"chr18",1,0.0253164556962025
"21128","chr18.9070000.9075000","chr18.9230000.9235000",160000,13,0.007576968,9070000,9230000,9075000,9235000,"chr18",624920,0,6,6,12,"chr18",1,0.0182841068917018
"21129","chr18.12375000.12380000","chr18.12655000.12660000",280000,22,7.227388e-12,12375000,12655000,12380000,12660000,"chr18",624972,3,14,23,40,"chr18",1,0.103141115799344
"21130","chr18.7620000.7625000","chr18.8480000.8485000",860000,8,0.001518106,7620000,8480000,7625000,8485000,"chr18",625018,2,5,5,12,"chr18",1,0.0112517580872011
"21131","chr18.3280000.3285000","chr18.3600000.3605000",320000,38,7.750863e-31,3280000,3600000,3285000,3605000,"chr18",625059,1,6,7,14,"chr18",1,0.0623534927332396
"21132","chr18.3010000.3015000","chr18.3665000.3670000",655000,8,0.006007667,3010000,3665000,3015000,3670000,"chr18",625082,4,11,8,23,"chr18",1,0.0215658696671355
"21133","chr18.330000.335000","chr18.455000.460000",125000,21,1.009499e-06,330000,455000,335000,460000,"chr18",625105,2,5,5,12,"chr18",1,0.029535864978903
"21134","chr18.56485000.56490000","chr18.56705000.56710000",220000,17,2.402577e-06,56485000,56705000,56490000,56710000,"chr18",625127,2,6,0,8,"chr18",1,0.0159399906235349
"21135","chr18.8615000.8620000","chr18.9475000.9480000",860000,7,0.008520403,8615000,9475000,8620000,9480000,"chr18",625135,2,1,2,5,"chr18",1,0.00410220346929208
"21136","chr18.8650000.8655000","chr18.9145000.9150000",495000,9,0.004693762,8650000,9145000,8655000,9150000,"chr18",625153,8,13,13,34,"chr18",1,0.0358649789029536
"21137","chr18.31665000.31670000","chr18.31685000.31690000",20000,37,0.003539362,31665000,31685000,31670000,31690000,"chr18",625155,0,6,0,6,"chr18",1,0.0260196905766526
"21138","chr18.620000.625000","chr18.710000.715000",90000,29,2.060848e-10,620000,710000,625000,715000,"chr18",625158,4,16,16,36,"chr18",1,0.122362869198312
"21139","chr18.60370000.60375000","chr18.60980000.60985000",610000,9,0.001707702,60370000,60980000,60375000,60985000,"chr18",625224,2,0,1,3,"chr18",1,0.00316455696202532
"21140","chr18.46385000.46390000","chr18.46625000.46630000",240000,11,0.008505224,46385000,46625000,46390000,46630000,"chr18",625242,0,1,2,3,"chr18",1,0.00386779184247539
"21141","chr18.12470000.12475000","chr18.12515000.12520000",45000,31,2.733393e-06,12470000,12515000,12475000,12520000,"chr18",625247,9,21,25,55,"chr18",1,0.199835911861228
"21142","chr18.58990000.58995000","chr18.59140000.59145000",150000,24,8.737579e-10,58990000,59140000,58995000,59145000,"chr18",625260,2,5,3,10,"chr18",1,0.0281293952180028
"21143","chr18.9940000.9945000","chr18.10440000.10445000",500000,10,0.0009610019,9940000,10440000,9945000,10445000,"chr18",625334,0,1,3,4,"chr18",1,0.0046882325363338
"21144","chr18.3395000.3400000","chr18.3665000.3670000",270000,21,9.931845e-11,3395000,3665000,3400000,3670000,"chr18",625339,5,14,19,38,"chr18",1,0.0935302390998594
"21145","chr18.13575000.13580000","chr18.13630000.13635000",55000,26,4.240724e-05,13575000,13630000,13580000,13635000,"chr18",625343,0,2,1,3,"chr18",1,0.00914205344585091
"21146","chr18.12725000.12730000","chr18.13630000.13635000",905000,8,0.001103532,12725000,13630000,12730000,13635000,"chr18",625366,0,2,1,3,"chr18",1,0.00281293952180028
"21147","chr18.620000.625000","chr18.830000.835000",210000,18,7.028828e-07,620000,830000,625000,835000,"chr18",625389,1,4,5,10,"chr18",1,0.0210970464135021
"21148","chr18.11945000.11950000","chr18.11995000.12000000",50000,24,0.001052627,11945000,11995000,11950000,1.2e+07,"chr18",625442,2,0,2,4,"chr18",1,0.0112517580872011
"21149","chr18.9070000.9075000","chr18.9330000.9335000",260000,17,4.398074e-07,9070000,9330000,9075000,9335000,"chr18",625449,2,5,5,12,"chr18",1,0.0239099859353024
"21150","chr18.12725000.12730000","chr18.12925000.12930000",200000,19,2.103617e-07,12725000,12925000,12730000,12930000,"chr18",625525,0,3,6,9,"chr18",1,0.020042194092827
"21151","chr18.9615000.9620000","chr18.9950000.9955000",335000,14,1.116194e-05,9615000,9950000,9620000,9955000,"chr18",625558,0,1,0,1,"chr18",1,0.00164088138771683
"21152","chr18.2970000.2975000","chr18.3125000.3130000",155000,17,5.797054e-05,2970000,3125000,2975000,3130000,"chr18",625563,0,3,4,7,"chr18",1,0.0139474917955931
"21153","chr18.74135000.74140000","chr18.74410000.74415000",275000,14,4.754699e-05,74135000,74410000,74140000,74415000,"chr18",625625,3,0,2,5,"chr18",1,0.00820440693858415
"21154","chr18.3605000.3610000","chr18.3665000.3670000",60000,20,0.006107264,3605000,3665000,3610000,3670000,"chr18",625638,2,7,6,15,"chr18",1,0.0351617440225035
"21155","chr18.13555000.13560000","chr18.13575000.13580000",20000,43,4.240724e-05,13555000,13575000,13560000,13580000,"chr18",625655,0,2,3,5,"chr18",1,0.0251992498827942
"21156","chr18.10560000.10565000","chr18.11150000.11155000",590000,8,0.009378659,10560000,11150000,10565000,11155000,"chr18",625663,0,1,0,1,"chr18",1,0.00093764650726676
"21157","chr18.12390000.12395000","chr18.12650000.12655000",260000,38,1.694852e-28,12390000,12650000,12395000,12655000,"chr18",625680,7,18,18,43,"chr18",1,0.191514299109236
"21158","chr18.7600000.7605000","chr18.8480000.8485000",880000,7,0.007570243,7600000,8480000,7605000,8485000,"chr18",625693,2,5,5,12,"chr18",1,0.00984528832630099
"21159","chr18.46095000.46100000","chr18.46150000.46155000",55000,25,0.0001249918,46095000,46150000,46100000,46155000,"chr18",625749,3,10,6,19,"chr18",1,0.0556727613689639
"21160","chr18.640000.645000","chr18.835000.840000",195000,13,0.002427213,640000,835000,645000,840000,"chr18",625806,2,6,8,16,"chr18",1,0.0243788091889358
"21161","chr18.28005000.28010000","chr18.28040000.28045000",35000,27,0.004971863,28005000,28040000,28010000,28045000,"chr18",625852,2,1,1,4,"chr18",1,0.0126582278481013
"21162","chr18.3795000.3800000","chr18.3915000.3920000",120000,19,2.69309e-05,3795000,3915000,3800000,3920000,"chr18",625855,1,4,8,13,"chr18",1,0.0289498359118612
"21163","chr18.9070000.9075000","chr18.9340000.9345000",270000,14,5.475291e-05,9070000,9340000,9075000,9345000,"chr18",625876,2,15,18,35,"chr18",1,0.0574308485700891
"21164","chr18.320000.325000","chr18.455000.460000",135000,28,2.05162e-12,320000,455000,325000,460000,"chr18",625889,0,5,7,12,"chr18",1,0.0393811533052039
"21165","chr18.46150000.46155000","chr18.46170000.46175000",20000,40,0.0004458534,46150000,46170000,46155000,46175000,"chr18",625909,3,20,12,35,"chr18",1,0.164088138771683
"21166","chr18.12390000.12395000","chr18.12945000.12950000",555000,10,0.0005251926,12390000,12945000,12395000,12950000,"chr18",625930,5,11,14,30,"chr18",1,0.0351617440225035
"21167","chr18.9615000.9620000","chr18.9940000.9945000",325000,11,0.00173876,9615000,9940000,9620000,9945000,"chr18",625985,0,1,3,4,"chr18",1,0.00515705578996718
"21168","chr18.3440000.3445000","chr18.3610000.3615000",170000,15,0.0004586232,3440000,3610000,3445000,3615000,"chr18",626000,8,24,16,48,"chr18",1,0.0843881856540084
"21169","chr18.12390000.12395000","chr18.12455000.12460000",65000,19,0.006926519,12390000,12455000,12395000,12460000,"chr18",626018,3,3,12,18,"chr18",1,0.040084388185654
"21170","chr18.46070000.46075000","chr18.46115000.46120000",45000,26,0.0005133222,46070000,46115000,46075000,46120000,"chr18",626105,1,7,2,10,"chr18",1,0.0304735114861697
"21171","chr18.685000.690000","chr18.705000.710000",20000,39,0.0009356233,685000,705000,690000,710000,"chr18",626115,2,7,10,19,"chr18",1,0.0868495077355837
"21172","chr18.11935000.11940000","chr18.11995000.12000000",60000,33,9.9355e-10,11935000,11995000,11940000,1.2e+07,"chr18",626184,2,0,2,4,"chr18",1,0.0154711673699015
"21173","chr18.56575000.56580000","chr18.56705000.56710000",130000,16,0.0007668607,56575000,56705000,56580000,56710000,"chr18",626201,0,3,2,5,"chr18",1,0.00937646507266761
"21174","chr18.58995000.59000000","chr18.59140000.59145000",145000,15,0.00130368,58995000,59140000,5.9e+07,59145000,"chr18",626211,2,5,3,10,"chr18",1,0.0175808720112518
"21175","chr18.3355000.3360000","chr18.3395000.3400000",40000,31,1.835724e-05,3355000,3395000,3360000,3400000,"chr18",626242,7,11,8,26,"chr18",1,0.0944678856071261
"21176","chr18.59400000.59405000","chr18.59425000.59430000",25000,43,3.524186e-06,59400000,59425000,59405000,59430000,"chr18",626287,0,0,3,3,"chr18",1,0.0151195499296765
"21177","chr18.62280000.62285000","chr18.63130000.63135000",850000,9,0.0002453029,62280000,63130000,62285000,63135000,"chr18",626289,1,2,0,3,"chr18",1,0.00316455696202532
"21178","chr18.13265000.13270000","chr18.13370000.13375000",105000,16,0.003113714,13265000,13370000,13270000,13375000,"chr18",626294,1,8,2,11,"chr18",1,0.0206282231598687
"21179","chr18.9680000.9685000","chr18.9950000.9955000",270000,15,1.044692e-05,9680000,9950000,9685000,9955000,"chr18",626396,0,1,0,1,"chr18",1,0.00175808720112518
"21180","chr18.320000.325000","chr18.615000.620000",295000,16,8.177858e-07,320000,615000,325000,620000,"chr18",626448,0,4,2,6,"chr18",1,0.0112517580872011
"21181","chr18.4105000.4110000","chr18.5020000.5025000",915000,11,1.83174e-06,4105000,5020000,4110000,5025000,"chr18",626505,0,0,2,2,"chr18",1,0.00257852789498359
"21182","chr18.9075000.9080000","chr18.9230000.9235000",155000,13,0.00908001,9075000,9230000,9080000,9235000,"chr18",626530,0,6,6,12,"chr18",1,0.0182841068917018
"21183","chr18.46325000.46330000","chr18.46750000.46755000",425000,10,0.002162607,46325000,46750000,46330000,46755000,"chr18",626544,0,4,11,15,"chr18",1,0.0175808720112518
"21184","chr18.3450000.3455000","chr18.3585000.3590000",135000,37,1.613477e-20,3450000,3585000,3455000,3590000,"chr18",626549,2,5,4,11,"chr18",1,0.0477027660571964
"21185","chr18.9710000.9715000","chr18.9765000.9770000",55000,24,0.0003599919,9710000,9765000,9715000,9770000,"chr18",626570,3,5,6,14,"chr18",1,0.0393811533052039
"21186","chr18.6215000.6220000","chr18.6480000.6485000",265000,11,0.004987879,6215000,6480000,6220000,6485000,"chr18",626629,5,5,9,19,"chr18",1,0.0244960150023441
"21187","chr18.13555000.13560000","chr18.13630000.13635000",75000,69,7.119796e-45,13555000,13630000,13560000,13635000,"chr18",626682,0,2,1,3,"chr18",1,0.0242616033755274
"21188","chr18.9070000.9075000","chr18.9615000.9620000",545000,11,9.905246e-05,9070000,9615000,9075000,9620000,"chr18",626686,2,5,15,22,"chr18",1,0.0283638068448195
"21189","chr18.265000.270000","chr18.615000.620000",350000,14,8.25904e-06,265000,615000,270000,620000,"chr18",626700,0,4,2,6,"chr18",1,0.00984528832630099
"21190","chr18.46295000.46300000","chr18.46755000.46760000",460000,9,0.006471476,46295000,46755000,46300000,46760000,"chr18",626739,0,1,3,4,"chr18",1,0.00421940928270042
"21191","chr18.40150000.40155000","chr18.40170000.40175000",20000,37,0.003539362,40150000,40170000,40155000,40175000,"chr18",626794,0,2,1,3,"chr18",1,0.0130098452883263
"21192","chr18.675000.680000","chr18.705000.710000",30000,32,0.001052489,675000,705000,680000,710000,"chr18",626799,0,2,3,5,"chr18",1,0.0187529301453352
"21193","chr18.48665000.48670000","chr18.49055000.49060000",390000,10,0.003163826,48665000,49055000,48670000,49060000,"chr18",626803,0,0,3,3,"chr18",1,0.00351617440225035
"21194","chr18.3010000.3015000","chr18.3125000.3130000",115000,20,9.811042e-06,3010000,3125000,3015000,3130000,"chr18",626828,2,7,8,17,"chr18",1,0.0398499765588373
"21195","chr18.23860000.23865000","chr18.24515000.24520000",655000,8,0.006007667,23860000,24515000,23865000,24520000,"chr18",626864,4,8,4,16,"chr18",1,0.0150023441162682
"21196","chr18.13245000.13250000","chr18.13265000.13270000",20000,40,0.0004458534,13245000,13265000,13250000,13270000,"chr18",626954,0,1,0,1,"chr18",1,0.0046882325363338
"21197","chr18.3525000.3530000","chr18.3585000.3590000",60000,25,3.86588e-05,3525000,3585000,3530000,3590000,"chr18",626957,2,9,7,18,"chr18",1,0.0527426160337553
"21198","chr18.9615000.9620000","chr18.10525000.10530000",910000,7,0.006343452,9615000,10525000,9620000,10530000,"chr18",627014,0,5,4,9,"chr18",1,0.00738396624472574
"21199","chr18.3260000.3265000","chr18.3605000.3610000",345000,11,0.001282808,3260000,3605000,3265000,3610000,"chr18",627030,2,7,6,15,"chr18",1,0.0193389592123769
"21200","chr18.11040000.11045000","chr18.11120000.11125000",80000,34,3.981159e-13,11040000,11120000,11045000,11125000,"chr18",627064,2,4,4,10,"chr18",1,0.0398499765588373
"21201","chr18.48340000.48345000","chr18.48510000.48515000",170000,16,0.0001156822,48340000,48510000,48345000,48515000,"chr18",627073,0,3,5,8,"chr18",1,0.0150023441162682
"21202","chr18.57790000.57795000","chr18.58205000.58210000",415000,13,1.609533e-05,57790000,58205000,57795000,58210000,"chr18",627106,1,12,12,25,"chr18",1,0.0380918893577121
"21203","chr18.3450000.3455000","chr18.3525000.3530000",75000,24,5.993886e-06,3450000,3525000,3455000,3530000,"chr18",627142,2,5,4,11,"chr18",1,0.0309423347398031
"21204","chr18.59030000.59035000","chr18.59055000.59060000",25000,34,0.004750559,59030000,59055000,59035000,59060000,"chr18",627224,3,2,3,8,"chr18",1,0.0318799812470699
"21205","chr18.320000.325000","chr18.640000.645000",320000,11,0.001882232,320000,640000,325000,645000,"chr18",627227,0,6,7,13,"chr18",1,0.0167604313173933
"21206","chr18.10010000.10015000","chr18.10050000.10055000",40000,24,0.009872378,10010000,10050000,10015000,10055000,"chr18",627231,3,1,1,5,"chr18",1,0.0140646976090014
"21207","chr18.52905000.52910000","chr18.52975000.52980000",70000,36,2.490364e-13,52905000,52975000,52910000,52980000,"chr18",627268,0,1,2,3,"chr18",1,0.0126582278481013
"21208","chr18.640000.645000","chr18.830000.835000",190000,12,0.009202968,640000,830000,645000,835000,"chr18",627278,1,4,5,10,"chr18",1,0.0140646976090014
"21209","chr18.12650000.12655000","chr18.12945000.12950000",295000,15,4.977643e-06,12650000,12945000,12655000,12950000,"chr18",627316,5,11,14,30,"chr18",1,0.0527426160337553
"21210","chr18.24445000.24450000","chr18.24515000.24520000",70000,20,0.001348303,24445000,24515000,24450000,24520000,"chr18",627322,2,9,3,14,"chr18",1,0.0328176277543366
"21211","chr18.46245000.46250000","chr18.46755000.46760000",510000,9,0.004116615,46245000,46755000,46250000,46760000,"chr18",627371,0,1,3,4,"chr18",1,0.00421940928270042
"21212","chr18.265000.270000","chr18.705000.710000",440000,17,2.840449e-09,265000,705000,270000,710000,"chr18",627394,0,7,4,11,"chr18",1,0.0219174871073605
"21213","chr18.3260000.3265000","chr18.3620000.3625000",360000,15,1.050074e-06,3260000,3620000,3265000,3625000,"chr18",627434,3,8,8,19,"chr18",1,0.0334036568213783
"21214","chr18.60935000.60940000","chr18.60980000.60985000",45000,39,8.745775e-11,60935000,60980000,60940000,60985000,"chr18",627477,2,0,1,3,"chr18",1,0.0137130801687764
"21215","chr18.3260000.3265000","chr18.3585000.3590000",325000,12,0.0003834266,3260000,3585000,3265000,3590000,"chr18",627503,3,8,8,19,"chr18",1,0.0267229254571027
"21216","chr18.8705000.8710000","chr18.8985000.8990000",280000,16,1.299325e-06,8705000,8985000,8710000,8990000,"chr18",627508,3,3,9,15,"chr18",1,0.0281293952180028
"21217","chr18.7270000.7275000","chr18.7975000.7980000",705000,8,0.004291578,7270000,7975000,7275000,7980000,"chr18",627525,1,3,2,6,"chr18",1,0.00562587904360056
"21218","chr18.8700000.8705000","chr18.9145000.9150000",445000,9,0.007417877,8700000,9145000,8705000,9150000,"chr18",627530,9,13,13,35,"chr18",1,0.0369198312236287
"21219","chr18.12390000.12395000","chr18.12625000.12630000",235000,11,0.009378659,12390000,12625000,12395000,12630000,"chr18",627542,1,9,3,13,"chr18",1,0.0167604313173933
"21220","chr18.31940000.31945000","chr18.32360000.32365000",420000,12,8.843995e-05,31940000,32360000,31945000,32365000,"chr18",627608,0,2,0,2,"chr18",1,0.00281293952180028
"21221","chr18.32445000.32450000","chr18.32710000.32715000",265000,12,0.001291094,32445000,32710000,32450000,32715000,"chr18",627626,1,0,0,1,"chr18",1,0.00140646976090014
"21222","chr18.48340000.48345000","chr18.48590000.48595000",250000,17,6.538087e-07,48340000,48590000,48345000,48595000,"chr18",627638,0,3,5,8,"chr18",1,0.0159399906235349
"21223","chr18.3060000.3065000","chr18.3245000.3250000",185000,18,2.619719e-06,3060000,3245000,3065000,3250000,"chr18",627654,3,7,2,12,"chr18",1,0.0253164556962025
"21224","chr18.12725000.12730000","chr18.12945000.12950000",220000,33,4.505787e-21,12725000,12945000,12730000,12950000,"chr18",627677,5,11,6,22,"chr18",1,0.0850914205344585
"21225","chr18.12415000.12420000","chr18.12455000.12460000",40000,42,2.356952e-11,12415000,12455000,12420000,12460000,"chr18",627687,3,3,12,18,"chr18",1,0.0886075949367089
"21226","chr18.13245000.13250000","chr18.13630000.13635000",385000,10,0.003379627,13245000,13630000,13250000,13635000,"chr18",627751,0,1,0,1,"chr18",1,0.00117205813408345
"21227","chr18.9680000.9685000","chr18.9795000.9800000",115000,25,3.932737e-09,9680000,9795000,9685000,9800000,"chr18",627785,2,3,0,5,"chr18",1,0.0146507266760431
"21228","chr18.2995000.3000000","chr18.3210000.3215000",215000,12,0.004693506,2995000,3210000,3e+06,3215000,"chr18",627789,0,6,2,8,"chr18",1,0.0112517580872011
"21229","chr18.12390000.12395000","chr18.12930000.12935000",540000,11,0.0001051644,12390000,12930000,12395000,12935000,"chr18",627795,3,9,6,18,"chr18",1,0.0232067510548523
"21230","chr18.8650000.8655000","chr18.8985000.8990000",335000,23,6.660155e-14,8650000,8985000,8655000,8990000,"chr18",627837,7,14,21,42,"chr18",1,0.113220815752461
"21231","chr18.11115000.11120000","chr18.11150000.11155000",35000,29,0.001035393,11115000,11150000,11120000,11155000,"chr18",627903,1,4,0,5,"chr18",1,0.01699484294421
"21232","chr18.12470000.12475000","chr18.12685000.12690000",215000,12,0.004693506,12470000,12685000,12475000,12690000,"chr18",627916,3,10,8,21,"chr18",1,0.029535864978903
"21233","chr18.3440000.3445000","chr18.3620000.3625000",180000,15,0.0003037338,3440000,3620000,3445000,3625000,"chr18",627948,8,24,16,48,"chr18",1,0.0843881856540084
"21234","chr18.2970000.2975000","chr18.3245000.3250000",275000,21,7.905306e-11,2970000,3245000,2975000,3250000,"chr18",628026,0,3,2,5,"chr18",1,0.0123066104078762
"21235","chr18.3280000.3285000","chr18.3440000.3445000",160000,26,8.591418e-12,3280000,3440000,3285000,3445000,"chr18",628061,1,6,7,14,"chr18",1,0.0426629160806376
"21236","chr18.3450000.3455000","chr18.3600000.3605000",150000,32,1.151485e-16,3450000,3600000,3455000,3605000,"chr18",628121,2,5,4,11,"chr18",1,0.0412564463197375
"21237","chr18.8660000.8665000","chr18.8980000.8985000",320000,15,2.57547e-06,8660000,8980000,8665000,8985000,"chr18",628125,3,7,9,19,"chr18",1,0.0334036568213783
"21238","chr18.46070000.46075000","chr18.46170000.46175000",100000,16,0.004395273,46070000,46170000,46075000,46175000,"chr18",628130,1,7,2,10,"chr18",1,0.0187529301453352
"21239","chr18.46025000.46030000","chr18.46170000.46175000",145000,15,0.00130368,46025000,46170000,46030000,46175000,"chr18",628144,3,10,12,25,"chr18",1,0.0439521800281294
"21240","chr18.57640000.57645000","chr18.58240000.58245000",600000,8,0.00884415,57640000,58240000,57645000,58245000,"chr18",628167,5,12,21,38,"chr18",1,0.0356305672761369
"21241","chr18.10780000.10785000","chr18.11040000.11045000",260000,18,6.734027e-08,10780000,11040000,10785000,11045000,"chr18",628241,2,4,2,8,"chr18",1,0.0168776371308017
"21242","chr18.2995000.3000000","chr18.3125000.3130000",130000,24,4.838917e-09,2995000,3125000,3e+06,3130000,"chr18",628258,2,7,11,20,"chr18",1,0.0562587904360056
"21243","chr18.12375000.12380000","chr18.12645000.12650000",270000,24,1.468162e-13,12375000,12645000,12380000,12650000,"chr18",628271,6,9,10,25,"chr18",1,0.070323488045007
"21244","chr18.3440000.3445000","chr18.3585000.3590000",145000,28,7.377644e-13,3440000,3585000,3445000,3590000,"chr18",628365,8,24,16,48,"chr18",1,0.157524613220816
"21245","chr18.285000.290000","chr18.710000.715000",425000,11,0.0004458534,285000,710000,290000,715000,"chr18",628368,2,13,11,26,"chr18",1,0.0335208626347867
"21246","chr18.3795000.3800000","chr18.3845000.3850000",50000,22,0.006107264,3795000,3845000,3800000,3850000,"chr18",628395,2,0,1,3,"chr18",1,0.00773558368495077
"21247","chr18.48730000.48735000","chr18.48900000.48905000",170000,13,0.005448836,48730000,48900000,48735000,48905000,"chr18",628416,0,2,1,3,"chr18",1,0.00457102672292546
"21248","chr18.9100000.9105000","chr18.9330000.9335000",230000,15,4.196263e-05,9100000,9330000,9105000,9335000,"chr18",628440,0,0,3,3,"chr18",1,0.00527426160337553
"21249","chr18.9135000.9140000","chr18.9330000.9335000",195000,21,7.699014e-09,9135000,9330000,9140000,9335000,"chr18",628462,4,3,4,11,"chr18",1,0.0270745428973277
"21250","chr18.13220000.13225000","chr18.13380000.13385000",160000,22,1.437435e-08,13220000,13380000,13225000,13385000,"chr18",628479,1,2,4,7,"chr18",1,0.0180496952648851
"21251","chr18.9950000.9955000","chr18.10545000.10550000",595000,12,7.867992e-06,9950000,10545000,9955000,10550000,"chr18",628525,0,1,0,1,"chr18",1,0.00140646976090014
"21252","chr18.46660000.46665000","chr18.46680000.46685000",20000,39,0.0009356233,46660000,46680000,46665000,46685000,"chr18",628536,1,1,1,3,"chr18",1,0.0137130801687764
"21253","chr18.3440000.3445000","chr18.3590000.3595000",150000,37,1.907194e-21,3440000,3590000,3445000,3595000,"chr18",628563,4,12,11,27,"chr18",1,0.117088607594937
"21254","chr18.12415000.12420000","chr18.12655000.12660000",240000,16,5.602352e-06,12415000,12655000,12420000,12660000,"chr18",628656,3,14,20,37,"chr18",1,0.0693858415377403
"21255","chr18.3260000.3265000","chr18.3445000.3450000",185000,13,0.003378704,3260000,3445000,3265000,3450000,"chr18",628673,0,3,7,10,"chr18",1,0.0152367557430849
"21256","chr19.2640000.2645000","chr19.2740000.2745000",100000,22,8.067631e-06,2640000,2740000,2645000,2745000,"chr19",628702,9,17,15,41,"chr19",1,0.105719643694327
"21257","chr19.6480000.6485000","chr19.6525000.6530000",45000,25,0.00205386,6480000,6525000,6485000,6530000,"chr19",628708,14,30,30,74,"chr19",1,0.216830754805438
"21258","chr19.38890000.38895000","chr19.39120000.39125000",230000,19,7.219749e-08,38890000,39120000,38895000,39125000,"chr19",628727,6,16,11,33,"chr19",1,0.0734880450070323
"21259","chr19.12830000.12835000","chr19.12985000.12990000",155000,14,0.004800452,12830000,12985000,12835000,12990000,"chr19",628732,1,1,1,3,"chr19",1,0.00492264416315049
"21260","chr19.6455000.6460000","chr19.6475000.6480000",20000,36,0.004609976,6455000,6475000,6460000,6480000,"chr19",628736,2,5,16,23,"chr19",1,0.0970464135021097
"21261","chr19.57830000.57835000","chr19.57900000.57905000",70000,22,0.0003639768,57830000,57900000,57835000,57905000,"chr19",628739,0,0,7,7,"chr19",1,0.0180496952648851
"21262","chr19.2665000.2670000","chr19.2685000.2690000",20000,69,4.849224e-18,2665000,2685000,2670000,2690000,"chr19",628741,6,15,18,39,"chr19",1,0.315400843881857
"21263","chr19.2500000.2505000","chr19.2540000.2545000",40000,28,0.000539888,2500000,2540000,2505000,2545000,"chr19",628764,2,9,11,22,"chr19",1,0.0721987810595406
"21264","chr19.5930000.5935000","chr19.5965000.5970000",35000,34,1.389882e-05,5930000,5965000,5935000,5970000,"chr19",628771,0,3,0,3,"chr19",1,0.0119549929676512
"21265","chr19.18710000.18715000","chr19.18945000.18950000",235000,14,0.0002188068,18710000,18945000,18715000,18950000,"chr19",628784,3,7,2,12,"chr19",1,0.019690576652602
"21266","chr19.7515000.7520000","chr19.7530000.7535000",15000,57,1.810972e-11,7515000,7530000,7520000,7535000,"chr19",628795,2,12,17,31,"chr19",1,0.207102672292546
"21267","chr19.5945000.5950000","chr19.5965000.5970000",20000,46,1.783247e-06,5945000,5965000,5950000,5970000,"chr19",628800,0,2,0,2,"chr19",1,0.0107829348335677
"21268","chr19.16320000.16325000","chr19.16505000.16510000",185000,14,0.001474598,16320000,16505000,16325000,16510000,"chr19",628812,6,13,9,28,"chr19",1,0.0459446788560713
"21269","chr19.2155000.2160000","chr19.2175000.2180000",20000,43,2.524408e-05,2155000,2175000,2160000,2180000,"chr19",628814,13,41,42,96,"chr19",1,0.483825597749648
"21270","chr19.2540000.2545000","chr19.2635000.2640000",95000,22,1.420945e-05,2540000,2635000,2545000,2640000,"chr19",628816,0,6,2,8,"chr19",1,0.0206282231598687
"21271","chr19.2235000.2240000","chr19.2270000.2275000",35000,29,0.001308007,2235000,2270000,2240000,2275000,"chr19",628831,0,2,12,14,"chr19",1,0.0475855602437881
"21272","chr19.2690000.2695000","chr19.2780000.2785000",90000,20,0.000285034,2690000,2780000,2695000,2785000,"chr19",628841,1,6,5,12,"chr19",1,0.0281293952180028
"21273","chr19.17700000.17705000","chr19.18070000.18075000",370000,11,0.0007354913,17700000,18070000,17705000,18075000,"chr19",628863,6,27,22,55,"chr19",1,0.0709095171120488
"21274","chr19.18460000.18465000","chr19.18520000.18525000",60000,25,9.196901e-05,18460000,18520000,18465000,18525000,"chr19",628888,3,2,9,14,"chr19",1,0.0410220346929208
"21275","chr19.48105000.48110000","chr19.48200000.48205000",95000,18,0.001643925,48105000,48200000,48110000,48205000,"chr19",628915,2,10,7,19,"chr19",1,0.040084388185654
"21276","chr19.2455000.2460000","chr19.2625000.2630000",170000,16,0.0002142958,2455000,2625000,2460000,2630000,"chr19",628926,6,4,10,20,"chr19",1,0.0375058602906704
"21277","chr19.18120000.18125000","chr19.18165000.18170000",45000,48,4.436782e-16,18120000,18165000,18125000,18170000,"chr19",628940,5,14,10,29,"chr19",1,0.163150492264416
"21278","chr19.2460000.2465000","chr19.2625000.2630000",165000,15,0.0009825248,2460000,2625000,2465000,2630000,"chr19",628947,6,4,10,20,"chr19",1,0.0351617440225035
"21279","chr19.12190000.12195000","chr19.12640000.12645000",450000,13,4.573029e-06,12190000,12640000,12195000,12645000,"chr19",628951,8,22,37,67,"chr19",1,0.102086263478669
"21280","chr19.2475000.2480000","chr19.2545000.2550000",70000,26,3.506676e-06,2475000,2545000,2480000,2550000,"chr19",628989,0,1,1,2,"chr19",1,0.00609470229723394
"21281","chr19.5720000.5725000","chr19.5965000.5970000",245000,14,0.0001519474,5720000,5965000,5725000,5970000,"chr19",628992,0,3,0,3,"chr19",1,0.00492264416315049
"21282","chr19.18110000.18115000","chr19.18150000.18155000",40000,25,0.006352757,18110000,18150000,18115000,18155000,"chr19",628995,5,8,11,24,"chr19",1,0.070323488045007
"21283","chr19.50530000.50535000","chr19.50635000.50640000",105000,25,6.08511e-08,50530000,50635000,50535000,50640000,"chr19",629015,0,2,5,7,"chr19",1,0.0205110173464604
"21284","chr19.12550000.12555000","chr19.12720000.12725000",170000,15,0.000785457,12550000,12720000,12555000,12725000,"chr19",629030,3,20,16,39,"chr19",1,0.0685654008438819
"21285","chr19.18055000.18060000","chr19.18100000.18105000",45000,28,0.0001275693,18055000,18100000,18060000,18105000,"chr19",629038,4,15,12,31,"chr19",1,0.101734646038444
"21286","chr19.46575000.46580000","chr19.46785000.46790000",210000,13,0.002067484,46575000,46785000,46580000,46790000,"chr19",629054,1,14,8,23,"chr19",1,0.0350445382090952
"21287","chr19.14685000.14690000","chr19.14885000.14890000",200000,14,0.0008147499,14685000,14885000,14690000,14890000,"chr19",629058,3,15,12,30,"chr19",1,0.0492264416315049
"21288","chr19.9765000.9770000","chr19.9890000.9895000",125000,21,3.089493e-06,9765000,9890000,9770000,9895000,"chr19",629060,5,19,23,47,"chr19",1,0.115682137834037
"21289","chr19.9780000.9785000","chr19.9890000.9895000",110000,35,7.615531e-16,9780000,9890000,9785000,9895000,"chr19",629073,5,19,23,47,"chr19",1,0.192803563056728
"21290","chr19.3035000.3040000","chr19.3090000.3095000",55000,32,8.081663e-08,3035000,3090000,3040000,3095000,"chr19",629078,5,17,8,30,"chr19",1,0.112517580872011
"21291","chr19.38400000.38405000","chr19.38700000.38705000",300000,12,0.0006255539,38400000,38700000,38405000,38705000,"chr19",629080,1,3,1,5,"chr19",1,0.0070323488045007
"21292","chr19.2150000.2155000","chr19.2315000.2320000",165000,21,1.546331e-07,2150000,2315000,2155000,2320000,"chr19",629089,9,26,19,54,"chr19",1,0.132911392405063
"21293","chr19.3375000.3380000","chr19.3400000.3405000",25000,52,2.658715e-10,3375000,3400000,3380000,3405000,"chr19",629092,1,7,8,16,"chr19",1,0.0975152367557431
"21294","chr19.35845000.35850000","chr19.35955000.35960000",110000,18,0.0005109813,35845000,35955000,35850000,35960000,"chr19",629120,1,11,12,24,"chr19",1,0.0506329113924051
"21295","chr19.50315000.50320000","chr19.50355000.50360000",40000,31,3.031599e-05,50315000,50355000,50320000,50360000,"chr19",629122,6,14,14,34,"chr19",1,0.123534927332396
"21296","chr19.40660000.40665000","chr19.40680000.40685000",20000,56,5.711427e-11,40660000,40680000,40665000,40685000,"chr19",629123,7,11,17,35,"chr19",1,0.229723394280356
"21297","chr19.48465000.48470000","chr19.48605000.48610000",140000,20,4.359916e-06,48465000,48605000,48470000,48610000,"chr19",629125,0,7,5,12,"chr19",1,0.0281293952180028
"21298","chr19.49330000.49335000","chr19.49485000.49490000",155000,15,0.001528694,49330000,49485000,49335000,49490000,"chr19",629134,7,23,31,61,"chr19",1,0.107243319268636
"21299","chr19.18060000.18065000","chr19.18105000.18110000",45000,31,5.493383e-06,18060000,18105000,18065000,18110000,"chr19",629140,5,15,17,37,"chr19",1,0.134435067979372
"21300","chr19.36490000.36495000","chr19.36605000.36610000",115000,24,8.835185e-08,36490000,36605000,36495000,36610000,"chr19",629141,0,6,2,8,"chr19",1,0.0225035161744023
"21301","chr19.2455000.2460000","chr19.2630000.2635000",175000,15,0.0006228664,2455000,2630000,2460000,2635000,"chr19",629146,4,4,8,16,"chr19",1,0.0281293952180028
"21302","chr19.6735000.6740000","chr19.6860000.6865000",125000,41,2.021069e-22,6735000,6860000,6740000,6865000,"chr19",629151,2,4,10,16,"chr19",1,0.0768870135958744
"21303","chr19.57900000.57905000","chr19.58330000.58335000",430000,9,0.005992947,57900000,58330000,57905000,58335000,"chr19",629154,0,0,7,7,"chr19",1,0.00738396624472574
"21304","chr19.47695000.47700000","chr19.47715000.47720000",20000,39,0.0005824433,47695000,47715000,47700000,47720000,"chr19",629159,1,11,3,15,"chr19",1,0.0685654008438819
"21305","chr19.49150000.49155000","chr19.49485000.49490000",335000,11,0.001358109,49150000,49485000,49155000,49490000,"chr19",629166,0,2,4,6,"chr19",1,0.00773558368495077
"21306","chr19.38000000.38005000","chr19.38220000.38225000",220000,12,0.005163818,3.8e+07,38220000,38005000,38225000,"chr19",629167,4,4,7,15,"chr19",1,0.0210970464135021
"21307","chr19.2460000.2465000","chr19.2630000.2635000",170000,17,5.300745e-05,2460000,2630000,2465000,2635000,"chr19",629178,4,4,8,16,"chr19",1,0.0318799812470699
"21308","chr19.17700000.17705000","chr19.17930000.17935000",230000,13,0.001066595,17700000,17930000,17705000,17935000,"chr19",629204,6,14,19,39,"chr19",1,0.0594233473980309
"21309","chr19.38945000.38950000","chr19.39445000.39450000",500000,9,0.002453548,38945000,39445000,38950000,39450000,"chr19",629205,7,24,26,57,"chr19",1,0.060126582278481
"21310","chr19.10760000.10765000","chr19.10810000.10815000",50000,24,0.00185032,10760000,10810000,10765000,10815000,"chr19",629210,2,9,6,17,"chr19",1,0.0478199718706048
"21311","chr19.38090000.38095000","chr19.38205000.38210000",115000,19,0.0001017501,38090000,38205000,38095000,38210000,"chr19",629220,2,8,5,15,"chr19",1,0.0334036568213783
"21312","chr19.920000.925000","chr19.1040000.1045000",120000,15,0.00740459,920000,1040000,925000,1045000,"chr19",629234,0,2,2,4,"chr19",1,0.0070323488045007
"21313","chr19.47425000.47430000","chr19.47490000.47495000",65000,25,3.1669e-05,47425000,47490000,47430000,47495000,"chr19",629239,0,3,0,3,"chr19",1,0.00879043600562588
"21314","chr19.49150000.49155000","chr19.49330000.49335000",180000,18,6.905772e-06,49150000,49330000,49155000,49335000,"chr19",629253,0,2,4,6,"chr19",1,0.0126582278481013
"21315","chr19.39345000.39350000","chr19.39390000.39395000",45000,31,5.493383e-06,39345000,39390000,39350000,39395000,"chr19",629276,1,0,1,2,"chr19",1,0.00726676043131739
"21316","chr19.2150000.2155000","chr19.2275000.2280000",125000,20,1.27237e-05,2150000,2275000,2155000,2280000,"chr19",629301,4,16,19,39,"chr19",1,0.0914205344585091
"21317","chr19.5305000.5310000","chr19.5340000.5345000",35000,37,6.061632e-07,5305000,5340000,5310000,5345000,"chr19",629311,5,13,16,34,"chr19",1,0.147444913267698
"21318","chr19.4800000.4805000","chr19.4905000.4910000",105000,17,0.002216849,4800000,4905000,4805000,4910000,"chr19",629319,4,18,16,38,"chr19",1,0.0757149554617909
"21319","chr19.12830000.12835000","chr19.12910000.12915000",80000,21,0.000285034,12830000,12910000,12835000,12915000,"chr19",629326,2,5,1,8,"chr19",1,0.019690576652602
"21320","chr19.47600000.47605000","chr19.47740000.47745000",140000,17,0.0002705186,47600000,47740000,47605000,47745000,"chr19",629332,7,13,14,34,"chr19",1,0.0677449601500234
"21321","chr19.3335000.3340000","chr19.3425000.3430000",90000,20,0.000285034,3335000,3425000,3340000,3430000,"chr19",629340,4,5,20,29,"chr19",1,0.0679793717768401
"21322","chr19.39140000.39145000","chr19.39345000.39350000",205000,13,0.00243611,39140000,39345000,39145000,39350000,"chr19",629344,1,0,1,2,"chr19",1,0.00304735114861697
"21323","chr19.18110000.18115000","chr19.18275000.18280000",165000,13,0.009962913,18110000,18275000,18115000,18280000,"chr19",629352,5,21,22,48,"chr19",1,0.0731364275668073
"21324","chr19.17265000.17270000","chr19.17290000.17295000",25000,35,0.002234426,17265000,17290000,17270000,17295000,"chr19",629355,9,26,26,61,"chr19",1,0.250234411626817
"21325","chr19.2645000.2650000","chr19.2695000.2700000",50000,23,0.004395035,2645000,2695000,2650000,2700000,"chr19",629358,1,14,4,19,"chr19",1,0.0512189404594468
"21326","chr19.3340000.3345000","chr19.3425000.3430000",85000,29,3.022359e-09,3340000,3425000,3345000,3430000,"chr19",629363,7,22,20,49,"chr19",1,0.166549460853258
"21327","chr19.7095000.7100000","chr19.7550000.7555000",455000,9,0.004395035,7095000,7550000,7100000,7555000,"chr19",629372,2,8,4,14,"chr19",1,0.0147679324894515
"21328","chr19.13280000.13285000","chr19.13835000.13840000",555000,9,0.001260546,13280000,13835000,13285000,13840000,"chr19",629379,3,7,5,15,"chr19",1,0.0158227848101266
"21329","chr19.1865000.1870000","chr19.1895000.1900000",30000,40,8.194104e-07,1865000,1895000,1870000,1900000,"chr19",629390,14,29,17,60,"chr19",1,0.281293952180028
"21330","chr19.4815000.4820000","chr19.5575000.5580000",760000,7,0.006173938,4815000,5575000,4820000,5580000,"chr19",629401,5,12,12,29,"chr19",1,0.023792780121894
"21331","chr19.4870000.4875000","chr19.4905000.4910000",35000,51,9.724699e-15,4870000,4905000,4875000,4910000,"chr19",629412,4,31,16,51,"chr19",1,0.304852320675105
"21332","chr19.38000000.38005000","chr19.38140000.38145000",140000,15,0.002948886,3.8e+07,38140000,38005000,38145000,"chr19",629424,1,6,2,9,"chr19",1,0.0158227848101266
"21333","chr19.15430000.15435000","chr19.16280000.16285000",850000,7,0.003433602,15430000,16280000,15435000,16285000,"chr19",629427,1,4,12,17,"chr19",1,0.0139474917955931
"21334","chr19.12845000.12850000","chr19.12885000.12890000",40000,26,0.002907628,12845000,12885000,12850000,12890000,"chr19",629435,13,22,20,55,"chr19",1,0.167604313173933
"21335","chr19.12780000.12785000","chr19.12805000.12810000",25000,34,0.004460775,12780000,12805000,12785000,12810000,"chr19",629442,8,5,24,37,"chr19",1,0.147444913267698
"21336","chr19.10610000.10615000","chr19.10760000.10765000",150000,20,2.199475e-06,10610000,10760000,10615000,10765000,"chr19",629449,9,12,15,36,"chr19",1,0.0843881856540084
"21337","chr19.45420000.45425000","chr19.45450000.45455000",30000,32,0.001187867,45420000,45450000,45425000,45455000,"chr19",629495,3,17,14,34,"chr19",1,0.127519924988279
"21338","chr19.13280000.13285000","chr19.13715000.13720000",435000,9,0.005591771,13280000,13715000,13285000,13720000,"chr19",629512,3,7,5,15,"chr19",1,0.0158227848101266
"21339","chr19.4260000.4265000","chr19.4350000.4355000",90000,18,0.002504067,4260000,4350000,4265000,4355000,"chr19",629514,5,26,25,56,"chr19",1,0.118143459915612
"21340","chr19.39105000.39110000","chr19.39380000.39385000",275000,12,0.001155268,39105000,39380000,39110000,39385000,"chr19",629520,1,0,2,3,"chr19",1,0.00421940928270042
"21341","chr19.4875000.4880000","chr19.4905000.4910000",30000,56,2.375454e-15,4875000,4905000,4880000,4910000,"chr19",629523,4,33,16,53,"chr19",1,0.347866854195968
"21342","chr19.48805000.48810000","chr19.48855000.48860000",50000,22,0.009804879,48805000,48855000,48810000,48860000,"chr19",629534,7,20,21,48,"chr19",1,0.123769338959212
"21343","chr19.2975000.2980000","chr19.3090000.3095000",115000,15,0.009573557,2975000,3090000,2980000,3095000,"chr19",629536,6,27,27,60,"chr19",1,0.105485232067511
"21344","chr19.13710000.13715000","chr19.13830000.13835000",120000,19,7.1299e-05,13710000,13830000,13715000,13835000,"chr19",629549,1,5,6,12,"chr19",1,0.0267229254571027
"21345","chr19.7495000.7500000","chr19.7550000.7555000",55000,32,8.081663e-08,7495000,7550000,7500000,7555000,"chr19",629564,2,8,13,23,"chr19",1,0.086263478668542
"21346","chr19.12670000.12675000","chr19.12775000.12780000",105000,16,0.00618472,12670000,12775000,12675000,12780000,"chr19",629574,4,18,18,40,"chr19",1,0.0750117205813408
"21347","chr19.56765000.56770000","chr19.56840000.56845000",75000,21,0.000539888,56765000,56840000,56770000,56845000,"chr19",629582,3,5,1,9,"chr19",1,0.0221518987341772
"21348","chr19.57190000.57195000","chr19.57735000.57740000",545000,9,0.001431292,57190000,57735000,57195000,57740000,"chr19",629584,0,2,2,4,"chr19",1,0.00421940928270042
"21349","chr19.5985000.5990000","chr19.6020000.6025000",35000,34,1.389882e-05,5985000,6020000,5990000,6025000,"chr19",629585,0,3,0,3,"chr19",1,0.0119549929676512
"21350","chr19.10835000.10840000","chr19.10910000.10915000",75000,24,1.737306e-05,10835000,10910000,10840000,10915000,"chr19",629607,1,5,13,19,"chr19",1,0.0534458509142053
"21351","chr19.2640000.2645000","chr19.2665000.2670000",25000,41,1.936096e-05,2640000,2665000,2645000,2670000,"chr19",629623,7,17,15,39,"chr19",1,0.187412095639944
"21352","chr19.10390000.10395000","chr19.10450000.10455000",60000,26,3.026438e-05,10390000,10450000,10395000,10455000,"chr19",629650,1,2,1,4,"chr19",1,0.0121894045944679
"21353","chr19.48265000.48270000","chr19.48290000.48295000",25000,143,5.073387e-80,48265000,48290000,48270000,48295000,"chr19",629681,0,24,11,35,"chr19",1,0.586615096108767
"21354","chr19.12780000.12785000","chr19.12845000.12850000",65000,27,2.903741e-06,12780000,12845000,12785000,12850000,"chr19",629686,8,5,26,39,"chr19",1,0.123417721518987
"21355","chr19.45350000.45355000","chr19.45450000.45455000",100000,17,0.003153897,45350000,45450000,45355000,45455000,"chr19",629704,3,4,9,16,"chr19",1,0.0318799812470699
"21356","chr19.12720000.12725000","chr19.12830000.12835000",110000,21,1.119592e-05,12720000,12830000,12725000,12835000,"chr19",629786,2,5,1,8,"chr19",1,0.019690576652602
"21357","chr19.18055000.18060000","chr19.18105000.18110000",50000,27,0.0001045479,18055000,18105000,18060000,18110000,"chr19",629808,4,15,12,31,"chr19",1,0.0981012658227848
"21358","chr19.53425000.53430000","chr19.53465000.53470000",40000,28,0.000539888,53425000,53465000,53430000,53470000,"chr19",629813,5,20,18,43,"chr19",1,0.141115799343647
"21359","chr19.4725000.4730000","chr19.4790000.4795000",65000,55,1.068246e-26,4725000,4790000,4730000,4795000,"chr19",629823,2,3,2,7,"chr19",1,0.0451242381622128
"21360","chr19.3375000.3380000","chr19.3435000.3440000",60000,31,6.339004e-08,3375000,3435000,3380000,3440000,"chr19",629853,9,36,39,84,"chr19",1,0.305203938115331
"21361","chr19.10450000.10455000","chr19.10500000.10505000",50000,23,0.004395035,10450000,10500000,10455000,10505000,"chr19",629879,1,2,1,4,"chr19",1,0.0107829348335677
"21362","chr19.11040000.11045000","chr19.11195000.11200000",155000,14,0.004800452,11040000,11195000,11045000,11200000,"chr19",629883,7,17,12,36,"chr19",1,0.0590717299578059
"21363","chr19.45175000.45180000","chr19.45325000.45330000",150000,16,0.0005709282,45175000,45325000,45180000,45330000,"chr19",629893,8,33,35,76,"chr19",1,0.142522269104548
"21364","chr19.7490000.7495000","chr19.7515000.7520000",25000,61,4.085071e-15,7490000,7515000,7495000,7520000,"chr19",629903,6,12,17,35,"chr19",1,0.250234411626817
"21365","chr19.17995000.18000000","chr19.18085000.18090000",90000,19,0.0008791889,17995000,18085000,1.8e+07,18090000,"chr19",629922,8,21,20,49,"chr19",1,0.109118612283169
"21366","chr19.39140000.39145000","chr19.39195000.39200000",55000,23,0.001807231,39140000,39195000,39145000,39200000,"chr19",629930,4,18,11,33,"chr19",1,0.0889592123769339
"21367","chr19.46945000.46950000","chr19.46975000.46980000",30000,31,0.002502255,46945000,46975000,46950000,46980000,"chr19",629935,0,2,1,3,"chr19",1,0.0109001406469761
"21368","chr19.8000000.8005000","chr19.8265000.8270000",265000,13,0.000350941,8e+06,8265000,8005000,8270000,"chr19",629952,4,8,12,24,"chr19",1,0.0365682137834037
"21369","chr19.2455000.2460000","chr19.2635000.2640000",180000,13,0.005869735,2455000,2635000,2460000,2640000,"chr19",629988,0,6,2,8,"chr19",1,0.0121894045944679
"21370","chr19.2820000.2825000","chr19.2945000.2950000",125000,15,0.005869735,2820000,2945000,2825000,2950000,"chr19",630001,2,11,12,25,"chr19",1,0.0439521800281294
"21371","chr19.2650000.2655000","chr19.2680000.2685000",30000,40,8.194104e-07,2650000,2680000,2655000,2685000,"chr19",630009,8,20,17,45,"chr19",1,0.210970464135021
"21372","chr19.39030000.39035000","chr19.39405000.39410000",375000,11,0.0006743265,39030000,39405000,39035000,39410000,"chr19",630016,1,9,7,17,"chr19",1,0.0219174871073605
"21373","chr19.45405000.45410000","chr19.45445000.45450000",40000,28,0.000539888,45405000,45445000,45410000,45450000,"chr19",630032,0,2,5,7,"chr19",1,0.0229723394280356
"21374","chr19.38070000.38075000","chr19.38210000.38215000",140000,14,0.00876904,38070000,38210000,38075000,38215000,"chr19",630077,7,13,24,44,"chr19",1,0.0721987810595406
"21375","chr19.2650000.2655000","chr19.2700000.2705000",50000,26,0.000284069,2650000,2700000,2655000,2705000,"chr19",630085,8,5,17,30,"chr19",1,0.0914205344585091
"21376","chr19.1895000.1900000","chr19.2055000.2060000",160000,17,9.232441e-05,1895000,2055000,1900000,2060000,"chr19",630091,1,11,9,21,"chr19",1,0.0418424753867792
"21377","chr19.12870000.12875000","chr19.12910000.12915000",40000,27,0.001267379,12870000,12910000,12875000,12915000,"chr19",630114,6,10,8,24,"chr19",1,0.0759493670886076
"21378","chr19.13880000.13885000","chr19.13970000.13975000",90000,24,1.890324e-06,13880000,13970000,13885000,13975000,"chr19",630123,4,1,2,7,"chr19",1,0.019690576652602
"21379","chr19.39140000.39145000","chr19.39340000.39345000",200000,14,0.0008147499,39140000,39340000,39145000,39345000,"chr19",630128,0,5,2,7,"chr19",1,0.0114861697140178
"21380","chr19.3375000.3380000","chr19.3405000.3410000",30000,48,9.092822e-11,3375000,3405000,3380000,3410000,"chr19",630149,10,30,33,73,"chr19",1,0.410689170182841
"21381","chr19.4115000.4120000","chr19.4200000.4205000",85000,18,0.003986847,4115000,4200000,4120000,4205000,"chr19",630155,8,34,33,75,"chr19",1,0.158227848101266
"21382","chr19.15380000.15385000","chr19.15430000.15435000",50000,25,0.0007428205,15380000,15430000,15385000,15435000,"chr19",630170,1,4,12,17,"chr19",1,0.0498124706985466
"21383","chr19.18450000.18455000","chr19.18470000.18475000",20000,39,0.0005824433,18450000,18470000,18455000,18475000,"chr19",630175,3,11,4,18,"chr19",1,0.0822784810126582
"21384","chr19.6425000.6430000","chr19.6505000.6510000",80000,23,2.813619e-05,6425000,6505000,6430000,6510000,"chr19",630177,9,15,31,55,"chr19",1,0.148265353961556
"21385","chr19.18635000.18640000","chr19.19030000.19035000",395000,10,0.002245043,18635000,19030000,18640000,19035000,"chr19",630180,3,17,22,42,"chr19",1,0.0492264416315049
"21386","chr19.36570000.36575000","chr19.36605000.36610000",35000,28,0.002907628,36570000,36605000,36575000,36610000,"chr19",630229,0,6,2,8,"chr19",1,0.0262541022034693
"21387","chr19.4790000.4795000","chr19.4905000.4910000",115000,18,0.000350699,4790000,4905000,4795000,4910000,"chr19",630233,2,3,2,7,"chr19",1,0.0147679324894515
"21388","chr19.3345000.3350000","chr19.3405000.3410000",60000,41,2.149932e-14,3345000,3405000,3350000,3410000,"chr19",630238,8,28,26,62,"chr19",1,0.297937177684013
"21389","chr19.7550000.7555000","chr19.7595000.7600000",45000,33,5.726783e-07,7550000,7595000,7555000,7600000,"chr19",630271,2,8,2,12,"chr19",1,0.0464135021097046
"21390","chr19.10380000.10385000","chr19.10405000.10410000",25000,45,4.702601e-07,10380000,10405000,10385000,10410000,"chr19",630290,13,37,33,83,"chr19",1,0.437763713080169
"21391","chr19.2960000.2965000","chr19.3075000.3080000",115000,34,2.221094e-15,2960000,3075000,2965000,3080000,"chr19",630313,10,34,30,74,"chr19",1,0.294889826535396
"21392","chr19.17965000.17970000","chr19.18105000.18110000",140000,16,0.0009326159,17965000,18105000,17970000,18110000,"chr19",630319,4,7,7,18,"chr19",1,0.0337552742616034
"21393","chr19.48835000.48840000","chr19.48855000.48860000",20000,53,1.561571e-09,48835000,48855000,48840000,48860000,"chr19",630326,1,3,3,7,"chr19",1,0.043483356774496
"21394","chr19.7500000.7505000","chr19.7550000.7555000",50000,28,3.705247e-05,7500000,7550000,7505000,7555000,"chr19",630339,2,8,13,23,"chr19",1,0.0754805438349742
"21395","chr19.10765000.10770000","chr19.10935000.10940000",170000,16,0.0002142958,10765000,10935000,10770000,10940000,"chr19",630360,4,1,7,12,"chr19",1,0.0225035161744023
"21396","chr19.36915000.36920000","chr19.36970000.36975000",55000,22,0.004393008,36915000,36970000,36920000,36975000,"chr19",630362,0,3,2,5,"chr19",1,0.012892639474918
"21397","chr19.38400000.38405000","chr19.38720000.38725000",320000,14,1.507973e-05,38400000,38720000,38405000,38725000,"chr19",630379,3,7,5,15,"chr19",1,0.0246132208157525
"21398","chr19.13380000.13385000","chr19.13830000.13835000",450000,14,6.373762e-07,13380000,13830000,13385000,13835000,"chr19",630380,1,5,7,13,"chr19",1,0.0213314580403188
"21399","chr19.3435000.3440000","chr19.3485000.3490000",50000,29,1.246676e-05,3435000,3485000,3440000,3490000,"chr19",630392,9,36,39,84,"chr19",1,0.285513361462729
"21400","chr19.12480000.12485000","chr19.12720000.12725000",240000,12,0.002907628,12480000,12720000,12485000,12725000,"chr19",630405,3,16,18,37,"chr19",1,0.0520393811533052
"21401","chr19.2650000.2655000","chr19.2675000.2680000",25000,47,6.227751e-08,2650000,2675000,2655000,2680000,"chr19",630411,3,7,4,14,"chr19",1,0.077121425222691
"21402","chr19.2235000.2240000","chr19.2380000.2385000",145000,21,6.889071e-07,2235000,2380000,2240000,2385000,"chr19",630433,10,22,23,55,"chr19",1,0.135372714486639
"21403","chr19.40330000.40335000","chr19.40500000.40505000",170000,14,0.002640458,40330000,40500000,40335000,40505000,"chr19",630455,8,20,20,48,"chr19",1,0.0787623066104079
"21404","chr19.13715000.13720000","chr19.13830000.13835000",115000,33,1.508338e-14,13715000,13830000,13720000,13835000,"chr19",630475,1,5,7,13,"chr19",1,0.05028129395218
"21405","chr19.2675000.2680000","chr19.2745000.2750000",70000,22,0.0003639768,2675000,2745000,2680000,2750000,"chr19",630483,3,7,4,14,"chr19",1,0.0360993905297703
"21406","chr19.47765000.47770000","chr19.48265000.48270000",500000,10,0.0004774819,47765000,48265000,47770000,48270000,"chr19",630487,4,14,8,26,"chr19",1,0.0304735114861697
"21407","chr19.39530000.39535000","chr19.39820000.39825000",290000,13,0.000176215,39530000,39820000,39535000,39825000,"chr19",630501,3,8,6,17,"chr19",1,0.0259024847632443
"21408","chr19.39035000.39040000","chr19.39435000.39440000",400000,9,0.008792529,39035000,39435000,39040000,39440000,"chr19",630512,3,34,13,50,"chr19",1,0.0527426160337553
"21409","chr19.2640000.2645000","chr19.2745000.2750000",105000,28,5.113242e-10,2640000,2745000,2645000,2750000,"chr19",630514,9,17,15,41,"chr19",1,0.13455227379278
"21410","chr19.10610000.10615000","chr19.10810000.10815000",200000,16,4.890691e-05,10610000,10810000,10615000,10815000,"chr19",630523,2,9,6,17,"chr19",1,0.0318799812470699
"21411","chr19.18685000.18690000","chr19.18930000.18935000",245000,11,0.008957819,18685000,18930000,18690000,18935000,"chr19",630528,7,20,24,51,"chr19",1,0.0657524613220816
"21412","chr19.18570000.18575000","chr19.18970000.18975000",400000,12,8.257753e-05,18570000,18970000,18575000,18975000,"chr19",630537,7,20,18,45,"chr19",1,0.0632911392405063
"21413","chr19.10915000.10920000","chr19.10935000.10940000",20000,47,7.035622e-07,10915000,10935000,10920000,10940000,"chr19",630542,10,11,16,37,"chr19",1,0.203820909517112
"21414","chr19.45090000.45095000","chr19.45140000.45145000",50000,23,0.004395035,45090000,45140000,45095000,45145000,"chr19",630562,1,12,11,24,"chr19",1,0.0646976090014065
"21415","chr19.49120000.49125000","chr19.49150000.49155000",30000,30,0.005134157,49120000,49150000,49125000,49155000,"chr19",630570,0,2,4,6,"chr19",1,0.0210970464135021
"21416","chr19.39535000.39540000","chr19.39820000.39825000",285000,27,9.379899e-17,39535000,39820000,39540000,39825000,"chr19",630623,3,8,6,17,"chr19",1,0.0537974683544304
"21417","chr19.2950000.2955000","chr19.3060000.3065000",110000,20,4.226484e-05,2950000,3060000,2955000,3065000,"chr19",630625,1,11,12,24,"chr19",1,0.0562587904360056
"21418","chr19.12670000.12675000","chr19.12720000.12725000",50000,29,1.246676e-05,12670000,12720000,12675000,12725000,"chr19",630633,3,18,18,39,"chr19",1,0.132559774964838
"21419","chr19.14005000.14010000","chr19.14145000.14150000",140000,14,0.00876904,14005000,14145000,14010000,14150000,"chr19",630639,0,5,6,11,"chr19",1,0.0180496952648851
"21420","chr19.4670000.4675000","chr19.4725000.4730000",55000,22,0.004393008,4670000,4725000,4675000,4730000,"chr19",630642,12,48,56,116,"chr19",1,0.299109235818097
"21421","chr19.10765000.10770000","chr19.10835000.10840000",70000,19,0.006892072,10765000,10835000,10770000,10840000,"chr19",630657,4,1,7,12,"chr19",1,0.0267229254571027
"21422","chr19.13425000.13430000","chr19.13665000.13670000",240000,14,0.0001816006,13425000,13665000,13430000,13670000,"chr19",630668,0,10,9,19,"chr19",1,0.0311767463666198
"21423","chr19.5030000.5035000","chr19.5575000.5580000",545000,8,0.007018374,5030000,5575000,5035000,5580000,"chr19",630673,6,11,14,31,"chr19",1,0.0290670417252696
"21424","chr19.10625000.10630000","chr19.10765000.10770000",140000,14,0.00876904,10625000,10765000,10630000,10770000,"chr19",630679,4,1,7,12,"chr19",1,0.019690576652602
"21425","chr19.11985000.11990000","chr19.12155000.12160000",170000,13,0.008398178,11985000,12155000,11990000,12160000,"chr19",630701,7,8,13,28,"chr19",1,0.0426629160806376
"21426","chr19.18590000.18595000","chr19.18610000.18615000",20000,38,0.001201054,18590000,18610000,18595000,18615000,"chr19",630705,0,3,0,3,"chr19",1,0.0133614627285513
"21427","chr19.4910000.4915000","chr19.4975000.4980000",65000,21,0.002127914,4910000,4975000,4915000,4980000,"chr19",630758,2,6,6,14,"chr19",1,0.0344585091420534
"21428","chr19.1885000.1890000","chr19.2065000.2070000",180000,13,0.005869735,1885000,2065000,1890000,2070000,"chr19",630769,9,35,41,85,"chr19",1,0.129512423816221
"21429","chr19.13715000.13720000","chr19.13835000.13840000",120000,17,0.0008392628,13715000,13835000,13720000,13840000,"chr19",630770,8,26,23,57,"chr19",1,0.113572433192686
"21430","chr19.3760000.3765000","chr19.4180000.4185000",420000,14,1.28244e-06,3760000,4180000,3765000,4185000,"chr19",630771,1,16,11,28,"chr19",1,0.0459446788560713
"21431","chr19.50315000.50320000","chr19.50380000.50385000",65000,54,7.964921e-26,50315000,50380000,50320000,50385000,"chr19",630793,2,3,4,9,"chr19",1,0.0569620253164557
"21432","chr19.17465000.17470000","chr19.17505000.17510000",40000,27,0.001267379,17465000,17505000,17470000,17510000,"chr19",630799,2,15,5,22,"chr19",1,0.069620253164557
"21433","chr19.10305000.10310000","chr19.10330000.10335000",25000,37,0.0005281227,10305000,10330000,10310000,10335000,"chr19",630804,2,7,2,11,"chr19",1,0.0477027660571964
"21434","chr19.13830000.13835000","chr19.13965000.13970000",135000,21,1.43396e-06,13830000,13965000,13835000,13970000,"chr19",630805,1,5,7,13,"chr19",1,0.0319971870604782
"21435","chr19.3985000.3990000","chr19.4140000.4145000",155000,27,9.066651e-12,3985000,4140000,3990000,4145000,"chr19",630811,4,14,13,31,"chr19",1,0.0981012658227848
"21436","chr19.46635000.46640000","chr19.46660000.46665000",25000,33,0.008466812,46635000,46660000,46640000,46665000,"chr19",630812,1,4,2,7,"chr19",1,0.0270745428973277
"21437","chr19.48925000.48930000","chr19.49085000.49090000",160000,18,2.247732e-05,48925000,49085000,48930000,49090000,"chr19",630828,8,33,31,72,"chr19",1,0.151898734177215
"21438","chr19.6360000.6365000","chr19.6390000.6395000",30000,30,0.005134157,6360000,6390000,6365000,6395000,"chr19",630859,8,13,15,36,"chr19",1,0.126582278481013
"21439","chr19.46525000.46530000","chr19.46575000.46580000",50000,64,6.298936e-30,46525000,46575000,46530000,46580000,"chr19",630861,0,4,2,6,"chr19",1,0.0450070323488045
"21440","chr19.5910000.5915000","chr19.5945000.5950000",35000,37,6.061632e-07,5910000,5945000,5915000,5950000,"chr19",630873,0,2,3,5,"chr19",1,0.0216830754805438
"21441","chr19.11490000.11495000","chr19.11585000.11590000",95000,29,4.9651e-10,11490000,11585000,11495000,11590000,"chr19",630878,6,15,14,35,"chr19",1,0.11896390060947
"21442","chr19.48145000.48150000","chr19.48170000.48175000",25000,37,0.0005281227,48145000,48170000,48150000,48175000,"chr19",630886,4,13,8,25,"chr19",1,0.108415377402719
"21443","chr19.46525000.46530000","chr19.46755000.46760000",230000,13,0.001066595,46525000,46755000,46530000,46760000,"chr19",630889,0,4,2,6,"chr19",1,0.00914205344585091
"21444","chr19.2235000.2240000","chr19.2275000.2280000",40000,52,2.412494e-17,2235000,2275000,2240000,2280000,"chr19",630894,4,16,23,43,"chr19",1,0.26207219878106
"21445","chr19.18220000.18225000","chr19.18275000.18280000",55000,28,1.055327e-05,18220000,18275000,18225000,18280000,"chr19",630895,4,15,20,39,"chr19",1,0.127988748241913
"21446","chr19.38720000.38725000","chr19.38890000.38895000",170000,14,0.002640458,38720000,38890000,38725000,38895000,"chr19",630935,3,7,5,15,"chr19",1,0.0246132208157525
"21447","chr19.10600000.10605000","chr19.10640000.10645000",40000,26,0.002907628,10600000,10640000,10605000,10645000,"chr19",630984,6,10,6,22,"chr19",1,0.0670417252695734
"21448","chr19.11455000.11460000","chr19.11495000.11500000",40000,29,0.0002149935,11455000,11495000,11460000,11500000,"chr19",630987,13,29,12,54,"chr19",1,0.183544303797468
"21449","chr19.13745000.13750000","chr19.14555000.14560000",810000,7,0.004490786,13745000,14555000,13750000,14560000,"chr19",631001,2,19,17,38,"chr19",1,0.0311767463666198
"21450","chr19.1995000.2000000","chr19.2280000.2285000",285000,11,0.00363026,1995000,2280000,2e+06,2285000,"chr19",631005,7,28,24,59,"chr19",1,0.0760665729020159
"21451","chr19.19145000.19150000","chr19.19300000.19305000",155000,15,0.001528694,19145000,19300000,19150000,19305000,"chr19",631008,0,7,2,9,"chr19",1,0.0158227848101266
"21452","chr19.38635000.38640000","chr19.38655000.38660000",20000,40,0.0002766033,38635000,38655000,38640000,38660000,"chr19",631052,7,24,18,49,"chr19",1,0.229723394280356
"21453","chr19.1275000.1280000","chr19.1380000.1385000",105000,26,1.280054e-08,1275000,1380000,1280000,1385000,"chr19",631053,2,20,10,32,"chr19",1,0.0975152367557431
"21454","chr19.18590000.18595000","chr19.18965000.18970000",375000,13,2.390018e-05,18590000,18965000,18595000,18970000,"chr19",631075,5,20,13,38,"chr19",1,0.0578996718237225
"21455","chr19.35610000.35615000","chr19.36150000.36155000",540000,8,0.00740459,35610000,36150000,35615000,36155000,"chr19",631091,5,16,12,33,"chr19",1,0.0309423347398031
"21456","chr19.45520000.45525000","chr19.45550000.45555000",30000,46,1.011621e-09,45520000,45550000,45525000,45555000,"chr19",631097,5,14,6,25,"chr19",1,0.134786685419597
"21457","chr19.53945000.53950000","chr19.53980000.53985000",35000,55,2.503573e-17,53945000,53980000,53950000,53985000,"chr19",631115,1,1,0,2,"chr19",1,0.012892639474918
"21458","chr19.1905000.1910000","chr19.2060000.2065000",155000,15,0.001528694,1905000,2060000,1910000,2065000,"chr19",631126,8,31,22,61,"chr19",1,0.107243319268636
"21459","chr19.17235000.17240000","chr19.17265000.17270000",30000,31,0.002502255,17235000,17265000,17240000,17270000,"chr19",631134,7,32,37,76,"chr19",1,0.276136896390061
"21460","chr19.38720000.38725000","chr19.38830000.38835000",110000,19,0.0001512444,38720000,38830000,38725000,38835000,"chr19",631148,3,7,5,15,"chr19",1,0.0334036568213783
"21461","chr19.4375000.4380000","chr19.4395000.4400000",20000,66,2.698799e-16,4375000,4395000,4380000,4400000,"chr19",631170,2,6,3,11,"chr19",1,0.0850914205344585
"21462","chr19.17215000.17220000","chr19.17290000.17295000",75000,20,0.001506047,17215000,17290000,17220000,17295000,"chr19",631172,3,19,16,38,"chr19",1,0.0890764181903422
"21463","chr19.47715000.47720000","chr19.47750000.47755000",35000,48,6.706107e-13,47715000,47750000,47720000,47755000,"chr19",631178,1,5,3,9,"chr19",1,0.0506329113924051
"21464","chr19.43460000.43465000","chr19.43615000.43620000",155000,14,0.004800452,43460000,43615000,43465000,43620000,"chr19",631180,7,11,11,29,"chr19",1,0.0475855602437881
"21465","chr19.40640000.40645000","chr19.40810000.40815000",170000,27,1.992133e-12,40640000,40810000,40645000,40815000,"chr19",631196,5,6,9,20,"chr19",1,0.0632911392405063
"21466","chr19.37310000.37315000","chr19.38140000.38145000",830000,8,0.0005932786,37310000,38140000,37315000,38145000,"chr19",631206,1,6,2,9,"chr19",1,0.00843881856540084
"21467","chr19.48120000.48125000","chr19.48200000.48205000",80000,22,9.341776e-05,48120000,48200000,48125000,48205000,"chr19",631207,2,10,7,19,"chr19",1,0.0489920300046882
"21468","chr19.2455000.2460000","chr19.2610000.2615000",155000,18,3.026438e-05,2455000,2610000,2460000,2615000,"chr19",631212,7,18,20,45,"chr19",1,0.0949367088607595
"21469","chr19.38145000.38150000","chr19.38205000.38210000",60000,25,9.196901e-05,38145000,38205000,38150000,38210000,"chr19",631225,2,8,5,15,"chr19",1,0.0439521800281294
"21470","chr19.13300000.13305000","chr19.13970000.13975000",670000,8,0.002186832,13300000,13970000,13305000,13975000,"chr19",631230,5,10,7,22,"chr19",1,0.0206282231598687
"21471","chr19.6460000.6465000","chr19.6735000.6740000",275000,17,3.124221e-07,6460000,6735000,6465000,6740000,"chr19",631236,2,4,10,16,"chr19",1,0.0318799812470699
"21472","chr19.2460000.2465000","chr19.2610000.2615000",150000,28,2.331201e-12,2460000,2610000,2465000,2615000,"chr19",631240,7,18,16,41,"chr19",1,0.13455227379278
"21473","chr19.39100000.39105000","chr19.39405000.39410000",305000,10,0.009134932,39100000,39405000,39105000,39410000,"chr19",631242,2,9,7,18,"chr19",1,0.0210970464135021
"21474","chr19.39030000.39035000","chr19.39110000.39115000",80000,20,0.000850976,39030000,39110000,39035000,39115000,"chr19",631257,1,8,2,11,"chr19",1,0.0257852789498359
"21475","chr19.10810000.10815000","chr19.10910000.10915000",100000,17,0.003153897,10810000,10910000,10815000,10915000,"chr19",631263,1,9,6,16,"chr19",1,0.0318799812470699
"21476","chr19.46785000.46790000","chr19.46895000.46900000",110000,17,0.00157089,46785000,46895000,46790000,46900000,"chr19",631284,1,12,8,21,"chr19",1,0.0418424753867792
"21477","chr19.47410000.47415000","chr19.47435000.47440000",25000,54,2.583903e-11,47410000,47435000,47415000,47440000,"chr19",631293,4,16,18,38,"chr19",1,0.240506329113924
"21478","chr19.18710000.18715000","chr19.18965000.18970000",255000,13,0.0004852181,18710000,18965000,18715000,18970000,"chr19",631303,3,7,2,12,"chr19",1,0.0182841068917018
"21479","chr19.11495000.11500000","chr19.11530000.11535000",35000,30,0.0005709282,11495000,11530000,11500000,11535000,"chr19",631343,9,28,12,49,"chr19",1,0.172292545710267
"21480","chr19.2095000.2100000","chr19.2150000.2155000",55000,22,0.004393008,2095000,2150000,2100000,2155000,"chr19",631351,0,4,1,5,"chr19",1,0.012892639474918
"21481","chr19.5900000.5905000","chr19.5975000.5980000",75000,22,0.00018093,5900000,5975000,5905000,5980000,"chr19",631353,2,7,8,17,"chr19",1,0.0438349742147211
"21482","chr19.16825000.16830000","chr19.17345000.17350000",520000,8,0.009134932,16825000,17345000,16830000,17350000,"chr19",631354,9,26,25,60,"chr19",1,0.0562587904360056
"21483","chr19.40640000.40645000","chr19.40670000.40675000",30000,38,6.029156e-06,40640000,40670000,40645000,40675000,"chr19",631402,3,6,8,17,"chr19",1,0.0757149554617909
"21484","chr19.47435000.47440000","chr19.47470000.47475000",35000,30,0.0005709282,47435000,47470000,47440000,47475000,"chr19",631411,4,16,18,38,"chr19",1,0.133614627285513
"21485","chr19.6460000.6465000","chr19.6515000.6520000",55000,27,3.180048e-05,6460000,6515000,6465000,6520000,"chr19",631421,3,29,11,43,"chr19",1,0.136075949367089
"21486","chr19.41215000.41220000","chr19.41325000.41330000",110000,21,1.119592e-05,41215000,41325000,41220000,41330000,"chr19",631438,4,15,7,26,"chr19",1,0.0639943741209564
"21487","chr19.9765000.9770000","chr19.9880000.9885000",115000,19,0.0001017501,9765000,9880000,9770000,9885000,"chr19",631448,9,23,32,64,"chr19",1,0.142522269104548
"21488","chr19.7095000.7100000","chr19.7625000.7630000",530000,10,0.0003034129,7095000,7625000,7100000,7630000,"chr19",631457,0,2,0,2,"chr19",1,0.0023441162681669
"21489","chr19.11560000.11565000","chr19.11585000.11590000",25000,49,7.434461e-09,11560000,11585000,11565000,11590000,"chr19",631465,11,15,18,44,"chr19",1,0.252695733708392
"21490","chr19.13965000.13970000","chr19.14180000.14185000",215000,16,2.452079e-05,13965000,14180000,13970000,14185000,"chr19",631477,2,7,7,16,"chr19",1,0.0300046882325363
"21491","chr19.1020000.1025000","chr19.1095000.1100000",75000,38,1.329624e-14,1020000,1095000,1025000,1100000,"chr19",631478,8,15,15,38,"chr19",1,0.16924519456165
"21492","chr19.4400000.4405000","chr19.4470000.4475000",70000,24,3.972185e-05,4400000,4470000,4405000,4475000,"chr19",631485,0,7,7,14,"chr19",1,0.0393811533052039
"21493","chr19.38645000.38650000","chr19.38700000.38705000",55000,21,0.009962913,38645000,38700000,38650000,38705000,"chr19",631488,1,3,1,5,"chr19",1,0.0123066104078762
"21494","chr19.45075000.45080000","chr19.45150000.45155000",75000,22,0.00018093,45075000,45150000,45080000,45155000,"chr19",631516,1,1,2,4,"chr19",1,0.0103141115799344
"21495","chr19.2960000.2965000","chr19.3210000.3215000",250000,17,9.386077e-07,2960000,3210000,2965000,3215000,"chr19",631525,9,35,24,68,"chr19",1,0.135489920300047
"21496","chr19.4730000.4735000","chr19.4800000.4805000",70000,28,2.601012e-07,4730000,4800000,4735000,4805000,"chr19",631526,2,15,14,31,"chr19",1,0.101734646038444
"21497","chr19.40660000.40665000","chr19.40700000.40705000",40000,36,1.228095e-07,40660000,40700000,40665000,40705000,"chr19",631528,4,2,6,12,"chr19",1,0.0506329113924051
"21498","chr19.7485000.7490000","chr19.7515000.7520000",30000,59,3.272481e-17,7485000,7515000,7490000,7520000,"chr19",631542,6,12,17,35,"chr19",1,0.242030004688233
"21499","chr19.1895000.1900000","chr19.2070000.2075000",175000,16,0.0001658877,1895000,2070000,1900000,2075000,"chr19",631548,6,39,33,78,"chr19",1,0.146272855133615
"21500","chr19.48835000.48840000","chr19.48870000.48875000",35000,32,9.632462e-05,48835000,48870000,48840000,48875000,"chr19",631549,1,3,3,7,"chr19",1,0.0262541022034693
"21501","chr19.38895000.38900000","chr19.39140000.39145000",245000,11,0.008957819,38895000,39140000,38900000,39145000,"chr19",631554,10,22,21,53,"chr19",1,0.0683309892170652
"21502","chr19.9405000.9410000","chr19.9670000.9675000",265000,11,0.005588291,9405000,9670000,9410000,9675000,"chr19",631567,4,9,7,20,"chr19",1,0.0257852789498359
"21503","chr19.3325000.3330000","chr19.3440000.3445000",115000,16,0.003423039,3325000,3440000,3330000,3445000,"chr19",631573,5,11,11,27,"chr19",1,0.0506329113924051
"21504","chr19.52170000.52175000","chr19.52185000.52190000",15000,36,0.004609976,52170000,52185000,52175000,52190000,"chr19",631580,4,24,22,50,"chr19",1,0.210970464135021
"21505","chr19.11090000.11095000","chr19.11195000.11200000",105000,22,4.666449e-06,11090000,11195000,11095000,11200000,"chr19",631585,8,17,12,37,"chr19",1,0.0954055321143929
"21506","chr19.2460000.2465000","chr19.2645000.2650000",185000,16,0.000100971,2460000,2645000,2465000,2650000,"chr19",631586,9,24,16,49,"chr19",1,0.0918893577121425
"21507","chr19.38205000.38210000","chr19.38265000.38270000",60000,27,9.571974e-06,38205000,38265000,38210000,38270000,"chr19",631593,2,8,5,15,"chr19",1,0.0474683544303797
"21508","chr19.3985000.3990000","chr19.4185000.4190000",200000,27,1.059333e-13,3985000,4185000,3990000,4190000,"chr19",631608,4,14,13,31,"chr19",1,0.0981012658227848
"21509","chr19.39465000.39470000","chr19.39540000.39545000",75000,20,0.001506047,39465000,39540000,39470000,39545000,"chr19",631636,3,6,7,16,"chr19",1,0.0375058602906704
"21510","chr19.46495000.46500000","chr19.47045000.47050000",550000,13,5.980453e-07,46495000,47045000,46500000,47050000,"chr19",631637,4,12,8,24,"chr19",1,0.0365682137834037
"21511","chr19.18680000.18685000","chr19.18970000.18975000",290000,11,0.003247526,18680000,18970000,18685000,18975000,"chr19",631645,5,23,15,43,"chr19",1,0.0554383497421472
"21512","chr19.47715000.47720000","chr19.47740000.47745000",25000,38,0.0002399242,47715000,47740000,47720000,47745000,"chr19",631665,1,11,3,15,"chr19",1,0.0668073136427567
"21513","chr19.35645000.35650000","chr19.36170000.36175000",525000,8,0.008633885,35645000,36170000,35650000,36175000,"chr19",631667,11,26,16,53,"chr19",1,0.0496952648851383
"21514","chr19.47265000.47270000","chr19.47315000.47320000",50000,23,0.004395035,47265000,47315000,47270000,47320000,"chr19",631669,10,16,27,53,"chr19",1,0.142873886544773
"21515","chr19.2160000.2165000","chr19.2315000.2320000",155000,19,7.062564e-06,2160000,2315000,2165000,2320000,"chr19",631686,6,25,14,45,"chr19",1,0.100210970464135
"21516","chr19.47710000.47715000","chr19.47740000.47745000",30000,33,0.000539888,47710000,47740000,47715000,47745000,"chr19",631711,9,13,14,36,"chr19",1,0.139240506329114
"21517","chr19.43950000.43955000","chr19.44025000.44030000",75000,59,9.241089e-33,43950000,44025000,43955000,44030000,"chr19",631716,0,4,3,7,"chr19",1,0.0484060009376465
"21518","chr19.12830000.12835000","chr19.12870000.12875000",40000,25,0.006352757,12830000,12870000,12835000,12875000,"chr19",631731,2,5,1,8,"chr19",1,0.023441162681669
"21519","chr19.13985000.13990000","chr19.14180000.14185000",195000,25,9.598008e-12,13985000,14180000,13990000,14185000,"chr19",631733,1,16,10,27,"chr19",1,0.0791139240506329
"21520","chr19.6425000.6430000","chr19.6460000.6465000",35000,37,6.061632e-07,6425000,6460000,6430000,6465000,"chr19",631757,9,15,27,51,"chr19",1,0.221167369901547
"21521","chr19.10025000.10030000","chr19.10135000.10140000",110000,18,0.0005109813,10025000,10135000,10030000,10140000,"chr19",631758,1,15,25,41,"chr19",1,0.0864978902953586
"21522","chr19.2540000.2545000","chr19.2625000.2630000",85000,19,0.001440986,2540000,2625000,2545000,2630000,"chr19",631762,6,4,10,20,"chr19",1,0.0445382090951711
"21523","chr19.38400000.38405000","chr19.38545000.38550000",145000,18,5.442317e-05,38400000,38545000,38405000,38550000,"chr19",631773,7,13,7,27,"chr19",1,0.0569620253164557
"21524","chr19.9765000.9770000","chr19.9885000.9890000",120000,21,4.618767e-06,9765000,9885000,9770000,9890000,"chr19",631801,6,13,19,38,"chr19",1,0.0935302390998594
"21525","chr19.46575000.46580000","chr19.46695000.46700000",120000,20,1.859648e-05,46575000,46695000,46580000,46700000,"chr19",631832,6,17,14,37,"chr19",1,0.0867323019221753
"21526","chr19.2155000.2160000","chr19.2275000.2280000",120000,29,1.14483e-11,2155000,2275000,2160000,2280000,"chr19",631833,4,16,24,44,"chr19",1,0.149554617909048
"21527","chr19.7095000.7100000","chr19.8005000.8010000",910000,9,3.608169e-05,7095000,8005000,7100000,8010000,"chr19",631836,3,15,4,22,"chr19",1,0.0232067510548523
"21528","chr19.3395000.3400000","chr19.3435000.3440000",40000,35,3.975541e-07,3395000,3435000,3400000,3440000,"chr19",631852,9,26,22,57,"chr19",1,0.233825597749648
"21529","chr19.11240000.11245000","chr19.11670000.11675000",430000,9,0.005992947,11240000,11670000,11245000,11675000,"chr19",631856,0,9,11,20,"chr19",1,0.0210970464135021
"21530","chr19.18100000.18105000","chr19.18155000.18160000",55000,21,0.009962913,18100000,18155000,18105000,18160000,"chr19",631863,6,37,33,76,"chr19",1,0.187060478199719
"21531","chr19.2475000.2480000","chr19.2600000.2605000",125000,24,3.198137e-08,2475000,2600000,2480000,2605000,"chr19",631933,1,1,1,3,"chr19",1,0.00843881856540084
"21532","chr19.18570000.18575000","chr19.18680000.18685000",110000,18,0.0005109813,18570000,18680000,18575000,18685000,"chr19",631937,5,20,15,40,"chr19",1,0.0843881856540084
"21533","chr19.3985000.3990000","chr19.4205000.4210000",220000,16,1.917252e-05,3985000,4205000,3990000,4210000,"chr19",631957,4,14,13,31,"chr19",1,0.0581340834505391
"21534","chr19.1330000.1335000","chr19.1350000.1355000",20000,48,2.655985e-07,1330000,1350000,1335000,1355000,"chr19",631960,7,34,25,66,"chr19",1,0.371308016877637
"21535","chr19.45305000.45310000","chr19.45325000.45330000",20000,38,0.001201054,45305000,45325000,45310000,45330000,"chr19",631986,1,6,7,14,"chr19",1,0.0623534927332396
"21536","chr19.2685000.2690000","chr19.2740000.2745000",55000,23,0.001807231,2685000,2740000,2690000,2745000,"chr19",632006,6,15,18,39,"chr19",1,0.105133614627286
"21537","chr19.43935000.43940000","chr19.44025000.44030000",90000,19,0.0008791889,43935000,44025000,43940000,44030000,"chr19",632026,0,3,3,6,"chr19",1,0.0133614627285513
"21538","chr19.1605000.1610000","chr19.1845000.1850000",240000,12,0.002907628,1605000,1845000,1610000,1850000,"chr19",632041,6,12,14,32,"chr19",1,0.0450070323488045
"21539","chr19.38890000.38895000","chr19.39035000.39040000",145000,20,3.101369e-06,38890000,39035000,38895000,39040000,"chr19",632046,6,16,11,33,"chr19",1,0.0773558368495077
"21540","chr19.19775000.19780000","chr19.19930000.19935000",155000,18,3.026438e-05,19775000,19930000,19780000,19935000,"chr19",632073,0,6,4,10,"chr19",1,0.0210970464135021
"21541","chr19.18055000.18060000","chr19.18110000.18115000",55000,34,5.581861e-09,18055000,18110000,18060000,18115000,"chr19",632082,4,15,12,31,"chr19",1,0.123534927332396
"21542","chr19.36150000.36155000","chr19.36170000.36175000",20000,42,5.727509e-05,36150000,36170000,36155000,36175000,"chr19",632089,5,24,12,41,"chr19",1,0.20182841068917
"21543","chr19.1900000.1905000","chr19.2145000.2150000",245000,15,3.210916e-05,1900000,2145000,1905000,2150000,"chr19",632104,4,12,13,29,"chr19",1,0.0509845288326301
"21544","chr19.1315000.1320000","chr19.1380000.1385000",65000,22,0.0008062846,1315000,1380000,1320000,1385000,"chr19",632108,9,24,23,56,"chr19",1,0.144397562119081
"21545","chr19.2540000.2545000","chr19.2575000.2580000",35000,30,0.0005709282,2540000,2575000,2545000,2580000,"chr19",632120,7,21,26,54,"chr19",1,0.189873417721519
"21546","chr19.860000.865000","chr19.920000.925000",60000,22,0.001858745,860000,920000,865000,925000,"chr19",632131,2,7,5,14,"chr19",1,0.0360993905297703
"21547","chr19.265000.270000","chr19.475000.480000",210000,12,0.006987688,265000,475000,270000,480000,"chr19",632150,0,5,0,5,"chr19",1,0.0070323488045007
"21548","chr19.38220000.38225000","chr19.38260000.38265000",40000,32,1.074946e-05,38220000,38260000,38225000,38265000,"chr19",632151,4,4,7,15,"chr19",1,0.0562587904360056
"21549","chr19.13380000.13385000","chr19.13715000.13720000",335000,15,1.688575e-06,13380000,13715000,13385000,13720000,"chr19",632152,6,13,8,27,"chr19",1,0.0474683544303797
"21550","chr19.39140000.39145000","chr19.39460000.39465000",320000,10,0.007064441,39140000,39460000,39145000,39465000,"chr19",632163,5,22,18,45,"chr19",1,0.0527426160337553
"21551","chr19.3985000.3990000","chr19.4245000.4250000",260000,12,0.00169637,3985000,4245000,3990000,4250000,"chr19",632166,4,14,13,31,"chr19",1,0.0436005625879044
"21552","chr19.2650000.2655000","chr19.2690000.2695000",40000,32,1.074946e-05,2650000,2690000,2655000,2695000,"chr19",632170,8,20,17,45,"chr19",1,0.168776371308017
"21553","chr19.5405000.5410000","chr19.5575000.5580000",170000,13,0.008398178,5405000,5575000,5410000,5580000,"chr19",632176,6,15,18,39,"chr19",1,0.0594233473980309
"21554","chr19.6525000.6530000","chr19.7065000.7070000",540000,10,0.0002660784,6525000,7065000,6530000,7070000,"chr19",632197,11,12,15,38,"chr19",1,0.0445382090951711
"21555","chr19.3345000.3350000","chr19.3425000.3430000",80000,26,5.86432e-07,3345000,3425000,3350000,3430000,"chr19",632234,8,28,26,62,"chr19",1,0.188935771214252
"21556","chr19.16425000.16430000","chr19.16455000.16460000",30000,37,1.572519e-05,16425000,16455000,16430000,16460000,"chr19",632287,4,11,16,31,"chr19",1,0.134435067979372
"21557","chr19.4350000.4355000","chr19.4400000.4405000",50000,25,0.0007428205,4350000,4400000,4355000,4405000,"chr19",632292,0,7,7,14,"chr19",1,0.0410220346929208
"21558","chr19.3405000.3410000","chr19.3435000.3440000",30000,35,9.828778e-05,3405000,3435000,3410000,3440000,"chr19",632300,9,30,33,72,"chr19",1,0.29535864978903
"21559","chr19.18685000.18690000","chr19.19030000.19035000",345000,10,0.004745102,18685000,19030000,18690000,19035000,"chr19",632314,7,23,26,56,"chr19",1,0.0656352555086732
"21560","chr19.11670000.11675000","chr19.11695000.11700000",25000,59,5.502837e-14,11670000,11695000,11675000,11700000,"chr19",632340,0,9,11,20,"chr19",1,0.138302859821847
"21561","chr19.49150000.49155000","chr19.49450000.49455000",300000,12,0.0006255539,49150000,49450000,49155000,49455000,"chr19",632349,0,2,4,6,"chr19",1,0.00843881856540084
"21562","chr19.38630000.38635000","chr19.38720000.38725000",90000,34,2.936518e-13,38630000,38720000,38635000,38725000,"chr19",632350,3,7,5,15,"chr19",1,0.059774964838256
"21563","chr19.4720000.4725000","chr19.4790000.4795000",70000,59,1.425805e-31,4720000,4790000,4725000,4795000,"chr19",632359,1,3,2,6,"chr19",1,0.0414908579465541
"21564","chr19.570000.575000","chr19.920000.925000",350000,12,0.0002195816,570000,920000,575000,925000,"chr19",632361,2,12,9,23,"chr19",1,0.0323488045007032
"21565","chr19.46525000.46530000","chr19.46700000.46705000",175000,13,0.006971328,46525000,46700000,46530000,46705000,"chr19",632376,0,4,2,6,"chr19",1,0.00914205344585091
"21566","chr19.17605000.17610000","chr19.17965000.17970000",360000,11,0.0008745337,17605000,17965000,17610000,17970000,"chr19",632386,4,7,7,18,"chr19",1,0.0232067510548523
"21567","chr19.10695000.10700000","chr19.10760000.10765000",65000,23,0.000285034,10695000,10760000,10700000,10765000,"chr19",632405,9,12,15,36,"chr19",1,0.0970464135021097
"21568","chr19.39445000.39450000","chr19.39820000.39825000",375000,16,7.79449e-08,39445000,39820000,39450000,39825000,"chr19",632415,3,8,6,17,"chr19",1,0.0318799812470699
"21569","chr19.47270000.47275000","chr19.47315000.47320000",45000,29,4.689851e-05,47270000,47315000,47275000,47320000,"chr19",632416,3,3,6,12,"chr19",1,0.0407876230661041
"21570","chr19.18455000.18460000","chr19.18520000.18525000",65000,20,0.005245412,18455000,18520000,18460000,18525000,"chr19",632431,3,15,22,40,"chr19",1,0.093764650726676
"21571","chr19.4730000.4735000","chr19.4790000.4795000",60000,53,1.111448e-23,4730000,4790000,4735000,4795000,"chr19",632440,2,3,2,7,"chr19",1,0.043483356774496
"21572","chr19.48170000.48175000","chr19.48190000.48195000",20000,35,0.008589977,48170000,48190000,48175000,48195000,"chr19",632448,1,4,6,11,"chr19",1,0.0451242381622128
"21573","chr19.2500000.2505000","chr19.2520000.2525000",20000,40,0.0002766033,2500000,2520000,2505000,2525000,"chr19",632455,2,9,10,21,"chr19",1,0.0984528832630098
"21574","chr19.10165000.10170000","chr19.10190000.10195000",25000,36,0.00110474,10165000,10190000,10170000,10195000,"chr19",632456,4,14,22,40,"chr19",1,0.168776371308017
"21575","chr19.40640000.40645000","chr19.40700000.40705000",60000,26,3.026438e-05,40640000,40700000,40645000,40705000,"chr19",632515,4,2,6,12,"chr19",1,0.0365682137834037
"21576","chr19.38140000.38145000","chr19.38210000.38215000",70000,33,1.958107e-10,38140000,38210000,38145000,38215000,"chr19",632520,1,6,2,9,"chr19",1,0.0348101265822785
"21577","chr19.50430000.50435000","chr19.50635000.50640000",205000,20,5.451664e-08,50430000,50635000,50435000,50640000,"chr19",632566,0,2,10,12,"chr19",1,0.0281293952180028
"21578","chr19.11090000.11095000","chr19.11240000.11245000",150000,16,0.0005709282,11090000,11240000,11095000,11245000,"chr19",632568,8,29,19,56,"chr19",1,0.105016408813877
"21579","chr19.34675000.34680000","chr19.34730000.34735000",55000,22,0.004393008,34675000,34730000,34680000,34735000,"chr19",632578,0,1,1,2,"chr19",1,0.00515705578996718
"21580","chr19.39035000.39040000","chr19.39125000.39130000",90000,17,0.006750948,39035000,39125000,39040000,39130000,"chr19",632580,3,11,14,28,"chr19",1,0.0557899671823722
"21581","chr19.35875000.35880000","chr19.35955000.35960000",80000,21,0.000285034,35875000,35955000,35880000,35960000,"chr19",632592,4,11,17,32,"chr19",1,0.0787623066104079
"21582","chr19.16660000.16665000","chr19.17535000.17540000",875000,7,0.002907628,16660000,17535000,16665000,17540000,"chr19",632598,6,16,24,46,"chr19",1,0.0377402719174871
"21583","chr19.38220000.38225000","chr19.38250000.38255000",30000,35,9.828778e-05,38220000,38250000,38225000,38255000,"chr19",632614,1,4,3,8,"chr19",1,0.0328176277543366
"21584","chr19.6460000.6465000","chr19.6485000.6490000",25000,37,0.0005281227,6460000,6485000,6465000,6490000,"chr19",632618,9,31,27,67,"chr19",1,0.290553211439287
"21585","chr19.45955000.45960000","chr19.45975000.45980000",20000,46,1.783247e-06,45955000,45975000,45960000,45980000,"chr19",632648,5,11,4,20,"chr19",1,0.107829348335677
"21586","chr19.47345000.47350000","chr19.47410000.47415000",65000,20,0.005245412,47345000,47410000,47350000,47415000,"chr19",632680,3,11,10,24,"chr19",1,0.0562587904360056
"21587","chr19.39035000.39040000","chr19.39120000.39125000",85000,26,2.525127e-07,39035000,39120000,39040000,39125000,"chr19",632682,13,35,32,80,"chr19",1,0.243788091889358
"21588","chr19.12400000.12405000","chr19.12780000.12785000",380000,10,0.002817371,12400000,12780000,12405000,12785000,"chr19",632687,2,5,6,13,"chr19",1,0.0152367557430849
"21589","chr19.39030000.39035000","chr19.39390000.39395000",360000,11,0.0008745337,39030000,39390000,39035000,39395000,"chr19",632691,1,12,7,20,"chr19",1,0.0257852789498359
"21590","chr19.2015000.2020000","chr19.2065000.2070000",50000,58,5.992334e-25,2015000,2065000,2020000,2070000,"chr19",632696,9,36,41,86,"chr19",1,0.584622597280825
"21591","chr19.50535000.50540000","chr19.50635000.50640000",100000,27,5.324838e-09,50535000,50635000,50540000,50640000,"chr19",632698,0,2,9,11,"chr19",1,0.0348101265822785
"21592","chr19.10835000.10840000","chr19.10915000.10920000",80000,18,0.00618472,10835000,10915000,10840000,10920000,"chr19",632706,6,5,13,24,"chr19",1,0.0506329113924051
"21593","chr19.35640000.35645000","chr19.35745000.35750000",105000,20,6.655049e-05,35640000,35745000,35645000,35750000,"chr19",632753,0,17,11,28,"chr19",1,0.0656352555086732
"21594","chr19.38895000.38900000","chr19.39390000.39395000",495000,12,1.299661e-05,38895000,39390000,38900000,39395000,"chr19",632759,11,19,23,53,"chr19",1,0.0745428973277075
"21595","chr19.57240000.57245000","chr19.57610000.57615000",370000,17,1.145947e-08,57240000,57610000,57245000,57615000,"chr19",632765,3,3,4,10,"chr19",1,0.0199249882794187
"21596","chr19.18045000.18050000","chr19.18165000.18170000",120000,15,0.00740459,18045000,18165000,18050000,18170000,"chr19",632773,1,11,19,31,"chr19",1,0.0545007032348805
"21597","chr19.47470000.47475000","chr19.47490000.47495000",20000,36,0.004609976,47470000,47490000,47475000,47495000,"chr19",632776,0,3,0,3,"chr19",1,0.0126582278481013
"21598","chr19.2460000.2465000","chr19.2575000.2580000",115000,18,0.000350699,2460000,2575000,2465000,2580000,"chr19",632787,9,24,16,49,"chr19",1,0.10337552742616
"21599","chr19.11495000.11500000","chr19.11585000.11590000",90000,25,4.751593e-07,11495000,11585000,11500000,11590000,"chr19",632788,11,15,12,38,"chr19",1,0.111345522737928
"21600","chr19.10610000.10615000","chr19.10765000.10770000",155000,16,0.0004493358,10610000,10765000,10615000,10770000,"chr19",632792,4,1,7,12,"chr19",1,0.0225035161744023
"21601","chr19.5170000.5175000","chr19.5575000.5580000",405000,9,0.00832647,5170000,5575000,5175000,5580000,"chr19",632796,6,15,18,39,"chr19",1,0.0411392405063291
"21602","chr19.13395000.13400000","chr19.13715000.13720000",320000,15,2.572857e-06,13395000,13715000,13400000,13720000,"chr19",632822,0,4,2,6,"chr19",1,0.0105485232067511
"21603","chr19.17535000.17540000","chr19.17965000.17970000",430000,15,1.323069e-07,17535000,17965000,17540000,17970000,"chr19",632832,4,7,7,18,"chr19",1,0.0316455696202532
"21604","chr19.13585000.13590000","chr19.13835000.13840000",250000,11,0.007971054,13585000,13835000,13590000,13840000,"chr19",632834,6,19,12,37,"chr19",1,0.0477027660571964
"21605","chr19.17700000.17705000","chr19.18020000.18025000",320000,10,0.007064441,17700000,18020000,17705000,18025000,"chr19",632836,5,14,13,32,"chr19",1,0.0375058602906704
"21606","chr19.18570000.18575000","chr19.18940000.18945000",370000,11,0.0007354913,18570000,18940000,18575000,18945000,"chr19",632846,3,7,8,18,"chr19",1,0.0232067510548523
"21607","chr19.12780000.12785000","chr19.12830000.12835000",50000,39,3.38064e-11,12780000,12830000,12785000,12835000,"chr19",632869,2,5,1,8,"chr19",1,0.0365682137834037
"21608","chr19.57350000.57355000","chr19.57610000.57615000",260000,12,0.00169637,57350000,57610000,57355000,57615000,"chr19",632881,2,0,1,3,"chr19",1,0.00421940928270042
"21609","chr19.2960000.2965000","chr19.2980000.2985000",20000,42,5.727509e-05,2960000,2980000,2965000,2985000,"chr19",632911,2,13,6,21,"chr19",1,0.10337552742616
"21610","chr19.39110000.39115000","chr19.39140000.39145000",30000,30,0.005134157,39110000,39140000,39115000,39145000,"chr19",632912,2,8,2,12,"chr19",1,0.0421940928270042
"21611","chr19.38400000.38405000","chr19.38630000.38635000",230000,13,0.001066595,38400000,38630000,38405000,38635000,"chr19",632927,9,13,7,29,"chr19",1,0.0441865916549461
"21612","chr19.2665000.2670000","chr19.2780000.2785000",115000,18,0.000350699,2665000,2780000,2670000,2785000,"chr19",632933,1,6,5,12,"chr19",1,0.0253164556962025
"21613","chr19.43615000.43620000","chr19.43740000.43745000",125000,16,0.001986455,43615000,43740000,43620000,43745000,"chr19",632935,10,29,24,63,"chr19",1,0.118143459915612
"21614","chr19.2235000.2240000","chr19.2650000.2655000",415000,9,0.007220543,2235000,2650000,2240000,2655000,"chr19",632941,8,20,17,45,"chr19",1,0.0474683544303797
"21615","chr19.40640000.40645000","chr19.40815000.40820000",175000,13,0.006971328,40640000,40815000,40645000,40820000,"chr19",632943,6,21,13,40,"chr19",1,0.0609470229723394
"21616","chr19.18470000.18475000","chr19.18990000.18995000",520000,9,0.001933229,18470000,18990000,18475000,18995000,"chr19",632946,0,5,3,8,"chr19",1,0.00843881856540084
"21617","chr19.45505000.45510000","chr19.45815000.45820000",310000,11,0.002180681,45505000,45815000,45510000,45820000,"chr19",632967,2,5,1,8,"chr19",1,0.0103141115799344
"21618","chr19.13115000.13120000","chr19.13135000.13140000",20000,36,0.004609976,13115000,13135000,13120000,13140000,"chr19",632976,0,2,1,3,"chr19",1,0.0126582278481013
"21619","chr19.47410000.47415000","chr19.47465000.47470000",55000,27,3.180048e-05,47410000,47465000,47415000,47470000,"chr19",632992,3,9,2,14,"chr19",1,0.0443037974683544
"21620","chr19.11040000.11045000","chr19.11240000.11245000",200000,13,0.002907628,11040000,11240000,11045000,11245000,"chr19",632993,7,29,20,56,"chr19",1,0.0853258321612752
"21621","chr19.3355000.3360000","chr19.3375000.3380000",20000,49,1.005126e-07,3355000,3375000,3360000,3380000,"chr19",632995,7,11,34,52,"chr19",1,0.298640412564463
"21622","chr19.11085000.11090000","chr19.11505000.11510000",420000,9,0.006790763,11085000,11505000,11090000,11510000,"chr19",633012,5,21,19,45,"chr19",1,0.0474683544303797
"21623","chr19.6825000.6830000","chr19.7515000.7520000",690000,8,0.00184407,6825000,7515000,6830000,7520000,"chr19",633013,2,8,6,16,"chr19",1,0.0150023441162682
"21624","chr19.41950000.41955000","chr19.42075000.42080000",125000,20,1.27237e-05,41950000,42075000,41955000,42080000,"chr19",633022,0,3,0,3,"chr19",1,0.0070323488045007
"21625","chr19.10650000.10655000","chr19.10765000.10770000",115000,16,0.003423039,10650000,10765000,10655000,10770000,"chr19",633060,4,1,7,12,"chr19",1,0.0225035161744023
"21626","chr19.11200000.11205000","chr19.11640000.11645000",440000,9,0.005214364,11200000,11640000,11205000,11645000,"chr19",633082,2,3,3,8,"chr19",1,0.00843881856540084
"21627","chr19.2280000.2285000","chr19.2380000.2385000",100000,16,0.008589977,2280000,2380000,2285000,2385000,"chr19",633093,12,29,27,68,"chr19",1,0.127519924988279
"21628","chr19.2155000.2160000","chr19.2325000.2330000",170000,26,1.359014e-11,2155000,2325000,2160000,2330000,"chr19",633100,4,13,7,24,"chr19",1,0.0731364275668073
"21629","chr19.13905000.13910000","chr19.13965000.13970000",60000,26,3.026438e-05,13905000,13965000,13910000,13970000,"chr19",633126,2,7,7,16,"chr19",1,0.0487576183778715
"21630","chr19.11090000.11095000","chr19.11435000.11440000",345000,13,4.615303e-05,11090000,11435000,11095000,11440000,"chr19",633139,8,30,19,57,"chr19",1,0.0868495077355837
"21631","chr19.2155000.2160000","chr19.2380000.2385000",225000,14,0.0003103595,2155000,2380000,2160000,2385000,"chr19",633163,13,37,37,87,"chr19",1,0.142756680731364
"21632","chr19.6515000.6520000","chr19.6630000.6635000",115000,44,2.116033e-24,6515000,6630000,6520000,6635000,"chr19",633170,3,26,11,40,"chr19",1,0.206282231598687
"21633","chr19.2030000.2035000","chr19.2060000.2065000",30000,39,2.239052e-06,2030000,2060000,2035000,2065000,"chr19",633181,2,13,8,23,"chr19",1,0.105133614627286
"21634","chr19.40280000.40285000","chr19.40330000.40335000",50000,42,4.072238e-13,40280000,40330000,40285000,40335000,"chr19",633189,1,9,12,22,"chr19",1,0.108298171589311
"21635","chr19.18110000.18115000","chr19.18155000.18160000",45000,31,5.493383e-06,18110000,18155000,18115000,18160000,"chr19",633190,5,30,22,57,"chr19",1,0.207102672292546
"21636","chr19.48270000.48275000","chr19.48290000.48295000",20000,77,5.78379e-23,48270000,48290000,48275000,48295000,"chr19",633211,0,23,11,34,"chr19",1,0.306844819503047
"21637","chr19.55250000.55255000","chr19.55280000.55285000",30000,30,0.005134157,55250000,55280000,55255000,55285000,"chr19",633230,0,6,7,13,"chr19",1,0.0457102672292546
"21638","chr19.2665000.2670000","chr19.2745000.2750000",80000,31,3.780539e-10,2665000,2745000,2670000,2750000,"chr19",633270,7,25,32,64,"chr19",1,0.232536333802157
"21639","chr19.47110000.47115000","chr19.47130000.47135000",20000,38,0.001201054,47110000,47130000,47115000,47135000,"chr19",633299,3,5,7,15,"chr19",1,0.0668073136427567
"21640","chr19.5050000.5055000","chr19.5250000.5255000",200000,12,0.009556575,5050000,5250000,5055000,5255000,"chr19",633306,1,1,1,3,"chr19",1,0.00421940928270042
"21641","chr19.14030000.14035000","chr19.14135000.14140000",105000,16,0.00618472,14030000,14135000,14035000,14140000,"chr19",633307,10,18,11,39,"chr19",1,0.0731364275668073
"21642","chr19.6525000.6530000","chr19.6860000.6865000",335000,14,1.031588e-05,6525000,6860000,6530000,6865000,"chr19",633331,6,21,29,56,"chr19",1,0.0918893577121425
"21643","chr19.46415000.46420000","chr19.46510000.46515000",95000,24,9.68507e-07,46415000,46510000,46420000,46515000,"chr19",633338,2,11,13,26,"chr19",1,0.0731364275668073
"21644","chr19.11240000.11245000","chr19.11455000.11460000",215000,12,0.006052161,11240000,11455000,11245000,11460000,"chr19",633357,10,29,21,60,"chr19",1,0.0843881856540084
"21645","chr19.48290000.48295000","chr19.48805000.48810000",515000,9,0.00205386,48290000,48805000,48295000,48810000,"chr19",633368,0,20,11,31,"chr19",1,0.0327004219409283
"21646","chr19.4725000.4730000","chr19.4800000.4805000",75000,27,3.644107e-07,4725000,4800000,4730000,4805000,"chr19",633400,12,18,24,54,"chr19",1,0.170886075949367
"21647","chr19.8475000.8480000","chr19.8525000.8530000",50000,22,0.009804879,8475000,8525000,8480000,8530000,"chr19",633405,3,10,9,22,"chr19",1,0.056727613689639
"21648","chr19.48970000.48975000","chr19.49120000.49125000",150000,17,0.0001574289,48970000,49120000,48975000,49125000,"chr19",633420,9,28,21,58,"chr19",1,0.115564932020628
"21649","chr19.38720000.38725000","chr19.38845000.38850000",125000,15,0.005869735,38720000,38845000,38725000,38850000,"chr19",633426,3,7,5,15,"chr19",1,0.0263713080168776
"21650","chr19.2145000.2150000","chr19.2325000.2330000",180000,13,0.005869735,2145000,2325000,2150000,2330000,"chr19",633430,4,12,7,23,"chr19",1,0.0350445382090952
"21651","chr19.18115000.18120000","chr19.18160000.18165000",45000,24,0.004627476,18115000,18160000,18120000,18165000,"chr19",633441,4,6,2,12,"chr19",1,0.0337552742616034
"21652","chr19.47705000.47710000","chr19.47750000.47755000",45000,26,0.000850976,47705000,47750000,47710000,47755000,"chr19",633452,3,5,3,11,"chr19",1,0.0335208626347867
"21653","chr19.12870000.12875000","chr19.12955000.12960000",85000,23,1.392645e-05,12870000,12955000,12875000,12960000,"chr19",633465,4,10,8,22,"chr19",1,0.0593061415846226
"21654","chr19.47420000.47425000","chr19.47470000.47475000",50000,27,0.0001045479,47420000,47470000,47425000,47475000,"chr19",633471,4,11,10,25,"chr19",1,0.0791139240506329
"21655","chr19.2645000.2650000","chr19.2740000.2745000",95000,21,5.101306e-05,2645000,2740000,2650000,2745000,"chr19",633475,10,23,25,58,"chr19",1,0.142756680731364
"21656","chr19.10835000.10840000","chr19.10860000.10865000",25000,83,2.568332e-29,10835000,10860000,10840000,10865000,"chr19",633476,4,5,13,22,"chr19",1,0.214017815283638
"21657","chr19.12790000.12795000","chr19.12830000.12835000",40000,36,1.228095e-07,12790000,12830000,12795000,12835000,"chr19",633481,1,5,1,7,"chr19",1,0.029535864978903
"21658","chr19.2520000.2525000","chr19.2685000.2690000",165000,13,0.009962913,2520000,2685000,2525000,2690000,"chr19",633487,6,13,10,29,"chr19",1,0.0441865916549461
"21659","chr19.44900000.44905000","chr19.44965000.44970000",65000,53,5.884639e-25,44900000,44965000,44905000,44970000,"chr19",633489,3,9,10,22,"chr19",1,0.13666197843413
"21660","chr19.13355000.13360000","chr19.13665000.13670000",310000,10,0.008437098,13355000,13665000,13360000,13670000,"chr19",633493,2,4,3,9,"chr19",1,0.0105485232067511
"21661","chr19.2975000.2980000","chr19.3035000.3040000",60000,42,4.085071e-15,2975000,3035000,2980000,3040000,"chr19",633494,5,17,8,30,"chr19",1,0.147679324894515
"21662","chr19.3985000.3990000","chr19.4200000.4205000",215000,14,0.0004616259,3985000,4200000,3990000,4205000,"chr19",633505,4,14,13,31,"chr19",1,0.0508673230192218
"21663","chr19.1895000.1900000","chr19.1925000.1930000",30000,32,0.001187867,1895000,1925000,1900000,1930000,"chr19",633545,8,42,41,91,"chr19",1,0.341303328645101
"21664","chr19.50000000.50005000","chr19.50050000.50055000",50000,36,2.202181e-09,5e+07,50050000,50005000,50055000,"chr19",633549,2,2,3,7,"chr19",1,0.029535864978903
"21665","chr19.17675000.17680000","chr19.17845000.17850000",170000,13,0.008398178,17675000,17845000,17680000,17850000,"chr19",633590,8,23,26,57,"chr19",1,0.0868495077355837
"21666","chr19.47390000.47395000","chr19.47410000.47415000",20000,53,1.561571e-09,47390000,47410000,47395000,47415000,"chr19",633593,4,13,16,33,"chr19",1,0.204992967651196
"21667","chr19.18110000.18115000","chr19.18160000.18165000",50000,29,1.246676e-05,18110000,18160000,18115000,18165000,"chr19",633604,4,25,22,51,"chr19",1,0.173347398030942
"21668","chr19.1325000.1330000","chr19.1345000.1350000",20000,35,0.008589977,1325000,1345000,1330000,1350000,"chr19",633605,6,23,15,44,"chr19",1,0.180496952648851
"21669","chr19.46020000.46025000","chr19.46070000.46075000",50000,31,1.268103e-06,46020000,46070000,46025000,46075000,"chr19",633619,0,4,1,5,"chr19",1,0.0181669010782935
"21670","chr19.7195000.7200000","chr19.7290000.7295000",95000,44,3.799586e-22,7195000,7290000,7200000,7295000,"chr19",633623,2,8,7,17,"chr19",1,0.0876699484294421
"21671","chr19.49150000.49155000","chr19.49205000.49210000",55000,24,0.0007085265,49150000,49205000,49155000,49210000,"chr19",633630,0,2,4,6,"chr19",1,0.0168776371308017
"21672","chr19.2945000.2950000","chr19.3035000.3040000",90000,22,2.620616e-05,2945000,3035000,2950000,3040000,"chr19",633642,2,16,8,26,"chr19",1,0.0670417252695734
"21673","chr19.18685000.18690000","chr19.18945000.18950000",260000,12,0.00169637,18685000,18945000,18690000,18950000,"chr19",633660,4,15,17,36,"chr19",1,0.0506329113924051
"21674","chr19.3325000.3330000","chr19.3490000.3495000",165000,20,7.891323e-07,3325000,3490000,3330000,3495000,"chr19",633664,4,12,22,38,"chr19",1,0.0890764181903422
"21675","chr19.38890000.38895000","chr19.39390000.39395000",500000,12,1.189326e-05,38890000,39390000,38895000,39395000,"chr19",633689,6,16,11,33,"chr19",1,0.0464135021097046
"21676","chr19.2980000.2985000","chr19.3035000.3040000",55000,30,9.937711e-07,2980000,3035000,2985000,3040000,"chr19",633698,2,13,6,21,"chr19",1,0.0738396624472574
"21677","chr19.2280000.2285000","chr19.2315000.2320000",35000,34,1.389882e-05,2280000,2315000,2285000,2320000,"chr19",633707,10,26,25,61,"chr19",1,0.243084857008908
"21678","chr19.3345000.3350000","chr19.3395000.3400000",50000,41,1.837559e-12,3345000,3395000,3350000,3400000,"chr19",633712,8,26,22,56,"chr19",1,0.26910454758556
"21679","chr19.2665000.2670000","chr19.2700000.2705000",35000,45,3.800872e-11,2665000,2700000,2670000,2705000,"chr19",633730,7,5,19,31,"chr19",1,0.163502109704641
"21680","chr19.48960000.48965000","chr19.49115000.49120000",155000,14,0.004800452,48960000,49115000,48965000,49120000,"chr19",633731,0,4,2,6,"chr19",1,0.00984528832630099
"21681","chr19.47410000.47415000","chr19.47480000.47485000",70000,22,0.0003639768,47410000,47480000,47415000,47485000,"chr19",633789,0,8,5,13,"chr19",1,0.0335208626347867
"21682","chr19.5910000.5915000","chr19.5930000.5935000",20000,43,2.524408e-05,5910000,5930000,5915000,5935000,"chr19",633803,5,3,3,11,"chr19",1,0.0554383497421472
"21683","chr19.6455000.6460000","chr19.6500000.6505000",45000,25,0.00205386,6455000,6500000,6460000,6505000,"chr19",633805,2,5,9,16,"chr19",1,0.046882325363338
"21684","chr19.48780000.48785000","chr19.49195000.49200000",415000,12,6.033469e-05,48780000,49195000,48785000,49200000,"chr19",633838,6,23,19,48,"chr19",1,0.0675105485232067
"21685","chr19.2540000.2545000","chr19.2585000.2590000",45000,26,0.000850976,2540000,2585000,2545000,2590000,"chr19",633842,3,13,19,35,"chr19",1,0.106657290201594
"21686","chr19.2660000.2665000","chr19.2690000.2695000",30000,37,1.572519e-05,2660000,2690000,2665000,2695000,"chr19",633873,3,9,2,14,"chr19",1,0.0607126113455227
"21687","chr19.17215000.17220000","chr19.17235000.17240000",20000,40,0.0002766033,17215000,17235000,17220000,17240000,"chr19",633874,3,19,16,38,"chr19",1,0.178152836380684
"21688","chr19.49985000.49990000","chr19.50050000.50055000",65000,25,3.1669e-05,49985000,50050000,49990000,50055000,"chr19",633893,0,2,2,4,"chr19",1,0.0117205813408345
"21689","chr19.10580000.10585000","chr19.10650000.10655000",70000,19,0.006892072,10580000,10650000,10585000,10655000,"chr19",633916,7,18,24,49,"chr19",1,0.109118612283169
"21690","chr19.2650000.2655000","chr19.2750000.2755000",100000,26,2.563189e-08,2650000,2750000,2655000,2755000,"chr19",633931,6,20,17,43,"chr19",1,0.13103609939053
"21691","chr19.2155000.2160000","chr19.2270000.2275000",115000,28,1.275868e-10,2155000,2270000,2160000,2275000,"chr19",633934,0,2,12,14,"chr19",1,0.0459446788560713
"21692","chr19.11845000.11850000","chr19.12780000.12785000",935000,7,0.001885355,11845000,12780000,11850000,12785000,"chr19",633938,8,5,10,23,"chr19",1,0.0188701359587436
"21693","chr19.55465000.55470000","chr19.56250000.56255000",785000,7,0.005187376,55465000,56250000,55470000,56255000,"chr19",633948,5,7,9,21,"chr19",1,0.0172292545710267
"21694","chr19.7065000.7070000","chr19.7095000.7100000",30000,36,3.98299e-05,7065000,7095000,7070000,7100000,"chr19",633980,3,12,4,19,"chr19",1,0.080168776371308
"21695","chr19.2950000.2955000","chr19.3160000.3165000",210000,27,4.157754e-14,2950000,3160000,2955000,3165000,"chr19",633989,1,13,12,26,"chr19",1,0.0822784810126582
"21696","chr19.39035000.39040000","chr19.39140000.39145000",105000,19,0.0002301067,39035000,39140000,39040000,39145000,"chr19",634003,10,22,21,53,"chr19",1,0.118026254102203
"21697","chr19.3325000.3330000","chr19.3435000.3440000",110000,36,1.098919e-16,3325000,3435000,3330000,3440000,"chr19",634038,9,36,38,83,"chr19",1,0.350210970464135
"21698","chr19.57190000.57195000","chr19.57570000.57575000",380000,13,2.117427e-05,57190000,57570000,57195000,57575000,"chr19",634076,0,2,2,4,"chr19",1,0.00609470229723394
"21699","chr19.6455000.6460000","chr19.6480000.6485000",25000,33,0.008466812,6455000,6480000,6460000,6485000,"chr19",634079,2,5,17,24,"chr19",1,0.0928270042194093
"21700","chr19.8475000.8480000","chr19.8505000.8510000",30000,44,1.051662e-08,8475000,8505000,8480000,8510000,"chr19",634087,5,19,9,33,"chr19",1,0.170182841068917
"21701","chr19.10625000.10630000","chr19.10650000.10655000",25000,72,7.93509e-22,10625000,10650000,10630000,10655000,"chr19",634091,7,21,24,52,"chr19",1,0.438818565400844
"21702","chr19.15375000.15380000","chr19.15430000.15435000",55000,25,0.0002637507,15375000,15430000,15380000,15435000,"chr19",634102,1,3,11,15,"chr19",1,0.0439521800281294
"21703","chr19.18680000.18685000","chr19.19030000.19035000",350000,11,0.001052087,18680000,19030000,18685000,19035000,"chr19",634112,5,23,15,43,"chr19",1,0.0554383497421472
"21704","chr19.7495000.7500000","chr19.7515000.7520000",20000,102,1.138804e-40,7495000,7515000,7500000,7520000,"chr19",634171,6,12,17,35,"chr19",1,0.418424753867792
"21705","chr19.48105000.48110000","chr19.48190000.48195000",85000,21,0.0001590206,48105000,48190000,48110000,48195000,"chr19",634175,1,4,6,11,"chr19",1,0.0270745428973277
"21706","chr19.11670000.11675000","chr19.11690000.11695000",20000,46,1.783247e-06,11670000,11690000,11675000,11695000,"chr19",634184,0,9,11,20,"chr19",1,0.107829348335677
"21707","chr19.48835000.48840000","chr19.49085000.49090000",250000,30,1.144826e-18,48835000,49085000,48840000,49090000,"chr19",634205,1,3,3,7,"chr19",1,0.0246132208157525
"21708","chr19.2475000.2480000","chr19.2595000.2600000",120000,21,4.618767e-06,2475000,2595000,2480000,2600000,"chr19",634211,1,1,1,3,"chr19",1,0.00738396624472574
"21709","chr19.38895000.38900000","chr19.39400000.39405000",505000,11,7.364253e-05,38895000,39400000,38900000,39405000,"chr19",634216,8,14,22,44,"chr19",1,0.056727613689639
"21710","chr19.42380000.42385000","chr19.42450000.42455000",70000,25,1.208659e-05,42380000,42450000,42385000,42455000,"chr19",634226,4,7,18,29,"chr19",1,0.0849742147210502
"21711","chr19.6455000.6460000","chr19.6860000.6865000",405000,9,0.00832647,6455000,6860000,6460000,6865000,"chr19",634229,2,5,17,24,"chr19",1,0.0253164556962025
"21712","chr19.1545000.1550000","chr19.1810000.1815000",265000,11,0.005588291,1545000,1810000,1550000,1815000,"chr19",634273,4,6,10,20,"chr19",1,0.0257852789498359
"21713","chr19.11490000.11495000","chr19.11560000.11565000",70000,20,0.002739872,11490000,11560000,11495000,11565000,"chr19",634309,6,22,14,42,"chr19",1,0.0984528832630098
"21714","chr19.49155000.49160000","chr19.49475000.49480000",320000,11,0.001807231,49155000,49475000,49160000,49480000,"chr19",634362,2,11,20,33,"chr19",1,0.0425457102672293
"21715","chr19.4805000.4810000","chr19.4905000.4910000",100000,37,1.230346e-16,4805000,4905000,4810000,4910000,"chr19",634382,4,33,16,53,"chr19",1,0.229840600093765
"21716","chr19.1895000.1900000","chr19.2095000.2100000",200000,12,0.009556575,1895000,2095000,1900000,2100000,"chr19",634414,0,4,1,5,"chr19",1,0.0070323488045007
"21717","chr19.10110000.10115000","chr19.10135000.10140000",25000,51,8.326738e-10,10110000,10135000,10115000,10140000,"chr19",634424,1,4,0,5,"chr19",1,0.029887482419128
"21718","chr19.910000.915000","chr19.1190000.1195000",280000,12,0.001021956,910000,1190000,915000,1195000,"chr19",634437,14,26,32,72,"chr19",1,0.10126582278481
"21719","chr19.18070000.18075000","chr19.18160000.18165000",90000,17,0.006750948,18070000,18160000,18075000,18165000,"chr19",634441,4,25,24,53,"chr19",1,0.105602437880919
"21720","chr19.35525000.35530000","chr19.35625000.35630000",100000,20,0.0001047637,35525000,35625000,35530000,35630000,"chr19",634463,0,2,1,3,"chr19",1,0.0070323488045007
"21721","chr19.48870000.48875000","chr19.49110000.49115000",240000,14,0.0001816006,48870000,49110000,48875000,49115000,"chr19",634464,6,28,38,72,"chr19",1,0.118143459915612
"21722","chr19.4005000.4010000","chr19.4065000.4070000",60000,25,9.196901e-05,4005000,4065000,4010000,4070000,"chr19",634477,3,11,13,27,"chr19",1,0.0791139240506329
"21723","chr19.48970000.48975000","chr19.49085000.49090000",115000,15,0.009573557,48970000,49085000,48975000,49090000,"chr19",634513,8,28,21,57,"chr19",1,0.100210970464135
"21724","chr19.38210000.38215000","chr19.38260000.38265000",50000,24,0.00185032,38210000,38260000,38215000,38265000,"chr19",634515,6,13,24,43,"chr19",1,0.120956399437412
"21725","chr19.45075000.45080000","chr19.45175000.45180000",100000,17,0.003153897,45075000,45175000,45080000,45180000,"chr19",634516,3,5,2,10,"chr19",1,0.0199249882794187
"21726","chr19.30560000.30565000","chr19.30920000.30925000",360000,12,0.0001796652,30560000,30920000,30565000,30925000,"chr19",634550,1,1,3,5,"chr19",1,0.0070323488045007
"21727","chr19.980000.985000","chr19.1240000.1245000",260000,12,0.00169637,980000,1240000,985000,1245000,"chr19",634569,9,22,24,55,"chr19",1,0.0773558368495077
"21728","chr19.3700000.3705000","chr19.4115000.4120000",415000,13,9.877653e-06,3700000,4115000,3705000,4120000,"chr19",634578,6,22,22,50,"chr19",1,0.0761837787154243
"21729","chr19.2460000.2465000","chr19.2635000.2640000",175000,18,9.296638e-06,2460000,2635000,2465000,2640000,"chr19",634591,0,6,2,8,"chr19",1,0.0168776371308017
"21730","chr19.2280000.2285000","chr19.2460000.2465000",180000,13,0.005869735,2280000,2460000,2285000,2465000,"chr19",634607,9,24,16,49,"chr19",1,0.0746601031411158
"21731","chr19.6055000.6060000","chr19.6110000.6115000",55000,21,0.009962913,6055000,6110000,6060000,6115000,"chr19",634613,3,2,3,8,"chr19",1,0.019690576652602
"21732","chr19.46785000.46790000","chr19.47035000.47040000",250000,13,0.0005597238,46785000,47035000,46790000,47040000,"chr19",634621,1,14,8,23,"chr19",1,0.0350445382090952
"21733","chr19.10915000.10920000","chr19.10960000.10965000",45000,25,0.00205386,10915000,10960000,10920000,10965000,"chr19",634684,8,11,16,35,"chr19",1,0.102555086732302
"21734","chr19.7630000.7635000","chr19.7950000.7955000",320000,11,0.001807231,7630000,7950000,7635000,7955000,"chr19",634709,3,8,10,21,"chr19",1,0.0270745428973277
"21735","chr19.2150000.2155000","chr19.2235000.2240000",85000,21,0.0001590206,2150000,2235000,2155000,2240000,"chr19",634725,9,22,19,50,"chr19",1,0.123066104078762
"21736","chr19.1545000.1550000","chr19.1670000.1675000",125000,16,0.001986455,1545000,1670000,1550000,1675000,"chr19",634729,4,16,21,41,"chr19",1,0.0768870135958744
"21737","chr19.39100000.39105000","chr19.39820000.39825000",720000,7,0.00809329,39100000,39820000,39105000,39825000,"chr19",634730,3,8,6,17,"chr19",1,0.0139474917955931
"21738","chr19.7630000.7635000","chr19.7650000.7655000",20000,41,0.0001275693,7630000,7650000,7635000,7655000,"chr19",634734,3,8,10,21,"chr19",1,0.100914205344585
"21739","chr19.3345000.3350000","chr19.3485000.3490000",140000,20,4.359916e-06,3345000,3485000,3350000,3490000,"chr19",634752,8,28,26,62,"chr19",1,0.145335208626348
"21740","chr19.13275000.13280000","chr19.13880000.13885000",605000,10,0.0001100023,13275000,13880000,13280000,13885000,"chr19",634755,1,1,2,4,"chr19",1,0.0046882325363338
"21741","chr19.18110000.18115000","chr19.18280000.18285000",170000,14,0.002640458,18110000,18280000,18115000,18285000,"chr19",634761,2,14,15,31,"chr19",1,0.0508673230192218
"21742","chr19.7515000.7520000","chr19.7950000.7955000",435000,16,1.380079e-08,7515000,7950000,7520000,7955000,"chr19",634769,6,12,17,35,"chr19",1,0.0656352555086732
"21743","chr19.10390000.10395000","chr19.10415000.10420000",25000,35,0.002234426,10390000,10415000,10395000,10420000,"chr19",634770,0,1,1,2,"chr19",1,0.00820440693858415
"21744","chr19.38220000.38225000","chr19.38255000.38260000",35000,29,0.001308007,38220000,38255000,38225000,38260000,"chr19",634774,4,4,7,15,"chr19",1,0.0509845288326301
"21745","chr19.10640000.10645000","chr19.10810000.10815000",170000,13,0.008398178,10640000,10810000,10645000,10815000,"chr19",634795,2,9,6,17,"chr19",1,0.0259024847632443
"21746","chr19.1895000.1900000","chr19.2265000.2270000",370000,10,0.003280482,1895000,2265000,1900000,2270000,"chr19",634801,12,46,42,100,"chr19",1,0.117205813408345
"21747","chr19.49580000.49585000","chr19.49660000.49665000",80000,18,0.00618472,49580000,49660000,49585000,49665000,"chr19",634806,4,7,3,14,"chr19",1,0.029535864978903
"21748","chr19.47600000.47605000","chr19.47725000.47730000",125000,16,0.001986455,47600000,47725000,47605000,47730000,"chr19",634817,7,14,15,36,"chr19",1,0.0675105485232067
"21749","chr19.3970000.3975000","chr19.4185000.4190000",215000,12,0.006052161,3970000,4185000,3975000,4190000,"chr19",634828,8,37,41,86,"chr19",1,0.120956399437412
"21750","chr19.40270000.40275000","chr19.40595000.40600000",325000,11,0.001637734,40270000,40595000,40275000,40600000,"chr19",634851,5,9,13,27,"chr19",1,0.0348101265822785
"21751","chr19.1895000.1900000","chr19.2015000.2020000",120000,20,1.859648e-05,1895000,2015000,1900000,2020000,"chr19",634858,12,38,47,97,"chr19",1,0.227379278012189
"21752","chr19.47270000.47275000","chr19.47515000.47520000",245000,12,0.002521533,47270000,47515000,47275000,47520000,"chr19",634865,3,3,6,12,"chr19",1,0.0168776371308017
"21753","chr19.6480000.6485000","chr19.6860000.6865000",380000,11,0.0006158993,6480000,6860000,6485000,6865000,"chr19",634890,6,21,29,56,"chr19",1,0.0721987810595406
"21754","chr19.49470000.49475000","chr19.49495000.49500000",25000,33,0.008466812,49470000,49495000,49475000,49500000,"chr19",634917,8,17,22,47,"chr19",1,0.181786216596343
"21755","chr19.46390000.46395000","chr19.46510000.46515000",120000,16,0.002564687,46390000,46510000,46395000,46515000,"chr19",634921,1,3,5,9,"chr19",1,0.0168776371308017
"21756","chr19.7435000.7440000","chr19.7515000.7520000",80000,39,5.016175e-16,7435000,7515000,7440000,7520000,"chr19",634927,6,12,17,35,"chr19",1,0.159985935302391
"21757","chr19.12670000.12675000","chr19.12790000.12795000",120000,15,0.00740459,12670000,12790000,12675000,12795000,"chr19",634937,1,14,14,29,"chr19",1,0.0509845288326301
"21758","chr19.45075000.45080000","chr19.45130000.45135000",55000,22,0.004393008,45075000,45130000,45080000,45135000,"chr19",634938,3,5,2,10,"chr19",1,0.0257852789498359
"21759","chr19.48880000.48885000","chr19.48930000.48935000",50000,22,0.009804879,48880000,48930000,48885000,48935000,"chr19",634943,9,32,43,84,"chr19",1,0.216596343178622
"21760","chr19.41950000.41955000","chr19.42080000.42085000",130000,18,0.0001319747,41950000,42080000,41955000,42085000,"chr19",634951,7,26,27,60,"chr19",1,0.126582278481013
"21761","chr19.2160000.2165000","chr19.2325000.2330000",165000,14,0.003251169,2160000,2325000,2165000,2330000,"chr19",634966,4,13,7,24,"chr19",1,0.0393811533052039
"21762","chr19.38630000.38635000","chr19.38715000.38720000",85000,23,1.392645e-05,38630000,38715000,38635000,38720000,"chr19",634972,4,9,6,19,"chr19",1,0.0512189404594468
"21763","chr19.2645000.2650000","chr19.2685000.2690000",40000,33,3.717034e-06,2645000,2685000,2650000,2690000,"chr19",635003,6,15,18,39,"chr19",1,0.15084388185654
"21764","chr19.2950000.2955000","chr19.3035000.3040000",85000,31,1.320294e-10,2950000,3035000,2955000,3040000,"chr19",635010,1,17,8,26,"chr19",1,0.0944678856071261
"21765","chr19.18625000.18630000","chr19.18935000.18940000",310000,12,0.0005105904,18625000,18935000,18630000,18940000,"chr19",635024,11,39,26,76,"chr19",1,0.106891701828411
"21766","chr19.39465000.39470000","chr19.39820000.39825000",355000,14,6.204096e-06,39465000,39820000,39470000,39825000,"chr19",635048,3,6,6,15,"chr19",1,0.0246132208157525
"21767","chr19.38140000.38145000","chr19.38265000.38270000",125000,17,0.0006201799,38140000,38265000,38145000,38270000,"chr19",635056,1,6,2,9,"chr19",1,0.0179324894514768
"21768","chr19.48870000.48875000","chr19.49085000.49090000",215000,15,0.0001081811,48870000,49085000,48875000,49090000,"chr19",635069,6,33,31,70,"chr19",1,0.123066104078762
"21769","chr19.46895000.46900000","chr19.47045000.47050000",150000,15,0.001919485,46895000,47045000,46900000,47050000,"chr19",635075,4,12,8,24,"chr19",1,0.0421940928270042
"21770","chr19.10380000.10385000","chr19.10500000.10505000",120000,52,5.418402e-33,10380000,10500000,10385000,10505000,"chr19",635147,3,17,15,35,"chr19",1,0.213314580403188
"21771","chr19.47725000.47730000","chr19.47750000.47755000",25000,52,2.658715e-10,47725000,47750000,47730000,47755000,"chr19",635149,3,5,3,11,"chr19",1,0.0670417252695734
"21772","chr19.48085000.48090000","chr19.48805000.48810000",720000,7,0.00809329,48085000,48805000,48090000,48810000,"chr19",635151,1,5,3,9,"chr19",1,0.00738396624472574
"21773","chr19.12675000.12680000","chr19.12720000.12725000",45000,24,0.004627476,12675000,12720000,12680000,12725000,"chr19",635177,3,13,18,34,"chr19",1,0.0956399437412096
"21774","chr19.2150000.2155000","chr19.2265000.2270000",115000,23,3.988488e-07,2150000,2265000,2155000,2270000,"chr19",635201,9,34,19,62,"chr19",1,0.1671354899203
"21775","chr19.46530000.46535000","chr19.46755000.46760000",225000,13,0.001241484,46530000,46755000,46535000,46760000,"chr19",635202,1,8,5,14,"chr19",1,0.0213314580403188
"21776","chr19.2885000.2890000","chr19.2945000.2950000",60000,24,0.0002613597,2885000,2945000,2890000,2950000,"chr19",635210,2,15,12,29,"chr19",1,0.0815752461322082
"21777","chr19.40795000.40800000","chr19.41135000.41140000",340000,10,0.005138915,40795000,41135000,40800000,41140000,"chr19",635264,4,18,9,31,"chr19",1,0.036333802156587
"21778","chr19.10765000.10770000","chr19.10810000.10815000",45000,47,2.185826e-15,10765000,10810000,10770000,10815000,"chr19",635290,2,1,6,9,"chr19",1,0.04957805907173
"21779","chr19.5720000.5725000","chr19.6280000.6285000",560000,9,0.001198677,5720000,6280000,5725000,6285000,"chr19",635316,9,21,26,56,"chr19",1,0.0590717299578059
"21780","chr19.4875000.4880000","chr19.4910000.4915000",35000,46,1.015403e-11,4875000,4910000,4880000,4915000,"chr19",635319,5,7,6,18,"chr19",1,0.0970464135021097
"21781","chr19.38895000.38900000","chr19.39345000.39350000",450000,9,0.004609976,38895000,39345000,38900000,39350000,"chr19",635322,1,0,1,2,"chr19",1,0.00210970464135021
"21782","chr19.12660000.12665000","chr19.12780000.12785000",120000,15,0.00740459,12660000,12780000,12665000,12785000,"chr19",635331,8,5,26,39,"chr19",1,0.0685654008438819
"21783","chr19.18455000.18460000","chr19.18485000.18490000",30000,32,0.001187867,18455000,18485000,18460000,18490000,"chr19",635338,0,3,1,4,"chr19",1,0.0150023441162682
"21784","chr19.46610000.46615000","chr19.46630000.46635000",20000,36,0.004609976,46610000,46630000,46615000,46635000,"chr19",635342,2,6,5,13,"chr19",1,0.0548523206751055
"21785","chr19.10695000.10700000","chr19.10715000.10720000",20000,45,4.359916e-06,10695000,10715000,10700000,10720000,"chr19",635347,3,11,16,30,"chr19",1,0.158227848101266
"21786","chr19.2155000.2160000","chr19.2315000.2320000",160000,29,1.121517e-13,2155000,2315000,2160000,2320000,"chr19",635358,10,26,25,61,"chr19",1,0.207337083919362
"21787","chr19.47035000.47040000","chr19.47110000.47115000",75000,18,0.009962913,47035000,47110000,47040000,47115000,"chr19",635363,3,5,7,15,"chr19",1,0.0316455696202532
"21788","chr19.14245000.14250000","chr19.14510000.14515000",265000,15,1.526102e-05,14245000,14510000,14250000,14515000,"chr19",635367,4,6,12,22,"chr19",1,0.0386779184247539
"21789","chr19.57725000.57730000","chr19.57745000.57750000",20000,55,1.780642e-10,57725000,57745000,57730000,57750000,"chr19",635369,1,4,1,6,"chr19",1,0.0386779184247539
"21790","chr19.10810000.10815000","chr19.10935000.10940000",125000,23,1.533277e-07,10810000,10935000,10815000,10940000,"chr19",635413,2,9,6,17,"chr19",1,0.0458274730426629
"21791","chr19.12930000.12935000","chr19.12985000.12990000",55000,21,0.009962913,12930000,12985000,12935000,12990000,"chr19",635451,1,1,7,9,"chr19",1,0.0221518987341772
"21792","chr19.1040000.1045000","chr19.1190000.1195000",150000,18,4.024957e-05,1040000,1190000,1045000,1195000,"chr19",635454,0,2,2,4,"chr19",1,0.00843881856540084
"21793","chr19.50315000.50320000","chr19.50365000.50370000",50000,24,0.00185032,50315000,50365000,50320000,50370000,"chr19",635456,7,20,21,48,"chr19",1,0.135021097046413
"21794","chr19.3340000.3345000","chr19.3440000.3445000",100000,17,0.003153897,3340000,3440000,3345000,3445000,"chr19",635461,5,11,11,27,"chr19",1,0.0537974683544304
"21795","chr19.39540000.39545000","chr19.39820000.39825000",280000,13,0.0002332934,39540000,39820000,39545000,39825000,"chr19",635469,3,8,6,17,"chr19",1,0.0259024847632443
"21796","chr19.47255000.47260000","chr19.47345000.47350000",90000,19,0.0008791889,47255000,47345000,47260000,47350000,"chr19",635479,3,11,10,24,"chr19",1,0.0534458509142053
"21797","chr19.40330000.40335000","chr19.40595000.40600000",265000,11,0.005588291,40330000,40595000,40335000,40600000,"chr19",635491,5,9,13,27,"chr19",1,0.0348101265822785
"21798","chr19.18045000.18050000","chr19.18105000.18110000",60000,58,6.07569e-28,18045000,18105000,18050000,18110000,"chr19",635497,1,11,19,31,"chr19",1,0.210736052508204
"21799","chr19.4805000.4810000","chr19.5035000.5040000",230000,13,0.001066595,4805000,5035000,4810000,5040000,"chr19",635532,1,4,2,7,"chr19",1,0.0106657290201594
"21800","chr19.18060000.18065000","chr19.18100000.18105000",40000,35,3.975541e-07,18060000,18100000,18065000,18105000,"chr19",635555,5,15,17,37,"chr19",1,0.151781528363807
"21801","chr19.45290000.45295000","chr19.45325000.45330000",35000,43,5.013496e-10,45290000,45325000,45295000,45330000,"chr19",635556,4,6,9,19,"chr19",1,0.0957571495546179
"21802","chr19.5340000.5345000","chr19.5575000.5580000",235000,12,0.003379023,5340000,5575000,5345000,5580000,"chr19",635558,6,15,16,37,"chr19",1,0.0520393811533052
"21803","chr19.10835000.10840000","chr19.10935000.10940000",100000,26,2.563189e-08,10835000,10935000,10840000,10940000,"chr19",635593,6,5,13,24,"chr19",1,0.0731364275668073
"21804","chr19.47045000.47050000","chr19.47155000.47160000",110000,24,1.511739e-07,47045000,47155000,47050000,47160000,"chr19",635596,4,12,8,24,"chr19",1,0.0675105485232067
"21805","chr19.7115000.7120000","chr19.7515000.7520000",400000,9,0.008792529,7115000,7515000,7120000,7520000,"chr19",635615,5,12,17,34,"chr19",1,0.0358649789029536
"21806","chr19.4805000.4810000","chr19.5030000.5035000",225000,20,1.535207e-08,4805000,5030000,4810000,5035000,"chr19",635634,11,11,14,36,"chr19",1,0.0843881856540084
"21807","chr19.36195000.36200000","chr19.36485000.36490000",290000,11,0.003247526,36195000,36485000,36200000,36490000,"chr19",635635,6,20,23,49,"chr19",1,0.063173933427098
"21808","chr19.13300000.13305000","chr19.13880000.13885000",580000,8,0.00494832,13300000,13880000,13305000,13885000,"chr19",635656,4,1,2,7,"chr19",1,0.00656352555086732
"21809","chr19.49335000.49340000","chr19.49470000.49475000",135000,17,0.0003512967,49335000,49470000,49340000,49475000,"chr19",635664,1,5,5,11,"chr19",1,0.0219174871073605
"21810","chr19.17830000.17835000","chr19.17855000.17860000",25000,39,0.0001056016,17830000,17855000,17835000,17860000,"chr19",635695,5,17,20,42,"chr19",1,0.191983122362869
"21811","chr19.46745000.46750000","chr19.47695000.47700000",950000,7,0.001670099,46745000,47695000,46750000,47700000,"chr19",635705,4,11,10,25,"chr19",1,0.0205110173464604
"21812","chr19.11455000.11460000","chr19.11585000.11590000",130000,17,0.0004750317,11455000,11585000,11460000,11590000,"chr19",635712,11,15,18,44,"chr19",1,0.0876699484294421
"21813","chr19.2490000.2495000","chr19.2540000.2545000",50000,27,0.0001045479,2490000,2540000,2495000,2545000,"chr19",635724,1,8,8,17,"chr19",1,0.0537974683544304
"21814","chr19.10695000.10700000","chr19.10810000.10815000",115000,20,2.808002e-05,10695000,10810000,10700000,10815000,"chr19",635735,2,9,6,17,"chr19",1,0.0398499765588373
"21815","chr19.47470000.47475000","chr19.47600000.47605000",130000,16,0.001529227,47470000,47600000,47475000,47605000,"chr19",635765,5,22,15,42,"chr19",1,0.0787623066104079
"21816","chr19.1020000.1025000","chr19.1100000.1105000",80000,37,1.822302e-14,1020000,1100000,1025000,1105000,"chr19",635810,5,15,18,38,"chr19",1,0.164791373652133
"21817","chr19.13985000.13990000","chr19.14135000.14140000",150000,17,0.0001574289,13985000,14135000,13990000,14140000,"chr19",635813,1,18,10,29,"chr19",1,0.0577824660103141
"21818","chr19.45405000.45410000","chr19.45450000.45455000",45000,70,2.633902e-33,45405000,45450000,45410000,45455000,"chr19",635816,0,2,5,7,"chr19",1,0.0574308485700891
"21819","chr19.50265000.50270000","chr19.50315000.50320000",50000,42,4.072238e-13,50265000,50315000,50270000,50320000,"chr19",635818,3,20,16,39,"chr19",1,0.191983122362869
"21820","chr19.4830000.4835000","chr19.4850000.4855000",20000,47,7.035622e-07,4830000,4850000,4835000,4855000,"chr19",635838,12,26,31,69,"chr19",1,0.380098452883263
"21821","chr19.46530000.46535000","chr19.46575000.46580000",45000,42,4.05301e-12,46530000,46575000,46535000,46580000,"chr19",635883,1,12,5,18,"chr19",1,0.0886075949367089
"21822","chr19.42300000.42305000","chr19.42325000.42330000",25000,35,0.002234426,42300000,42325000,42305000,42330000,"chr19",635885,7,12,16,35,"chr19",1,0.143577121425223
"21823","chr19.47045000.47050000","chr19.47095000.47100000",50000,23,0.004395035,47045000,47095000,47050000,47100000,"chr19",635928,1,7,3,11,"chr19",1,0.0296530707923113
"21824","chr19.18590000.18595000","chr19.18710000.18715000",120000,15,0.00740459,18590000,18710000,18595000,18715000,"chr19",635939,3,7,2,12,"chr19",1,0.0210970464135021
"21825","chr19.53425000.53430000","chr19.53460000.53465000",35000,28,0.002907628,53425000,53460000,53430000,53465000,"chr19",635955,5,13,18,36,"chr19",1,0.118143459915612
"21826","chr19.6200000.6205000","chr19.6280000.6285000",80000,26,5.86432e-07,6200000,6280000,6205000,6285000,"chr19",635979,6,15,21,42,"chr19",1,0.127988748241913
"21827","chr19.48465000.48470000","chr19.48620000.48625000",155000,19,7.062564e-06,48465000,48620000,48470000,48625000,"chr19",635984,0,7,5,12,"chr19",1,0.0267229254571027
"21828","chr19.2645000.2650000","chr19.2735000.2740000",90000,20,0.000285034,2645000,2735000,2650000,2740000,"chr19",635991,4,19,18,41,"chr19",1,0.0961087669948429
"21829","chr19.5900000.5905000","chr19.6735000.6740000",835000,7,0.003836908,5900000,6735000,5905000,6740000,"chr19",636004,2,4,10,16,"chr19",1,0.0131270511017346
"21830","chr19.8220000.8225000","chr19.8265000.8270000",45000,32,1.801546e-06,8220000,8265000,8225000,8270000,"chr19",636021,11,36,21,68,"chr19",1,0.255039849976559
"21831","chr19.11500000.11505000","chr19.11535000.11540000",35000,27,0.006173938,11500000,11535000,11505000,11540000,"chr19",636027,7,19,10,36,"chr19",1,0.113924050632911
"21832","chr19.17235000.17240000","chr19.17330000.17335000",95000,19,0.0005524344,17235000,17330000,17240000,17335000,"chr19",636057,3,5,9,17,"chr19",1,0.0378574777308955
"21833","chr19.50635000.50640000","chr19.51335000.51340000",700000,8,0.001688463,50635000,51335000,50640000,51340000,"chr19",636058,0,2,10,12,"chr19",1,0.0112517580872011
"21834","chr19.38145000.38150000","chr19.38265000.38270000",120000,15,0.00740459,38145000,38265000,38150000,38270000,"chr19",636062,6,14,10,30,"chr19",1,0.0527426160337553
"21835","chr19.10590000.10595000","chr19.10810000.10815000",220000,14,0.0003738737,10590000,10810000,10595000,10815000,"chr19",636103,2,9,6,17,"chr19",1,0.0278949835911861
"21836","chr19.47610000.47615000","chr19.47750000.47755000",140000,14,0.00876904,47610000,47750000,47615000,47755000,"chr19",636122,2,5,3,10,"chr19",1,0.0164088138771683
"21837","chr19.2960000.2965000","chr19.3060000.3065000",100000,28,1.074239e-09,2960000,3060000,2965000,3065000,"chr19",636128,2,11,17,30,"chr19",1,0.0984528832630098
"21838","chr19.2645000.2650000","chr19.2780000.2785000",135000,21,1.43396e-06,2645000,2780000,2650000,2785000,"chr19",636133,1,6,5,12,"chr19",1,0.029535864978903
"21839","chr19.17420000.17425000","chr19.17535000.17540000",115000,16,0.003423039,17420000,17535000,17425000,17540000,"chr19",636144,4,6,9,19,"chr19",1,0.0356305672761369
"21840","chr19.4005000.4010000","chr19.4055000.4060000",50000,31,1.268103e-06,4005000,4055000,4010000,4060000,"chr19",636182,6,33,23,62,"chr19",1,0.225269573370839
"21841","chr19.18385000.18390000","chr19.18460000.18465000",75000,26,1.38361e-06,18385000,18460000,18390000,18465000,"chr19",636188,3,2,9,14,"chr19",1,0.0426629160806376
"21842","chr19.3345000.3350000","chr19.3375000.3380000",30000,43,3.260819e-08,3345000,3375000,3350000,3380000,"chr19",636231,8,28,26,62,"chr19",1,0.312470698546648
"21843","chr19.2150000.2155000","chr19.2380000.2385000",230000,14,0.0002613597,2150000,2380000,2155000,2385000,"chr19",636235,9,34,19,62,"chr19",1,0.101734646038444
"21844","chr19.52200000.52205000","chr19.52235000.52240000",35000,31,0.0002399242,52200000,52235000,52205000,52240000,"chr19",636245,1,4,2,7,"chr19",1,0.0254336615096109
"21845","chr19.46895000.46900000","chr19.47010000.47015000",115000,24,8.835185e-08,46895000,47010000,46900000,47015000,"chr19",636246,5,12,19,36,"chr19",1,0.10126582278481
"21846","chr19.6200000.6205000","chr19.6455000.6460000",255000,11,0.007017769,6200000,6455000,6205000,6460000,"chr19",636247,2,5,17,24,"chr19",1,0.0309423347398031
"21847","chr19.35640000.35645000","chr19.35740000.35745000",100000,21,3.026438e-05,35640000,35740000,35645000,35745000,"chr19",636262,0,15,1,16,"chr19",1,0.0393811533052039
"21848","chr19.50380000.50385000","chr19.50430000.50435000",50000,23,0.004395035,50380000,50430000,50385000,50435000,"chr19",636282,2,3,4,9,"chr19",1,0.0242616033755274
"21849","chr19.47425000.47430000","chr19.47465000.47470000",40000,28,0.000539888,47425000,47465000,47430000,47470000,"chr19",636369,3,9,2,14,"chr19",1,0.0459446788560713
"21850","chr19.56710000.56715000","chr19.56750000.56755000",40000,29,0.0002149935,56710000,56750000,56715000,56755000,"chr19",636375,1,6,2,9,"chr19",1,0.0305907172995781
"21851","chr19.38895000.38900000","chr19.39120000.39125000",225000,21,2.330374e-09,38895000,39120000,38900000,39125000,"chr19",636380,13,25,32,70,"chr19",1,0.172292545710267
"21852","chr19.3325000.3330000","chr19.3345000.3350000",20000,37,0.002384861,3325000,3345000,3330000,3350000,"chr19",636391,8,28,26,62,"chr19",1,0.268870135958744
"21853","chr19.2520000.2525000","chr19.2595000.2600000",75000,23,5.727509e-05,2520000,2595000,2525000,2600000,"chr19",636410,5,13,10,28,"chr19",1,0.0754805438349742
"21854","chr19.4865000.4870000","chr19.4965000.4970000",100000,18,0.001099799,4865000,4965000,4870000,4970000,"chr19",636411,0,10,8,18,"chr19",1,0.0379746835443038
"21855","chr19.2950000.2955000","chr19.3075000.3080000",125000,24,3.198137e-08,2950000,3075000,2955000,3080000,"chr19",636415,1,18,12,31,"chr19",1,0.0872011251758087
"21856","chr19.18290000.18295000","chr19.18470000.18475000",180000,17,3.079573e-05,18290000,18470000,18295000,18475000,"chr19",636431,1,5,4,10,"chr19",1,0.0199249882794187
"21857","chr19.12885000.12890000","chr19.12955000.12960000",70000,24,3.972185e-05,12885000,12955000,12890000,12960000,"chr19",636440,4,22,20,46,"chr19",1,0.129395218002813
"21858","chr19.18710000.18715000","chr19.18750000.18755000",40000,26,0.002907628,18710000,18750000,18715000,18755000,"chr19",636444,3,7,2,12,"chr19",1,0.0365682137834037
"21859","chr19.6360000.6365000","chr19.6460000.6465000",100000,18,0.001099799,6360000,6460000,6365000,6465000,"chr19",636475,8,13,15,36,"chr19",1,0.0759493670886076
"21860","chr19.11845000.11850000","chr19.12720000.12725000",875000,7,0.002907628,11845000,12720000,11850000,12725000,"chr19",636491,3,15,10,28,"chr19",1,0.0229723394280356
"21861","chr19.39460000.39465000","chr19.39540000.39545000",80000,19,0.002384861,39460000,39540000,39465000,39545000,"chr19",636503,5,31,18,54,"chr19",1,0.120253164556962
"21862","chr19.18685000.18690000","chr19.18935000.18940000",250000,12,0.002217,18685000,18935000,18690000,18940000,"chr19",636520,7,23,26,56,"chr19",1,0.0787623066104079
"21863","chr19.4140000.4145000","chr19.4185000.4190000",45000,35,5.075321e-08,4140000,4185000,4145000,4190000,"chr19",636532,9,32,30,71,"chr19",1,0.291256446319737
"21864","chr19.15415000.15420000","chr19.15430000.15435000",15000,36,0.004609976,15415000,15430000,15420000,15435000,"chr19",636594,1,4,12,17,"chr19",1,0.0717299578059072
"21865","chr19.45950000.45955000","chr19.45975000.45980000",25000,37,0.0005281227,45950000,45975000,45955000,45980000,"chr19",636622,5,11,4,20,"chr19",1,0.0867323019221753
"21866","chr19.13125000.13130000","chr19.13160000.13165000",35000,29,0.001308007,13125000,13160000,13130000,13165000,"chr19",636645,9,25,15,49,"chr19",1,0.166549460853258
"21867","chr19.14480000.14485000","chr19.14530000.14535000",50000,22,0.009804879,14480000,14530000,14485000,14535000,"chr19",636664,5,18,14,37,"chr19",1,0.0954055321143929
"21868","chr19.38895000.38900000","chr19.39110000.39115000",215000,23,9.785286e-11,38895000,39110000,38900000,39115000,"chr19",636672,2,8,2,12,"chr19",1,0.0323488045007032
"21869","chr19.40665000.40670000","chr19.40700000.40705000",35000,34,1.389882e-05,40665000,40700000,40670000,40705000,"chr19",636674,2,2,3,7,"chr19",1,0.0278949835911861
"21870","chr19.2540000.2545000","chr19.2600000.2605000",60000,27,9.571974e-06,2540000,2600000,2545000,2605000,"chr19",636700,7,21,31,59,"chr19",1,0.186708860759494
"21871","chr19.13845000.13850000","chr19.13970000.13975000",125000,18,0.0001817725,13845000,13970000,13850000,13975000,"chr19",636718,6,22,21,49,"chr19",1,0.10337552742616
"21872","chr19.11845000.11850000","chr19.12835000.12840000",990000,6,0.008122377,11845000,12835000,11850000,12840000,"chr19",636775,8,15,10,33,"chr19",1,0.0232067510548523
"21873","chr19.1900000.1905000","chr19.2070000.2075000",170000,19,2.728696e-06,1900000,2070000,1905000,2075000,"chr19",636796,6,39,33,78,"chr19",1,0.173699015471167
"21874","chr19.54200000.54205000","chr19.54230000.54235000",30000,30,0.005134157,54200000,54230000,54205000,54235000,"chr19",636803,0,3,3,6,"chr19",1,0.0210970464135021
"21875","chr19.6630000.6635000","chr19.6860000.6865000",230000,30,7.624838e-18,6630000,6860000,6635000,6865000,"chr19",636805,6,21,21,48,"chr19",1,0.168776371308017
"21876","chr19.14180000.14185000","chr19.14530000.14535000",350000,11,0.001052087,14180000,14530000,14185000,14535000,"chr19",636811,5,16,14,35,"chr19",1,0.0451242381622128
"21877","chr19.10730000.10735000","chr19.10765000.10770000",35000,28,0.002907628,10730000,10765000,10735000,10770000,"chr19",636827,4,1,7,12,"chr19",1,0.0393811533052039
"21878","chr19.43685000.43690000","chr19.43770000.43775000",85000,33,4.988249e-12,43685000,43770000,43690000,43775000,"chr19",636835,2,11,14,27,"chr19",1,0.104430379746835
"21879","chr19.11345000.11350000","chr19.11690000.11695000",345000,12,0.0002410528,11345000,11690000,11350000,11695000,"chr19",636836,1,9,9,19,"chr19",1,0.0267229254571027
"21880","chr19.4985000.4990000","chr19.5575000.5580000",590000,10,0.0001336972,4985000,5575000,4990000,5580000,"chr19",636855,5,15,16,36,"chr19",1,0.0421940928270042
"21881","chr19.5900000.5905000","chr19.5945000.5950000",45000,37,3.861463e-09,5900000,5945000,5905000,5950000,"chr19",636861,0,2,3,5,"chr19",1,0.0216830754805438
"21882","chr19.6740000.6745000","chr19.6860000.6865000",120000,16,0.002564687,6740000,6860000,6745000,6865000,"chr19",636898,6,21,21,48,"chr19",1,0.090014064697609
"21883","chr19.15315000.15320000","chr19.15625000.15630000",310000,10,0.008437098,15315000,15625000,15320000,15630000,"chr19",636912,0,6,2,8,"chr19",1,0.00937646507266761
"21884","chr19.13275000.13280000","chr19.14135000.14140000",860000,8,0.0004775756,13275000,14135000,13280000,14140000,"chr19",636950,1,12,7,20,"chr19",1,0.0187529301453352
"21885","chr19.11920000.11925000","chr19.12645000.12650000",725000,7,0.007785541,11920000,12645000,11925000,12650000,"chr19",636957,5,18,16,39,"chr19",1,0.0319971870604782
"21886","chr19.2155000.2160000","chr19.2265000.2270000",110000,33,3.511122e-14,2155000,2265000,2160000,2270000,"chr19",636984,12,41,42,95,"chr19",1,0.367440225035162
"21887","chr19.40280000.40285000","chr19.40500000.40505000",220000,18,7.300835e-07,40280000,40500000,40285000,40505000,"chr19",636991,1,9,12,22,"chr19",1,0.0464135021097046
"21888","chr19.1895000.1900000","chr19.1995000.2000000",100000,18,0.001099799,1895000,1995000,1900000,2e+06,"chr19",637000,7,28,24,59,"chr19",1,0.124472573839662
"21889","chr19.41955000.41960000","chr19.42070000.42075000",115000,23,3.988488e-07,41955000,42070000,41960000,42075000,"chr19",637029,4,3,3,10,"chr19",1,0.0269573370839194
"21890","chr19.49145000.49150000","chr19.49335000.49340000",190000,25,1.489721e-11,49145000,49335000,49150000,49340000,"chr19",637030,1,5,5,11,"chr19",1,0.0322315986872949
"21891","chr19.10610000.10615000","chr19.10650000.10655000",40000,48,1.165674e-14,10610000,10650000,10615000,10655000,"chr19",637045,7,21,24,52,"chr19",1,0.292545710267229
"21892","chr19.7515000.7520000","chr19.7630000.7635000",115000,25,1.811814e-08,7515000,7630000,7520000,7635000,"chr19",637058,3,8,10,21,"chr19",1,0.0615330520393812
"21893","chr19.4865000.4870000","chr19.5030000.5035000",165000,14,0.003251169,4865000,5030000,4870000,5035000,"chr19",637065,0,10,8,18,"chr19",1,0.029535864978903
"21894","chr19.48465000.48470000","chr19.48780000.48785000",315000,11,0.001980271,48465000,48780000,48470000,48785000,"chr19",637080,0,7,5,12,"chr19",1,0.0154711673699015
"21895","chr19.1100000.1105000","chr19.1190000.1195000",90000,29,1.1731e-09,1100000,1190000,1105000,1195000,"chr19",637086,5,18,18,41,"chr19",1,0.139357712142522
"21896","chr19.2750000.2755000","chr19.2775000.2780000",25000,36,0.00110474,2750000,2775000,2755000,2780000,"chr19",637096,6,12,18,36,"chr19",1,0.151898734177215
"21897","chr19.4245000.4250000","chr19.4325000.4330000",80000,30,1.743066e-09,4245000,4325000,4250000,4330000,"chr19",637104,3,5,9,17,"chr19",1,0.059774964838256
"21898","chr19.47265000.47270000","chr19.47345000.47350000",80000,18,0.00618472,47265000,47345000,47270000,47350000,"chr19",637114,3,11,10,24,"chr19",1,0.0506329113924051
"21899","chr19.4185000.4190000","chr19.4410000.4415000",225000,12,0.004529666,4185000,4410000,4190000,4415000,"chr19",637145,8,27,25,60,"chr19",1,0.0843881856540084
"21900","chr19.18460000.18465000","chr19.18515000.18520000",55000,27,3.180048e-05,18460000,18515000,18465000,18520000,"chr19",637163,3,2,9,14,"chr19",1,0.0443037974683544
"21901","chr19.18570000.18575000","chr19.18685000.18690000",115000,15,0.009573557,18570000,18685000,18575000,18690000,"chr19",637183,7,20,18,45,"chr19",1,0.0791139240506329
"21902","chr19.1895000.1900000","chr19.2060000.2065000",165000,26,2.179597e-11,1895000,2060000,1900000,2065000,"chr19",637201,8,35,32,75,"chr19",1,0.228551336146273
"21903","chr19.51885000.51890000","chr19.52185000.52190000",300000,10,0.009962913,51885000,52185000,51890000,52190000,"chr19",637202,0,4,2,6,"chr19",1,0.0070323488045007
"21904","chr19.5900000.5905000","chr19.5960000.5965000",60000,27,9.571974e-06,5900000,5960000,5905000,5965000,"chr19",637220,2,4,6,12,"chr19",1,0.0379746835443038
"21905","chr19.13455000.13460000","chr19.13620000.13625000",165000,13,0.009962913,13455000,13620000,13460000,13625000,"chr19",637222,3,7,13,23,"chr19",1,0.0350445382090952
"21906","chr19.5720000.5725000","chr19.6390000.6395000",670000,8,0.002186832,5720000,6390000,5725000,6395000,"chr19",637236,9,15,23,47,"chr19",1,0.0440693858415377
"21907","chr19.12910000.12915000","chr19.12985000.12990000",75000,18,0.009962913,12910000,12985000,12915000,12990000,"chr19",637238,1,1,9,11,"chr19",1,0.0232067510548523
"21908","chr19.10700000.10705000","chr19.10760000.10765000",60000,23,0.0007156404,10700000,10760000,10705000,10765000,"chr19",637248,9,12,15,36,"chr19",1,0.0970464135021097
"21909","chr19.12400000.12405000","chr19.12550000.12555000",150000,83,5.187462e-74,12400000,12550000,12405000,12555000,"chr19",637254,2,10,6,18,"chr19",1,0.175105485232068
"21910","chr19.530000.535000","chr19.570000.575000",40000,25,0.006352757,530000,570000,535000,575000,"chr19",637260,1,10,7,18,"chr19",1,0.0527426160337553
"21911","chr19.47600000.47605000","chr19.47750000.47755000",150000,14,0.005916382,47600000,47750000,47605000,47755000,"chr19",637262,3,5,3,11,"chr19",1,0.0180496952648851
"21912","chr19.980000.985000","chr19.1190000.1195000",210000,19,2.298657e-07,980000,1190000,985000,1195000,"chr19",637266,9,22,24,55,"chr19",1,0.122480075011721
"21913","chr19.4725000.4730000","chr19.4805000.4810000",80000,29,7.948693e-09,4725000,4805000,4730000,4810000,"chr19",637281,12,39,35,86,"chr19",1,0.292311298640413
"21914","chr19.47435000.47440000","chr19.47465000.47470000",30000,35,9.828778e-05,47435000,47465000,47440000,47470000,"chr19",637283,3,9,2,14,"chr19",1,0.0574308485700891
"21915","chr19.3335000.3340000","chr19.3445000.3450000",110000,19,0.0001512444,3335000,3445000,3340000,3450000,"chr19",637296,3,5,20,28,"chr19",1,0.0623534927332396
"21916","chr19.38930000.38935000","chr19.39535000.39540000",605000,8,0.003986847,38930000,39535000,38935000,39540000,"chr19",637319,3,8,9,20,"chr19",1,0.0187529301453352
"21917","chr19.46925000.46930000","chr19.46975000.46980000",50000,24,0.00185032,46925000,46975000,46930000,46980000,"chr19",637321,0,2,0,2,"chr19",1,0.00562587904360056
"21918","chr19.5900000.5905000","chr19.5965000.5970000",65000,50,2.085723e-22,5900000,5965000,5905000,5970000,"chr19",637323,0,3,0,3,"chr19",1,0.0175808720112518
"21919","chr19.2745000.2750000","chr19.2785000.2790000",40000,25,0.006352757,2745000,2785000,2750000,2790000,"chr19",637335,5,15,27,47,"chr19",1,0.137716830754805
"21920","chr19.4850000.4855000","chr19.4910000.4915000",60000,25,9.196901e-05,4850000,4910000,4855000,4915000,"chr19",637336,5,7,6,18,"chr19",1,0.0527426160337553
"21921","chr19.4800000.4805000","chr19.4910000.4915000",110000,18,0.0005109813,4800000,4910000,4805000,4915000,"chr19",637338,5,7,6,18,"chr19",1,0.0379746835443038
"21922","chr19.18045000.18050000","chr19.18160000.18165000",115000,18,0.000350699,18045000,18160000,18050000,18165000,"chr19",637339,1,11,19,31,"chr19",1,0.0654008438818565
"21923","chr19.2475000.2480000","chr19.2635000.2640000",160000,22,4.309614e-08,2475000,2635000,2480000,2640000,"chr19",637347,0,1,1,2,"chr19",1,0.00515705578996718
"21924","chr19.6515000.6520000","chr19.6860000.6865000",345000,16,1.863845e-07,6515000,6860000,6520000,6865000,"chr19",637353,3,21,11,35,"chr19",1,0.0656352555086732
"21925","chr19.54160000.54165000","chr19.54230000.54235000",70000,20,0.002739872,54160000,54230000,54165000,54235000,"chr19",637368,0,3,3,6,"chr19",1,0.0140646976090014
"21926","chr19.40660000.40665000","chr19.40715000.40720000",55000,22,0.004393008,40660000,40715000,40665000,40720000,"chr19",637387,0,3,1,4,"chr19",1,0.0103141115799344
"21927","chr19.4830000.4835000","chr19.4870000.4875000",40000,29,0.0002149935,4830000,4870000,4835000,4875000,"chr19",637403,12,26,31,69,"chr19",1,0.234528832630098
"21928","chr19.49150000.49155000","chr19.49335000.49340000",185000,26,3.303981e-12,49150000,49335000,49155000,49340000,"chr19",637410,0,2,4,6,"chr19",1,0.0182841068917018
"21929","chr19.10385000.10390000","chr19.10500000.10505000",115000,27,6.910008e-10,10385000,10500000,10390000,10505000,"chr19",637435,3,17,15,35,"chr19",1,0.110759493670886
"21930","chr19.1040000.1045000","chr19.1210000.1215000",170000,13,0.008398178,1040000,1210000,1045000,1215000,"chr19",637444,0,2,2,4,"chr19",1,0.00609470229723394
"21931","chr19.45470000.45475000","chr19.45690000.45695000",220000,12,0.005163818,45470000,45690000,45475000,45695000,"chr19",637448,3,1,3,7,"chr19",1,0.00984528832630099
"21932","chr19.3405000.3410000","chr19.3425000.3430000",20000,41,0.0001275693,3405000,3425000,3410000,3430000,"chr19",637459,10,30,32,72,"chr19",1,0.345991561181435
"21933","chr19.13880000.13885000","chr19.13965000.13970000",85000,18,0.003986847,13880000,13965000,13885000,13970000,"chr19",637461,2,1,2,5,"chr19",1,0.0105485232067511
"21934","chr19.17475000.17480000","chr19.18005000.18010000",530000,8,0.008288386,17475000,18005000,17480000,18010000,"chr19",637480,2,14,15,31,"chr19",1,0.0290670417252696
"21935","chr19.45485000.45490000","chr19.45860000.45865000",375000,11,0.0006743265,45485000,45860000,45490000,45865000,"chr19",637481,4,19,15,38,"chr19",1,0.0489920300046882
"21936","chr19.47130000.47135000","chr19.47175000.47180000",45000,26,0.000850976,47130000,47175000,47135000,47180000,"chr19",637490,8,19,10,37,"chr19",1,0.112751992498828
"21937","chr19.3335000.3340000","chr19.3405000.3410000",70000,28,2.601012e-07,3335000,3405000,3340000,3410000,"chr19",637495,4,5,20,29,"chr19",1,0.0951711204875762
"21938","chr19.2455000.2460000","chr19.2595000.2600000",140000,17,0.0002705186,2455000,2595000,2460000,2600000,"chr19",637510,5,19,21,45,"chr19",1,0.089662447257384
"21939","chr19.44110000.44115000","chr19.44165000.44170000",55000,21,0.009962913,44110000,44165000,44115000,44170000,"chr19",637512,1,7,6,14,"chr19",1,0.0344585091420534
"21940","chr19.3340000.3345000","chr19.3405000.3410000",65000,25,3.1669e-05,3340000,3405000,3345000,3410000,"chr19",637526,7,22,20,49,"chr19",1,0.143577121425223
"21941","chr19.2460000.2465000","chr19.2595000.2600000",135000,17,0.0003512967,2460000,2595000,2465000,2600000,"chr19",637537,5,19,16,40,"chr19",1,0.0796999531176746
"21942","chr19.38210000.38215000","chr19.38255000.38260000",45000,24,0.004627476,38210000,38255000,38215000,38260000,"chr19",637540,5,13,19,37,"chr19",1,0.10407876230661
"21943","chr19.46635000.46640000","chr19.47175000.47180000",540000,8,0.00740459,46635000,47175000,46640000,47180000,"chr19",637544,1,4,2,7,"chr19",1,0.00656352555086732
"21944","chr19.7515000.7520000","chr19.7590000.7595000",75000,18,0.009962913,7515000,7590000,7520000,7595000,"chr19",637553,6,12,17,35,"chr19",1,0.0738396624472574
"21945","chr19.11200000.11205000","chr19.11240000.11245000",40000,37,3.701954e-08,11200000,11240000,11205000,11245000,"chr19",637559,2,3,3,8,"chr19",1,0.0346929207688701
"21946","chr19.55630000.55635000","chr19.56140000.56145000",510000,13,1.310676e-06,55630000,56140000,55635000,56145000,"chr19",637570,2,1,0,3,"chr19",1,0.00457102672292546
"21947","chr19.4340000.4345000","chr19.4400000.4405000",60000,24,0.0002613597,4340000,4400000,4345000,4405000,"chr19",637572,0,7,7,14,"chr19",1,0.0393811533052039
"21948","chr19.11290000.11295000","chr19.11500000.11505000",210000,14,0.0005539847,11290000,11500000,11295000,11505000,"chr19",637594,4,20,10,34,"chr19",1,0.0557899671823722
"21949","chr19.920000.925000","chr19.980000.985000",60000,77,1.055467e-45,920000,980000,925000,985000,"chr19",637601,9,22,24,55,"chr19",1,0.496366619784341
"21950","chr19.1020000.1025000","chr19.1040000.1045000",20000,55,1.780642e-10,1020000,1040000,1025000,1045000,"chr19",637643,0,2,2,4,"chr19",1,0.0257852789498359
"21951","chr19.12580000.12585000","chr19.12600000.12605000",20000,35,0.008589977,12580000,12600000,12585000,12605000,"chr19",637659,3,11,20,34,"chr19",1,0.139474917955931
"21952","chr19.17965000.17970000","chr19.18045000.18050000",80000,27,1.451103e-07,17965000,18045000,17970000,18050000,"chr19",637691,1,7,7,15,"chr19",1,0.0474683544303797
"21953","chr19.5910000.5915000","chr19.5960000.5965000",50000,27,0.0001045479,5910000,5960000,5915000,5965000,"chr19",637707,2,4,6,12,"chr19",1,0.0379746835443038
"21954","chr19.49145000.49150000","chr19.49330000.49335000",185000,19,1.053552e-06,49145000,49330000,49150000,49335000,"chr19",637722,4,21,13,38,"chr19",1,0.0846225972808251
"21955","chr19.2500000.2505000","chr19.2525000.2530000",25000,39,0.0001056016,2500000,2525000,2505000,2530000,"chr19",637725,2,9,11,22,"chr19",1,0.10056258790436
"21956","chr19.46630000.46635000","chr19.46745000.46750000",115000,16,0.003423039,46630000,46745000,46635000,46750000,"chr19",637728,2,6,5,13,"chr19",1,0.0243788091889358
"21957","chr19.10110000.10115000","chr19.10190000.10195000",80000,19,0.002384861,10110000,10190000,10115000,10195000,"chr19",637736,2,4,0,6,"chr19",1,0.0133614627285513
"21958","chr19.2015000.2020000","chr19.2070000.2075000",55000,24,0.0007085265,2015000,2070000,2020000,2075000,"chr19",637749,6,38,33,77,"chr19",1,0.216596343178622
"21959","chr19.37505000.37510000","chr19.38245000.38250000",740000,7,0.007000009,37505000,38245000,37510000,38250000,"chr19",637750,0,3,1,4,"chr19",1,0.00328176277543366
"21960","chr19.39120000.39125000","chr19.39340000.39345000",220000,14,0.0003738737,39120000,39340000,39125000,39345000,"chr19",637760,0,5,2,7,"chr19",1,0.0114861697140178
"21961","chr19.5720000.5725000","chr19.5900000.5905000",180000,16,0.0001279233,5720000,5900000,5725000,5905000,"chr19",637789,2,7,14,23,"chr19",1,0.043131739334271
"21962","chr19.18685000.18690000","chr19.18995000.19000000",310000,13,0.0001043785,18685000,18995000,18690000,1.9e+07,"chr19",637790,6,23,25,54,"chr19",1,0.0822784810126582
"21963","chr19.10695000.10700000","chr19.10730000.10735000",35000,42,1.706181e-09,10695000,10730000,10700000,10735000,"chr19",637806,11,22,19,52,"chr19",1,0.255977496483826
"21964","chr19.3355000.3360000","chr19.3395000.3400000",40000,29,0.0002149935,3355000,3395000,3360000,3400000,"chr19",637827,7,11,22,40,"chr19",1,0.13595874355368
"21965","chr19.11585000.11590000","chr19.11635000.11640000",50000,32,3.830421e-07,11585000,11635000,11590000,11640000,"chr19",637838,11,15,18,44,"chr19",1,0.16502578527895
"21966","chr19.4805000.4810000","chr19.4870000.4875000",65000,22,0.0008062846,4805000,4870000,4810000,4875000,"chr19",637850,13,31,35,79,"chr19",1,0.203703703703704
"21967","chr19.49420000.49425000","chr19.49450000.49455000",30000,33,0.000539888,49420000,49450000,49425000,49455000,"chr19",637879,2,5,6,13,"chr19",1,0.05028129395218
"21968","chr19.47130000.47135000","chr19.47155000.47160000",25000,59,5.502837e-14,47130000,47155000,47135000,47160000,"chr19",637884,7,19,10,36,"chr19",1,0.248945147679325
"21969","chr19.1895000.1900000","chr19.2065000.2070000",170000,18,1.234958e-05,1895000,2065000,1900000,2070000,"chr19",637885,9,36,41,86,"chr19",1,0.181434599156118
"21970","chr19.2495000.2500000","chr19.2600000.2605000",105000,22,4.666449e-06,2495000,2600000,2500000,2605000,"chr19",637891,2,10,8,20,"chr19",1,0.0515705578996718
"21971","chr19.6280000.6285000","chr19.6360000.6365000",80000,19,0.002384861,6280000,6360000,6285000,6365000,"chr19",637893,8,13,15,36,"chr19",1,0.080168776371308
"21972","chr19.5900000.5905000","chr19.5985000.5990000",85000,23,1.392645e-05,5900000,5985000,5905000,5990000,"chr19",637911,2,7,14,23,"chr19",1,0.0620018752930145
"21973","chr19.18645000.18650000","chr19.18945000.18950000",300000,11,0.002622576,18645000,18945000,18650000,18950000,"chr19",637931,2,6,0,8,"chr19",1,0.0103141115799344
"21974","chr19.7625000.7630000","chr19.7900000.7905000",275000,11,0.00451266,7625000,7900000,7630000,7905000,"chr19",637950,0,2,0,2,"chr19",1,0.00257852789498359
"21975","chr19.2475000.2480000","chr19.2575000.2580000",100000,29,2.133318e-10,2475000,2575000,2480000,2580000,"chr19",637963,1,1,1,3,"chr19",1,0.010196905766526
"21976","chr19.10590000.10595000","chr19.10935000.10940000",345000,11,0.001148295,10590000,10935000,10595000,10940000,"chr19",637969,14,47,39,100,"chr19",1,0.12892639474918
"21977","chr19.18710000.18715000","chr19.18930000.18935000",220000,13,0.001474998,18710000,18930000,18715000,18935000,"chr19",637984,3,7,2,12,"chr19",1,0.0182841068917018
"21978","chr19.42385000.42390000","chr19.42460000.42465000",75000,40,3.847016e-16,42385000,42460000,42390000,42465000,"chr19",637990,0,8,7,15,"chr19",1,0.070323488045007
"21979","chr19.48110000.48115000","chr19.48200000.48205000",90000,27,2.596232e-08,48110000,48200000,48115000,48205000,"chr19",637991,2,10,7,19,"chr19",1,0.060126582278481
"21980","chr19.38400000.38405000","chr19.38655000.38660000",255000,12,0.001939399,38400000,38655000,38405000,38660000,"chr19",637992,7,13,7,27,"chr19",1,0.0379746835443038
"21981","chr19.2490000.2495000","chr19.2575000.2580000",85000,19,0.001440986,2490000,2575000,2495000,2580000,"chr19",638009,1,8,8,17,"chr19",1,0.0378574777308955
"21982","chr19.2645000.2650000","chr19.2775000.2780000",130000,19,3.543823e-05,2645000,2775000,2650000,2780000,"chr19",638016,6,12,18,36,"chr19",1,0.080168776371308
"21983","chr19.18645000.18650000","chr19.18930000.18935000",285000,12,0.000894079,18645000,18930000,18650000,18935000,"chr19",638019,2,6,0,8,"chr19",1,0.0112517580872011
"21984","chr19.920000.925000","chr19.1190000.1195000",270000,16,2.299961e-06,920000,1190000,925000,1195000,"chr19",638023,9,31,34,74,"chr19",1,0.138771683075481
"21985","chr19.7095000.7100000","chr19.7515000.7520000",420000,10,0.00153892,7095000,7515000,7100000,7520000,"chr19",638024,3,12,4,19,"chr19",1,0.0222691045475856
"21986","chr19.18385000.18390000","chr19.18505000.18510000",120000,15,0.00740459,18385000,18505000,18390000,18510000,"chr19",638037,4,12,9,25,"chr19",1,0.0439521800281294
"21987","chr19.11445000.11450000","chr19.11585000.11590000",140000,19,1.84415e-05,11445000,11585000,11450000,11590000,"chr19",638043,0,5,3,8,"chr19",1,0.0178152836380684
"21988","chr19.40640000.40645000","chr19.40665000.40670000",25000,35,0.002234426,40640000,40665000,40645000,40670000,"chr19",638055,2,8,3,13,"chr19",1,0.053328645100797
"21989","chr19.18290000.18295000","chr19.18485000.18490000",195000,13,0.003466155,18290000,18485000,18295000,18490000,"chr19",638088,0,3,1,4,"chr19",1,0.00609470229723394
"21990","chr19.920000.925000","chr19.1240000.1245000",320000,19,9.90652e-10,920000,1240000,925000,1245000,"chr19",638137,9,31,34,74,"chr19",1,0.164791373652133
"21991","chr19.46575000.46580000","chr19.46755000.46760000",180000,21,5.250704e-08,46575000,46755000,46580000,46760000,"chr19",638152,11,8,17,36,"chr19",1,0.0886075949367089
"21992","chr19.6455000.6460000","chr19.6630000.6635000",175000,13,0.006971328,6455000,6630000,6460000,6635000,"chr19",638158,2,5,17,24,"chr19",1,0.0365682137834037
"21993","chr19.3345000.3350000","chr19.3385000.3390000",40000,33,3.717034e-06,3345000,3385000,3350000,3390000,"chr19",638159,5,19,7,31,"chr19",1,0.119901547116737
"21994","chr19.12790000.12795000","chr19.12870000.12875000",80000,18,0.00618472,12790000,12870000,12795000,12875000,"chr19",638170,1,10,8,19,"chr19",1,0.040084388185654
"21995","chr19.29500000.29505000","chr19.29520000.29525000",20000,37,0.002384861,29500000,29520000,29505000,29525000,"chr19",638195,0,2,0,2,"chr19",1,0.00867323019221753
"21996","chr19.2680000.2685000","chr19.2745000.2750000",65000,24,9.828778e-05,2680000,2745000,2685000,2750000,"chr19",638203,12,47,45,104,"chr19",1,0.292545710267229
"21997","chr19.37250000.37255000","chr19.38000000.38005000",750000,8,0.001128448,37250000,3.8e+07,37255000,38005000,"chr19",638220,0,11,7,18,"chr19",1,0.0168776371308017
"21998","chr19.18515000.18520000","chr19.18935000.18940000",420000,9,0.006790763,18515000,18935000,18520000,18940000,"chr19",638230,9,17,23,49,"chr19",1,0.0516877637130802
"21999","chr19.54160000.54165000","chr19.54190000.54195000",30000,32,0.001187867,54160000,54190000,54165000,54195000,"chr19",638267,0,15,12,27,"chr19",1,0.10126582278481
"22000","chr19.4800000.4805000","chr19.4855000.4860000",55000,21,0.009962913,4800000,4855000,4805000,4860000,"chr19",638271,12,18,20,50,"chr19",1,0.123066104078762
"22001","chr19.4805000.4810000","chr19.4850000.4855000",45000,41,1.675217e-11,4805000,4850000,4810000,4855000,"chr19",638272,15,39,35,89,"chr19",1,0.427684013127051
"22002","chr19.47750000.47755000","chr19.47770000.47775000",20000,37,0.002384861,47750000,47770000,47755000,47775000,"chr19",638285,3,5,3,11,"chr19",1,0.0477027660571964
"22003","chr19.55635000.55640000","chr19.56140000.56145000",505000,9,0.002323305,55635000,56140000,55640000,56145000,"chr19",638291,2,1,0,3,"chr19",1,0.00316455696202532
"22004","chr19.39140000.39145000","chr19.39325000.39330000",185000,19,1.053552e-06,39140000,39325000,39145000,39330000,"chr19",638293,8,12,16,36,"chr19",1,0.080168776371308
"22005","chr19.6515000.6520000","chr19.7065000.7070000",550000,8,0.006710529,6515000,7065000,6520000,7070000,"chr19",638305,3,12,11,26,"chr19",1,0.0243788091889358
"22006","chr19.11635000.11640000","chr19.11670000.11675000",35000,31,0.0002399242,11635000,11670000,11640000,11675000,"chr19",638312,0,9,11,20,"chr19",1,0.0726676043131739
"22007","chr19.3325000.3330000","chr19.3510000.3515000",185000,16,0.000100971,3325000,3510000,3330000,3515000,"chr19",638314,5,6,6,17,"chr19",1,0.0318799812470699
"22008","chr19.48805000.48810000","chr19.49085000.49090000",280000,11,0.004043892,48805000,49085000,48810000,49090000,"chr19",638319,7,20,21,48,"chr19",1,0.0618846694796062
"22009","chr19.12510000.12515000","chr19.12660000.12665000",150000,18,4.024957e-05,12510000,12660000,12515000,12665000,"chr19",638332,0,10,6,16,"chr19",1,0.0337552742616034
"22010","chr19.4830000.4835000","chr19.4975000.4980000",145000,18,5.442317e-05,4830000,4975000,4835000,4980000,"chr19",638334,2,6,6,14,"chr19",1,0.029535864978903
"22011","chr19.6515000.6520000","chr19.6735000.6740000",220000,17,3.83318e-06,6515000,6735000,6520000,6740000,"chr19",638349,2,4,10,16,"chr19",1,0.0318799812470699
"22012","chr19.48085000.48090000","chr19.48190000.48195000",105000,22,4.666449e-06,48085000,48190000,48090000,48195000,"chr19",638351,1,4,3,8,"chr19",1,0.0206282231598687
"22013","chr19.2780000.2785000","chr19.2840000.2845000",60000,23,0.0007156404,2780000,2840000,2785000,2845000,"chr19",638361,1,6,5,12,"chr19",1,0.0323488045007032
"22014","chr19.47695000.47700000","chr19.47750000.47755000",55000,21,0.009962913,47695000,47750000,47700000,47755000,"chr19",638375,3,5,3,11,"chr19",1,0.0270745428973277
"22015","chr19.2945000.2950000","chr19.3060000.3065000",115000,18,0.000350699,2945000,3060000,2950000,3065000,"chr19",638377,2,11,12,25,"chr19",1,0.0527426160337553
"22016","chr19.6460000.6465000","chr19.6505000.6510000",45000,24,0.004627476,6460000,6505000,6465000,6510000,"chr19",638386,9,31,27,67,"chr19",1,0.188466947960619
"22017","chr19.2645000.2650000","chr19.2680000.2685000",35000,32,9.632462e-05,2645000,2680000,2650000,2685000,"chr19",638396,10,31,34,75,"chr19",1,0.281293952180028
"22018","chr19.6195000.6200000","chr19.6280000.6285000",85000,22,4.842908e-05,6195000,6280000,6200000,6285000,"chr19",638401,7,19,24,50,"chr19",1,0.12892639474918
"22019","chr19.2155000.2160000","chr19.2280000.2285000",125000,21,3.089493e-06,2155000,2280000,2160000,2285000,"chr19",638424,12,29,27,68,"chr19",1,0.167369901547117
"22020","chr19.2685000.2690000","chr19.2745000.2750000",60000,22,0.001858745,2685000,2745000,2690000,2750000,"chr19",638431,6,15,18,39,"chr19",1,0.10056258790436
"22021","chr19.11455000.11460000","chr19.11490000.11495000",35000,29,0.001308007,11455000,11490000,11460000,11495000,"chr19",638440,6,22,14,42,"chr19",1,0.142756680731364
"22022","chr19.10695000.10700000","chr19.10765000.10770000",70000,20,0.002739872,10695000,10765000,10700000,10770000,"chr19",638452,4,1,7,12,"chr19",1,0.0281293952180028
"22023","chr19.38140000.38145000","chr19.38260000.38265000",120000,18,0.0002527435,38140000,38260000,38145000,38265000,"chr19",638461,1,6,2,9,"chr19",1,0.0189873417721519
"22024","chr19.2235000.2240000","chr19.2610000.2615000",375000,12,0.0001318677,2235000,2610000,2240000,2615000,"chr19",638468,7,18,20,45,"chr19",1,0.0632911392405063
"22025","chr19.18045000.18050000","chr19.18110000.18115000",65000,42,4.474484e-16,18045000,18110000,18050000,18115000,"chr19",638478,1,11,19,31,"chr19",1,0.152601969057665
"22026","chr19.2475000.2480000","chr19.2625000.2630000",150000,18,4.024957e-05,2475000,2625000,2480000,2630000,"chr19",638540,1,1,1,3,"chr19",1,0.00632911392405063
"22027","chr19.10810000.10815000","chr19.11040000.11045000",230000,13,0.001066595,10810000,11040000,10815000,11045000,"chr19",638545,2,9,6,17,"chr19",1,0.0259024847632443
"22028","chr19.58510000.58515000","chr19.58570000.58575000",60000,21,0.004609976,58510000,58570000,58515000,58575000,"chr19",638552,0,2,2,4,"chr19",1,0.00984528832630099
"22029","chr19.57190000.57195000","chr19.57610000.57615000",420000,14,1.28244e-06,57190000,57610000,57195000,57615000,"chr19",638554,0,2,2,4,"chr19",1,0.00656352555086732
"22030","chr19.18385000.18390000","chr19.18520000.18525000",135000,17,0.0003512967,18385000,18520000,18390000,18525000,"chr19",638559,6,13,9,28,"chr19",1,0.0557899671823722
"22031","chr19.12675000.12680000","chr19.13665000.13670000",990000,6,0.008122377,12675000,13665000,12680000,13670000,"chr19",638561,7,13,19,39,"chr19",1,0.0274261603375527
"22032","chr19.16830000.16835000","chr19.17265000.17270000",435000,11,0.0002399242,16830000,17265000,16835000,17270000,"chr19",638568,1,11,5,17,"chr19",1,0.0219174871073605
"22033","chr19.4805000.4810000","chr19.4855000.4860000",50000,32,3.830421e-07,4805000,4855000,4810000,4860000,"chr19",638572,16,39,20,75,"chr19",1,0.281293952180028
"22034","chr19.45520000.45525000","chr19.45555000.45560000",35000,34,1.389882e-05,45520000,45555000,45525000,45560000,"chr19",638584,6,14,6,26,"chr19",1,0.103609939052977
"22035","chr19.38890000.38895000","chr19.39445000.39450000",555000,8,0.006352757,38890000,39445000,38895000,39450000,"chr19",638602,6,16,11,33,"chr19",1,0.0309423347398031
"22036","chr19.46575000.46580000","chr19.46745000.46750000",170000,17,5.300745e-05,46575000,46745000,46580000,46750000,"chr19",638604,4,11,10,25,"chr19",1,0.0498124706985466
"22037","chr19.11040000.11045000","chr19.11200000.11205000",160000,22,4.309614e-08,11040000,11200000,11045000,11205000,"chr19",638605,2,3,3,8,"chr19",1,0.0206282231598687
"22038","chr19.2675000.2680000","chr19.2780000.2785000",105000,22,4.666449e-06,2675000,2780000,2680000,2785000,"chr19",638610,1,6,4,11,"chr19",1,0.0283638068448195
"22039","chr19.47515000.47520000","chr19.47615000.47620000",100000,16,0.008589977,47515000,47615000,47520000,47620000,"chr19",638619,5,22,18,45,"chr19",1,0.0843881856540084
"22040","chr19.49145000.49150000","chr19.49470000.49475000",325000,16,3.41216e-07,49145000,49470000,49150000,49475000,"chr19",638621,4,21,13,38,"chr19",1,0.0712611345522738
"22041","chr19.48855000.48860000","chr19.49085000.49090000",230000,16,1.224226e-05,48855000,49085000,48860000,49090000,"chr19",638624,8,33,31,72,"chr19",1,0.135021097046413
"22042","chr19.2640000.2645000","chr19.2780000.2785000",140000,21,9.905351e-07,2640000,2780000,2645000,2785000,"chr19",638647,1,6,5,12,"chr19",1,0.029535864978903
"22043","chr19.45520000.45525000","chr19.45605000.45610000",85000,18,0.003986847,45520000,45605000,45525000,45610000,"chr19",638653,6,14,6,26,"chr19",1,0.0548523206751055
"22044","chr19.13985000.13990000","chr19.14245000.14250000",260000,16,3.424979e-06,13985000,14245000,13990000,14250000,"chr19",638659,1,6,10,17,"chr19",1,0.0318799812470699
"22045","chr19.4830000.4835000","chr19.4905000.4910000",75000,19,0.004022159,4830000,4905000,4835000,4910000,"chr19",638677,4,26,16,46,"chr19",1,0.102437880918894
"22046","chr19.1315000.1320000","chr19.1345000.1350000",30000,31,0.002502255,1315000,1345000,1320000,1350000,"chr19",638681,9,25,29,63,"chr19",1,0.228902953586498
"22047","chr19.4865000.4870000","chr19.4910000.4915000",45000,44,2.150173e-13,4865000,4910000,4870000,4915000,"chr19",638688,0,7,6,13,"chr19",1,0.0670417252695734
"22048","chr19.2645000.2650000","chr19.2750000.2755000",105000,35,2.011976e-15,2645000,2750000,2650000,2755000,"chr19",638694,6,31,26,63,"chr19",1,0.258438818565401
"22049","chr19.38635000.38640000","chr19.38720000.38725000",85000,28,1.36942e-08,38635000,38720000,38640000,38725000,"chr19",638723,3,7,5,15,"chr19",1,0.0492264416315049
"22050","chr19.6110000.6115000","chr19.6455000.6460000",345000,10,0.004745102,6110000,6455000,6115000,6460000,"chr19",638729,2,5,17,24,"chr19",1,0.0281293952180028
"22051","chr19.18700000.18705000","chr19.18935000.18940000",235000,12,0.003379023,18700000,18935000,18705000,18940000,"chr19",638742,11,34,26,71,"chr19",1,0.09985935302391
"22052","chr19.10650000.10655000","chr19.10810000.10815000",160000,17,9.232441e-05,10650000,10810000,10655000,10815000,"chr19",638752,2,9,6,17,"chr19",1,0.0338724800750117
"22053","chr19.35865000.35870000","chr19.35930000.35935000",65000,23,0.000285034,35865000,35930000,35870000,35935000,"chr19",638760,1,6,0,7,"chr19",1,0.0188701359587436
"22054","chr19.57900000.57905000","chr19.57945000.57950000",45000,34,1.713283e-07,57900000,57945000,57905000,57950000,"chr19",638780,0,0,6,6,"chr19",1,0.0239099859353024
"22055","chr19.45550000.45555000","chr19.45580000.45585000",30000,30,0.005134157,45550000,45580000,45555000,45585000,"chr19",638791,4,15,10,29,"chr19",1,0.10196905766526
"22056","chr19.18325000.18330000","chr19.18515000.18520000",190000,14,0.001201054,18325000,18515000,18330000,18520000,"chr19",638801,9,17,23,49,"chr19",1,0.0804031879981247
"22057","chr19.11090000.11095000","chr19.11530000.11535000",440000,12,3.705506e-05,11090000,11530000,11095000,11535000,"chr19",638805,8,28,19,55,"chr19",1,0.0773558368495077
"22058","chr19.2180000.2185000","chr19.2315000.2320000",135000,17,0.0003512967,2180000,2315000,2185000,2320000,"chr19",638810,3,10,3,16,"chr19",1,0.0318799812470699
"22059","chr19.47410000.47415000","chr19.47470000.47475000",60000,38,2.568563e-12,47410000,47470000,47415000,47475000,"chr19",638821,4,22,18,44,"chr19",1,0.195968120018753
"22060","chr19.12400000.12405000","chr19.12510000.12515000",110000,20,4.226484e-05,12400000,12510000,12405000,12515000,"chr19",638826,0,10,6,16,"chr19",1,0.0375058602906704
"22061","chr19.4410000.4415000","chr19.4435000.4440000",25000,33,0.008466812,4410000,4435000,4415000,4440000,"chr19",638831,8,27,25,60,"chr19",1,0.232067510548523
"22062","chr19.18485000.18490000","chr19.18515000.18520000",30000,31,0.002502255,18485000,18515000,18490000,18520000,"chr19",638875,0,3,1,4,"chr19",1,0.0145335208626348
"22063","chr19.2150000.2155000","chr19.2325000.2330000",175000,14,0.00219028,2150000,2325000,2155000,2330000,"chr19",638876,4,13,7,24,"chr19",1,0.0393811533052039
"22064","chr19.52690000.52695000","chr19.52735000.52740000",45000,28,0.0001275693,52690000,52735000,52695000,52740000,"chr19",638877,9,28,39,76,"chr19",1,0.249413970932958
"22065","chr19.40220000.40225000","chr19.40550000.40555000",330000,11,0.00149124,40220000,40550000,40225000,40555000,"chr19",638883,2,10,7,19,"chr19",1,0.0244960150023441
"22066","chr19.49150000.49155000","chr19.49195000.49200000",45000,25,0.00205386,49150000,49195000,49155000,49200000,"chr19",638888,0,2,4,6,"chr19",1,0.0175808720112518
"22067","chr19.38180000.38185000","chr19.38205000.38210000",25000,64,7.276136e-17,38180000,38205000,38185000,38210000,"chr19",638911,2,8,5,15,"chr19",1,0.112517580872011
"22068","chr19.38180000.38185000","chr19.38210000.38215000",30000,63,8.112695e-20,38180000,38210000,38185000,38215000,"chr19",638914,7,13,11,31,"chr19",1,0.228902953586498
"22069","chr19.3385000.3390000","chr19.3405000.3410000",20000,35,0.008589977,3385000,3405000,3390000,3410000,"chr19",638942,5,19,7,31,"chr19",1,0.127168307548054
"22070","chr19.48120000.48125000","chr19.48190000.48195000",70000,23,0.0001240303,48120000,48190000,48125000,48195000,"chr19",638943,1,4,6,11,"chr19",1,0.0296530707923113
"22071","chr19.13905000.13910000","chr19.13970000.13975000",65000,25,3.1669e-05,13905000,13970000,13910000,13975000,"chr19",638949,8,37,31,76,"chr19",1,0.222691045475856
"22072","chr19.45925000.45930000","chr19.45995000.46000000",70000,30,1.630484e-08,45925000,45995000,45930000,4.6e+07,"chr19",638972,2,7,5,14,"chr19",1,0.0492264416315049
"22073","chr19.45580000.45585000","chr19.45605000.45610000",25000,34,0.004460775,45580000,45605000,45585000,45610000,"chr19",638974,4,19,25,48,"chr19",1,0.191279887482419
"22074","chr19.18625000.18630000","chr19.18660000.18665000",35000,33,3.705506e-05,18625000,18660000,18630000,18665000,"chr19",638982,3,5,4,12,"chr19",1,0.0464135021097046
"22075","chr19.17215000.17220000","chr19.17280000.17285000",65000,22,0.0008062846,17215000,17280000,17220000,17285000,"chr19",638990,3,14,16,33,"chr19",1,0.0850914205344585
"22076","chr19.41955000.41960000","chr19.42075000.42080000",120000,29,1.14483e-11,41955000,42075000,41960000,42080000,"chr19",638997,0,3,0,3,"chr19",1,0.010196905766526
"22077","chr19.39100000.39105000","chr19.39275000.39280000",175000,13,0.006971328,39100000,39275000,39105000,39280000,"chr19",639010,10,28,31,69,"chr19",1,0.105133614627286
"22078","chr19.41375000.41380000","chr19.41395000.41400000",20000,40,0.0002766033,41375000,41395000,41380000,41400000,"chr19",639064,2,16,9,27,"chr19",1,0.126582278481013
"22079","chr19.11195000.11200000","chr19.11585000.11590000",390000,12,9.829558e-05,11195000,11585000,11200000,11590000,"chr19",639066,11,15,12,38,"chr19",1,0.0534458509142053
"22080","chr19.58520000.58525000","chr19.58540000.58545000",20000,36,0.004609976,58520000,58540000,58525000,58545000,"chr19",639080,3,25,14,42,"chr19",1,0.177215189873418
"22081","chr19.34170000.34175000","chr19.34250000.34255000",80000,19,0.002384861,34170000,34250000,34175000,34255000,"chr19",639106,0,8,3,11,"chr19",1,0.0244960150023441
"22082","chr19.55165000.55170000","chr19.55465000.55470000",300000,10,0.009962913,55165000,55465000,55170000,55470000,"chr19",639112,5,7,21,33,"chr19",1,0.0386779184247539
"22083","chr19.46510000.46515000","chr19.46575000.46580000",65000,25,3.1669e-05,46510000,46575000,46515000,46580000,"chr19",639125,2,11,13,26,"chr19",1,0.0761837787154243
"22084","chr19.10625000.10630000","chr19.10810000.10815000",185000,13,0.004864819,10625000,10810000,10630000,10815000,"chr19",639127,2,9,6,17,"chr19",1,0.0259024847632443
"22085","chr19.47130000.47135000","chr19.47270000.47275000",140000,15,0.002948886,47130000,47270000,47135000,47275000,"chr19",639130,3,3,6,12,"chr19",1,0.0210970464135021
"22086","chr19.38515000.38520000","chr19.38545000.38550000",30000,32,0.001187867,38515000,38545000,38520000,38550000,"chr19",639135,7,17,15,39,"chr19",1,0.146272855133615
"22087","chr19.2945000.2950000","chr19.3160000.3165000",215000,12,0.006052161,2945000,3160000,2950000,3165000,"chr19",639143,2,13,12,27,"chr19",1,0.0379746835443038
"22088","chr19.12675000.12680000","chr19.12780000.12785000",105000,37,4.211519e-17,12675000,12780000,12680000,12785000,"chr19",639192,7,5,19,31,"chr19",1,0.134435067979372
"22089","chr19.17555000.17560000","chr19.17965000.17970000",410000,10,0.001807231,17555000,17965000,17560000,17970000,"chr19",639193,4,7,7,18,"chr19",1,0.0210970464135021
"22090","chr19.12285000.12290000","chr19.12640000.12645000",355000,11,0.0009566211,12285000,12640000,12290000,12645000,"chr19",639215,2,14,17,33,"chr19",1,0.0425457102672293
"22091","chr19.38890000.38895000","chr19.39370000.39375000",480000,9,0.003154722,38890000,39370000,38895000,39375000,"chr19",639219,2,15,11,28,"chr19",1,0.029535864978903
"22092","chr19.35875000.35880000","chr19.35895000.35900000",20000,37,0.002384861,35875000,35895000,35880000,35900000,"chr19",639228,4,8,8,20,"chr19",1,0.0867323019221753
"22093","chr19.1925000.1930000","chr19.2070000.2075000",145000,18,5.442317e-05,1925000,2070000,1930000,2075000,"chr19",639247,6,39,33,78,"chr19",1,0.164556962025316
"22094","chr19.37250000.37255000","chr19.38210000.38215000",960000,6,0.009984959,37250000,38210000,37255000,38215000,"chr19",639250,0,11,9,20,"chr19",1,0.0140646976090014
"22095","chr19.38895000.38900000","chr19.39105000.39110000",210000,18,1.252542e-06,38895000,39105000,38900000,39110000,"chr19",639261,7,25,33,65,"chr19",1,0.137130801687764
"22096","chr19.4805000.4810000","chr19.4910000.4915000",105000,50,4.165395e-29,4805000,4910000,4810000,4915000,"chr19",639277,5,7,6,18,"chr19",1,0.105485232067511
"22097","chr19.7435000.7440000","chr19.7650000.7655000",215000,12,0.006052161,7435000,7650000,7440000,7655000,"chr19",639285,12,28,23,63,"chr19",1,0.0886075949367089
"22098","chr19.10450000.10455000","chr19.10580000.10585000",130000,15,0.004609976,10450000,10580000,10455000,10585000,"chr19",639296,1,2,1,4,"chr19",1,0.0070323488045007
"22099","chr19.3985000.3990000","chr19.4005000.4010000",20000,53,1.561571e-09,3985000,4005000,3990000,4010000,"chr19",639300,4,14,13,31,"chr19",1,0.192569151429911
"22100","chr19.12660000.12665000","chr19.12720000.12725000",60000,29,8.438118e-07,12660000,12720000,12665000,12725000,"chr19",639327,3,20,18,41,"chr19",1,0.139357712142522
"22101","chr19.39035000.39040000","chr19.39390000.39395000",355000,17,1.836531e-08,39035000,39390000,39040000,39395000,"chr19",639351,11,19,23,53,"chr19",1,0.105602437880919
"22102","chr19.4245000.4250000","chr19.4385000.4390000",140000,15,0.002948886,4245000,4385000,4250000,4390000,"chr19",639399,6,25,16,47,"chr19",1,0.0826300984528833
"22103","chr19.39035000.39040000","chr19.39100000.39105000",65000,28,8.289357e-07,39035000,39100000,39040000,39105000,"chr19",639401,15,34,39,88,"chr19",1,0.288795124238162
"22104","chr19.3355000.3360000","chr19.3435000.3440000",80000,34,3.056076e-12,3355000,3435000,3360000,3440000,"chr19",639402,7,11,34,52,"chr19",1,0.207219878105954
"22105","chr19.1895000.1900000","chr19.2160000.2165000",265000,16,2.839038e-06,1895000,2160000,1900000,2165000,"chr19",639408,6,25,14,45,"chr19",1,0.0843881856540084
"22106","chr19.6055000.6060000","chr19.6090000.6095000",35000,29,0.001308007,6055000,6090000,6060000,6095000,"chr19",639422,3,2,3,8,"chr19",1,0.0271917487107361
"22107","chr19.18645000.18650000","chr19.18965000.18970000",320000,10,0.007064441,18645000,18965000,18650000,18970000,"chr19",639426,2,6,0,8,"chr19",1,0.00937646507266761
"22108","chr19.3335000.3340000","chr19.3435000.3440000",100000,24,5.037462e-07,3335000,3435000,3340000,3440000,"chr19",639452,4,5,20,29,"chr19",1,0.0815752461322082
"22109","chr19.46925000.46930000","chr19.46945000.46950000",20000,40,0.0002766033,46925000,46945000,46930000,46950000,"chr19",639458,2,4,0,6,"chr19",1,0.0281293952180028
"22110","chr19.48465000.48470000","chr19.48660000.48665000",195000,13,0.003466155,48465000,48660000,48470000,48665000,"chr19",639469,0,7,5,12,"chr19",1,0.0182841068917018
"22111","chr19.2700000.2705000","chr19.2735000.2740000",35000,30,0.0005709282,2700000,2735000,2705000,2740000,"chr19",639484,4,5,18,27,"chr19",1,0.0949367088607595
"22112","chr19.13395000.13400000","chr19.13680000.13685000",285000,13,0.0002030323,13395000,13680000,13400000,13685000,"chr19",639506,0,4,2,6,"chr19",1,0.00914205344585091
"22113","chr19.10810000.10815000","chr19.10960000.10965000",150000,15,0.001919485,10810000,10960000,10815000,10965000,"chr19",639507,2,9,6,17,"chr19",1,0.029887482419128
"22114","chr19.7515000.7520000","chr19.7595000.7600000",80000,19,0.002384861,7515000,7595000,7520000,7600000,"chr19",639511,3,12,2,17,"chr19",1,0.0378574777308955
"22115","chr19.2900000.2905000","chr19.2945000.2950000",45000,24,0.004627476,2900000,2945000,2905000,2950000,"chr19",639528,2,16,12,30,"chr19",1,0.0843881856540084
"22116","chr19.47710000.47715000","chr19.47750000.47755000",40000,47,5.077612e-14,47710000,47750000,47715000,47755000,"chr19",639533,3,5,3,11,"chr19",1,0.0605954055321144
"22117","chr19.6455000.6460000","chr19.6515000.6520000",60000,27,9.571974e-06,6455000,6515000,6460000,6520000,"chr19",639538,2,5,11,18,"chr19",1,0.0569620253164557
"22118","chr19.12720000.12725000","chr19.12775000.12780000",55000,25,0.0002637507,12720000,12775000,12725000,12780000,"chr19",639544,3,18,18,39,"chr19",1,0.114275668073136
"22119","chr19.1380000.1385000","chr19.1400000.1405000",20000,35,0.008589977,1380000,1400000,1385000,1405000,"chr19",639564,9,20,19,48,"chr19",1,0.19690576652602
"22120","chr19.4800000.4805000","chr19.4830000.4835000",30000,34,0.0002344108,4800000,4830000,4805000,4835000,"chr19",639565,12,18,24,54,"chr19",1,0.215189873417722
"22121","chr19.13380000.13385000","chr19.13690000.13695000",310000,13,0.0001043785,13380000,13690000,13385000,13695000,"chr19",639573,5,13,8,26,"chr19",1,0.0396155649320206
"22122","chr19.3340000.3345000","chr19.3435000.3440000",95000,28,2.409388e-09,3340000,3435000,3345000,3440000,"chr19",639579,7,22,20,49,"chr19",1,0.160806375996249
"22123","chr19.57725000.57730000","chr19.57765000.57770000",40000,26,0.002907628,57725000,57765000,57730000,57770000,"chr19",639581,3,18,25,46,"chr19",1,0.140178152836381
"22124","chr19.1545000.1550000","chr19.1825000.1830000",280000,11,0.004043892,1545000,1825000,1550000,1830000,"chr19",639599,4,15,20,39,"chr19",1,0.05028129395218
"22125","chr19.5965000.5970000","chr19.5985000.5990000",20000,52,4.585913e-09,5965000,5985000,5970000,5990000,"chr19",639606,0,3,0,3,"chr19",1,0.0182841068917018
"22126","chr19.39120000.39125000","chr19.39390000.39395000",270000,18,6.090143e-08,39120000,39390000,39125000,39395000,"chr19",639617,11,19,23,53,"chr19",1,0.111814345991561
"22127","chr19.3340000.3345000","chr19.3485000.3490000",145000,19,1.338558e-05,3340000,3485000,3345000,3490000,"chr19",639626,7,22,20,49,"chr19",1,0.109118612283169
"22128","chr19.8220000.8225000","chr19.8320000.8325000",100000,18,0.001099799,8220000,8320000,8225000,8325000,"chr19",639635,10,25,30,65,"chr19",1,0.137130801687764
"22129","chr19.2675000.2680000","chr19.2690000.2695000",15000,47,7.035622e-07,2675000,2690000,2680000,2695000,"chr19",639640,3,7,4,14,"chr19",1,0.077121425222691
"22130","chr19.47410000.47415000","chr19.47490000.47495000",80000,22,9.341776e-05,47410000,47490000,47415000,47495000,"chr19",639661,0,3,0,3,"chr19",1,0.00773558368495077
"22131","chr19.5910000.5915000","chr19.5965000.5970000",55000,39,4.298207e-12,5910000,5965000,5915000,5970000,"chr19",639679,0,3,0,3,"chr19",1,0.0137130801687764
"22132","chr19.2520000.2525000","chr19.2540000.2545000",20000,43,2.524408e-05,2520000,2540000,2525000,2545000,"chr19",639690,6,13,10,29,"chr19",1,0.146155649320206
"22133","chr19.2980000.2985000","chr19.3020000.3025000",40000,34,1.240976e-06,2980000,3020000,2985000,3025000,"chr19",639695,2,13,6,21,"chr19",1,0.0836849507735584
"22134","chr19.17215000.17220000","chr19.17265000.17270000",50000,23,0.004395035,17215000,17265000,17220000,17270000,"chr19",639700,3,19,16,38,"chr19",1,0.102437880918894
"22135","chr19.46920000.46925000","chr19.46975000.46980000",55000,21,0.009962913,46920000,46975000,46925000,46980000,"chr19",639701,0,1,1,2,"chr19",1,0.00492264416315049
"22136","chr19.13830000.13835000","chr19.13970000.13975000",140000,19,1.84415e-05,13830000,13970000,13835000,13975000,"chr19",639759,1,5,7,13,"chr19",1,0.0289498359118612
"22137","chr19.46425000.46430000","chr19.46510000.46515000",85000,19,0.001440986,46425000,46510000,46430000,46515000,"chr19",639767,0,6,4,10,"chr19",1,0.0222691045475856
"22138","chr19.18275000.18280000","chr19.18520000.18525000",245000,11,0.008957819,18275000,18520000,18280000,18525000,"chr19",639772,6,21,27,54,"chr19",1,0.069620253164557
"22139","chr19.48465000.48470000","chr19.48750000.48755000",285000,18,3.16419e-08,48465000,48750000,48470000,48755000,"chr19",639784,0,7,5,12,"chr19",1,0.0253164556962025
"22140","chr19.18385000.18390000","chr19.18485000.18490000",100000,20,0.0001047637,18385000,18485000,18390000,18490000,"chr19",639786,0,3,1,4,"chr19",1,0.00937646507266761
"22141","chr19.4695000.4700000","chr19.4720000.4725000",25000,34,0.004460775,4695000,4720000,4700000,4725000,"chr19",639800,1,10,9,20,"chr19",1,0.0796999531176746
"22142","chr19.3075000.3080000","chr19.3160000.3165000",85000,21,0.0001590206,3075000,3160000,3080000,3165000,"chr19",639804,8,13,17,38,"chr19",1,0.0935302390998594
"22143","chr19.11495000.11500000","chr19.11635000.11640000",140000,18,7.380246e-05,11495000,11635000,11500000,11640000,"chr19",639822,11,29,12,52,"chr19",1,0.109704641350211
"22144","chr19.10390000.10395000","chr19.10500000.10505000",110000,23,6.805827e-07,10390000,10500000,10395000,10505000,"chr19",639839,3,17,15,35,"chr19",1,0.0943506797937178
"22145","chr19.53035000.53040000","chr19.53190000.53195000",155000,14,0.004800452,53035000,53190000,53040000,53195000,"chr19",639842,1,10,9,20,"chr19",1,0.0328176277543366
"22146","chr19.2455000.2460000","chr19.2600000.2605000",145000,23,2.763978e-08,2455000,2600000,2460000,2605000,"chr19",639858,11,28,38,77,"chr19",1,0.207571495546179
"22147","chr19.7440000.7445000","chr19.7515000.7520000",75000,26,1.38361e-06,7440000,7515000,7445000,7520000,"chr19",639861,6,12,17,35,"chr19",1,0.106657290201594
"22148","chr19.4325000.4330000","chr19.4400000.4405000",75000,18,0.009962913,4325000,4400000,4330000,4405000,"chr19",639866,0,5,7,12,"chr19",1,0.0253164556962025
"22149","chr19.3325000.3330000","chr19.3425000.3430000",100000,28,1.074239e-09,3325000,3425000,3330000,3430000,"chr19",639876,15,38,32,85,"chr19",1,0.278949835911861
"22150","chr19.2460000.2465000","chr19.2600000.2605000",140000,15,0.002948886,2460000,2600000,2465000,2605000,"chr19",639880,9,24,16,49,"chr19",1,0.0861462728551336
"22151","chr19.13275000.13280000","chr19.13300000.13305000",25000,38,0.0002399242,13275000,13300000,13280000,13305000,"chr19",639888,1,10,7,18,"chr19",1,0.080168776371308
"22152","chr19.17505000.17510000","chr19.17535000.17540000",30000,38,6.029156e-06,17505000,17535000,17510000,17540000,"chr19",639911,2,20,19,41,"chr19",1,0.182606657290202
"22153","chr19.5790000.5795000","chr19.5900000.5905000",110000,25,3.270803e-08,5790000,5900000,5795000,5905000,"chr19",639928,2,7,8,17,"chr19",1,0.0498124706985466
"22154","chr19.48870000.48875000","chr19.49115000.49120000",245000,14,0.0001519474,48870000,49115000,48875000,49120000,"chr19",639952,0,4,2,6,"chr19",1,0.00984528832630099
"22155","chr19.10590000.10595000","chr19.10700000.10705000",110000,16,0.004609976,10590000,10700000,10595000,10705000,"chr19",639975,14,48,62,124,"chr19",1,0.232536333802157
"22156","chr19.6525000.6530000","chr19.6735000.6740000",210000,20,3.923412e-08,6525000,6735000,6530000,6740000,"chr19",639976,2,4,10,16,"chr19",1,0.0375058602906704
"22157","chr19.2635000.2640000","chr19.2780000.2785000",145000,14,0.007172536,2635000,2780000,2640000,2785000,"chr19",639989,0,6,2,8,"chr19",1,0.0131270511017346
"22158","chr19.50545000.50550000","chr19.50635000.50640000",90000,38,2.067416e-16,50545000,50635000,50550000,50640000,"chr19",640007,0,2,10,12,"chr19",1,0.0534458509142053
"22159","chr19.40640000.40645000","chr19.40660000.40665000",20000,60,5.325984e-13,40640000,40660000,40645000,40665000,"chr19",640031,6,11,13,30,"chr19",1,0.210970464135021
"22160","chr19.13710000.13715000","chr19.13835000.13840000",125000,15,0.005869735,13710000,13835000,13715000,13840000,"chr19",640058,5,19,6,30,"chr19",1,0.0527426160337553
"22161","chr19.40700000.40705000","chr19.40795000.40800000",95000,21,5.101306e-05,40700000,40795000,40705000,40800000,"chr19",640069,4,2,6,12,"chr19",1,0.029535864978903
"22162","chr19.46345000.46350000","chr19.47265000.47270000",920000,7,0.002116322,46345000,47265000,46350000,47270000,"chr19",640074,2,16,11,29,"chr19",1,0.023792780121894
"22163","chr19.38660000.38665000","chr19.38695000.38700000",35000,34,1.389882e-05,38660000,38695000,38665000,38700000,"chr19",640125,1,3,1,5,"chr19",1,0.0199249882794187
"22164","chr19.6460000.6465000","chr19.6480000.6485000",20000,40,0.0002766033,6460000,6480000,6465000,6485000,"chr19",640129,9,30,27,66,"chr19",1,0.309423347398031
"22165","chr19.7515000.7520000","chr19.7535000.7540000",20000,54,5.371103e-10,7515000,7535000,7520000,7540000,"chr19",640144,3,9,3,15,"chr19",1,0.0949367088607595
"22166","chr19.1325000.1330000","chr19.1350000.1355000",25000,39,0.0001056016,1325000,1350000,1330000,1355000,"chr19",640188,6,23,15,44,"chr19",1,0.20112517580872
"22167","chr19.2475000.2480000","chr19.2610000.2615000",135000,38,2.353849e-20,2475000,2610000,2480000,2615000,"chr19",640210,1,1,1,3,"chr19",1,0.0133614627285513
"22168","chr19.7440000.7445000","chr19.7630000.7635000",190000,16,8.060524e-05,7440000,7630000,7445000,7635000,"chr19",640241,3,8,10,21,"chr19",1,0.0393811533052039
"22169","chr19.34730000.34735000","chr19.34770000.34775000",40000,28,0.000539888,34730000,34770000,34735000,34775000,"chr19",640265,0,0,1,1,"chr19",1,0.00328176277543366
"22170","chr19.3355000.3360000","chr19.3405000.3410000",50000,28,3.705247e-05,3355000,3405000,3360000,3410000,"chr19",640271,7,11,33,51,"chr19",1,0.167369901547117
"22171","chr19.4830000.4835000","chr19.4855000.4860000",25000,48,2.173353e-08,4830000,4855000,4835000,4860000,"chr19",640281,12,26,20,58,"chr19",1,0.326300984528833
"22172","chr19.46425000.46430000","chr19.46500000.46505000",75000,22,0.00018093,46425000,46500000,46430000,46505000,"chr19",640290,0,6,4,10,"chr19",1,0.0257852789498359
"22173","chr19.46525000.46530000","chr19.46840000.46845000",315000,13,9.341776e-05,46525000,46840000,46530000,46845000,"chr19",640292,0,4,2,6,"chr19",1,0.00914205344585091
"22174","chr19.42385000.42390000","chr19.42450000.42455000",65000,36,8.96e-12,42385000,42450000,42390000,42455000,"chr19",640297,4,7,18,29,"chr19",1,0.122362869198312
"22175","chr19.12510000.12515000","chr19.12720000.12725000",210000,18,1.252542e-06,12510000,12720000,12515000,12725000,"chr19",640336,0,10,6,16,"chr19",1,0.0337552742616034
"22176","chr19.12510000.12515000","chr19.12600000.12605000",90000,19,0.0008791889,12510000,12600000,12515000,12605000,"chr19",640342,0,10,6,16,"chr19",1,0.0356305672761369
"22177","chr19.39110000.39115000","chr19.39325000.39330000",215000,15,0.0001081811,39110000,39325000,39115000,39330000,"chr19",640348,2,8,2,12,"chr19",1,0.0210970464135021
"22178","chr19.49150000.49155000","chr19.49470000.49475000",320000,16,3.99399e-07,49150000,49470000,49155000,49475000,"chr19",640351,0,2,4,6,"chr19",1,0.0112517580872011
"22179","chr19.11495000.11500000","chr19.11595000.11600000",100000,19,0.000348893,11495000,11595000,11500000,11600000,"chr19",640372,13,29,12,54,"chr19",1,0.120253164556962
"22180","chr19.39035000.39040000","chr19.39345000.39350000",310000,10,0.008437098,39035000,39345000,39040000,39350000,"chr19",640418,1,0,1,2,"chr19",1,0.0023441162681669
"22181","chr19.7205000.7210000","chr19.7290000.7295000",85000,27,6.08511e-08,7205000,7290000,7210000,7295000,"chr19",640438,2,9,13,24,"chr19",1,0.0759493670886076
"22182","chr19.6110000.6115000","chr19.6480000.6485000",370000,10,0.003280482,6110000,6480000,6115000,6485000,"chr19",640452,8,11,22,41,"chr19",1,0.0480543834974215
"22183","chr19.2490000.2495000","chr19.2585000.2590000",95000,22,1.420945e-05,2490000,2585000,2495000,2590000,"chr19",640453,1,8,8,17,"chr19",1,0.0438349742147211
"22184","chr19.11240000.11245000","chr19.11585000.11590000",345000,15,1.268103e-06,11240000,11585000,11245000,11590000,"chr19",640455,10,15,18,43,"chr19",1,0.0755977496483826
"22185","chr19.4855000.4860000","chr19.4905000.4910000",50000,25,0.0007428205,4855000,4905000,4860000,4910000,"chr19",640460,4,33,16,53,"chr19",1,0.155297702766057
"22186","chr19.40550000.40555000","chr19.40660000.40665000",110000,17,0.00157089,40550000,40660000,40555000,40665000,"chr19",640471,7,11,12,30,"chr19",1,0.059774964838256
"22187","chr19.39035000.39040000","chr19.39340000.39345000",305000,10,0.009134932,39035000,39340000,39040000,39345000,"chr19",640507,0,5,2,7,"chr19",1,0.00820440693858415
"22188","chr19.2235000.2240000","chr19.2325000.2330000",90000,27,2.596232e-08,2235000,2325000,2240000,2330000,"chr19",640525,4,13,7,24,"chr19",1,0.0759493670886076
"22189","chr19.2645000.2650000","chr19.2675000.2680000",30000,41,2.832677e-07,2645000,2675000,2650000,2680000,"chr19",640530,3,7,4,14,"chr19",1,0.0672761368963901
"22190","chr19.18700000.18705000","chr19.18945000.18950000",245000,12,0.002521533,18700000,18945000,18705000,18950000,"chr19",640541,4,15,17,36,"chr19",1,0.0506329113924051
"22191","chr19.2675000.2680000","chr19.2700000.2705000",25000,38,0.0002399242,2675000,2700000,2680000,2705000,"chr19",640544,3,5,4,12,"chr19",1,0.0534458509142053
"22192","chr19.4870000.4875000","chr19.4910000.4915000",40000,82,2.381333e-41,4870000,4910000,4875000,4915000,"chr19",640547,5,7,6,18,"chr19",1,0.172995780590717
"22193","chr19.2640000.2645000","chr19.2700000.2705000",60000,25,9.196901e-05,2640000,2700000,2645000,2705000,"chr19",640574,9,5,15,29,"chr19",1,0.0849742147210502
"22194","chr19.38890000.38895000","chr19.39325000.39330000",435000,9,0.005591771,38890000,39325000,38895000,39330000,"chr19",640596,6,12,11,29,"chr19",1,0.0305907172995781
"22195","chr19.11925000.11930000","chr19.12140000.12145000",215000,12,0.006052161,11925000,12140000,11930000,12145000,"chr19",640610,4,17,12,33,"chr19",1,0.0464135021097046
"22196","chr19.56710000.56715000","chr19.57500000.57505000",790000,7,0.005033169,56710000,57500000,56715000,57505000,"chr19",640612,1,6,2,9,"chr19",1,0.00738396624472574
"22197","chr19.3325000.3330000","chr19.3700000.3705000",375000,12,0.0001318677,3325000,3700000,3330000,3705000,"chr19",640628,6,22,22,50,"chr19",1,0.070323488045007
"22198","chr19.39105000.39110000","chr19.39390000.39395000",285000,26,9.965169e-16,39105000,39390000,39110000,39395000,"chr19",640641,7,19,23,49,"chr19",1,0.149320206282232
"22199","chr19.2490000.2495000","chr19.2600000.2605000",110000,17,0.00157089,2490000,2600000,2495000,2605000,"chr19",640661,1,8,8,17,"chr19",1,0.0338724800750117
"22200","chr19.14245000.14250000","chr19.14515000.14520000",270000,13,0.0003028683,14245000,14515000,14250000,14520000,"chr19",640688,1,6,2,9,"chr19",1,0.0137130801687764
"22201","chr19.10695000.10700000","chr19.10750000.10755000",55000,46,5.782704e-17,10695000,10750000,10700000,10755000,"chr19",640703,11,36,19,66,"chr19",1,0.355836849507736
"22202","chr19.2645000.2650000","chr19.2665000.2670000",20000,42,5.727509e-05,2645000,2665000,2650000,2670000,"chr19",640711,7,25,32,64,"chr19",1,0.315049226441632
"22203","chr19.2540000.2545000","chr19.2595000.2600000",55000,23,0.001807231,2540000,2595000,2545000,2600000,"chr19",640722,5,19,21,45,"chr19",1,0.121308016877637
"22204","chr19.2645000.2650000","chr19.2690000.2695000",45000,44,2.150173e-13,2645000,2690000,2650000,2695000,"chr19",640731,9,29,20,58,"chr19",1,0.299109235818097
"22205","chr19.10810000.10815000","chr19.10835000.10840000",25000,39,0.0001056016,10810000,10835000,10815000,10840000,"chr19",640738,2,5,6,13,"chr19",1,0.0594233473980309
"22206","chr19.6525000.6530000","chr19.6630000.6635000",105000,26,1.280054e-08,6525000,6630000,6530000,6635000,"chr19",640742,8,26,21,55,"chr19",1,0.167604313173933
"22207","chr19.43980000.43985000","chr19.44000000.44005000",20000,45,4.359916e-06,43980000,4.4e+07,43985000,44005000,"chr19",640753,3,9,7,19,"chr19",1,0.100210970464135
"22208","chr19.2475000.2480000","chr19.2540000.2545000",65000,28,8.289357e-07,2475000,2540000,2480000,2545000,"chr19",640760,1,1,1,3,"chr19",1,0.00984528832630099
"22209","chr19.4805000.4810000","chr19.4865000.4870000",60000,28,2.897103e-06,4805000,4865000,4810000,4870000,"chr19",640775,0,10,8,18,"chr19",1,0.0590717299578059
"22210","chr19.2650000.2655000","chr19.2720000.2725000",70000,19,0.006892072,2650000,2720000,2655000,2725000,"chr19",640799,2,9,7,18,"chr19",1,0.040084388185654
"22211","chr19.18045000.18050000","chr19.18100000.18105000",55000,26,9.478444e-05,18045000,18100000,18050000,18105000,"chr19",640807,1,11,19,31,"chr19",1,0.0944678856071261
"22212","chr19.2265000.2270000","chr19.2380000.2385000",115000,15,0.009573557,2265000,2380000,2270000,2385000,"chr19",640827,12,37,37,86,"chr19",1,0.151195499296765
"22213","chr19.19030000.19035000","chr19.19050000.19055000",20000,37,0.002384861,19030000,19050000,19035000,19055000,"chr19",640834,5,15,20,40,"chr19",1,0.173464603844351
"22214","chr19.39120000.39125000","chr19.39360000.39365000",240000,12,0.002907628,39120000,39360000,39125000,39365000,"chr19",640840,0,1,3,4,"chr19",1,0.00562587904360056
"22215","chr19.3375000.3380000","chr19.3425000.3430000",50000,35,8.387915e-09,3375000,3425000,3380000,3430000,"chr19",640844,10,41,32,83,"chr19",1,0.340482887951242
"22216","chr19.17245000.17250000","chr19.17265000.17270000",20000,42,5.727509e-05,17245000,17265000,17250000,17270000,"chr19",640858,9,17,23,49,"chr19",1,0.241209563994374
"22217","chr19.49150000.49155000","chr19.49475000.49480000",325000,13,7.346712e-05,49150000,49475000,49155000,49480000,"chr19",640860,0,2,4,6,"chr19",1,0.00914205344585091
"22218","chr19.38090000.38095000","chr19.38195000.38200000",105000,16,0.00618472,38090000,38195000,38095000,38200000,"chr19",640869,3,5,8,16,"chr19",1,0.0300046882325363
"22219","chr19.5965000.5970000","chr19.6360000.6365000",395000,9,0.00945816,5965000,6360000,5970000,6365000,"chr19",640879,0,3,0,3,"chr19",1,0.00316455696202532
"22220","chr19.49980000.49985000","chr19.50050000.50055000",70000,19,0.006892072,49980000,50050000,49985000,50055000,"chr19",640902,2,10,7,19,"chr19",1,0.0423112986404126
"22221","chr19.10695000.10700000","chr19.10745000.10750000",50000,49,5.29469e-18,10695000,10745000,10700000,10750000,"chr19",640929,6,19,15,40,"chr19",1,0.229723394280356
"22222","chr19.11195000.11200000","chr19.11240000.11245000",45000,25,0.00205386,11195000,11240000,11200000,11245000,"chr19",640951,10,17,12,39,"chr19",1,0.114275668073136
"22223","chr19.38890000.38895000","chr19.39195000.39200000",305000,11,0.002384861,38890000,39195000,38895000,39200000,"chr19",640962,4,16,11,31,"chr19",1,0.0399671823722457
"22224","chr19.43930000.43935000","chr19.44025000.44030000",95000,26,5.317766e-08,43930000,44025000,43935000,44030000,"chr19",640981,0,4,3,7,"chr19",1,0.0213314580403188
"22225","chr19.4805000.4810000","chr19.4830000.4835000",25000,51,8.326738e-10,4805000,4830000,4810000,4835000,"chr19",641009,12,26,31,69,"chr19",1,0.412447257383966
"22226","chr19.1095000.1100000","chr19.1190000.1195000",95000,27,1.149328e-08,1095000,1190000,1100000,1195000,"chr19",641019,8,25,15,48,"chr19",1,0.151898734177215
"22227","chr19.38140000.38145000","chr19.38180000.38185000",40000,37,3.701954e-08,38140000,38180000,38145000,38185000,"chr19",641022,1,6,2,9,"chr19",1,0.0390295358649789
"22228","chr19.2280000.2285000","chr19.2325000.2330000",45000,27,0.0003362609,2280000,2325000,2285000,2330000,"chr19",641024,4,13,7,24,"chr19",1,0.0759493670886076
"22229","chr19.39030000.39035000","chr19.39105000.39110000",75000,19,0.004022159,39030000,39105000,39035000,39110000,"chr19",641027,1,12,7,20,"chr19",1,0.0445382090951711
"22230","chr19.47110000.47115000","chr19.47175000.47180000",65000,20,0.005245412,47110000,47175000,47115000,47180000,"chr19",641038,3,5,7,15,"chr19",1,0.0351617440225035
"22231","chr19.48855000.48860000","chr19.49115000.49120000",260000,11,0.006242392,48855000,49115000,48860000,49120000,"chr19",641041,0,4,2,6,"chr19",1,0.00773558368495077
"22232","chr19.1925000.1930000","chr19.2065000.2070000",140000,17,0.0002705186,1925000,2065000,1930000,2070000,"chr19",641047,8,36,41,85,"chr19",1,0.169362400375059
"22233","chr19.48810000.48815000","chr19.49085000.49090000",275000,14,5.58534e-05,48810000,49085000,48815000,49090000,"chr19",641083,2,13,10,25,"chr19",1,0.0410220346929208
"22234","chr19.40305000.40310000","chr19.40345000.40350000",40000,25,0.006352757,40305000,40345000,40310000,40350000,"chr19",641089,4,15,10,29,"chr19",1,0.0849742147210502
"22235","chr19.18070000.18075000","chr19.18100000.18105000",30000,51,2.049171e-12,18070000,18100000,18075000,18105000,"chr19",641099,10,37,33,80,"chr19",1,0.478199718706048
"22236","chr19.57935000.57940000","chr19.58520000.58525000",585000,8,0.004698437,57935000,58520000,57940000,58525000,"chr19",641100,3,24,21,48,"chr19",1,0.0450070323488045
"22237","chr19.50200000.50205000","chr19.50315000.50320000",115000,15,0.009573557,50200000,50315000,50205000,50320000,"chr19",641116,7,8,8,23,"chr19",1,0.040436005625879
"22238","chr19.3985000.3990000","chr19.4065000.4070000",80000,21,0.000285034,3985000,4065000,3990000,4070000,"chr19",641119,3,11,13,27,"chr19",1,0.0664556962025316
"22239","chr19.3325000.3330000","chr19.3405000.3410000",80000,23,2.813619e-05,3325000,3405000,3330000,3410000,"chr19",641155,10,30,33,73,"chr19",1,0.196788560712611
"22240","chr19.3345000.3350000","chr19.3445000.3450000",100000,17,0.003153897,3345000,3445000,3350000,3450000,"chr19",641179,3,16,20,39,"chr19",1,0.0777074542897328
"22241","chr19.38180000.38185000","chr19.38265000.38270000",85000,21,0.0001590206,38180000,38265000,38185000,38270000,"chr19",641205,6,14,11,31,"chr19",1,0.0763009845288326
"22242","chr19.18680000.18685000","chr19.18935000.18940000",255000,13,0.0004852181,18680000,18935000,18685000,18940000,"chr19",641238,5,23,15,43,"chr19",1,0.0655180496952649
"22243","chr19.2175000.2180000","chr19.2315000.2320000",140000,14,0.00876904,2175000,2315000,2180000,2320000,"chr19",641239,10,26,25,61,"chr19",1,0.100093764650727
"22244","chr19.4370000.4375000","chr19.4395000.4400000",25000,39,0.0001056016,4370000,4395000,4375000,4400000,"chr19",641250,2,2,6,10,"chr19",1,0.0457102672292546
"22245","chr19.10590000.10595000","chr19.10650000.10655000",60000,30,2.357043e-07,10590000,10650000,10595000,10655000,"chr19",641262,7,21,24,52,"chr19",1,0.182841068917018
"22246","chr19.2160000.2165000","chr19.2235000.2240000",75000,28,9.265378e-08,2160000,2235000,2165000,2240000,"chr19",641275,6,22,14,42,"chr19",1,0.137834036568214
"22247","chr19.47270000.47275000","chr19.47295000.47300000",25000,49,7.434461e-09,47270000,47295000,47275000,47300000,"chr19",641308,3,3,6,12,"chr19",1,0.0689170182841069
"22248","chr19.4855000.4860000","chr19.4910000.4915000",55000,27,3.180048e-05,4855000,4910000,4860000,4915000,"chr19",641325,5,7,6,18,"chr19",1,0.0569620253164557
"22249","chr19.45420000.45425000","chr19.45445000.45450000",25000,35,0.002234426,45420000,45445000,45425000,45450000,"chr19",641327,3,17,14,34,"chr19",1,0.139474917955931
"22250","chr19.49775000.49780000","chr19.49800000.49805000",25000,36,0.00110474,49775000,49800000,49780000,49805000,"chr19",641386,7,10,21,38,"chr19",1,0.160337552742616
"22251","chr19.38890000.38895000","chr19.39125000.39130000",235000,14,0.0002188068,38890000,39125000,38895000,39130000,"chr19",641417,3,11,11,25,"chr19",1,0.0410220346929208
"22252","chr19.38895000.38900000","chr19.39460000.39465000",565000,9,0.001132825,38895000,39460000,38900000,39465000,"chr19",641433,5,25,18,48,"chr19",1,0.0506329113924051
"22253","chr19.39140000.39145000","chr19.39390000.39395000",250000,16,5.103023e-06,39140000,39390000,39145000,39395000,"chr19",641444,10,19,21,50,"chr19",1,0.093764650726676
"22254","chr19.2475000.2480000","chr19.2630000.2635000",155000,20,1.566351e-06,2475000,2630000,2480000,2635000,"chr19",641476,1,1,1,3,"chr19",1,0.0070323488045007
"22255","chr19.39035000.39040000","chr19.39105000.39110000",70000,32,8.823505e-10,39035000,39105000,39040000,39110000,"chr19",641494,7,25,33,65,"chr19",1,0.243788091889358
"22256","chr19.38635000.38640000","chr19.38695000.38700000",60000,29,8.438118e-07,38635000,38695000,38640000,38700000,"chr19",641517,1,3,1,5,"chr19",1,0.01699484294421
"22257","chr19.1020000.1025000","chr19.1170000.1175000",150000,15,0.001919485,1020000,1170000,1025000,1175000,"chr19",641533,1,1,4,6,"chr19",1,0.0105485232067511
"22258","chr19.2680000.2685000","chr19.2740000.2745000",60000,21,0.004609976,2680000,2740000,2685000,2745000,"chr19",641555,14,23,25,62,"chr19",1,0.152601969057665
"22259","chr19.3325000.3330000","chr19.3485000.3490000",160000,42,4.16055e-26,3325000,3485000,3330000,3490000,"chr19",641591,15,38,38,91,"chr19",1,0.447960618846695
"22260","chr19.39445000.39450000","chr19.39535000.39540000",90000,17,0.006750948,39445000,39535000,39450000,39540000,"chr19",641598,3,16,19,38,"chr19",1,0.0757149554617909
"22261","chr19.3345000.3350000","chr19.3400000.3405000",55000,24,0.0007085265,3345000,3400000,3350000,3405000,"chr19",641602,1,7,8,16,"chr19",1,0.0450070323488045
"22262","chr19.2960000.2965000","chr19.3020000.3025000",60000,21,0.004609976,2960000,3020000,2965000,3025000,"chr19",641606,9,46,45,100,"chr19",1,0.246132208157525
"22263","chr19.18115000.18120000","chr19.18165000.18170000",50000,61,2.019748e-27,18115000,18165000,18120000,18170000,"chr19",641654,4,6,2,12,"chr19",1,0.0857946554149086
"22264","chr19.48835000.48840000","chr19.49095000.49100000",260000,11,0.006242392,48835000,49095000,48840000,49100000,"chr19",641687,1,3,3,7,"chr19",1,0.00902484763244257
"22265","chr19.6245000.6250000","chr19.6280000.6285000",35000,28,0.002907628,6245000,6280000,6250000,6285000,"chr19",641692,12,18,18,48,"chr19",1,0.157524613220816
"22266","chr19.2780000.2785000","chr19.2820000.2825000",40000,25,0.006352757,2780000,2820000,2785000,2825000,"chr19",641718,1,6,5,12,"chr19",1,0.0351617440225035
"22267","chr19.18635000.18640000","chr19.18660000.18665000",25000,34,0.004460775,18635000,18660000,18640000,18665000,"chr19",641736,3,5,4,12,"chr19",1,0.0478199718706048
"22268","chr19.46020000.46025000","chr19.46090000.46095000",70000,19,0.006892072,46020000,46090000,46025000,46095000,"chr19",641738,0,5,10,15,"chr19",1,0.0334036568213783
"22269","chr19.2780000.2785000","chr19.2900000.2905000",120000,16,0.002564687,2780000,2900000,2785000,2905000,"chr19",641741,1,6,5,12,"chr19",1,0.0225035161744023
"22270","chr19.2745000.2750000","chr19.2900000.2905000",155000,16,0.0004493358,2745000,2900000,2750000,2905000,"chr19",641749,4,16,33,53,"chr19",1,0.0993905297702766
"22271","chr19.10835000.10840000","chr19.10870000.10875000",35000,50,4.139222e-14,10835000,10870000,10840000,10875000,"chr19",641771,6,5,13,24,"chr19",1,0.140646976090014
"22272","chr19.17535000.17540000","chr19.17845000.17850000",310000,10,0.008437098,17535000,17845000,17540000,17850000,"chr19",641776,15,39,44,98,"chr19",1,0.114861697140178
"22273","chr19.11370000.11375000","chr19.11585000.11590000",215000,13,0.001750998,11370000,11585000,11375000,11590000,"chr19",641783,11,15,18,44,"chr19",1,0.0670417252695734
"22274","chr19.2650000.2655000","chr19.2740000.2745000",90000,29,1.1731e-09,2650000,2740000,2655000,2745000,"chr19",641794,8,20,17,45,"chr19",1,0.15295358649789
"22275","chr19.3375000.3380000","chr19.3395000.3400000",20000,73,1.876551e-20,3375000,3395000,3380000,3400000,"chr19",641817,10,26,22,58,"chr19",1,0.496249413970933
"22276","chr19.45925000.45930000","chr19.45975000.45980000",50000,36,2.202181e-09,45925000,45975000,45930000,45980000,"chr19",641822,2,11,4,17,"chr19",1,0.0717299578059072
"22277","chr19.18455000.18460000","chr19.18515000.18520000",60000,26,3.026438e-05,18455000,18515000,18460000,18520000,"chr19",641823,3,15,22,40,"chr19",1,0.121894045944679
"22278","chr19.35835000.35840000","chr19.35955000.35960000",120000,18,0.0002527435,35835000,35955000,35840000,35960000,"chr19",641825,4,11,20,35,"chr19",1,0.0738396624472574
"22279","chr19.53100000.53105000","chr19.53250000.53255000",150000,16,0.0005709282,53100000,53250000,53105000,53255000,"chr19",641828,0,6,2,8,"chr19",1,0.0150023441162682
"22280","chr19.46785000.46790000","chr19.46840000.46845000",55000,23,0.001807231,46785000,46840000,46790000,46845000,"chr19",641843,1,14,8,23,"chr19",1,0.0620018752930145
"22281","chr19.18625000.18630000","chr19.18930000.18935000",305000,10,0.009134932,18625000,18930000,18630000,18935000,"chr19",641847,7,20,24,51,"chr19",1,0.059774964838256
"22282","chr19.40590000.40595000","chr19.40795000.40800000",205000,13,0.00243611,40590000,40795000,40595000,40800000,"chr19",641848,4,8,8,20,"chr19",1,0.0304735114861697
"22283","chr19.18750000.18755000","chr19.18935000.18940000",185000,14,0.001474598,18750000,18935000,18755000,18940000,"chr19",641849,6,16,12,34,"chr19",1,0.0557899671823722
"22284","chr19.2960000.2965000","chr19.3035000.3040000",75000,31,1.141167e-09,2960000,3035000,2965000,3040000,"chr19",641860,5,17,8,30,"chr19",1,0.109001406469761
"22285","chr19.12720000.12725000","chr19.12780000.12785000",60000,35,2.359842e-10,12720000,12780000,12725000,12785000,"chr19",641876,3,5,18,26,"chr19",1,0.106657290201594
"22286","chr19.4005000.4010000","chr19.4180000.4185000",175000,18,9.296638e-06,4005000,4180000,4010000,4185000,"chr19",641883,1,16,11,28,"chr19",1,0.0590717299578059
"22287","chr19.2650000.2655000","chr19.2745000.2750000",95000,39,8.476065e-18,2650000,2745000,2655000,2750000,"chr19",641896,8,20,17,45,"chr19",1,0.205696202531646
"22288","chr19.11640000.11645000","chr19.11670000.11675000",30000,36,3.98299e-05,11640000,11670000,11645000,11675000,"chr19",641930,0,9,11,20,"chr19",1,0.0843881856540084
"22289","chr19.2065000.2070000","chr19.2155000.2160000",90000,17,0.006750948,2065000,2155000,2070000,2160000,"chr19",641953,9,36,41,86,"chr19",1,0.171354899203
"22290","chr19.18645000.18650000","chr19.19135000.19140000",490000,10,0.0005477445,18645000,19135000,18650000,19140000,"chr19",641966,2,6,0,8,"chr19",1,0.00937646507266761
"22291","chr19.43950000.43955000","chr19.43980000.43985000",30000,31,0.002502255,43950000,43980000,43955000,43985000,"chr19",641986,2,6,7,15,"chr19",1,0.0545007032348805
"22292","chr19.5055000.5060000","chr19.5575000.5580000",520000,9,0.001933229,5055000,5575000,5060000,5580000,"chr19",642002,0,3,2,5,"chr19",1,0.00527426160337553
"22293","chr19.1110000.1115000","chr19.1190000.1195000",80000,27,1.451103e-07,1110000,1190000,1115000,1195000,"chr19",642004,0,4,3,7,"chr19",1,0.0221518987341772
"22294","chr19.47155000.47160000","chr19.47175000.47180000",20000,44,1.060913e-05,47155000,47175000,47160000,47180000,"chr19",642015,7,23,24,54,"chr19",1,0.278481012658228
"22295","chr19.19340000.19345000","chr19.19360000.19365000",20000,39,0.0005824433,19340000,19360000,19345000,19365000,"chr19",642038,4,14,15,33,"chr19",1,0.15084388185654
"22296","chr19.12510000.12515000","chr19.12780000.12785000",270000,12,0.001300302,12510000,12780000,12515000,12785000,"chr19",642040,0,5,6,11,"chr19",1,0.0154711673699015
"22297","chr19.13275000.13280000","chr19.14245000.14250000",970000,7,0.001414107,13275000,14245000,13280000,14250000,"chr19",642058,1,6,7,14,"chr19",1,0.0114861697140178
"22298","chr19.48465000.48470000","chr19.48795000.48800000",330000,11,0.00149124,48465000,48795000,48470000,48800000,"chr19",642093,0,7,5,12,"chr19",1,0.0154711673699015
"22299","chr19.57725000.57730000","chr19.58540000.58545000",815000,9,9.089945e-05,57725000,58540000,57730000,58545000,"chr19",642094,3,25,14,42,"chr19",1,0.0443037974683544
"22300","chr19.13745000.13750000","chr19.13795000.13800000",50000,22,0.009804879,13745000,13795000,13750000,13800000,"chr19",642100,2,17,9,28,"chr19",1,0.0721987810595406
"22301","chr19.18110000.18115000","chr19.18165000.18170000",55000,47,1.044047e-17,18110000,18165000,18115000,18170000,"chr19",642115,5,22,19,46,"chr19",1,0.253398968588842
"22302","chr19.2235000.2240000","chr19.2315000.2320000",80000,22,9.341776e-05,2235000,2315000,2240000,2320000,"chr19",642136,10,22,23,55,"chr19",1,0.141819034224098
"22303","chr19.12885000.12890000","chr19.12910000.12915000",25000,65,1.850273e-17,12885000,12910000,12890000,12915000,"chr19",642155,9,20,20,49,"chr19",1,0.373300515705579
"22304","chr19.46425000.46430000","chr19.46495000.46500000",70000,23,0.0001240303,46425000,46495000,46430000,46500000,"chr19",642171,0,6,4,10,"chr19",1,0.0269573370839194
"22305","chr19.46610000.46615000","chr19.46725000.46730000",115000,15,0.009573557,46610000,46725000,46615000,46730000,"chr19",642177,3,5,7,15,"chr19",1,0.0263713080168776
"22306","chr19.46745000.46750000","chr19.47045000.47050000",300000,12,0.0006255539,46745000,47045000,46750000,47050000,"chr19",642203,4,11,8,23,"chr19",1,0.0323488045007032
"22307","chr19.46525000.46530000","chr19.46695000.46700000",170000,15,0.000785457,46525000,46695000,46530000,46700000,"chr19",642227,0,4,2,6,"chr19",1,0.0105485232067511
"22308","chr19.6065000.6070000","chr19.6110000.6115000",45000,32,1.801546e-06,6065000,6110000,6070000,6115000,"chr19",642239,0,0,5,5,"chr19",1,0.0187529301453352
"22309","chr19.6480000.6485000","chr19.6735000.6740000",255000,13,0.0004852181,6480000,6735000,6485000,6740000,"chr19",642273,2,4,10,16,"chr19",1,0.0243788091889358
"22310","chr19.2160000.2165000","chr19.2265000.2270000",105000,20,6.655049e-05,2160000,2265000,2165000,2270000,"chr19",642308,6,25,14,45,"chr19",1,0.105485232067511
"22311","chr19.18485000.18490000","chr19.18930000.18935000",445000,9,0.004885123,18485000,18930000,18490000,18935000,"chr19",642310,0,3,1,4,"chr19",1,0.00421940928270042
"22312","chr19.50315000.50320000","chr19.50375000.50380000",60000,27,9.571974e-06,50315000,50375000,50320000,50380000,"chr19",642357,1,13,6,20,"chr19",1,0.0632911392405063
"22313","chr19.4720000.4725000","chr19.4800000.4805000",80000,22,9.341776e-05,4720000,4800000,4725000,4805000,"chr19",642384,1,10,9,20,"chr19",1,0.0515705578996718
"22314","chr19.6505000.6510000","chr19.6735000.6740000",230000,15,5.855298e-05,6505000,6735000,6510000,6740000,"chr19",642393,2,4,10,16,"chr19",1,0.0281293952180028
"22315","chr19.46735000.46740000","chr19.46755000.46760000",20000,39,0.0005824433,46735000,46755000,46740000,46760000,"chr19",642397,4,8,12,24,"chr19",1,0.109704641350211
"22316","chr19.2490000.2495000","chr19.2610000.2615000",120000,19,7.1299e-05,2490000,2610000,2495000,2615000,"chr19",642403,1,8,8,17,"chr19",1,0.0378574777308955
"22317","chr19.50555000.50560000","chr19.50635000.50640000",80000,36,1.04284e-13,50555000,50635000,50560000,50640000,"chr19",642421,0,2,1,3,"chr19",1,0.0126582278481013
"22318","chr19.54205000.54210000","chr19.54230000.54235000",25000,39,0.0001056016,54205000,54230000,54210000,54235000,"chr19",642449,0,3,1,4,"chr19",1,0.0182841068917018
"22319","chr19.17555000.17560000","chr19.17675000.17680000",120000,15,0.00740459,17555000,17675000,17560000,17680000,"chr19",642453,6,23,26,55,"chr19",1,0.0966947960618847
"22320","chr19.10135000.10140000","chr19.10190000.10195000",55000,23,0.001807231,10135000,10190000,10140000,10195000,"chr19",642460,1,15,25,41,"chr19",1,0.110525082044069
"22321","chr19.33840000.33845000","chr19.34170000.34175000",330000,10,0.006059179,33840000,34170000,33845000,34175000,"chr19",642483,0,6,3,9,"chr19",1,0.0105485232067511
"22322","chr19.2455000.2460000","chr19.2585000.2590000",130000,15,0.004609976,2455000,2585000,2460000,2590000,"chr19",642484,3,13,19,35,"chr19",1,0.0615330520393812
"22323","chr19.2460000.2465000","chr19.2585000.2590000",125000,17,0.0006201799,2460000,2585000,2465000,2590000,"chr19",642509,3,13,16,32,"chr19",1,0.0637599624941397
"22324","chr19.19145000.19150000","chr19.19170000.19175000",25000,36,0.00110474,19145000,19170000,19150000,19175000,"chr19",642527,0,7,2,9,"chr19",1,0.0379746835443038
"22325","chr19.18645000.18650000","chr19.18985000.18990000",340000,10,0.005138915,18645000,18985000,18650000,18990000,"chr19",642540,2,6,0,8,"chr19",1,0.00937646507266761
"22326","chr19.3325000.3330000","chr19.3445000.3450000",120000,22,1.100927e-06,3325000,3445000,3330000,3450000,"chr19",642544,3,16,20,39,"chr19",1,0.10056258790436
"22327","chr19.47710000.47715000","chr19.47745000.47750000",35000,39,6.325726e-08,47710000,47745000,47715000,47750000,"chr19",642548,5,34,38,77,"chr19",1,0.35196905766526
"22328","chr19.41870000.41875000","chr19.42385000.42390000",515000,8,0.009629245,41870000,42385000,41875000,42390000,"chr19",642552,4,28,35,67,"chr19",1,0.0628223159868729
"22329","chr19.18070000.18075000","chr19.18095000.18100000",25000,36,0.00110474,18070000,18095000,18075000,18100000,"chr19",642560,5,16,13,34,"chr19",1,0.143459915611814
"22330","chr19.6460000.6465000","chr19.6500000.6505000",40000,29,0.0002149935,6460000,6500000,6465000,6505000,"chr19",642580,9,17,9,35,"chr19",1,0.11896390060947
"22331","chr19.7515000.7520000","chr19.7625000.7630000",110000,22,2.839038e-06,7515000,7625000,7520000,7630000,"chr19",642594,0,2,0,2,"chr19",1,0.00515705578996718
"22332","chr19.48465000.48470000","chr19.48585000.48590000",120000,19,7.1299e-05,48465000,48585000,48470000,48590000,"chr19",642604,0,7,5,12,"chr19",1,0.0267229254571027
"22333","chr19.11240000.11245000","chr19.11640000.11645000",400000,10,0.002090477,11240000,11640000,11245000,11645000,"chr19",642632,9,23,16,48,"chr19",1,0.0562587904360056
"22334","chr19.3035000.3040000","chr19.3060000.3065000",25000,34,0.004460775,3035000,3060000,3040000,3065000,"chr19",642667,2,11,8,21,"chr19",1,0.0836849507735584
"22335","chr19.6450000.6455000","chr19.6485000.6490000",35000,32,9.632462e-05,6450000,6485000,6455000,6490000,"chr19",642722,6,25,23,54,"chr19",1,0.20253164556962
"22336","chr19.14245000.14250000","chr19.14495000.14500000",250000,12,0.002217,14245000,14495000,14250000,14500000,"chr19",642752,4,6,12,22,"chr19",1,0.0309423347398031
"22337","chr19.46895000.46900000","chr19.46975000.46980000",80000,20,0.000850976,46895000,46975000,46900000,46980000,"chr19",642755,0,2,1,3,"chr19",1,0.0070323488045007
"22338","chr19.47770000.47775000","chr19.48105000.48110000",335000,10,0.005588291,47770000,48105000,47775000,48110000,"chr19",642792,4,28,24,56,"chr19",1,0.0656352555086732
"22339","chr19.49815000.49820000","chr19.49935000.49940000",120000,15,0.00740459,49815000,49935000,49820000,49940000,"chr19",642838,5,21,21,47,"chr19",1,0.0826300984528833
"22340","chr19.49775000.49780000","chr19.49875000.49880000",100000,16,0.008589977,49775000,49875000,49780000,49880000,"chr19",642856,0,2,0,2,"chr19",1,0.00375058602906704
"22341","chr19.57360000.57365000","chr19.57570000.57575000",210000,13,0.002067484,57360000,57570000,57365000,57575000,"chr19",642887,1,10,4,15,"chr19",1,0.0228551336146273
"22342","chr19.48605000.48610000","chr19.48660000.48665000",55000,32,8.081663e-08,48605000,48660000,48610000,48665000,"chr19",642900,2,11,11,24,"chr19",1,0.090014064697609
"22343","chr19.38140000.38145000","chr19.38205000.38210000",65000,21,0.002127914,38140000,38205000,38145000,38210000,"chr19",642914,1,6,2,9,"chr19",1,0.0221518987341772
"22344","chr19.18470000.18475000","chr19.18515000.18520000",45000,24,0.004627476,18470000,18515000,18475000,18520000,"chr19",642946,3,11,4,18,"chr19",1,0.0506329113924051
"22345","chr19.7515000.7520000","chr19.7550000.7555000",35000,53,5.022095e-16,7515000,7550000,7520000,7555000,"chr19",642948,2,8,13,23,"chr19",1,0.142873886544773
"22346","chr19.3985000.3990000","chr19.4120000.4125000",135000,17,0.0003512967,3985000,4120000,3990000,4125000,"chr19",642974,0,3,2,5,"chr19",1,0.00996249413970933
"22347","chr19.17930000.17935000","chr19.17995000.18000000",65000,25,3.1669e-05,17930000,17995000,17935000,1.8e+07,"chr19",642978,7,14,19,40,"chr19",1,0.117205813408345
"22348","chr19.3325000.3330000","chr19.3400000.3405000",75000,19,0.004022159,3325000,3400000,3330000,3405000,"chr19",642984,1,7,8,16,"chr19",1,0.0356305672761369
"22349","chr19.47345000.47350000","chr19.47470000.47475000",125000,15,0.005869735,47345000,47470000,47350000,47475000,"chr19",643002,3,11,10,24,"chr19",1,0.0421940928270042
"22350","chr19.38375000.38380000","chr19.38830000.38835000",455000,9,0.004395035,38375000,38830000,38380000,38835000,"chr19",643007,9,31,38,78,"chr19",1,0.0822784810126582
"22351","chr19.2145000.2150000","chr19.2235000.2240000",90000,18,0.002504067,2145000,2235000,2150000,2240000,"chr19",643023,4,12,13,29,"chr19",1,0.0611814345991561
"22352","chr19.40810000.40815000","chr19.41135000.41140000",325000,12,0.0003595058,40810000,41135000,40815000,41140000,"chr19",643061,5,6,9,20,"chr19",1,0.0281293952180028
"22353","chr19.47390000.47395000","chr19.47470000.47475000",80000,20,0.000850976,47390000,47470000,47395000,47475000,"chr19",643075,5,13,16,34,"chr19",1,0.0796999531176746
"22354","chr19.12440000.12445000","chr19.12510000.12515000",70000,21,0.001047069,12440000,12510000,12445000,12515000,"chr19",643104,0,10,5,15,"chr19",1,0.0369198312236287
"22355","chr19.1040000.1045000","chr19.1100000.1105000",60000,31,6.339004e-08,1040000,1100000,1045000,1105000,"chr19",643114,0,2,2,4,"chr19",1,0.0145335208626348
"22356","chr19.10380000.10385000","chr19.10420000.10425000",40000,25,0.006352757,10380000,10420000,10385000,10425000,"chr19",643118,0,3,2,5,"chr19",1,0.0146507266760431
"22357","chr19.11635000.11640000","chr19.11690000.11695000",55000,21,0.009962913,11635000,11690000,11640000,11695000,"chr19",643122,8,16,21,45,"chr19",1,0.110759493670886
"22358","chr19.7550000.7555000","chr19.7865000.7870000",315000,10,0.007729651,7550000,7865000,7555000,7870000,"chr19",643148,2,8,13,23,"chr19",1,0.0269573370839194
"22359","chr19.16245000.16250000","chr19.16280000.16285000",35000,28,0.002907628,16245000,16280000,16250000,16285000,"chr19",643150,2,12,17,31,"chr19",1,0.101734646038444
"22360","chr19.2650000.2655000","chr19.2685000.2690000",35000,31,0.0002399242,2650000,2685000,2655000,2690000,"chr19",643153,6,15,17,38,"chr19",1,0.13806844819503
"22361","chr19.47410000.47415000","chr19.47495000.47500000",85000,18,0.003986847,47410000,47495000,47415000,47500000,"chr19",643158,4,1,2,7,"chr19",1,0.0147679324894515
"22362","chr19.4720000.4725000","chr19.4805000.4810000",85000,22,4.842908e-05,4720000,4805000,4725000,4810000,"chr19",643168,1,10,9,20,"chr19",1,0.0515705578996718
"22363","chr19.39110000.39115000","chr19.39340000.39345000",230000,17,2.361154e-06,39110000,39340000,39115000,39345000,"chr19",643173,0,5,2,7,"chr19",1,0.0139474917955931
"22364","chr19.18830000.18835000","chr19.18930000.18935000",100000,18,0.001099799,18830000,18930000,18835000,18935000,"chr19",643192,7,14,24,45,"chr19",1,0.0949367088607595
"22365","chr19.12035000.12040000","chr19.12720000.12725000",685000,8,0.001919485,12035000,12720000,12040000,12725000,"chr19",643197,3,15,11,29,"chr19",1,0.0271917487107361
"22366","chr19.2700000.2705000","chr19.2745000.2750000",45000,28,0.0001275693,2700000,2745000,2705000,2750000,"chr19",643227,9,5,19,33,"chr19",1,0.108298171589311
"22367","chr19.2265000.2270000","chr19.2325000.2330000",60000,22,0.001858745,2265000,2325000,2270000,2330000,"chr19",643232,4,13,7,24,"chr19",1,0.0618846694796062
"22368","chr19.38400000.38405000","chr19.38845000.38850000",445000,12,3.354713e-05,38400000,38845000,38405000,38850000,"chr19",643259,5,13,7,25,"chr19",1,0.0351617440225035
"22369","chr19.46510000.46515000","chr19.47480000.47485000",970000,6,0.009424668,46510000,47480000,46515000,47485000,"chr19",643263,0,8,5,13,"chr19",1,0.00914205344585091
"22370","chr19.47295000.47300000","chr19.47315000.47320000",20000,50,3.685705e-08,47295000,47315000,47300000,47320000,"chr19",643269,11,26,27,64,"chr19",1,0.375058602906704
"22371","chr19.5900000.5905000","chr19.6390000.6395000",490000,12,1.420945e-05,5900000,6390000,5905000,6395000,"chr19",643292,2,7,14,23,"chr19",1,0.0323488045007032
"22372","chr19.3555000.3560000","chr19.3700000.3705000",145000,14,0.007172536,3555000,3700000,3560000,3705000,"chr19",643297,6,22,19,47,"chr19",1,0.077121425222691
"22373","chr19.18700000.18705000","chr19.18940000.18945000",240000,13,0.0007652525,18700000,18940000,18705000,18945000,"chr19",643309,3,7,8,18,"chr19",1,0.0274261603375527
"22374","chr19.48510000.48515000","chr19.48580000.48585000",70000,19,0.006892072,48510000,48580000,48515000,48585000,"chr19",643337,0,1,1,2,"chr19",1,0.00445382090951711
"22375","chr19.50635000.50640000","chr19.50970000.50975000",335000,10,0.005588291,50635000,50970000,50640000,50975000,"chr19",643343,0,2,10,12,"chr19",1,0.0140646976090014
"22376","chr19.2015000.2020000","chr19.2060000.2065000",45000,32,1.801546e-06,2015000,2060000,2020000,2065000,"chr19",643349,8,35,32,75,"chr19",1,0.281293952180028
"22377","chr19.7630000.7635000","chr19.7940000.7945000",310000,12,0.0005105904,7630000,7940000,7635000,7945000,"chr19",643371,3,8,10,21,"chr19",1,0.029535864978903
"22378","chr19.12510000.12515000","chr19.12550000.12555000",40000,140,5.663085e-101,12510000,12550000,12515000,12555000,"chr19",643375,0,10,6,16,"chr19",1,0.262541022034693
"22379","chr19.48855000.48860000","chr19.48930000.48935000",75000,20,0.001506047,48855000,48930000,48860000,48935000,"chr19",643382,9,32,38,79,"chr19",1,0.185185185185185
"22380","chr19.1920000.1925000","chr19.2065000.2070000",145000,16,0.0007323504,1920000,2065000,1925000,2070000,"chr19",643391,6,7,13,26,"chr19",1,0.0487576183778715
"22381","chr19.4850000.4855000","chr19.5030000.5035000",180000,14,0.001807231,4850000,5030000,4855000,5035000,"chr19",643393,11,11,14,36,"chr19",1,0.0590717299578059
"22382","chr19.1350000.1355000","chr19.1380000.1385000",30000,43,3.260819e-08,1350000,1380000,1355000,1385000,"chr19",643401,9,24,23,56,"chr19",1,0.282231598687295
"22383","chr19.2235000.2240000","chr19.2265000.2270000",30000,53,1.479578e-13,2235000,2265000,2240000,2270000,"chr19",643405,10,22,23,55,"chr19",1,0.341654946085326
"22384","chr19.38895000.38900000","chr19.39325000.39330000",430000,11,0.00026082,38895000,39325000,38900000,39330000,"chr19",643418,8,12,16,36,"chr19",1,0.0464135021097046
"22385","chr19.18470000.18475000","chr19.18505000.18510000",35000,29,0.001308007,18470000,18505000,18475000,18510000,"chr19",643428,3,11,4,18,"chr19",1,0.0611814345991561
"22386","chr19.2585000.2590000","chr19.2610000.2615000",25000,34,0.004460775,2585000,2610000,2590000,2615000,"chr19",643453,3,13,19,35,"chr19",1,0.139474917955931
"22387","chr19.2660000.2665000","chr19.2745000.2750000",85000,25,1.010972e-06,2660000,2745000,2665000,2750000,"chr19",643454,3,9,2,14,"chr19",1,0.0410220346929208
"22388","chr19.6455000.6460000","chr19.6735000.6740000",280000,11,0.004043892,6455000,6735000,6460000,6740000,"chr19",643464,2,4,10,16,"chr19",1,0.0206282231598687
"22389","chr19.12845000.12850000","chr19.12870000.12875000",25000,34,0.004460775,12845000,12870000,12850000,12875000,"chr19",643477,6,10,8,24,"chr19",1,0.0956399437412096
"22390","chr19.12400000.12405000","chr19.12440000.12445000",40000,36,1.228095e-07,12400000,12440000,12405000,12445000,"chr19",643490,2,10,5,17,"chr19",1,0.0717299578059072
"22391","chr19.8220000.8225000","chr19.8305000.8310000",85000,51,4.054615e-27,8220000,8305000,8225000,8310000,"chr19",643496,6,23,9,38,"chr19",1,0.227144866385373
"22392","chr19.17675000.17680000","chr19.17930000.17935000",255000,13,0.0004852181,17675000,17930000,17680000,17935000,"chr19",643508,7,14,19,40,"chr19",1,0.0609470229723394
"22393","chr19.48950000.48955000","chr19.49085000.49090000",135000,15,0.003755441,48950000,49085000,48955000,49090000,"chr19",643512,8,18,17,43,"chr19",1,0.0755977496483826
"22394","chr19.42180000.42185000","chr19.42215000.42220000",35000,30,0.0005709282,42180000,42215000,42185000,42220000,"chr19",643537,0,5,3,8,"chr19",1,0.0281293952180028
"22395","chr19.2645000.2650000","chr19.2785000.2790000",140000,22,2.096589e-07,2645000,2785000,2650000,2790000,"chr19",643541,5,15,27,47,"chr19",1,0.121190811064229
"22396","chr19.4140000.4145000","chr19.4200000.4205000",60000,24,0.0002613597,4140000,4200000,4145000,4205000,"chr19",643564,8,32,30,70,"chr19",1,0.19690576652602
"22397","chr19.2155000.2160000","chr19.2235000.2240000",80000,34,3.056076e-12,2155000,2235000,2160000,2240000,"chr19",643566,10,22,23,55,"chr19",1,0.219174871073605
"22398","chr19.4340000.4345000","chr19.4395000.4400000",55000,22,0.004393008,4340000,4395000,4345000,4400000,"chr19",643576,2,16,9,27,"chr19",1,0.069620253164557
"22399","chr19.34675000.34680000","chr19.34770000.34775000",95000,22,1.420945e-05,34675000,34770000,34680000,34775000,"chr19",643600,0,0,1,1,"chr19",1,0.00257852789498359
"22400","chr19.6425000.6430000","chr19.6480000.6485000",55000,24,0.0007085265,6425000,6480000,6430000,6485000,"chr19",643612,9,15,31,55,"chr19",1,0.154711673699015
"22401","chr19.12670000.12675000","chr19.12780000.12785000",110000,38,2.028264e-18,12670000,12780000,12675000,12785000,"chr19",643622,4,5,18,27,"chr19",1,0.120253164556962
"22402","chr19.8220000.8225000","chr19.8250000.8255000",30000,36,3.98299e-05,8220000,8250000,8225000,8255000,"chr19",643624,12,51,49,112,"chr19",1,0.472573839662447
"22403","chr19.39035000.39040000","chr19.39325000.39330000",290000,12,0.0007989375,39035000,39325000,39040000,39330000,"chr19",643635,8,12,16,36,"chr19",1,0.0506329113924051
"22404","chr19.6425000.6430000","chr19.6455000.6460000",30000,52,5.495524e-13,6425000,6455000,6430000,6460000,"chr19",643668,2,5,17,24,"chr19",1,0.146272855133615
"22405","chr19.2665000.2670000","chr19.2750000.2755000",85000,25,1.010972e-06,2665000,2750000,2670000,2755000,"chr19",643669,6,25,26,57,"chr19",1,0.167018284106892
"22406","chr19.2745000.2750000","chr19.2780000.2785000",35000,40,1.956127e-08,2745000,2780000,2750000,2785000,"chr19",643682,1,6,5,12,"chr19",1,0.0562587904360056
"22407","chr19.2275000.2280000","chr19.2380000.2385000",105000,17,0.002216849,2275000,2380000,2280000,2385000,"chr19",643683,4,16,24,44,"chr19",1,0.0876699484294421
"22408","chr19.49120000.49125000","chr19.49145000.49150000",25000,46,1.718397e-07,49120000,49145000,49125000,49150000,"chr19",643708,4,21,13,38,"chr19",1,0.204875761837787
"22409","chr19.51900000.51905000","chr19.52170000.52175000",270000,12,0.001300302,51900000,52170000,51905000,52175000,"chr19",643713,3,17,14,34,"chr19",1,0.0478199718706048
"22410","chr19.4350000.4355000","chr19.4395000.4400000",45000,34,1.713283e-07,4350000,4395000,4355000,4400000,"chr19",643765,5,22,25,52,"chr19",1,0.207219878105954
"22411","chr19.54155000.54160000","chr19.54230000.54235000",75000,22,0.00018093,54155000,54230000,54160000,54235000,"chr19",643789,0,3,3,6,"chr19",1,0.0154711673699015
"22412","chr19.9785000.9790000","chr19.9890000.9895000",105000,19,0.0002301067,9785000,9890000,9790000,9895000,"chr19",643796,5,19,11,35,"chr19",1,0.0779418659165495
"22413","chr19.55255000.55260000","chr19.55285000.55290000",30000,32,0.001187867,55255000,55285000,55260000,55290000,"chr19",643816,2,6,4,12,"chr19",1,0.0450070323488045
"22414","chr19.38655000.38660000","chr19.38695000.38700000",40000,31,3.031599e-05,38655000,38695000,38660000,38700000,"chr19",643822,1,3,1,5,"chr19",1,0.0181669010782935
"22415","chr19.37310000.37315000","chr19.38210000.38215000",900000,8,0.0003371775,37310000,38210000,37315000,38215000,"chr19",643874,5,13,9,27,"chr19",1,0.0253164556962025
"22416","chr19.4910000.4915000","chr19.4965000.4970000",55000,21,0.009962913,4910000,4965000,4915000,4970000,"chr19",643876,5,7,6,18,"chr19",1,0.0443037974683544
"22417","chr19.47605000.47610000","chr19.48370000.48375000",765000,7,0.005968404,47605000,48370000,47610000,48375000,"chr19",643906,9,9,25,43,"chr19",1,0.0352789498359119
"22418","chr19.2475000.2480000","chr19.2620000.2625000",145000,17,0.0002091231,2475000,2620000,2480000,2625000,"chr19",643923,1,1,1,3,"chr19",1,0.0059774964838256
"22419","chr19.18385000.18390000","chr19.18515000.18520000",130000,23,9.906885e-08,18385000,18515000,18390000,18520000,"chr19",643928,9,13,9,31,"chr19",1,0.08356774496015
"22420","chr19.3345000.3350000","chr19.3435000.3440000",90000,37,1.319065e-15,3345000,3435000,3350000,3440000,"chr19",643934,8,28,26,62,"chr19",1,0.268870135958744
"22421","chr19.2960000.2965000","chr19.3160000.3165000",200000,34,1.90882e-20,2960000,3160000,2965000,3165000,"chr19",643952,8,13,17,38,"chr19",1,0.151429910923582
"22422","chr19.13860000.13865000","chr19.13970000.13975000",110000,16,0.004609976,13860000,13970000,13865000,13975000,"chr19",643977,8,8,12,28,"chr19",1,0.0525082044069386
"22423","chr19.2680000.2685000","chr19.2750000.2755000",70000,23,0.0001240303,2680000,2750000,2685000,2755000,"chr19",643987,6,31,26,63,"chr19",1,0.169831223628692
"22424","chr19.50550000.50555000","chr19.50635000.50640000",85000,19,0.001440986,50550000,50635000,50555000,50640000,"chr19",643995,0,1,2,3,"chr19",1,0.00668073136427567
"22425","chr19.17700000.17705000","chr19.17995000.18000000",295000,13,0.0001536956,17700000,17995000,17705000,1.8e+07,"chr19",644003,6,21,20,47,"chr19",1,0.0716127519924988
"22426","chr19.47410000.47415000","chr19.47505000.47510000",95000,17,0.004609976,47410000,47505000,47415000,47510000,"chr19",644004,4,5,9,18,"chr19",1,0.0358649789029536
"22427","chr19.11585000.11590000","chr19.11640000.11645000",55000,21,0.009962913,11585000,11640000,11590000,11645000,"chr19",644008,9,15,16,40,"chr19",1,0.0984528832630098
"22428","chr19.2635000.2640000","chr19.2745000.2750000",110000,23,6.805827e-07,2635000,2745000,2640000,2750000,"chr19",644017,0,6,2,8,"chr19",1,0.0215658696671355
"22429","chr19.15330000.15335000","chr19.15430000.15435000",100000,19,0.000348893,15330000,15430000,15335000,15435000,"chr19",644064,1,4,12,17,"chr19",1,0.0378574777308955
"22430","chr19.2650000.2655000","chr19.2775000.2780000",125000,17,0.0006201799,2650000,2775000,2655000,2780000,"chr19",644081,6,12,17,35,"chr19",1,0.0697374589779653
"22431","chr19.57725000.57730000","chr19.58325000.58330000",600000,8,0.004163378,57725000,58325000,57730000,58330000,"chr19",644086,0,1,2,3,"chr19",1,0.00281293952180028
"22432","chr19.12400000.12405000","chr19.12480000.12485000",80000,21,0.000285034,12400000,12480000,12405000,12485000,"chr19",644098,2,10,6,18,"chr19",1,0.0443037974683544
"22433","chr19.2495000.2500000","chr19.2595000.2600000",100000,23,2.070235e-06,2495000,2595000,2500000,2600000,"chr19",644119,2,10,8,20,"chr19",1,0.0539146741678387
"22434","chr19.38090000.38095000","chr19.38140000.38145000",50000,22,0.009804879,38090000,38140000,38095000,38145000,"chr19",644124,1,6,2,9,"chr19",1,0.0232067510548523
"22435","chr19.2665000.2670000","chr19.2690000.2695000",25000,65,1.850273e-17,2665000,2690000,2670000,2695000,"chr19",644129,7,25,20,52,"chr19",1,0.396155649320206
"22436","chr19.42350000.42355000","chr19.42450000.42455000",100000,17,0.003153897,42350000,42450000,42355000,42455000,"chr19",644130,0,3,5,8,"chr19",1,0.0159399906235349
"22437","chr19.57360000.57365000","chr19.57595000.57600000",235000,13,0.000894079,57360000,57595000,57365000,57600000,"chr19",644132,1,14,7,22,"chr19",1,0.0335208626347867
"22438","chr19.46005000.46010000","chr19.46945000.46950000",940000,8,0.0002387575,46005000,46945000,46010000,46950000,"chr19",644148,2,4,4,10,"chr19",1,0.00937646507266761
"22439","chr19.40500000.40505000","chr19.40595000.40600000",95000,24,9.68507e-07,40500000,40595000,40505000,40600000,"chr19",644159,5,9,13,27,"chr19",1,0.0759493670886076
"22440","chr19.4790000.4795000","chr19.4910000.4915000",120000,18,0.0002527435,4790000,4910000,4795000,4915000,"chr19",644180,2,3,2,7,"chr19",1,0.0147679324894515
"22441","chr19.8240000.8245000","chr19.8265000.8270000",25000,33,0.008466812,8240000,8265000,8245000,8270000,"chr19",644190,9,15,21,45,"chr19",1,0.174050632911392
"22442","chr19.4830000.4835000","chr19.4965000.4970000",135000,16,0.001199946,4830000,4965000,4835000,4970000,"chr19",644200,10,13,15,38,"chr19",1,0.0712611345522738
"22443","chr19.44025000.44030000","chr19.44160000.44165000",135000,15,0.003755441,44025000,44160000,44030000,44165000,"chr19",644205,0,4,3,7,"chr19",1,0.0123066104078762
"22444","chr19.5575000.5580000","chr19.5715000.5720000",140000,14,0.00876904,5575000,5715000,5580000,5720000,"chr19",644218,6,15,18,39,"chr19",1,0.0639943741209564
"22445","chr19.39340000.39345000","chr19.39390000.39395000",50000,50,9.699261e-19,39340000,39390000,39345000,39395000,"chr19",644225,0,5,2,7,"chr19",1,0.0410220346929208
"22446","chr19.45075000.45080000","chr19.45380000.45385000",305000,11,0.002384861,45075000,45380000,45080000,45385000,"chr19",644240,3,5,2,10,"chr19",1,0.012892639474918
"22447","chr19.11240000.11245000","chr19.11290000.11295000",50000,25,0.0007428205,11240000,11290000,11245000,11295000,"chr19",644246,4,20,18,42,"chr19",1,0.123066104078762
"22448","chr19.18070000.18075000","chr19.18085000.18090000",15000,45,4.359916e-06,18070000,18085000,18075000,18090000,"chr19",644269,10,28,23,61,"chr19",1,0.321729957805907
"22449","chr19.47130000.47135000","chr19.47235000.47240000",105000,21,1.814807e-05,47130000,47235000,47135000,47240000,"chr19",644273,8,19,10,37,"chr19",1,0.0910689170182841
"22450","chr19.39540000.39545000","chr19.39845000.39850000",305000,11,0.002384861,39540000,39845000,39545000,39850000,"chr19",644278,2,2,2,6,"chr19",1,0.00773558368495077
"22451","chr19.8005000.8010000","chr19.8220000.8225000",215000,32,3.461129e-19,8005000,8220000,8010000,8225000,"chr19",644311,13,44,51,108,"chr19",1,0.40506329113924
"22452","chr19.4815000.4820000","chr19.4910000.4915000",95000,18,0.001643925,4815000,4910000,4820000,4915000,"chr19",644318,5,7,6,18,"chr19",1,0.0379746835443038
"22453","chr19.53940000.53945000","chr19.53975000.53980000",35000,109,1.539864e-62,53940000,53975000,53945000,53980000,"chr19",644335,1,9,6,16,"chr19",1,0.204406938584154
"22454","chr19.47390000.47395000","chr19.47505000.47510000",115000,15,0.009573557,47390000,47505000,47395000,47510000,"chr19",644345,4,5,9,18,"chr19",1,0.0316455696202532
"22455","chr19.5965000.5970000","chr19.6020000.6025000",55000,25,0.0002637507,5965000,6020000,5970000,6025000,"chr19",644349,0,3,0,3,"chr19",1,0.00879043600562588
"22456","chr19.40665000.40670000","chr19.40810000.40815000",145000,19,1.338558e-05,40665000,40810000,40670000,40815000,"chr19",644355,2,6,3,11,"chr19",1,0.0244960150023441
"22457","chr19.39030000.39035000","chr19.39460000.39465000",430000,9,0.005992947,39030000,39460000,39035000,39465000,"chr19",644372,1,12,7,20,"chr19",1,0.0210970464135021
"22458","chr19.18160000.18165000","chr19.18515000.18520000",355000,11,0.0009566211,18160000,18515000,18165000,18520000,"chr19",644386,4,17,23,44,"chr19",1,0.056727613689639
"22459","chr19.2500000.2505000","chr19.2650000.2655000",150000,14,0.005916382,2500000,2650000,2505000,2655000,"chr19",644396,2,9,11,22,"chr19",1,0.0360993905297703
"22460","chr19.7205000.7210000","chr19.7515000.7520000",310000,20,1.828645e-10,7205000,7515000,7210000,7520000,"chr19",644402,6,12,17,35,"chr19",1,0.0820440693858415
"22461","chr19.17205000.17210000","chr19.17225000.17230000",20000,45,4.359916e-06,17205000,17225000,17210000,17230000,"chr19",644421,4,24,28,56,"chr19",1,0.29535864978903
"22462","chr19.47095000.47100000","chr19.47235000.47240000",140000,18,7.380246e-05,47095000,47235000,47100000,47240000,"chr19",644451,1,7,3,11,"chr19",1,0.0232067510548523
"22463","chr19.42045000.42050000","chr19.42070000.42075000",25000,33,0.008466812,42045000,42070000,42050000,42075000,"chr19",644461,7,7,13,27,"chr19",1,0.104430379746835
"22464","chr19.2645000.2650000","chr19.2745000.2750000",100000,75,2.921365e-55,2645000,2745000,2650000,2750000,"chr19",644484,10,31,34,75,"chr19",1,0.659282700421941
"22465","chr19.47615000.47620000","chr19.47750000.47755000",135000,23,6.371183e-08,47615000,47750000,47620000,47755000,"chr19",644485,3,5,3,11,"chr19",1,0.0296530707923113
"22466","chr19.55630000.55635000","chr19.56120000.56125000",490000,10,0.0005477445,55630000,56120000,55635000,56125000,"chr19",644494,0,6,5,11,"chr19",1,0.012892639474918
"22467","chr19.18450000.18455000","chr19.18515000.18520000",65000,20,0.005245412,18450000,18515000,18455000,18520000,"chr19",644497,7,13,10,30,"chr19",1,0.070323488045007
"22468","chr19.10715000.10720000","chr19.10745000.10750000",30000,43,3.260819e-08,10715000,10745000,10720000,10750000,"chr19",644508,3,11,15,29,"chr19",1,0.146155649320206
"22469","chr19.4245000.4250000","chr19.4395000.4400000",150000,20,2.199475e-06,4245000,4395000,4250000,4400000,"chr19",644516,6,22,16,44,"chr19",1,0.103141115799344
"22470","chr19.47420000.47425000","chr19.47615000.47620000",195000,13,0.003466155,47420000,47615000,47425000,47620000,"chr19",644525,4,11,10,25,"chr19",1,0.0380918893577121
"22471","chr19.39445000.39450000","chr19.39540000.39545000",95000,18,0.001643925,39445000,39540000,39450000,39545000,"chr19",644548,7,24,25,56,"chr19",1,0.118143459915612
"22472","chr19.920000.925000","chr19.1000000.1005000",80000,22,9.341776e-05,920000,1e+06,925000,1005000,"chr19",644558,6,10,14,30,"chr19",1,0.0773558368495077
"22473","chr19.54100000.54105000","chr19.54135000.54140000",35000,27,0.006173938,54100000,54135000,54105000,54140000,"chr19",644578,1,12,10,23,"chr19",1,0.0727848101265823
"22474","chr19.7095000.7100000","chr19.7900000.7905000",805000,7,0.004609976,7095000,7900000,7100000,7905000,"chr19",644592,3,4,3,10,"chr19",1,0.00820440693858415
"22475","chr19.50635000.50640000","chr19.50705000.50710000",70000,19,0.006892072,50635000,50705000,50640000,50710000,"chr19",644611,0,2,10,12,"chr19",1,0.0267229254571027
"22476","chr19.45690000.45695000","chr19.45815000.45820000",125000,15,0.005869735,45690000,45815000,45695000,45820000,"chr19",644613,2,11,4,17,"chr19",1,0.029887482419128
"22477","chr19.1900000.1905000","chr19.2060000.2065000",160000,15,0.001219266,1900000,2060000,1905000,2065000,"chr19",644615,8,35,32,75,"chr19",1,0.131856540084388
"22478","chr19.17535000.17540000","chr19.17675000.17680000",140000,15,0.002948886,17535000,17675000,17540000,17680000,"chr19",644641,8,23,26,57,"chr19",1,0.100210970464135
"22479","chr19.5680000.5685000","chr19.5720000.5725000",40000,31,3.031599e-05,5680000,5720000,5685000,5725000,"chr19",644649,6,31,23,60,"chr19",1,0.218002812939522
"22480","chr19.11035000.11040000","chr19.11240000.11245000",205000,13,0.00243611,11035000,11240000,11040000,11245000,"chr19",644716,10,22,21,53,"chr19",1,0.0807548054383497
"22481","chr19.1900000.1905000","chr19.2065000.2070000",165000,22,2.928931e-08,1900000,2065000,1905000,2070000,"chr19",644721,9,36,41,86,"chr19",1,0.221753398968589
"22482","chr19.10590000.10595000","chr19.10610000.10615000",20000,54,5.371103e-10,10590000,10610000,10595000,10615000,"chr19",644745,15,45,44,104,"chr19",1,0.658227848101266
"22483","chr19.2275000.2280000","chr19.2315000.2320000",40000,38,1.083882e-08,2275000,2315000,2280000,2320000,"chr19",644781,4,16,24,44,"chr19",1,0.195968120018753
"22484","chr19.39100000.39105000","chr19.39400000.39405000",300000,10,0.009962913,39100000,39400000,39105000,39405000,"chr19",644786,8,14,22,44,"chr19",1,0.0515705578996718
"22485","chr19.49765000.49770000","chr19.49815000.49820000",50000,23,0.004395035,49765000,49815000,49770000,49820000,"chr19",644806,0,6,5,11,"chr19",1,0.0296530707923113
"22486","chr19.17840000.17845000","chr19.18070000.18075000",230000,12,0.003950469,17840000,18070000,17845000,18075000,"chr19",644827,1,4,8,13,"chr19",1,0.0182841068917018
"22487","chr19.6480000.6485000","chr19.6630000.6635000",150000,16,0.0005709282,6480000,6630000,6485000,6635000,"chr19",644834,8,26,21,55,"chr19",1,0.103141115799344
"22488","chr19.46525000.46530000","chr19.47075000.47080000",550000,8,0.006710529,46525000,47075000,46530000,47080000,"chr19",644837,0,4,2,6,"chr19",1,0.00562587904360056
"22489","chr19.46525000.46530000","chr19.46785000.46790000",260000,11,0.006242392,46525000,46785000,46530000,46790000,"chr19",644862,0,4,2,6,"chr19",1,0.00773558368495077
"22490","chr19.36375000.36380000","chr19.36415000.36420000",40000,58,1.249647e-21,36375000,36415000,36380000,36420000,"chr19",644864,2,16,9,27,"chr19",1,0.183544303797468
"22491","chr19.10700000.10705000","chr19.10745000.10750000",45000,43,9.427798e-13,10700000,10745000,10705000,10750000,"chr19",644869,6,19,15,40,"chr19",1,0.201593999062353
"22492","chr19.18660000.18665000","chr19.18990000.18995000",330000,10,0.006059179,18660000,18990000,18665000,18995000,"chr19",644875,0,5,3,8,"chr19",1,0.00937646507266761
"22493","chr19.12035000.12040000","chr19.12400000.12405000",365000,12,0.0001621569,12035000,12400000,12040000,12405000,"chr19",644877,2,10,6,18,"chr19",1,0.0253164556962025
"22494","chr19.48835000.48840000","chr19.49120000.49125000",285000,16,1.314136e-06,48835000,49120000,48840000,49125000,"chr19",644881,1,3,3,7,"chr19",1,0.0131270511017346
"22495","chr19.4870000.4875000","chr19.5030000.5035000",160000,16,0.0003463836,4870000,5030000,4875000,5035000,"chr19",644889,11,11,14,36,"chr19",1,0.0675105485232067
"22496","chr19.54135000.54140000","chr19.54200000.54205000",65000,22,0.0008062846,54135000,54200000,54140000,54205000,"chr19",644912,1,12,10,23,"chr19",1,0.0593061415846226
"22497","chr19.8505000.8510000","chr19.8525000.8530000",20000,38,0.001201054,8505000,8525000,8510000,8530000,"chr19",644918,3,10,13,26,"chr19",1,0.115799343647445
"22498","chr19.2945000.2950000","chr19.3345000.3350000",400000,9,0.008792529,2945000,3345000,2950000,3350000,"chr19",644920,2,16,12,30,"chr19",1,0.0316455696202532
"22499","chr19.39105000.39110000","chr19.39325000.39330000",220000,15,9.089945e-05,39105000,39325000,39110000,39330000,"chr19",644945,7,12,16,35,"chr19",1,0.0615330520393812
"22500","chr19.46345000.46350000","chr19.47175000.47180000",830000,7,0.003973456,46345000,47175000,46350000,47180000,"chr19",644952,2,22,11,35,"chr19",1,0.0287154242850445
"22501","chr19.2645000.2650000","chr19.2700000.2705000",55000,29,3.272655e-06,2645000,2700000,2650000,2705000,"chr19",644953,9,5,19,33,"chr19",1,0.112165963431786
"22502","chr19.3335000.3340000","chr19.3485000.3490000",150000,15,0.001919485,3335000,3485000,3340000,3490000,"chr19",644959,4,5,20,29,"chr19",1,0.0509845288326301
"22503","chr19.38890000.38895000","chr19.39110000.39115000",220000,15,9.089945e-05,38890000,39110000,38895000,39115000,"chr19",644982,2,8,2,12,"chr19",1,0.0210970464135021
"22504","chr19.13275000.13280000","chr19.13970000.13975000",695000,8,0.00177001,13275000,13970000,13280000,13975000,"chr19",645001,1,12,7,20,"chr19",1,0.0187529301453352
"22505","chr19.6280000.6285000","chr19.6455000.6460000",175000,13,0.006971328,6280000,6455000,6285000,6460000,"chr19",645019,2,5,17,24,"chr19",1,0.0365682137834037
"22506","chr19.52170000.52175000","chr19.52200000.52205000",30000,32,0.001187867,52170000,52200000,52175000,52205000,"chr19",645053,1,4,2,7,"chr19",1,0.0262541022034693
"22507","chr19.5250000.5255000","chr19.5305000.5310000",55000,22,0.004393008,5250000,5305000,5255000,5310000,"chr19",645074,1,3,1,5,"chr19",1,0.012892639474918
"22508","chr19.17470000.17475000","chr19.17930000.17935000",460000,9,0.004118603,17470000,17930000,17475000,17935000,"chr19",645075,7,14,19,40,"chr19",1,0.0421940928270042
"22509","chr19.13860000.13865000","chr19.13880000.13885000",20000,36,0.004609976,13860000,13880000,13865000,13885000,"chr19",645087,4,1,2,7,"chr19",1,0.029535864978903
"22510","chr19.10700000.10705000","chr19.10750000.10755000",50000,36,2.202181e-09,10700000,10750000,10705000,10755000,"chr19",645112,14,48,40,102,"chr19",1,0.430379746835443
"22511","chr19.40700000.40705000","chr19.40810000.40815000",110000,16,0.004609976,40700000,40810000,40705000,40815000,"chr19",645128,4,2,6,12,"chr19",1,0.0225035161744023
"22512","chr19.50200000.50205000","chr19.50265000.50270000",65000,21,0.002127914,50200000,50265000,50205000,50270000,"chr19",645134,3,8,8,19,"chr19",1,0.0467651195499297
"22513","chr19.57190000.57195000","chr19.58180000.58185000",990000,6,0.008122377,57190000,58180000,57195000,58185000,"chr19",645135,0,2,2,4,"chr19",1,0.00281293952180028
"22514","chr19.2150000.2155000","chr19.2270000.2275000",120000,16,0.002564687,2150000,2270000,2155000,2275000,"chr19",645138,0,2,12,14,"chr19",1,0.0262541022034693
"22515","chr19.38210000.38215000","chr19.38265000.38270000",55000,31,2.840849e-07,38210000,38265000,38215000,38270000,"chr19",645147,6,13,17,36,"chr19",1,0.130801687763713
"22516","chr19.18120000.18125000","chr19.18155000.18160000",35000,32,9.632462e-05,18120000,18155000,18125000,18160000,"chr19",645163,5,14,10,29,"chr19",1,0.108766994842944
"22517","chr19.7630000.7635000","chr19.7865000.7870000",235000,17,1.862527e-06,7630000,7865000,7635000,7870000,"chr19",645165,3,8,10,21,"chr19",1,0.0418424753867792
"22518","chr19.38145000.38150000","chr19.38180000.38185000",35000,65,2.307559e-24,38145000,38180000,38150000,38185000,"chr19",645180,6,16,10,32,"chr19",1,0.243788091889358
"22519","chr19.18120000.18125000","chr19.18160000.18165000",40000,41,2.30188e-10,18120000,18160000,18125000,18165000,"chr19",645183,4,14,10,28,"chr19",1,0.13455227379278
"22520","chr19.2680000.2685000","chr19.2700000.2705000",20000,43,2.524408e-05,2680000,2700000,2685000,2705000,"chr19",645198,9,5,19,33,"chr19",1,0.166315049226442
"22521","chr19.48780000.48785000","chr19.49085000.49090000",305000,11,0.002384861,48780000,49085000,48785000,49090000,"chr19",645200,6,23,19,48,"chr19",1,0.0618846694796062
"22522","chr19.39445000.39450000","chr19.39800000.39805000",355000,11,0.0009566211,39445000,39800000,39450000,39805000,"chr19",645208,2,6,8,16,"chr19",1,0.0206282231598687
"22523","chr19.45465000.45470000","chr19.45485000.45490000",20000,37,0.002384861,45465000,45485000,45470000,45490000,"chr19",645216,6,16,15,37,"chr19",1,0.160454758556024
"22524","chr19.38890000.38895000","chr19.39105000.39110000",215000,19,1.710749e-07,38890000,39105000,38895000,39110000,"chr19",645218,6,16,11,33,"chr19",1,0.0734880450070323
"22525","chr19.55445000.55450000","chr19.55465000.55470000",20000,35,0.008589977,55445000,55465000,55450000,55470000,"chr19",645220,0,6,5,11,"chr19",1,0.0451242381622128
"22526","chr19.2460000.2465000","chr19.2640000.2645000",180000,14,0.001807231,2460000,2640000,2465000,2645000,"chr19",645222,9,17,15,41,"chr19",1,0.0672761368963901
"22527","chr19.37075000.37080000","chr19.38070000.38075000",995000,6,0.007775785,37075000,38070000,37080000,38075000,"chr19",645224,0,3,2,5,"chr19",1,0.00351617440225035
"22528","chr19.40640000.40645000","chr19.40805000.40810000",165000,13,0.009962913,40640000,40805000,40645000,40810000,"chr19",645241,0,2,1,3,"chr19",1,0.00457102672292546
"22529","chr19.57705000.57710000","chr19.57725000.57730000",20000,42,5.727509e-05,57705000,57725000,57710000,57730000,"chr19",645278,1,11,9,21,"chr19",1,0.10337552742616
"22530","chr19.10910000.10915000","chr19.10935000.10940000",25000,34,0.004460775,10910000,10935000,10915000,10940000,"chr19",645301,1,27,15,43,"chr19",1,0.171354899203
"22531","chr19.6485000.6490000","chr19.6630000.6635000",145000,22,1.405238e-07,6485000,6630000,6490000,6635000,"chr19",645305,8,26,21,55,"chr19",1,0.141819034224098
"22532","chr19.4730000.4735000","chr19.4805000.4810000",75000,31,1.141167e-09,4730000,4805000,4735000,4810000,"chr19",645310,2,15,14,31,"chr19",1,0.11263478668542
"22533","chr19.45520000.45525000","chr19.45580000.45585000",60000,23,0.0007156404,45520000,45580000,45525000,45585000,"chr19",645311,4,14,6,24,"chr19",1,0.0646976090014065
"22534","chr19.18750000.18755000","chr19.18965000.18970000",215000,18,9.64247e-07,18750000,18965000,18755000,18970000,"chr19",645328,6,16,12,34,"chr19",1,0.0717299578059072
"22535","chr19.8005000.8010000","chr19.8305000.8310000",300000,12,0.0006255539,8005000,8305000,8010000,8310000,"chr19",645339,6,23,9,38,"chr19",1,0.0534458509142053
"22536","chr19.52095000.52100000","chr19.52200000.52205000",105000,16,0.00618472,52095000,52200000,52100000,52205000,"chr19",645341,1,4,2,7,"chr19",1,0.0131270511017346
"22537","chr19.2490000.2495000","chr19.2595000.2600000",105000,18,0.0007345656,2490000,2595000,2495000,2600000,"chr19",645364,1,8,8,17,"chr19",1,0.0358649789029536
"22538","chr19.2475000.2480000","chr19.2585000.2590000",110000,20,4.226484e-05,2475000,2585000,2480000,2590000,"chr19",645368,1,1,1,3,"chr19",1,0.0070323488045007
"22539","chr19.38895000.38900000","chr19.39100000.39105000",205000,15,0.0001683862,38895000,39100000,38900000,39105000,"chr19",645383,13,25,37,75,"chr19",1,0.131856540084388
"22540","chr19.13730000.13735000","chr19.13830000.13835000",100000,16,0.008589977,13730000,13830000,13735000,13835000,"chr19",645385,1,5,7,13,"chr19",1,0.0243788091889358
"22541","chr19.38890000.38895000","chr19.39465000.39470000",575000,8,0.005188373,38890000,39465000,38895000,39470000,"chr19",645396,3,6,7,16,"chr19",1,0.0150023441162682
"22542","chr19.46635000.46640000","chr19.47285000.47290000",650000,8,0.002572558,46635000,47285000,46640000,47290000,"chr19",645403,1,4,2,7,"chr19",1,0.00656352555086732
"22543","chr19.49145000.49150000","chr19.49450000.49455000",305000,18,1.372589e-08,49145000,49450000,49150000,49455000,"chr19",645409,4,21,13,38,"chr19",1,0.080168776371308
"22544","chr19.13850000.13855000","chr19.13965000.13970000",115000,17,0.001148295,13850000,13965000,13855000,13970000,"chr19",645420,2,7,7,16,"chr19",1,0.0318799812470699
"22545","chr19.14245000.14250000","chr19.14525000.14530000",280000,18,3.874974e-08,14245000,14525000,14250000,14530000,"chr19",645464,2,6,10,18,"chr19",1,0.0379746835443038
"22546","chr19.39460000.39465000","chr19.39820000.39825000",360000,10,0.003875406,39460000,39820000,39465000,39825000,"chr19",645469,3,8,6,17,"chr19",1,0.0199249882794187
"22547","chr19.3985000.3990000","chr19.4180000.4185000",195000,21,1.787278e-08,3985000,4180000,3990000,4185000,"chr19",645494,1,14,11,26,"chr19",1,0.0639943741209564
"22548","chr19.2325000.2330000","chr19.2380000.2385000",55000,24,0.0007085265,2325000,2380000,2330000,2385000,"chr19",645543,4,13,7,24,"chr19",1,0.0675105485232067
"22549","chr19.5720000.5725000","chr19.5790000.5795000",70000,25,1.208659e-05,5720000,5790000,5725000,5795000,"chr19",645565,9,17,8,34,"chr19",1,0.0996249413970933
"22550","chr19.53100000.53105000","chr19.53190000.53195000",90000,24,1.890324e-06,53100000,53190000,53105000,53195000,"chr19",645572,5,11,16,32,"chr19",1,0.090014064697609
"22551","chr19.920000.925000","chr19.1020000.1025000",100000,28,1.074239e-09,920000,1020000,925000,1025000,"chr19",645594,9,15,28,52,"chr19",1,0.17065166432255
"22552","chr19.6735000.6740000","chr19.7065000.7070000",330000,10,0.006059179,6735000,7065000,6740000,7070000,"chr19",645610,2,4,10,16,"chr19",1,0.0187529301453352
"22553","chr19.13280000.13285000","chr19.13300000.13305000",20000,49,1.005126e-07,13280000,13300000,13285000,13305000,"chr19",645611,3,7,5,15,"chr19",1,0.0861462728551336
"22554","chr19.7515000.7520000","chr19.7650000.7655000",135000,22,3.08447e-07,7515000,7650000,7520000,7655000,"chr19",645626,6,12,17,35,"chr19",1,0.0902484763244257
"22555","chr19.4725000.4730000","chr19.5720000.5725000",995000,8,0.0001318677,4725000,5720000,4730000,5725000,"chr19",645629,9,31,45,85,"chr19",1,0.0796999531176746
"22556","chr19.9780000.9785000","chr19.9880000.9885000",100000,31,7.325133e-12,9780000,9880000,9785000,9885000,"chr19",645631,9,21,27,57,"chr19",1,0.207102672292546
"22557","chr19.47155000.47160000","chr19.47240000.47245000",85000,20,0.0005003411,47155000,47240000,47160000,47245000,"chr19",645633,0,7,4,11,"chr19",1,0.0257852789498359
"22558","chr19.48990000.48995000","chr19.49085000.49090000",95000,34,9.930683e-14,48990000,49085000,48995000,49090000,"chr19",645634,0,8,8,16,"chr19",1,0.0637599624941397
"22559","chr19.39035000.39040000","chr19.39080000.39085000",45000,26,0.000850976,39035000,39080000,39040000,39085000,"chr19",645640,9,21,22,52,"chr19",1,0.158462259728083
"22560","chr19.39110000.39115000","chr19.39390000.39395000",280000,17,2.565288e-07,39110000,39390000,39115000,39395000,"chr19",645644,2,8,2,12,"chr19",1,0.0239099859353024
"22561","chr19.11845000.11850000","chr19.11920000.11925000",75000,28,9.265378e-08,11845000,11920000,11850000,11925000,"chr19",645663,8,15,10,33,"chr19",1,0.108298171589311
"22562","chr19.46755000.46760000","chr19.47045000.47050000",290000,13,0.000176215,46755000,47045000,46760000,47050000,"chr19",645672,4,8,8,20,"chr19",1,0.0304735114861697
"22563","chr19.5910000.5915000","chr19.5975000.5980000",65000,26,9.877653e-06,5910000,5975000,5915000,5980000,"chr19",645687,4,9,8,21,"chr19",1,0.0639943741209564
"22564","chr19.12480000.12485000","chr19.12510000.12515000",30000,30,0.005134157,12480000,12510000,12485000,12515000,"chr19",645691,0,10,6,16,"chr19",1,0.0562587904360056
"22565","chr19.47435000.47440000","chr19.47490000.47495000",55000,28,1.055327e-05,47435000,47490000,47440000,47495000,"chr19",645692,0,3,0,3,"chr19",1,0.00984528832630099
"22566","chr19.4245000.4250000","chr19.4400000.4405000",155000,25,3.575046e-10,4245000,4400000,4250000,4405000,"chr19",645697,0,7,7,14,"chr19",1,0.0410220346929208
"22567","chr19.14245000.14250000","chr19.14530000.14535000",285000,17,2.110064e-07,14245000,14530000,14250000,14535000,"chr19",645699,4,6,12,22,"chr19",1,0.0438349742147211
"22568","chr19.3625000.3630000","chr19.3700000.3705000",75000,18,0.009962913,3625000,3700000,3630000,3705000,"chr19",645704,4,22,19,45,"chr19",1,0.0949367088607595
"22569","chr19.16400000.16405000","chr19.16425000.16430000",25000,45,4.702601e-07,16400000,16425000,16405000,16430000,"chr19",645709,3,1,3,7,"chr19",1,0.0369198312236287
"22570","chr19.2540000.2545000","chr19.2610000.2615000",70000,26,3.506676e-06,2540000,2610000,2545000,2615000,"chr19",645719,7,18,20,45,"chr19",1,0.137130801687764
"22571","chr19.1020000.1025000","chr19.1190000.1195000",170000,16,0.0002142958,1020000,1190000,1025000,1195000,"chr19",645736,9,15,28,52,"chr19",1,0.0975152367557431
"22572","chr19.53460000.53465000","chr19.53865000.53870000",405000,10,0.001939399,53460000,53865000,53465000,53870000,"chr19",645747,2,8,9,19,"chr19",1,0.0222691045475856
"22573","chr20.5540000.5545000","chr20.5835000.5840000",295000,10,0.009605389,5540000,5835000,5545000,5840000,"chr20",645754,1,2,0,3,"chr20",1,0.00351617440225035
"22574","chr20.1320000.1325000","chr20.1340000.1345000",20000,37,0.003368382,1320000,1340000,1325000,1345000,"chr20",645757,2,0,1,3,"chr20",1,0.0130098452883263
"22575","chr20.17635000.17640000","chr20.17935000.17940000",300000,11,0.002349651,17635000,17935000,17640000,17940000,"chr20",645805,0,3,2,5,"chr20",1,0.00644631973745898
"22576","chr20.34310000.34315000","chr20.34470000.34475000",160000,22,2.004862e-08,34310000,34470000,34315000,34475000,"chr20",645808,4,5,5,14,"chr20",1,0.0360993905297703
"22577","chr20.5555000.5560000","chr20.5730000.5735000",175000,15,0.000399872,5555000,5730000,5560000,5735000,"chr20",645833,3,8,7,18,"chr20",1,0.0316455696202532
"22578","chr20.35940000.35945000","chr20.35995000.36000000",55000,23,0.001208811,35940000,35995000,35945000,3.6e+07,"chr20",645848,1,9,5,15,"chr20",1,0.040436005625879
"22579","chr20.48745000.48750000","chr20.48765000.48770000",20000,38,0.001739905,48745000,48765000,48750000,48770000,"chr20",645879,0,2,1,3,"chr20",1,0.0133614627285513
"22580","chr20.34215000.34220000","chr20.34525000.34530000",310000,11,0.001950466,34215000,34525000,34220000,34530000,"chr20",645889,0,3,8,11,"chr20",1,0.0141819034224098
"22581","chr20.20840000.20845000","chr20.21550000.21555000",710000,23,1.762115e-19,20840000,21550000,20845000,21555000,"chr20",645893,2,8,8,18,"chr20",1,0.0485232067510548
"22582","chr20.48350000.48355000","chr20.48435000.48440000",85000,23,6.815046e-06,48350000,48435000,48355000,48440000,"chr20",645965,2,1,2,5,"chr20",1,0.0134786685419597
"22583","chr20.50415000.50420000","chr20.50460000.50465000",45000,24,0.003433675,50415000,50460000,50420000,50465000,"chr20",645977,1,6,3,10,"chr20",1,0.0281293952180028
"22584","chr20.43515000.43520000","chr20.43590000.43595000",75000,22,9.979179e-05,43515000,43590000,43520000,43595000,"chr20",645981,12,29,30,71,"chr20",1,0.183075480543835
"22585","chr20.32520000.32525000","chr20.32625000.32630000",105000,17,0.001218971,32520000,32625000,32525000,32630000,"chr20",646022,0,0,1,1,"chr20",1,0.00199249882794187
"22586","chr20.35240000.35245000","chr20.35510000.35515000",270000,11,0.004164637,35240000,35510000,35245000,35515000,"chr20",646061,2,10,7,19,"chr20",1,0.0244960150023441
"22587","chr20.49640000.49645000","chr20.49920000.49925000",280000,12,0.0008621303,49640000,49920000,49645000,49925000,"chr20",646078,3,8,10,21,"chr20",1,0.029535864978903
"22588","chr20.5115000.5120000","chr20.5160000.5165000",45000,36,8.690558e-09,5115000,5160000,5120000,5165000,"chr20",646079,6,12,14,32,"chr20",1,0.135021097046413
"22589","chr20.37470000.37475000","chr20.37495000.37500000",25000,36,0.001389016,37470000,37495000,37475000,37500000,"chr20",646081,2,2,1,5,"chr20",1,0.0210970464135021
"22590","chr20.49610000.49615000","chr20.49925000.49930000",315000,10,0.00700017,49610000,49925000,49615000,49930000,"chr20",646085,6,10,20,36,"chr20",1,0.0421940928270042
"22591","chr20.5120000.5125000","chr20.5160000.5165000",40000,34,9.187053e-07,5120000,5160000,5125000,5165000,"chr20",646099,2,12,8,22,"chr20",1,0.0876699484294421
"22592","chr20.5555000.5560000","chr20.5765000.5770000",210000,14,0.0003908973,5555000,5765000,5560000,5770000,"chr20",646119,3,16,7,26,"chr20",1,0.0426629160806376
"22593","chr20.34110000.34115000","chr20.34470000.34475000",360000,16,1.322513e-07,34110000,34470000,34115000,34475000,"chr20",646183,4,5,5,14,"chr20",1,0.0262541022034693
"22594","chr20.45830000.45835000","chr20.46250000.46255000",420000,15,2.37743e-07,45830000,46250000,45835000,46255000,"chr20",646193,0,2,2,4,"chr20",1,0.0070323488045007
"22595","chr20.32535000.32540000","chr20.32670000.32675000",135000,19,1.266297e-05,32535000,32670000,32540000,32675000,"chr20",646235,0,2,0,2,"chr20",1,0.00445382090951711
"22596","chr20.46125000.46130000","chr20.46245000.46250000",120000,25,3.736851e-09,46125000,46245000,46130000,46250000,"chr20",646262,0,1,3,4,"chr20",1,0.0117205813408345
"22597","chr20.35435000.35440000","chr20.35495000.35500000",60000,26,1.799659e-05,35435000,35495000,35440000,35500000,"chr20",646297,0,3,2,5,"chr20",1,0.0152367557430849
"22598","chr20.33455000.33460000","chr20.33730000.33735000",275000,14,4.581439e-05,33455000,33730000,33460000,33735000,"chr20",646378,2,34,40,76,"chr20",1,0.124706985466479
"22599","chr20.17500000.17505000","chr20.17935000.17940000",435000,10,0.00143799,17500000,17935000,17505000,17940000,"chr20",646398,2,9,15,26,"chr20",1,0.0304735114861697
"22600","chr20.35815000.35820000","chr20.35995000.36000000",180000,15,0.0003213966,35815000,35995000,35820000,3.6e+07,"chr20",646511,1,9,5,15,"chr20",1,0.0263713080168776
"22601","chr20.20820000.20825000","chr20.21680000.21685000",860000,7,0.004886181,20820000,21680000,20825000,21685000,"chr20",646512,2,2,1,5,"chr20",1,0.00410220346929208
"22602","chr20.32460000.32465000","chr20.32725000.32730000",265000,22,1.891645e-11,32460000,32725000,32465000,32730000,"chr20",646553,0,4,7,11,"chr20",1,0.0283638068448195
"22603","chr20.5535000.5540000","chr20.5750000.5755000",215000,14,0.0003243528,5535000,5750000,5540000,5755000,"chr20",646560,13,27,21,61,"chr20",1,0.100093764650727
"22604","chr20.45855000.45860000","chr20.46255000.46260000",400000,12,9.275797e-05,45855000,46255000,45860000,46260000,"chr20",646564,4,3,3,10,"chr20",1,0.0140646976090014
"22605","chr20.8015000.8020000","chr20.8390000.8395000",375000,12,0.0001437466,8015000,8390000,8020000,8395000,"chr20",646582,1,2,6,9,"chr20",1,0.0126582278481013
"22606","chr20.5540000.5545000","chr20.5750000.5755000",210000,13,0.001464794,5540000,5750000,5545000,5755000,"chr20",646588,13,27,21,61,"chr20",1,0.0929442100328176
"22607","chr20.49635000.49640000","chr20.49935000.49940000",300000,10,0.008842406,49635000,49935000,49640000,49940000,"chr20",646615,4,5,16,25,"chr20",1,0.0293014533520863
"22608","chr20.47295000.47300000","chr20.47500000.47505000",205000,13,0.001741295,47295000,47500000,47300000,47505000,"chr20",646639,1,2,4,7,"chr20",1,0.0106657290201594
"22609","chr20.25245000.25250000","chr20.25395000.25400000",150000,15,0.001170465,25245000,25395000,25250000,25400000,"chr20",646726,0,2,0,2,"chr20",1,0.00351617440225035
"22610","chr20.35205000.35210000","chr20.35225000.35230000",20000,41,0.0002028225,35205000,35225000,35210000,35230000,"chr20",646740,1,2,0,3,"chr20",1,0.0144163150492264
"22611","chr20.4610000.4615000","chr20.4685000.4690000",75000,19,0.002482901,4610000,4685000,4615000,4690000,"chr20",646747,0,1,1,2,"chr20",1,0.00445382090951711
"22612","chr20.35780000.35785000","chr20.36135000.36140000",355000,10,0.004013879,35780000,36135000,35785000,36140000,"chr20",646796,6,28,26,60,"chr20",1,0.070323488045007
"22613","chr20.47270000.47275000","chr20.47335000.47340000",65000,21,0.001362274,47270000,47335000,47275000,47340000,"chr20",646909,3,12,11,26,"chr20",1,0.0639943741209564
"22614","chr20.4760000.4765000","chr20.5070000.5075000",310000,20,1.594357e-10,4760000,5070000,4765000,5075000,"chr20",646931,7,15,4,26,"chr20",1,0.0609470229723394
"22615","chr20.46090000.46095000","chr20.46245000.46250000",155000,15,0.000935357,46090000,46245000,46095000,46250000,"chr20",646939,0,8,1,9,"chr20",1,0.0158227848101266
"22616","chr20.35825000.35830000","chr20.36155000.36160000",330000,23,8.455958e-14,35825000,36155000,35830000,36160000,"chr20",647008,0,2,2,4,"chr20",1,0.0107829348335677
"22617","chr20.17685000.17690000","chr20.17935000.17940000",250000,15,2.030575e-05,17685000,17935000,17690000,17940000,"chr20",647053,2,4,2,8,"chr20",1,0.0140646976090014
"22618","chr20.33490000.33495000","chr20.33665000.33670000",175000,16,0.0001001787,33490000,33665000,33495000,33670000,"chr20",647068,0,4,6,10,"chr20",1,0.0187529301453352
"22619","chr20.46170000.46175000","chr20.46255000.46260000",85000,19,0.0008163845,46170000,46255000,46175000,46260000,"chr20",647085,1,2,0,3,"chr20",1,0.00668073136427567
"22620","chr20.32460000.32465000","chr20.32670000.32675000",210000,14,0.0003908973,32460000,32670000,32465000,32675000,"chr20",647105,0,4,7,11,"chr20",1,0.0180496952648851
"22621","chr20.37470000.37475000","chr20.37500000.37505000",30000,46,1.293371e-09,37470000,37500000,37475000,37505000,"chr20",647143,0,2,1,3,"chr20",1,0.0161744022503516
"22622","chr20.5535000.5540000","chr20.5610000.5615000",75000,18,0.006336967,5535000,5610000,5540000,5615000,"chr20",647161,3,15,8,26,"chr20",1,0.0548523206751055
"22623","chr20.44485000.44490000","chr20.44520000.44525000",35000,27,0.005498681,44485000,44520000,44490000,44525000,"chr20",647240,4,12,6,22,"chr20",1,0.069620253164557
"22624","chr20.4605000.4610000","chr20.4705000.4710000",100000,17,0.001754789,4605000,4705000,4610000,4710000,"chr20",647247,3,7,11,21,"chr20",1,0.0418424753867792
"22625","chr20.45810000.45815000","chr20.46255000.46260000",445000,13,7.124283e-06,45810000,46255000,45815000,46260000,"chr20",647250,4,3,3,10,"chr20",1,0.0152367557430849
"22626","chr20.62385000.62390000","chr20.62540000.62545000",155000,14,0.0030839,62385000,62540000,62390000,62545000,"chr20",647277,0,3,2,5,"chr20",1,0.00820440693858415
"22627","chr20.46130000.46135000","chr20.46215000.46220000",85000,18,0.002327667,46130000,46215000,46135000,46220000,"chr20",647404,0,3,8,11,"chr20",1,0.0232067510548523
"22628","chr20.48795000.48800000","chr20.49130000.49135000",335000,14,1.002228e-05,48795000,49130000,48800000,49135000,"chr20",647429,1,4,4,9,"chr20",1,0.0147679324894515
"22629","chr20.10430000.10435000","chr20.11105000.11110000",675000,9,0.0005551244,10430000,11105000,10435000,11110000,"chr20",647460,1,3,4,8,"chr20",1,0.00843881856540084
"22630","chr20.9450000.9455000","chr20.9880000.9885000",430000,9,0.006736969,9450000,9880000,9455000,9885000,"chr20",647478,0,2,2,4,"chr20",1,0.00421940928270042
"22631","chr20.24475000.24480000","chr20.24570000.24575000",95000,18,0.0009004496,24475000,24570000,24480000,24575000,"chr20",647495,0,2,2,4,"chr20",1,0.00843881856540084
"22632","chr20.47675000.47680000","chr20.47785000.47790000",110000,18,0.0002602343,47675000,47785000,47680000,47790000,"chr20",647569,2,2,3,7,"chr20",1,0.0147679324894515
"22633","chr20.35410000.35415000","chr20.35495000.35500000",85000,17,0.006202879,35410000,35495000,35415000,35500000,"chr20",647576,0,6,2,8,"chr20",1,0.0159399906235349
"22634","chr20.34335000.34340000","chr20.34360000.34365000",25000,41,2.780175e-05,34335000,34360000,34340000,34365000,"chr20",647615,7,32,22,61,"chr20",1,0.293131739334271
"22635","chr20.800000.805000","chr20.1210000.1215000",410000,11,0.0004254974,8e+05,1210000,805000,1215000,"chr20",647644,0,2,1,3,"chr20",1,0.00386779184247539
"22636","chr20.35845000.35850000","chr20.36150000.36155000",305000,11,0.002145599,35845000,36150000,35850000,36155000,"chr20",647646,0,2,3,5,"chr20",1,0.00644631973745898
"22637","chr20.17745000.17750000","chr20.17805000.17810000",60000,20,0.007320993,17745000,17805000,17750000,17810000,"chr20",647675,0,3,1,4,"chr20",1,0.00937646507266761
"22638","chr20.20845000.20850000","chr20.21255000.21260000",410000,10,0.002003048,20845000,21255000,20850000,21260000,"chr20",647717,0,2,1,3,"chr20",1,0.00351617440225035
"22639","chr20.32330000.32335000","chr20.32725000.32730000",395000,9,0.009944612,32330000,32725000,32335000,32730000,"chr20",647733,0,1,1,2,"chr20",1,0.00210970464135021
"22640","chr20.1775000.1780000","chr20.2135000.2140000",360000,12,0.0001834878,1775000,2135000,1780000,2140000,"chr20",647782,0,1,1,2,"chr20",1,0.00281293952180028
"22641","chr20.45375000.45380000","chr20.45770000.45775000",395000,10,0.0024522,45375000,45770000,45380000,45775000,"chr20",647785,1,14,14,29,"chr20",1,0.0339896858884201
"22642","chr20.45830000.45835000","chr20.46255000.46260000",425000,10,0.001651431,45830000,46255000,45835000,46260000,"chr20",647829,4,3,3,10,"chr20",1,0.0117205813408345
"22643","chr20.45960000.45965000","chr20.46250000.46255000",290000,11,0.002814862,45960000,46250000,45965000,46255000,"chr20",647832,0,2,2,4,"chr20",1,0.00515705578996718
"22644","chr20.17615000.17620000","chr20.17875000.17880000",260000,11,0.00519589,17615000,17875000,17620000,17880000,"chr20",647863,1,8,1,10,"chr20",1,0.012892639474918
"22645","chr20.46345000.46350000","chr20.46415000.46420000",70000,26,1.856292e-06,46345000,46415000,46350000,46420000,"chr20",647890,0,0,3,3,"chr20",1,0.00914205344585091
"22646","chr20.47335000.47340000","chr20.47410000.47415000",75000,19,0.002482901,47335000,47410000,47340000,47415000,"chr20",647909,3,12,11,26,"chr20",1,0.0578996718237225
"22647","chr20.36015000.36020000","chr20.36155000.36160000",140000,15,0.001757301,36015000,36155000,36020000,36160000,"chr20",647955,0,2,2,4,"chr20",1,0.0070323488045007
"22648","chr20.33560000.33565000","chr20.33685000.33690000",125000,18,9.262009e-05,33560000,33685000,33565000,33690000,"chr20",647961,6,12,9,27,"chr20",1,0.0569620253164557
"22649","chr20.3775000.3780000","chr20.3795000.3800000",20000,53,3.536441e-09,3775000,3795000,3780000,3800000,"chr20",648068,0,2,1,3,"chr20",1,0.0186357243319269
"22650","chr20.4955000.4960000","chr20.5070000.5075000",115000,16,0.001920685,4955000,5070000,4960000,5075000,"chr20",648088,10,17,20,47,"chr20",1,0.0881387716830755
"22651","chr20.34295000.34300000","chr20.34470000.34475000",175000,25,2.514862e-11,34295000,34470000,34300000,34475000,"chr20",648128,0,5,5,10,"chr20",1,0.0293014533520863
"22652","chr20.5500000.5505000","chr20.5930000.5935000",430000,12,5.731173e-05,5500000,5930000,5505000,5935000,"chr20",648133,1,1,5,7,"chr20",1,0.00984528832630099
"22653","chr20.44755000.44760000","chr20.44960000.44965000",205000,14,0.0004652476,44755000,44960000,44760000,44965000,"chr20",648163,1,3,1,5,"chr20",1,0.00820440693858415
"22654","chr20.38885000.38890000","chr20.39380000.39385000",495000,10,0.000678772,38885000,39380000,38890000,39385000,"chr20",648178,0,2,0,2,"chr20",1,0.0023441162681669
"22655","chr20.45880000.45885000","chr20.46250000.46255000",370000,10,0.003368382,45880000,46250000,45885000,46255000,"chr20",648186,0,2,2,4,"chr20",1,0.0046882325363338
"22656","chr20.2460000.2465000","chr20.2945000.2950000",485000,9,0.003724429,2460000,2945000,2465000,2950000,"chr20",648189,2,9,2,13,"chr20",1,0.0137130801687764
"22657","chr20.1775000.1780000","chr20.1900000.1905000",125000,16,0.001120029,1775000,1900000,1780000,1905000,"chr20",648202,0,1,1,2,"chr20",1,0.00375058602906704
"22658","chr20.17530000.17535000","chr20.17940000.17945000",410000,10,0.002003048,17530000,17940000,17535000,17945000,"chr20",648251,2,5,8,15,"chr20",1,0.0175808720112518
"22659","chr20.35820000.35825000","chr20.36170000.36175000",350000,11,0.001025356,35820000,36170000,35825000,36175000,"chr20",648254,4,8,12,24,"chr20",1,0.0309423347398031
"22660","chr20.32535000.32540000","chr20.32570000.32575000",35000,28,0.002611858,32535000,32570000,32540000,32575000,"chr20",648319,0,2,0,2,"chr20",1,0.00656352555086732
"22661","chr20.33575000.33580000","chr20.33675000.33680000",100000,21,1.408108e-05,33575000,33675000,33580000,33680000,"chr20",648376,3,8,6,17,"chr20",1,0.0418424753867792
"22662","chr20.32485000.32490000","chr20.32760000.32765000",275000,11,0.003761557,32485000,32760000,32490000,32765000,"chr20",648392,0,3,2,5,"chr20",1,0.00644631973745898
"22663","chr20.10470000.10475000","chr20.10500000.10505000",30000,30,0.005403861,10470000,10500000,10475000,10505000,"chr20",648409,0,3,3,6,"chr20",1,0.0210970464135021
"22664","chr20.330000.335000","chr20.380000.385000",50000,35,4.690527e-09,330000,380000,335000,385000,"chr20",648428,1,2,4,7,"chr20",1,0.0287154242850445
"22665","chr20.265000.270000","chr20.310000.315000",45000,25,0.001460937,265000,310000,270000,315000,"chr20",648429,7,15,11,33,"chr20",1,0.0966947960618847
"22666","chr20.5100000.5105000","chr20.5130000.5135000",30000,33,0.0005746803,5100000,5130000,5105000,5135000,"chr20",648438,5,16,11,32,"chr20",1,0.123769338959212
"22667","chr20.34190000.34195000","chr20.34215000.34220000",25000,34,0.005403861,34190000,34215000,34195000,34220000,"chr20",648537,0,3,7,10,"chr20",1,0.0398499765588373
"22668","chr20.4820000.4825000","chr20.4945000.4950000",125000,14,0.009944612,4820000,4945000,4825000,4950000,"chr20",648554,1,3,1,5,"chr20",1,0.00820440693858415
"22669","chr20.35900000.35905000","chr20.36155000.36160000",255000,29,4.368281e-18,35900000,36155000,35905000,36160000,"chr20",648581,0,2,2,4,"chr20",1,0.013595874355368
"22670","chr20.33365000.33370000","chr20.34265000.34270000",900000,7,0.003761557,33365000,34265000,33370000,34270000,"chr20",648631,7,14,12,33,"chr20",1,0.0270745428973277
"22671","chr20.49610000.49615000","chr20.49900000.49905000",290000,17,1.476604e-07,49610000,49900000,49615000,49905000,"chr20",648651,3,10,20,33,"chr20",1,0.0657524613220816
"22672","chr20.5115000.5120000","chr20.5130000.5135000",15000,37,0.003368382,5115000,5130000,5120000,5135000,"chr20",648667,5,18,14,37,"chr20",1,0.160454758556024
"22673","chr20.33455000.33460000","chr20.33685000.33690000",230000,17,1.654158e-06,33455000,33685000,33460000,33690000,"chr20",648732,6,12,9,27,"chr20",1,0.0537974683544304
"22674","chr20.48795000.48800000","chr20.49050000.49055000",255000,11,0.005718121,48795000,49050000,48800000,49055000,"chr20",648829,1,4,4,9,"chr20",1,0.0116033755274262
"22675","chr20.2525000.2530000","chr20.2560000.2565000",35000,38,1.818533e-07,2525000,2560000,2530000,2565000,"chr20",648883,2,3,5,10,"chr20",1,0.0445382090951711
"22676","chr20.35825000.35830000","chr20.36150000.36155000",325000,15,2.111649e-06,35825000,36150000,35830000,36155000,"chr20",648927,0,2,3,5,"chr20",1,0.00879043600562588
"22677","chr20.32625000.32630000","chr20.32650000.32655000",25000,34,0.005403861,32625000,32650000,32630000,32655000,"chr20",648936,2,3,1,6,"chr20",1,0.0239099859353024
"22678","chr20.18550000.18555000","chr20.18570000.18575000",20000,44,1.832532e-05,18550000,18570000,18555000,18575000,"chr20",648939,5,13,13,31,"chr20",1,0.159868729488983
"22679","chr20.44650000.44655000","chr20.44735000.44740000",85000,18,0.002327667,44650000,44735000,44655000,44740000,"chr20",648989,3,9,5,17,"chr20",1,0.0358649789029536
"22680","chr20.34615000.34620000","chr20.34675000.34680000",60000,22,0.001218971,34615000,34675000,34620000,34680000,"chr20",648998,3,10,13,26,"chr20",1,0.0670417252695734
"22681","chr20.33690000.33695000","chr20.33850000.33855000",160000,13,0.007887866,33690000,33850000,33695000,33855000,"chr20",649023,3,4,4,11,"chr20",1,0.0167604313173933
"22682","chr20.24965000.24970000","chr20.25395000.25400000",430000,9,0.006736969,24965000,25395000,24970000,25400000,"chr20",649086,0,2,0,2,"chr20",1,0.00210970464135021
"22683","chr20.5535000.5540000","chr20.5765000.5770000",230000,30,3.509858e-18,5535000,5765000,5540000,5770000,"chr20",649087,11,21,16,48,"chr20",1,0.168776371308017
"22684","chr20.33490000.33495000","chr20.33530000.33535000",40000,30,6.258212e-05,33490000,33530000,33495000,33535000,"chr20",649105,2,20,18,40,"chr20",1,0.140646976090014
"22685","chr20.5540000.5545000","chr20.5765000.5770000",225000,20,9.714548e-09,5540000,5765000,5545000,5770000,"chr20",649107,11,21,16,48,"chr20",1,0.112517580872011
"22686","chr20.540000.545000","chr20.630000.635000",90000,17,0.003988133,540000,630000,545000,635000,"chr20",649138,0,4,3,7,"chr20",1,0.0139474917955931
"22687","chr20.32900000.32905000","chr20.33095000.33100000",195000,16,4.025595e-05,32900000,33095000,32905000,33100000,"chr20",649147,6,16,18,40,"chr20",1,0.0750117205813408
"22688","chr20.36700000.36705000","chr20.36835000.36840000",135000,17,0.0001933485,36700000,36835000,36705000,36840000,"chr20",649166,7,26,33,66,"chr20",1,0.131504922644163
"22689","chr20.5555000.5560000","chr20.5990000.5995000",435000,10,0.00143799,5555000,5990000,5560000,5995000,"chr20",649192,2,6,4,12,"chr20",1,0.0140646976090014
"22690","chr20.25320000.25325000","chr20.25390000.25395000",70000,21,0.0006270638,25320000,25390000,25325000,25395000,"chr20",649194,1,8,4,13,"chr20",1,0.0319971870604782
"22691","chr20.3460000.3465000","chr20.3815000.3820000",355000,11,0.0009502226,3460000,3815000,3465000,3820000,"chr20",649196,2,2,10,14,"chr20",1,0.0180496952648851
"22692","chr20.25175000.25180000","chr20.25235000.25240000",60000,21,0.003079098,25175000,25235000,25180000,25240000,"chr20",649204,7,5,15,27,"chr20",1,0.0664556962025316
"22693","chr20.34110000.34115000","chr20.34265000.34270000",155000,13,0.009425255,34110000,34265000,34115000,34270000,"chr20",649275,7,14,12,33,"chr20",1,0.05028129395218
"22694","chr20.34330000.34335000","chr20.34435000.34440000",105000,20,3.152745e-05,34330000,34435000,34335000,34440000,"chr20",649344,7,9,5,21,"chr20",1,0.0492264416315049
"22695","chr20.20510000.20515000","chr20.20530000.20535000",20000,50,7.687603e-08,20510000,20530000,20515000,20535000,"chr20",649358,0,0,2,2,"chr20",1,0.0117205813408345
"22696","chr20.35390000.35395000","chr20.35495000.35500000",105000,15,0.009913256,35390000,35495000,35395000,35500000,"chr20",649386,0,6,2,8,"chr20",1,0.0140646976090014
"22697","chr20.3190000.3195000","chr20.3290000.3295000",100000,17,0.001754789,3190000,3290000,3195000,3295000,"chr20",649414,0,5,6,11,"chr20",1,0.0219174871073605
"22698","chr20.25675000.25680000","chr20.25850000.25855000",175000,13,0.004764841,25675000,25850000,25680000,25855000,"chr20",649422,1,3,2,6,"chr20",1,0.00914205344585091
"22699","chr20.44680000.44685000","chr20.44700000.44705000",20000,41,0.0002028225,44680000,44700000,44685000,44705000,"chr20",649424,0,2,1,3,"chr20",1,0.0144163150492264
"22700","chr20.32535000.32540000","chr20.32650000.32655000",115000,18,0.0001807271,32535000,32650000,32540000,32655000,"chr20",649445,0,2,0,2,"chr20",1,0.00421940928270042
"22701","chr20.34125000.34130000","chr20.34470000.34475000",345000,11,0.001114425,34125000,34470000,34130000,34475000,"chr20",649480,4,5,5,14,"chr20",1,0.0180496952648851
"22702","chr20.62135000.62140000","chr20.62540000.62545000",405000,9,0.008871052,62135000,62540000,62140000,62545000,"chr20",649481,0,1,0,1,"chr20",1,0.00105485232067511
"22703","chr20.32540000.32545000","chr20.32670000.32675000",130000,14,0.008010585,32540000,32670000,32545000,32675000,"chr20",649550,5,12,17,34,"chr20",1,0.0557899671823722
"22704","chr20.33455000.33460000","chr20.33645000.33650000",190000,12,0.009329695,33455000,33645000,33460000,33650000,"chr20",649607,3,8,7,18,"chr20",1,0.0253164556962025
"22705","chr20.32515000.32520000","chr20.32585000.32590000",70000,22,0.0002181321,32515000,32585000,32520000,32590000,"chr20",649625,2,2,2,6,"chr20",1,0.0154711673699015
"22706","chr20.33210000.33215000","chr20.33260000.33265000",50000,27,6.882692e-05,33210000,33260000,33215000,33265000,"chr20",649632,0,2,1,3,"chr20",1,0.00949367088607595
"22707","chr20.9405000.9410000","chr20.9880000.9885000",475000,9,0.004143692,9405000,9880000,9410000,9885000,"chr20",649665,0,3,3,6,"chr20",1,0.00632911392405063
"22708","chr20.5100000.5105000","chr20.5930000.5935000",830000,7,0.005817299,5100000,5930000,5105000,5935000,"chr20",649743,1,9,5,15,"chr20",1,0.0123066104078762
"22709","chr20.45960000.45965000","chr20.46255000.46260000",295000,11,0.002590431,45960000,46255000,45965000,46260000,"chr20",649759,2,3,3,8,"chr20",1,0.0103141115799344
"22710","chr20.34335000.34340000","chr20.34355000.34360000",20000,78,5.236463e-23,34335000,34355000,34340000,34360000,"chr20",649779,7,25,20,52,"chr20",1,0.475386779184248
"22711","chr20.32525000.32530000","chr20.32650000.32655000",125000,25,2.228756e-09,32525000,32650000,32530000,32655000,"chr20",649800,4,8,10,22,"chr20",1,0.0644631973745898
"22712","chr20.1775000.1780000","chr20.1890000.1895000",115000,33,3.451579e-15,1775000,1890000,1780000,1895000,"chr20",649856,0,1,1,2,"chr20",1,0.00773558368495077
"22713","chr20.44485000.44490000","chr20.44570000.44575000",85000,20,0.0002654827,44485000,44570000,44490000,44575000,"chr20",649880,1,9,4,14,"chr20",1,0.0328176277543366
"22714","chr20.34580000.34585000","chr20.34675000.34680000",95000,23,1.67595e-06,34580000,34675000,34585000,34680000,"chr20",649896,3,10,8,21,"chr20",1,0.0566104078762307
"22715","chr20.25270000.25275000","chr20.25385000.25390000",115000,16,0.001920685,25270000,25385000,25275000,25390000,"chr20",649928,4,20,26,50,"chr20",1,0.093764650726676
"22716","chr20.1320000.1325000","chr20.1465000.1470000",145000,14,0.004531415,1320000,1465000,1325000,1470000,"chr20",649952,2,0,1,3,"chr20",1,0.00492264416315049
"22717","chr20.46020000.46025000","chr20.46170000.46175000",150000,16,0.0003314045,46020000,46170000,46025000,46175000,"chr20",649963,0,2,0,2,"chr20",1,0.00375058602906704
"22718","chr20.4720000.4725000","chr20.4955000.4960000",235000,16,7.08711e-06,4720000,4955000,4725000,4960000,"chr20",649995,1,1,0,2,"chr20",1,0.00375058602906704
"22719","chr20.47975000.47980000","chr20.48005000.48010000",30000,37,1.815754e-05,47975000,48005000,47980000,48010000,"chr20",650006,1,5,4,10,"chr20",1,0.0433661509610877
"22720","chr20.49635000.49640000","chr20.50395000.50400000",760000,8,0.001648937,49635000,50395000,49640000,50400000,"chr20",650034,0,2,1,3,"chr20",1,0.00281293952180028
"22721","chr20.45820000.45825000","chr20.46245000.46250000",425000,17,3.082023e-09,45820000,46245000,45825000,46250000,"chr20",650132,0,8,6,14,"chr20",1,0.0278949835911861
"22722","chr20.33560000.33565000","chr20.33645000.33650000",85000,17,0.006202879,33560000,33645000,33565000,33650000,"chr20",650158,3,8,7,18,"chr20",1,0.0358649789029536
"22723","chr20.35360000.35365000","chr20.35505000.35510000",145000,17,0.0001132904,35360000,35505000,35365000,35510000,"chr20",650169,0,2,0,2,"chr20",1,0.00398499765588373
"22724","chr20.33465000.33470000","chr20.33685000.33690000",220000,13,0.001088438,33465000,33685000,33470000,33690000,"chr20",650170,3,12,9,24,"chr20",1,0.0365682137834037
"22725","chr20.17685000.17690000","chr20.17850000.17855000",165000,14,0.002108908,17685000,17850000,17690000,17855000,"chr20",650213,2,2,2,6,"chr20",1,0.00984528832630099
"22726","chr20.39045000.39050000","chr20.39080000.39085000",35000,28,0.002611858,39045000,39080000,39050000,39085000,"chr20",650220,0,4,8,12,"chr20",1,0.0393811533052039
"22727","chr20.34580000.34585000","chr20.34765000.34770000",185000,13,0.003398817,34580000,34765000,34585000,34770000,"chr20",650233,3,10,8,21,"chr20",1,0.0319971870604782
"22728","chr20.44420000.44425000","chr20.44520000.44525000",100000,18,0.0005782574,44420000,44520000,44425000,44525000,"chr20",650270,4,12,8,24,"chr20",1,0.0506329113924051
"22729","chr20.20825000.20830000","chr20.21550000.21555000",725000,8,0.002150239,20825000,21550000,20830000,21555000,"chr20",650288,3,10,8,21,"chr20",1,0.019690576652602
"22730","chr20.34215000.34220000","chr20.34470000.34475000",255000,14,8.411982e-05,34215000,34470000,34220000,34475000,"chr20",650293,0,3,5,8,"chr20",1,0.0131270511017346
"22731","chr20.33700000.33705000","chr20.34360000.34365000",660000,10,9.978572e-05,33700000,34360000,33705000,34365000,"chr20",650304,5,21,27,53,"chr20",1,0.0621190811064229
"22732","chr20.50930000.50935000","chr20.51570000.51575000",640000,8,0.004144821,50930000,51570000,50935000,51575000,"chr20",650311,0,1,1,2,"chr20",1,0.00187529301453352
"22733","chr20.32520000.32525000","chr20.32650000.32655000",130000,21,9.391545e-07,32520000,32650000,32525000,32655000,"chr20",650317,0,0,7,7,"chr20",1,0.0172292545710267
"22734","chr20.34065000.34070000","chr20.34520000.34525000",455000,10,0.001141219,34065000,34520000,34070000,34525000,"chr20",650333,5,6,10,21,"chr20",1,0.0246132208157525
"22735","chr20.5110000.5115000","chr20.5160000.5165000",50000,27,6.882692e-05,5110000,5160000,5115000,5165000,"chr20",650340,1,12,12,25,"chr20",1,0.0791139240506329
"22736","chr20.5125000.5130000","chr20.5160000.5165000",35000,27,0.005498681,5125000,5160000,5130000,5165000,"chr20",650361,6,12,15,33,"chr20",1,0.104430379746835
"22737","chr20.47675000.47680000","chr20.48280000.48285000",605000,8,0.005518428,47675000,48280000,47680000,48285000,"chr20",650458,3,3,3,9,"chr20",1,0.00843881856540084
"22738","chr20.5500000.5505000","chr20.5750000.5755000",250000,13,0.000437647,5500000,5750000,5505000,5755000,"chr20",650461,1,1,9,11,"chr20",1,0.0167604313173933
"22739","chr20.25320000.25325000","chr20.25355000.25360000",35000,32,8.580118e-05,25320000,25355000,25325000,25360000,"chr20",650474,1,8,4,13,"chr20",1,0.0487576183778715
"22740","chr20.31820000.31825000","chr20.31880000.31885000",60000,27,5.554083e-06,31820000,31880000,31825000,31885000,"chr20",650482,3,11,10,24,"chr20",1,0.0759493670886076
"22741","chr20.17535000.17540000","chr20.17615000.17620000",80000,17,0.009755195,17535000,17615000,17540000,17620000,"chr20",650544,1,10,1,12,"chr20",1,0.0239099859353024
"22742","chr20.3330000.3335000","chr20.3380000.3385000",50000,32,2.294597e-07,3330000,3380000,3335000,3385000,"chr20",650645,3,7,5,15,"chr20",1,0.0562587904360056
"22743","chr20.45935000.45940000","chr20.46200000.46205000",265000,11,0.004641088,45935000,46200000,45940000,46205000,"chr20",650701,2,3,6,11,"chr20",1,0.0141819034224098
"22744","chr20.17635000.17640000","chr20.17940000.17945000",305000,11,0.002145599,17635000,17940000,17640000,17945000,"chr20",650807,0,3,2,5,"chr20",1,0.00644631973745898
"22745","chr20.32455000.32460000","chr20.32625000.32630000",170000,14,0.001739905,32455000,32625000,32460000,32630000,"chr20",650815,2,3,1,6,"chr20",1,0.00984528832630099
"22746","chr20.45940000.45945000","chr20.45970000.45975000",30000,40,9.717568e-07,45940000,45970000,45945000,45975000,"chr20",650832,7,18,17,42,"chr20",1,0.19690576652602
"22747","chr20.45345000.45350000","chr20.46245000.46250000",900000,8,0.0005802128,45345000,46245000,45350000,46250000,"chr20",650876,0,5,2,7,"chr20",1,0.00656352555086732
"22748","chr20.49640000.49645000","chr20.49900000.49905000",260000,12,0.001370333,49640000,49900000,49645000,49905000,"chr20",650922,3,8,10,21,"chr20",1,0.029535864978903
"22749","chr20.9605000.9610000","chr20.9880000.9885000",275000,12,0.000958537,9605000,9880000,9610000,9885000,"chr20",650936,2,3,7,12,"chr20",1,0.0168776371308017
"22750","chr20.32515000.32520000","chr20.32650000.32655000",135000,35,2.900519e-18,32515000,32650000,32520000,32655000,"chr20",650947,3,2,8,13,"chr20",1,0.053328645100797
"22751","chr20.10075000.10080000","chr20.10125000.10130000",50000,28,2.383887e-05,10075000,10125000,10080000,10130000,"chr20",650967,2,0,0,2,"chr20",1,0.00656352555086732
"22752","chr20.35235000.35240000","chr20.35445000.35450000",210000,13,0.001464794,35235000,35445000,35240000,35450000,"chr20",651016,11,35,14,60,"chr20",1,0.0914205344585091
"22753","chr20.48245000.48250000","chr20.48350000.48355000",105000,16,0.003556132,48245000,48350000,48250000,48355000,"chr20",651037,1,1,2,4,"chr20",1,0.00750117205813408
"22754","chr20.45935000.45940000","chr20.46020000.46025000",85000,21,8.294513e-05,45935000,46020000,45940000,46025000,"chr20",651039,0,5,5,10,"chr20",1,0.0246132208157525
"22755","chr20.19755000.19760000","chr20.19845000.19850000",90000,18,0.001421265,19755000,19845000,19760000,19850000,"chr20",651110,0,2,0,2,"chr20",1,0.00421940928270042
"22756","chr20.46020000.46025000","chr20.46250000.46255000",230000,16,8.706479e-06,46020000,46250000,46025000,46255000,"chr20",651111,0,2,2,4,"chr20",1,0.00750117205813408
"22757","chr20.44700000.44705000","chr20.44735000.44740000",35000,35,4.582159e-06,44700000,44735000,44705000,44740000,"chr20",651124,0,2,1,3,"chr20",1,0.0123066104078762
"22758","chr20.35635000.35640000","chr20.35695000.35700000",60000,22,0.001218971,35635000,35695000,35640000,35700000,"chr20",651136,2,5,4,11,"chr20",1,0.0283638068448195
"22759","chr20.45820000.45825000","chr20.46020000.46025000",200000,13,0.002065894,45820000,46020000,45825000,46025000,"chr20",651144,0,5,5,10,"chr20",1,0.0152367557430849
"22760","chr20.35950000.35955000","chr20.35995000.36000000",45000,30,1.118762e-05,35950000,35995000,35955000,3.6e+07,"chr20",651164,1,9,5,15,"chr20",1,0.0527426160337553
"22761","chr20.33210000.33215000","chr20.33365000.33370000",155000,18,1.641199e-05,33210000,33365000,33215000,33370000,"chr20",651165,0,4,1,5,"chr20",1,0.0105485232067511
"22762","chr20.34360000.34365000","chr20.34470000.34475000",110000,35,1.578553e-16,34360000,34470000,34365000,34475000,"chr20",651183,4,5,5,14,"chr20",1,0.0574308485700891
"22763","chr20.35360000.35365000","chr20.35510000.35515000",150000,21,2.232924e-07,35360000,35510000,35365000,35515000,"chr20",651200,0,2,0,2,"chr20",1,0.00492264416315049
"22764","chr20.35820000.35825000","chr20.36150000.36155000",330000,12,0.0003107429,35820000,36150000,35825000,36155000,"chr20",651268,0,2,3,5,"chr20",1,0.0070323488045007
"22765","chr20.32165000.32170000","chr20.32725000.32730000",560000,8,0.008022267,32165000,32725000,32170000,32730000,"chr20",651290,4,4,4,12,"chr20",1,0.0112517580872011
"22766","chr20.49610000.49615000","chr20.49935000.49940000",325000,19,7.68554e-10,49610000,49935000,49615000,49940000,"chr20",651308,4,5,16,25,"chr20",1,0.0556727613689639
"22767","chr20.2535000.2540000","chr20.2555000.2560000",20000,49,2.038752e-07,2535000,2555000,2540000,2560000,"chr20",651323,2,7,7,16,"chr20",1,0.0918893577121425
"22768","chr20.50125000.50130000","chr20.50165000.50170000",40000,25,0.005118277,50125000,50165000,50130000,50170000,"chr20",651344,2,8,5,15,"chr20",1,0.0439521800281294
"22769","chr20.24475000.24480000","chr20.24505000.24510000",30000,31,0.002646902,24475000,24505000,24480000,24510000,"chr20",651356,0,2,1,3,"chr20",1,0.0109001406469761
"22770","chr20.34580000.34585000","chr20.34705000.34710000",125000,16,0.001120029,34580000,34705000,34585000,34710000,"chr20",651431,0,3,3,6,"chr20",1,0.0112517580872011
"22771","chr20.35205000.35210000","chr20.35510000.35515000",305000,11,0.002145599,35205000,35510000,35210000,35515000,"chr20",651451,2,15,16,33,"chr20",1,0.0425457102672293
"22772","chr20.48920000.48925000","chr20.48950000.48955000",30000,33,0.0005746803,48920000,48950000,48925000,48955000,"chr20",651462,1,1,4,6,"chr20",1,0.0232067510548523
"22773","chr20.45190000.45195000","chr20.45320000.45325000",130000,26,2.396604e-10,45190000,45320000,45195000,45325000,"chr20",651517,2,2,1,5,"chr20",1,0.0152367557430849
"22774","chr20.16800000.16805000","chr20.17420000.17425000",620000,12,3.035079e-06,16800000,17420000,16805000,17425000,"chr20",651603,0,1,0,1,"chr20",1,0.00140646976090014
"22775","chr20.25295000.25300000","chr20.25375000.25380000",80000,19,0.0013923,25295000,25375000,25300000,25380000,"chr20",651680,1,3,2,6,"chr20",1,0.0133614627285513
"22776","chr20.32525000.32530000","chr20.32670000.32675000",145000,20,1.534538e-06,32525000,32670000,32530000,32675000,"chr20",651722,4,8,11,23,"chr20",1,0.0539146741678387
"22777","chr20.20845000.20850000","chr20.21300000.21305000",455000,11,0.0002191147,20845000,21300000,20850000,21305000,"chr20",651737,0,2,1,3,"chr20",1,0.00386779184247539
"22778","chr20.46420000.46425000","chr20.47235000.47240000",815000,11,2.319345e-06,46420000,47235000,46425000,47240000,"chr20",651767,0,6,2,8,"chr20",1,0.0103141115799344
"22779","chr20.20405000.20410000","chr20.20510000.20515000",105000,23,4.825022e-07,20405000,20510000,20410000,20515000,"chr20",651778,0,2,1,3,"chr20",1,0.00808720112517581
"22780","chr20.5535000.5540000","chr20.5785000.5790000",250000,13,0.000437647,5535000,5785000,5540000,5790000,"chr20",651810,3,15,4,22,"chr20",1,0.0335208626347867
"22781","chr20.3380000.3385000","chr20.3460000.3465000",80000,20,0.0004853668,3380000,3460000,3385000,3465000,"chr20",651834,5,23,9,37,"chr20",1,0.0867323019221753
"22782","chr20.48790000.48795000","chr20.49185000.49190000",395000,9,0.009944612,48790000,49185000,48795000,49190000,"chr20",651872,0,8,5,13,"chr20",1,0.0137130801687764
"22783","chr20.46020000.46025000","chr20.46245000.46250000",225000,16,1.077472e-05,46020000,46245000,46025000,46250000,"chr20",651875,0,5,5,10,"chr20",1,0.0187529301453352
"22784","chr20.35235000.35240000","chr20.35510000.35515000",275000,22,1.110456e-11,35235000,35510000,35240000,35515000,"chr20",651898,2,16,14,32,"chr20",1,0.0825128926394749
"22785","chr20.36310000.36315000","chr20.36610000.36615000",300000,12,0.0005538738,36310000,36610000,36315000,36615000,"chr20",651913,1,3,2,6,"chr20",1,0.00843881856540084
"22786","chr20.45915000.45920000","chr20.46255000.46260000",340000,11,0.001204757,45915000,46255000,45920000,46260000,"chr20",652011,4,3,3,10,"chr20",1,0.012892639474918
"22787","chr20.46345000.46350000","chr20.47235000.47240000",890000,18,7.282027e-15,46345000,47235000,46350000,47240000,"chr20",652083,0,6,2,8,"chr20",1,0.0168776371308017
"22788","chr20.37410000.37415000","chr20.37500000.37505000",90000,17,0.003988133,37410000,37500000,37415000,37505000,"chr20",652091,0,2,2,4,"chr20",1,0.00796999531176746
"22789","chr20.3190000.3195000","chr20.3380000.3385000",190000,13,0.002874117,3190000,3380000,3195000,3385000,"chr20",652109,3,5,6,14,"chr20",1,0.0213314580403188
"22790","chr20.31940000.31945000","chr20.32625000.32630000",685000,9,0.0005035578,31940000,32625000,31945000,32630000,"chr20",652121,2,0,1,3,"chr20",1,0.00316455696202532
"22791","chr20.35225000.35230000","chr20.35495000.35500000",270000,13,0.0002534169,35225000,35495000,35230000,35500000,"chr20",652122,0,2,0,2,"chr20",1,0.00304735114861697
"22792","chr20.36860000.36865000","chr20.36940000.36945000",80000,23,1.425509e-05,36860000,36940000,36865000,36945000,"chr20",652123,1,1,5,7,"chr20",1,0.0188701359587436
"22793","chr20.50295000.50300000","chr20.50375000.50380000",80000,20,0.0004853668,50295000,50375000,50300000,50380000,"chr20",652150,0,1,0,1,"chr20",1,0.0023441162681669
"22794","chr20.33455000.33460000","chr20.33675000.33680000",220000,24,4.983736e-12,33455000,33675000,33460000,33680000,"chr20",652159,5,8,6,19,"chr20",1,0.0534458509142053
"22795","chr20.5100000.5105000","chr20.5160000.5165000",60000,25,5.493294e-05,5100000,5160000,5105000,5165000,"chr20",652222,6,12,11,29,"chr20",1,0.0849742147210502
"22796","chr20.4760000.4765000","chr20.4895000.4900000",135000,17,0.0001933485,4760000,4895000,4765000,4900000,"chr20",652259,1,2,2,5,"chr20",1,0.00996249413970933
"22797","chr20.32520000.32525000","chr20.32540000.32545000",20000,36,0.006264165,32520000,32540000,32525000,32545000,"chr20",652276,0,0,7,7,"chr20",1,0.029535864978903
"22798","chr20.48700000.48705000","chr20.48765000.48770000",65000,23,0.000174658,48700000,48765000,48705000,48770000,"chr20",652286,0,2,1,3,"chr20",1,0.00808720112517581
"22799","chr20.1775000.1780000","chr20.1860000.1865000",85000,18,0.002327667,1775000,1860000,1780000,1865000,"chr20",652306,0,1,1,2,"chr20",1,0.00421940928270042
"22800","chr20.51330000.51335000","chr20.52100000.52105000",770000,7,0.00836949,51330000,52100000,51335000,52105000,"chr20",652335,0,2,2,4,"chr20",1,0.00328176277543366
"22801","chr20.46165000.46170000","chr20.46245000.46250000",80000,27,6.322365e-08,46165000,46245000,46170000,46250000,"chr20",652416,0,1,2,3,"chr20",1,0.00949367088607595
"22802","chr20.50295000.50300000","chr20.50585000.50590000",290000,11,0.002814862,50295000,50585000,50300000,50590000,"chr20",652580,0,1,0,1,"chr20",1,0.0012892639474918
"22803","chr20.2870000.2875000","chr20.2900000.2905000",30000,47,3.948489e-10,2870000,2900000,2875000,2905000,"chr20",652608,0,1,1,2,"chr20",1,0.0110173464603844
"22804","chr20.4895000.4900000","chr20.5070000.5075000",175000,13,0.004764841,4895000,5070000,4900000,5075000,"chr20",652611,1,2,2,5,"chr20",1,0.00761837787154243
"22805","chr20.3100000.3105000","chr20.3165000.3170000",65000,19,0.00845526,3100000,3165000,3105000,3170000,"chr20",652625,1,1,3,5,"chr20",1,0.0111345522737928
"22806","chr20.45820000.45825000","chr20.46125000.46130000",305000,10,0.008080815,45820000,46125000,45825000,46130000,"chr20",652650,1,1,3,5,"chr20",1,0.00586029067041725
"22807","chr20.48620000.48625000","chr20.48690000.48695000",70000,26,1.856292e-06,48620000,48690000,48625000,48695000,"chr20",652664,4,2,7,13,"chr20",1,0.0396155649320206
"22808","chr20.35445000.35450000","chr20.35495000.35500000",50000,24,0.001269016,35445000,35495000,35450000,35500000,"chr20",652665,0,6,2,8,"chr20",1,0.0225035161744023
"22809","chr20.5730000.5735000","chr20.5750000.5755000",20000,40,0.0004271525,5730000,5750000,5735000,5755000,"chr20",652724,3,8,16,27,"chr20",1,0.126582278481013
"22810","chr20.45390000.45395000","chr20.45770000.45775000",380000,10,0.002947192,45390000,45770000,45395000,45775000,"chr20",652776,1,13,5,19,"chr20",1,0.0222691045475856
"22811","chr20.35235000.35240000","chr20.35560000.35565000",325000,11,0.001498749,35235000,35560000,35240000,35565000,"chr20",652810,3,5,6,14,"chr20",1,0.0180496952648851
"22812","chr20.1465000.1470000","chr20.2280000.2285000",815000,7,0.006374937,1465000,2280000,1470000,2285000,"chr20",652813,4,3,5,12,"chr20",1,0.00984528832630099
"22813","chr20.34580000.34585000","chr20.34745000.34750000",165000,21,7.72098e-08,34580000,34745000,34585000,34750000,"chr20",652830,3,0,5,8,"chr20",1,0.019690576652602
"22814","chr20.51570000.51575000","chr20.51590000.51595000",20000,43,4.195558e-05,51570000,51590000,51575000,51595000,"chr20",652838,0,5,0,5,"chr20",1,0.0251992498827942
"22815","chr20.34310000.34315000","chr20.34360000.34365000",50000,22,0.00700017,34310000,34360000,34315000,34365000,"chr20",652848,6,20,21,47,"chr20",1,0.121190811064229
"22816","chr20.32540000.32545000","chr20.32650000.32655000",110000,15,0.007335206,32540000,32650000,32545000,32655000,"chr20",652861,5,13,10,28,"chr20",1,0.0492264416315049
"22817","chr20.44990000.44995000","chr20.45055000.45060000",65000,19,0.00845526,44990000,45055000,44995000,45060000,"chr20",652883,0,4,2,6,"chr20",1,0.0133614627285513
"22818","chr20.33630000.33635000","chr20.33675000.33680000",45000,27,0.0002382565,33630000,33675000,33635000,33680000,"chr20",652923,5,8,6,19,"chr20",1,0.060126582278481
"22819","chr20.45915000.45920000","chr20.45940000.45945000",25000,35,0.002779009,45915000,45940000,45920000,45945000,"chr20",652924,7,27,30,64,"chr20",1,0.262541022034693
"22820","chr20.45960000.45965000","chr20.45985000.45990000",25000,54,4.885311e-11,45960000,45985000,45965000,45990000,"chr20",652930,2,10,16,28,"chr20",1,0.177215189873418
"22821","chr20.2870000.2875000","chr20.2955000.2960000",85000,17,0.006202879,2870000,2955000,2875000,2960000,"chr20",652938,0,1,1,2,"chr20",1,0.00398499765588373
"22822","chr20.4760000.4765000","chr20.4945000.4950000",185000,18,3.078212e-06,4760000,4945000,4765000,4950000,"chr20",652943,1,4,4,9,"chr20",1,0.0189873417721519
"22823","chr20.1775000.1780000","chr20.1915000.1920000",140000,31,6.113123e-15,1775000,1915000,1780000,1920000,"chr20",653008,0,1,1,2,"chr20",1,0.00726676043131739
"22824","chr20.48725000.48730000","chr20.48765000.48770000",40000,25,0.005118277,48725000,48765000,48730000,48770000,"chr20",653027,0,2,0,2,"chr20",1,0.00586029067041725
"22825","chr20.44720000.44725000","chr20.45055000.45060000",335000,10,0.005321539,44720000,45055000,44725000,45060000,"chr20",653053,0,3,2,5,"chr20",1,0.00586029067041725
"22826","chr20.50460000.50465000","chr20.50665000.50670000",205000,15,0.0001132904,50460000,50665000,50465000,50670000,"chr20",653085,3,17,8,28,"chr20",1,0.0492264416315049
"22827","chr20.58170000.58175000","chr20.58305000.58310000",135000,14,0.006636427,58170000,58305000,58175000,58310000,"chr20",653102,1,4,8,13,"chr20",1,0.0213314580403188
"22828","chr20.45375000.45380000","chr20.45935000.45940000",560000,8,0.008022267,45375000,45935000,45380000,45940000,"chr20",653109,2,7,9,18,"chr20",1,0.0168776371308017
"22829","chr20.35950000.35955000","chr20.35990000.35995000",40000,28,0.0004158209,35950000,35990000,35955000,35995000,"chr20",653113,6,28,14,48,"chr20",1,0.157524613220816
"22830","chr20.34355000.34360000","chr20.34435000.34440000",80000,18,0.003776418,34355000,34435000,34360000,34440000,"chr20",653182,7,9,5,21,"chr20",1,0.0443037974683544
"22831","chr20.32465000.32470000","chr20.32725000.32730000",260000,12,0.001370333,32465000,32725000,32470000,32730000,"chr20",653198,0,6,7,13,"chr20",1,0.0182841068917018
"22832","chr20.35825000.35830000","chr20.36015000.36020000",190000,15,0.0002113584,35825000,36015000,35830000,36020000,"chr20",653224,5,5,4,14,"chr20",1,0.0246132208157525
"22833","chr20.44700000.44705000","chr20.45040000.45045000",340000,12,0.0002593858,44700000,45040000,44705000,45045000,"chr20",653230,0,2,1,3,"chr20",1,0.00421940928270042
"22834","chr20.4085000.4090000","chr20.4145000.4150000",60000,32,8.374451e-09,4085000,4145000,4090000,4150000,"chr20",653325,0,3,6,9,"chr20",1,0.0337552742616034
"22835","chr20.46415000.46420000","chr20.47235000.47240000",820000,42,1.258021e-49,46415000,47235000,46420000,47240000,"chr20",653328,0,0,2,2,"chr20",1,0.00984528832630099
"22836","chr20.46295000.46300000","chr20.47235000.47240000",940000,10,5.746237e-06,46295000,47235000,46300000,47240000,"chr20",653389,0,5,2,7,"chr20",1,0.00820440693858415
"22837","chr20.46370000.46375000","chr20.47235000.47240000",865000,8,0.0007625582,46370000,47235000,46375000,47240000,"chr20",653402,0,3,2,5,"chr20",1,0.0046882325363338
"22838","chr20.48690000.48695000","chr20.48725000.48730000",35000,29,0.001182555,48690000,48725000,48695000,48730000,"chr20",653403,0,2,0,2,"chr20",1,0.00679793717768401
"22839","chr20.5500000.5505000","chr20.5805000.5810000",305000,15,3.609103e-06,5500000,5805000,5505000,5810000,"chr20",653440,1,1,9,11,"chr20",1,0.0193389592123769
"22840","chr20.33560000.33565000","chr20.33690000.33695000",130000,17,0.0002538211,33560000,33690000,33565000,33695000,"chr20",653441,4,26,17,47,"chr20",1,0.0936474449132677
"22841","chr20.35365000.35370000","chr20.35510000.35515000",145000,16,0.0004241772,35365000,35510000,35370000,35515000,"chr20",653473,2,6,4,12,"chr20",1,0.0225035161744023
"22842","chr20.46195000.46200000","chr20.46245000.46250000",50000,30,2.557327e-06,46195000,46245000,46200000,46250000,"chr20",653494,0,6,4,10,"chr20",1,0.0351617440225035
"22843","chr20.45855000.45860000","chr20.46245000.46250000",390000,10,0.002611858,45855000,46245000,45860000,46250000,"chr20",653552,0,8,6,14,"chr20",1,0.0164088138771683
"22844","chr20.47365000.47370000","chr20.47410000.47415000",45000,26,0.000603865,47365000,47410000,47370000,47415000,"chr20",653560,8,37,39,84,"chr20",1,0.255977496483826
"22845","chr20.265000.270000","chr20.320000.325000",55000,22,0.002980336,265000,320000,270000,325000,"chr20",653652,7,15,11,33,"chr20",1,0.0850914205344585
"22846","chr20.35845000.35850000","chr20.36155000.36160000",310000,10,0.007495908,35845000,36155000,35850000,36160000,"chr20",653689,0,2,2,4,"chr20",1,0.0046882325363338
"22847","chr20.32525000.32530000","chr20.32675000.32680000",150000,19,5.051945e-06,32525000,32675000,32530000,32680000,"chr20",653714,2,8,4,14,"chr20",1,0.0311767463666198
"22848","chr20.17525000.17530000","chr20.17940000.17945000",415000,10,0.001867039,17525000,17940000,17530000,17945000,"chr20",653758,0,5,7,12,"chr20",1,0.0140646976090014
"22849","chr20.48345000.48350000","chr20.48435000.48440000",90000,19,0.0004788308,48345000,48435000,48350000,48440000,"chr20",653768,4,11,10,25,"chr20",1,0.0556727613689639
"22850","chr20.5115000.5120000","chr20.5170000.5175000",55000,31,1.645323e-07,5115000,5170000,5120000,5175000,"chr20",653824,0,1,4,5,"chr20",1,0.0181669010782935
"22851","chr20.46395000.46400000","chr20.47235000.47240000",840000,9,0.0001307735,46395000,47235000,46400000,47240000,"chr20",653883,0,6,2,8,"chr20",1,0.00843881856540084
"22852","chr20.35900000.35905000","chr20.36170000.36175000",270000,14,5.302814e-05,35900000,36170000,35905000,36175000,"chr20",653899,3,19,12,34,"chr20",1,0.0557899671823722
"22853","chr20.46345000.46350000","chr20.46410000.46415000",65000,21,0.001362274,46345000,46410000,46350000,46415000,"chr20",653910,2,5,7,14,"chr20",1,0.0344585091420534
"22854","chr20.32515000.32520000","chr20.32670000.32675000",155000,19,3.695546e-06,32515000,32670000,32520000,32675000,"chr20",653915,3,2,8,13,"chr20",1,0.0289498359118612
"22855","chr20.2875000.2880000","chr20.2900000.2905000",25000,36,0.001389016,2875000,2900000,2880000,2905000,"chr20",653946,1,9,4,14,"chr20",1,0.0590717299578059
"22856","chr20.5555000.5560000","chr20.5750000.5755000",195000,23,2.31719e-10,5555000,5750000,5560000,5755000,"chr20",653971,3,16,7,26,"chr20",1,0.0700890764181903
"22857","chr20.44735000.44740000","chr20.44965000.44970000",230000,14,0.0001923845,44735000,44965000,44740000,44970000,"chr20",653977,2,7,5,14,"chr20",1,0.0229723394280356
"22858","chr20.49605000.49610000","chr20.49920000.49925000",315000,16,4.428643e-07,49605000,49920000,49610000,49925000,"chr20",654006,1,22,17,40,"chr20",1,0.0750117205813408
"22859","chr20.24540000.24545000","chr20.24570000.24575000",30000,34,0.0002555851,24540000,24570000,24545000,24575000,"chr20",654114,0,3,1,4,"chr20",1,0.0159399906235349
"22860","chr20.44700000.44705000","chr20.45055000.45060000",355000,13,3.773894e-05,44700000,45055000,44705000,45060000,"chr20",654148,0,2,1,3,"chr20",1,0.00457102672292546
"22861","chr20.45190000.45195000","chr20.45310000.45315000",120000,50,5.738504e-32,45190000,45310000,45195000,45315000,"chr20",654177,2,2,1,5,"chr20",1,0.0293014533520863
"22862","chr20.350000.355000","chr20.490000.495000",140000,18,3.839212e-05,350000,490000,355000,495000,"chr20",654193,9,20,19,48,"chr20",1,0.10126582278481
"22863","chr20.36405000.36410000","chr20.36435000.36440000",30000,30,0.005403861,36405000,36435000,36410000,36440000,"chr20",654214,2,4,7,13,"chr20",1,0.0457102672292546
"22864","chr20.5610000.5615000","chr20.5730000.5735000",120000,17,0.0004480627,5610000,5730000,5615000,5735000,"chr20",654256,3,8,8,19,"chr20",1,0.0378574777308955
"22865","chr20.44755000.44760000","chr20.45055000.45060000",300000,21,2.917945e-11,44755000,45055000,44760000,45060000,"chr20",654280,0,3,1,4,"chr20",1,0.00984528832630099
"22866","chr20.4085000.4090000","chr20.4150000.4155000",65000,26,5.554083e-06,4085000,4150000,4090000,4155000,"chr20",654287,0,3,2,5,"chr20",1,0.0152367557430849
"22867","chr20.44680000.44685000","chr20.44735000.44740000",55000,28,6.40544e-06,44680000,44735000,44685000,44740000,"chr20",654293,2,7,3,12,"chr20",1,0.0393811533052039
"22868","chr20.9615000.9620000","chr20.9880000.9885000",265000,12,0.001218971,9615000,9880000,9620000,9885000,"chr20",654302,2,3,1,6,"chr20",1,0.00843881856540084
"22869","chr20.24475000.24480000","chr20.24540000.24545000",65000,20,0.003473761,24475000,24540000,24480000,24545000,"chr20",654334,0,2,1,3,"chr20",1,0.0070323488045007
"22870","chr20.44650000.44655000","chr20.44720000.44725000",70000,22,0.0002181321,44650000,44720000,44655000,44725000,"chr20",654431,1,3,4,8,"chr20",1,0.0206282231598687
"22871","chr20.20330000.20335000","chr20.20510000.20515000",180000,14,0.001194848,20330000,20510000,20335000,20515000,"chr20",654484,0,3,2,5,"chr20",1,0.00820440693858415
"22872","chr20.15655000.15660000","chr20.15785000.15790000",130000,15,0.002757417,15655000,15785000,15660000,15790000,"chr20",654508,0,2,2,4,"chr20",1,0.0070323488045007
"22873","chr20.4720000.4725000","chr20.4945000.4950000",225000,12,0.003412297,4720000,4945000,4725000,4950000,"chr20",654517,1,1,0,2,"chr20",1,0.00281293952180028
"22874","chr20.34300000.34305000","chr20.34470000.34475000",170000,23,1.566976e-09,34300000,34470000,34305000,34475000,"chr20",654531,4,5,5,14,"chr20",1,0.0377402719174871
"22875","chr20.35315000.35320000","chr20.35510000.35515000",195000,13,0.002454964,35315000,35510000,35320000,35515000,"chr20",654578,2,4,12,18,"chr20",1,0.0274261603375527
"22876","chr20.10415000.10420000","chr20.10435000.10440000",20000,37,0.003368382,10415000,10435000,10420000,10440000,"chr20",654639,4,16,26,46,"chr20",1,0.199484294421003
"22877","chr20.1880000.1885000","chr20.1915000.1920000",35000,34,1.25583e-05,1880000,1915000,1885000,1920000,"chr20",654641,0,3,2,5,"chr20",1,0.0199249882794187
"22878","chr20.32525000.32530000","chr20.33210000.33215000",685000,8,0.002918699,32525000,33210000,32530000,33215000,"chr20",654697,0,4,1,5,"chr20",1,0.0046882325363338
"22879","chr20.2525000.2530000","chr20.2615000.2620000",90000,21,4.446278e-05,2525000,2615000,2530000,2620000,"chr20",654723,0,3,3,6,"chr20",1,0.0147679324894515
"22880","chr20.5525000.5530000","chr20.5765000.5770000",240000,18,1.818533e-07,5525000,5765000,5530000,5770000,"chr20",654725,11,21,16,48,"chr20",1,0.10126582278481
"22881","chr20.35900000.35905000","chr20.36015000.36020000",115000,15,0.005627825,35900000,36015000,35905000,36020000,"chr20",654728,3,5,4,12,"chr20",1,0.0210970464135021
"22882","chr20.4950000.4955000","chr20.5070000.5075000",120000,17,0.0004480627,4950000,5070000,4955000,5075000,"chr20",654798,2,13,5,20,"chr20",1,0.0398499765588373
"22883","chr20.46130000.46135000","chr20.46200000.46205000",70000,25,6.609589e-06,46130000,46200000,46135000,46205000,"chr20",654816,0,3,6,9,"chr20",1,0.0263713080168776
"22884","chr20.46345000.46350000","chr20.46650000.46655000",305000,11,0.002145599,46345000,46650000,46350000,46655000,"chr20",654836,1,9,7,17,"chr20",1,0.0219174871073605
"22885","chr20.50240000.50245000","chr20.50710000.50715000",470000,9,0.004389974,50240000,50710000,50245000,50715000,"chr20",654842,4,10,11,25,"chr20",1,0.0263713080168776
"22886","chr20.45810000.45815000","chr20.46020000.46025000",210000,12,0.005224406,45810000,46020000,45815000,46025000,"chr20",654843,0,5,5,10,"chr20",1,0.0140646976090014
"22887","chr20.37445000.37450000","chr20.37530000.37535000",85000,21,8.294513e-05,37445000,37530000,37450000,37535000,"chr20",654849,3,0,2,5,"chr20",1,0.0123066104078762
"22888","chr20.45915000.45920000","chr20.45935000.45940000",20000,37,0.003368382,45915000,45935000,45920000,45940000,"chr20",654850,5,7,9,21,"chr20",1,0.0910689170182841
"22889","chr20.5730000.5735000","chr20.5765000.5770000",35000,39,5.753814e-08,5730000,5765000,5735000,5770000,"chr20",654862,3,8,16,27,"chr20",1,0.123417721518987
"22890","chr20.45830000.45835000","chr20.46170000.46175000",340000,10,0.004966881,45830000,46170000,45835000,46175000,"chr20",654893,1,2,0,3,"chr20",1,0.00351617440225035
"22891","chr20.17535000.17540000","chr20.17555000.17560000",20000,36,0.006264165,17535000,17555000,17540000,17560000,"chr20",654922,3,6,2,11,"chr20",1,0.0464135021097046
"22892","chr20.47270000.47275000","chr20.47355000.47360000",85000,28,5.297555e-09,47270000,47355000,47275000,47360000,"chr20",654928,2,3,7,12,"chr20",1,0.0393811533052039
"22893","chr20.45415000.45420000","chr20.46020000.46025000",605000,8,0.005518428,45415000,46020000,45420000,46025000,"chr20",654938,0,4,3,7,"chr20",1,0.00656352555086732
"22894","chr20.4605000.4610000","chr20.4685000.4690000",80000,26,2.669362e-07,4605000,4685000,4610000,4690000,"chr20",654979,2,1,1,4,"chr20",1,0.0121894045944679
"22895","chr20.49640000.49645000","chr20.49955000.49960000",315000,10,0.00700017,49640000,49955000,49645000,49960000,"chr20",655018,3,8,10,21,"chr20",1,0.0246132208157525
"22896","chr20.45890000.45895000","chr20.46020000.46025000",130000,15,0.002757417,45890000,46020000,45895000,46025000,"chr20",655045,0,2,2,4,"chr20",1,0.0070323488045007
"22897","chr20.1775000.1780000","chr20.2065000.2070000",290000,11,0.002814862,1775000,2065000,1780000,2070000,"chr20",655067,0,1,1,2,"chr20",1,0.00257852789498359
"22898","chr20.33490000.33495000","chr20.33685000.33690000",195000,16,4.025595e-05,33490000,33685000,33495000,33690000,"chr20",655092,6,12,9,27,"chr20",1,0.0506329113924051
"22899","chr20.32540000.32545000","chr20.32625000.32630000",85000,22,2.424599e-05,32540000,32625000,32545000,32630000,"chr20",655131,2,3,1,6,"chr20",1,0.0154711673699015
"22900","chr20.46245000.46250000","chr20.47235000.47240000",990000,7,0.00200471,46245000,47235000,46250000,47240000,"chr20",655171,0,6,2,8,"chr20",1,0.00656352555086732
"22901","chr20.32355000.32360000","chr20.32725000.32730000",370000,12,0.0001557801,32355000,32725000,32360000,32730000,"chr20",655289,0,3,4,7,"chr20",1,0.00984528832630099
"22902","chr20.35770000.35775000","chr20.36125000.36130000",355000,12,0.0002004142,35770000,36125000,35775000,36130000,"chr20",655308,4,17,23,44,"chr20",1,0.0618846694796062
"22903","chr20.20835000.20840000","chr20.21180000.21185000",345000,12,0.0002382565,20835000,21180000,20840000,21185000,"chr20",655318,0,6,4,10,"chr20",1,0.0140646976090014
"22904","chr20.17495000.17500000","chr20.17880000.17885000",385000,11,0.0006058688,17495000,17880000,17500000,17885000,"chr20",655351,2,2,3,7,"chr20",1,0.00902484763244257
"22905","chr20.33465000.33470000","chr20.33630000.33635000",165000,17,4.025595e-05,33465000,33630000,33470000,33635000,"chr20",655362,3,27,21,51,"chr20",1,0.101617440225035
"22906","chr20.50325000.50330000","chr20.50585000.50590000",260000,11,0.00519589,50325000,50585000,50330000,50590000,"chr20",655363,1,3,3,7,"chr20",1,0.00902484763244257
"22907","chr20.33465000.33470000","chr20.33730000.33735000",265000,11,0.004641088,33465000,33730000,33470000,33735000,"chr20",655368,2,27,21,50,"chr20",1,0.0644631973745898
"22908","chr20.1320000.1325000","chr20.1435000.1440000",115000,15,0.005627825,1320000,1435000,1325000,1440000,"chr20",655431,0,0,1,1,"chr20",1,0.00175808720112518
"22909","chr20.17615000.17620000","chr20.17880000.17885000",265000,15,1.227787e-05,17615000,17880000,17620000,17885000,"chr20",655444,1,10,1,12,"chr20",1,0.0210970464135021
"22910","chr20.43940000.43945000","chr20.44385000.44390000",445000,10,0.001276326,43940000,44385000,43945000,44390000,"chr20",655445,5,4,8,17,"chr20",1,0.0199249882794187
"22911","chr20.17495000.17500000","chr20.17895000.17900000",400000,13,1.638997e-05,17495000,17895000,17500000,17900000,"chr20",655451,2,2,3,7,"chr20",1,0.0106657290201594
"22912","chr20.49130000.49135000","chr20.49165000.49170000",35000,30,0.0005042418,49130000,49165000,49135000,49170000,"chr20",655464,1,8,4,13,"chr20",1,0.0457102672292546
"22913","chr20.2875000.2880000","chr20.2995000.3000000",120000,15,0.004389974,2875000,2995000,2880000,3e+06,"chr20",655516,1,4,4,9,"chr20",1,0.0158227848101266
"22914","chr20.5580000.5585000","chr20.5730000.5735000",150000,15,0.001170465,5580000,5730000,5585000,5735000,"chr20",655577,3,8,15,26,"chr20",1,0.0457102672292546
"22915","chr20.33410000.33415000","chr20.33675000.33680000",265000,12,0.001218971,33410000,33675000,33415000,33680000,"chr20",655642,3,8,6,17,"chr20",1,0.0239099859353024
"22916","chr20.45930000.45935000","chr20.46245000.46250000",315000,13,8.47422e-05,45930000,46245000,45935000,46250000,"chr20",655646,0,8,6,14,"chr20",1,0.0213314580403188
"22917","chr20.4760000.4765000","chr20.4955000.4960000",195000,16,4.025595e-05,4760000,4955000,4765000,4960000,"chr20",655679,7,15,4,26,"chr20",1,0.0487576183778715
"22918","chr20.35770000.35775000","chr20.36525000.36530000",755000,7,0.009291678,35770000,36525000,35775000,36530000,"chr20",655696,0,2,3,5,"chr20",1,0.00410220346929208
"22919","chr20.34265000.34270000","chr20.34535000.34540000",270000,12,0.001087245,34265000,34535000,34270000,34540000,"chr20",655701,7,14,8,29,"chr20",1,0.0407876230661041
"22920","chr20.33630000.33635000","chr20.33650000.33655000",20000,61,4.197769e-13,33630000,33650000,33635000,33655000,"chr20",655733,6,8,13,27,"chr20",1,0.193037974683544
"22921","chr20.5115000.5120000","chr20.5135000.5140000",20000,52,9.992221e-09,5115000,5135000,5120000,5140000,"chr20",655765,8,18,14,40,"chr20",1,0.243788091889358
"22922","chr20.5535000.5540000","chr20.5930000.5935000",395000,9,0.009944612,5535000,5930000,5540000,5935000,"chr20",655772,1,9,5,15,"chr20",1,0.0158227848101266
"22923","chr20.44755000.44760000","chr20.44975000.44980000",220000,17,2.636993e-06,44755000,44975000,44760000,44980000,"chr20",655824,0,2,1,3,"chr20",1,0.0059774964838256
"22924","chr20.45880000.45885000","chr20.46020000.46025000",140000,20,2.111649e-06,45880000,46020000,45885000,46025000,"chr20",655825,0,5,5,10,"chr20",1,0.023441162681669
"22925","chr20.1760000.1765000","chr20.1880000.1885000",120000,15,0.004389974,1760000,1880000,1765000,1885000,"chr20",655896,0,3,2,5,"chr20",1,0.00879043600562588
"22926","chr20.17685000.17690000","chr20.17855000.17860000",170000,14,0.001739905,17685000,17855000,17690000,17860000,"chr20",655905,2,0,2,4,"chr20",1,0.00656352555086732
"22927","chr20.45940000.45945000","chr20.45960000.45965000",20000,61,4.197769e-13,45940000,45960000,45945000,45965000,"chr20",655922,2,10,16,28,"chr20",1,0.200187529301453
"22928","chr20.5590000.5595000","chr20.5930000.5935000",340000,13,5.066773e-05,5590000,5930000,5595000,5935000,"chr20",655944,0,3,5,8,"chr20",1,0.0121894045944679
"22929","chr20.17525000.17530000","chr20.17880000.17885000",355000,19,2.916642e-10,17525000,17880000,17530000,17885000,"chr20",655999,0,7,5,12,"chr20",1,0.0267229254571027
"22930","chr20.1825000.1830000","chr20.1890000.1895000",65000,19,0.00845526,1825000,1890000,1830000,1895000,"chr20",656008,3,2,3,8,"chr20",1,0.0178152836380684
"22931","chr20.9615000.9620000","chr20.9975000.9980000",360000,10,0.003776236,9615000,9975000,9620000,9980000,"chr20",656021,0,3,1,4,"chr20",1,0.0046882325363338
"22932","chr20.45375000.45380000","chr20.46245000.46250000",870000,7,0.004567027,45375000,46245000,45380000,46250000,"chr20",656028,0,8,6,14,"chr20",1,0.0114861697140178
"22933","chr20.17635000.17640000","chr20.17855000.17860000",220000,12,0.003907514,17635000,17855000,17640000,17860000,"chr20",656037,0,0,2,2,"chr20",1,0.00281293952180028
"22934","chr20.46415000.46420000","chr20.47250000.47255000",835000,8,0.0009502226,46415000,47250000,46420000,47255000,"chr20",656041,0,0,3,3,"chr20",1,0.00281293952180028
"22935","chr20.35615000.35620000","chr20.35635000.35640000",20000,36,0.006264165,35615000,35635000,35620000,35640000,"chr20",656056,2,5,4,11,"chr20",1,0.0464135021097046
"22936","chr20.15655000.15660000","chr20.16485000.16490000",830000,9,0.0001433745,15655000,16485000,15660000,16490000,"chr20",656130,0,2,2,4,"chr20",1,0.00421940928270042
"22937","chr20.35635000.35640000","chr20.35660000.35665000",25000,39,0.000146533,35635000,35660000,35640000,35665000,"chr20",656154,0,2,1,3,"chr20",1,0.0137130801687764
"22938","chr20.20835000.20840000","chr20.21550000.21555000",715000,9,0.0003896602,20835000,21550000,20840000,21555000,"chr20",656158,0,6,4,10,"chr20",1,0.0105485232067511
"22939","chr20.32760000.32765000","chr20.32780000.32785000",20000,37,0.003368382,32760000,32780000,32765000,32785000,"chr20",656161,0,3,2,5,"chr20",1,0.0216830754805438
"22940","chr20.45915000.45920000","chr20.45960000.45965000",45000,23,0.007616206,45915000,45960000,45920000,45965000,"chr20",656168,2,10,16,28,"chr20",1,0.0754805438349742
"22941","chr20.32520000.32525000","chr20.32675000.32680000",155000,14,0.0030839,32520000,32675000,32525000,32680000,"chr20",656176,0,0,4,4,"chr20",1,0.00656352555086732
"22942","chr20.33430000.33435000","chr20.33685000.33690000",255000,12,0.001537065,33430000,33685000,33435000,33690000,"chr20",656246,6,12,9,27,"chr20",1,0.0379746835443038
"22943","chr20.50325000.50330000","chr20.50375000.50380000",50000,24,0.001269016,50325000,50375000,50330000,50380000,"chr20",656256,1,2,2,5,"chr20",1,0.0140646976090014
"22944","chr20.24505000.24510000","chr20.24540000.24545000",35000,42,1.551354e-09,24505000,24540000,24510000,24545000,"chr20",656258,0,2,1,3,"chr20",1,0.0147679324894515
"22945","chr20.33645000.33650000","chr20.33675000.33680000",30000,41,3.488186e-07,33645000,33675000,33650000,33680000,"chr20",656286,3,8,6,17,"chr20",1,0.0816924519456165
"22946","chr20.35880000.35885000","chr20.36155000.36160000",275000,20,7.176679e-10,35880000,36155000,35885000,36160000,"chr20",656323,0,2,2,4,"chr20",1,0.00937646507266761
"22947","chr20.330000.335000","chr20.435000.440000",105000,33,1.988658e-14,330000,435000,335000,440000,"chr20",656424,0,2,1,3,"chr20",1,0.0116033755274262
"22948","chr20.35365000.35370000","chr20.35495000.35500000",130000,18,6.872437e-05,35365000,35495000,35370000,35500000,"chr20",656462,0,6,2,8,"chr20",1,0.0168776371308017
"22949","chr20.18465000.18470000","chr20.18540000.18545000",75000,18,0.006336967,18465000,18540000,18470000,18545000,"chr20",656496,0,2,1,3,"chr20",1,0.00632911392405063
"22950","chr20.330000.335000","chr20.430000.435000",100000,18,0.0005782574,330000,430000,335000,435000,"chr20",656501,0,2,0,2,"chr20",1,0.00421940928270042
"22951","chr20.3030000.3035000","chr20.3100000.3105000",70000,23,7.112479e-05,3030000,3100000,3035000,3105000,"chr20",656504,1,8,8,17,"chr20",1,0.0458274730426629
"22952","chr20.47315000.47320000","chr20.47410000.47415000",95000,16,0.007152335,47315000,47410000,47320000,47415000,"chr20",656557,0,5,3,8,"chr20",1,0.0150023441162682
"22953","chr20.45810000.45815000","chr20.46245000.46250000",435000,13,8.553862e-06,45810000,46245000,45815000,46250000,"chr20",656585,0,7,5,12,"chr20",1,0.0182841068917018
"22954","chr20.45880000.45885000","chr20.46245000.46250000",365000,12,0.0001691087,45880000,46245000,45885000,46250000,"chr20",656615,0,7,6,13,"chr20",1,0.0182841068917018
"22955","chr20.34435000.34440000","chr20.34470000.34475000",35000,28,0.002611858,34435000,34470000,34440000,34475000,"chr20",656618,4,5,5,14,"chr20",1,0.0459446788560713
"22956","chr20.3115000.3120000","chr20.3310000.3315000",195000,14,0.0006739899,3115000,3310000,3120000,3315000,"chr20",656626,4,9,14,27,"chr20",1,0.0443037974683544
"22957","chr20.44650000.44655000","chr20.44710000.44715000",60000,32,8.374451e-09,44650000,44710000,44655000,44715000,"chr20",656652,3,11,7,21,"chr20",1,0.0787623066104079
"22958","chr20.5555000.5560000","chr20.5940000.5945000",385000,11,0.0006058688,5555000,5940000,5560000,5945000,"chr20",656672,3,3,7,13,"chr20",1,0.0167604313173933
"22959","chr20.49610000.49615000","chr20.49920000.49925000",310000,17,7.518858e-08,49610000,49920000,49615000,49925000,"chr20",656697,6,10,20,36,"chr20",1,0.0717299578059072
"22960","chr20.35850000.35855000","chr20.36155000.36160000",305000,13,0.0001052363,35850000,36155000,35855000,36160000,"chr20",656709,0,2,2,4,"chr20",1,0.00609470229723394
"22961","chr20.44700000.44705000","chr20.45050000.45055000",350000,10,0.004329685,44700000,45050000,44705000,45055000,"chr20",656716,0,0,1,1,"chr20",1,0.00117205813408345
"22962","chr20.38030000.38035000","chr20.38070000.38075000",40000,30,6.258212e-05,38030000,38070000,38035000,38075000,"chr20",656721,0,3,1,4,"chr20",1,0.0140646976090014
"22963","chr20.1775000.1780000","chr20.1880000.1885000",105000,53,2.90227e-33,1775000,1880000,1780000,1885000,"chr20",656798,0,1,1,2,"chr20",1,0.0124238162212846
"22964","chr20.25235000.25240000","chr20.25375000.25380000",140000,17,0.0001490835,25235000,25375000,25240000,25380000,"chr20",656829,3,6,7,16,"chr20",1,0.0318799812470699
"22965","chr20.5110000.5115000","chr20.5130000.5135000",20000,50,7.687603e-08,5110000,5130000,5115000,5135000,"chr20",656881,1,13,12,26,"chr20",1,0.152367557430849
"22966","chr20.45915000.45920000","chr20.46020000.46025000",105000,18,0.000387431,45915000,46020000,45920000,46025000,"chr20",656891,0,5,5,10,"chr20",1,0.0210970464135021
"22967","chr20.32515000.32520000","chr20.32675000.32680000",160000,15,0.0007553906,32515000,32675000,32520000,32680000,"chr20",657023,2,2,4,8,"chr20",1,0.0140646976090014
"22968","chr20.33485000.33490000","chr20.33665000.33670000",180000,15,0.0003213966,33485000,33665000,33490000,33670000,"chr20",657026,0,4,6,10,"chr20",1,0.0175808720112518
"22969","chr20.35880000.35885000","chr20.36170000.36175000",290000,11,0.002814862,35880000,36170000,35885000,36175000,"chr20",657044,4,19,12,35,"chr20",1,0.0451242381622128
"22970","chr20.2875000.2880000","chr20.2945000.2950000",70000,19,0.004489567,2875000,2945000,2880000,2950000,"chr20",657089,1,9,4,14,"chr20",1,0.0311767463666198
"22971","chr20.20835000.20840000","chr20.21230000.21235000",395000,9,0.009944612,20835000,21230000,20840000,21235000,"chr20",657120,0,5,4,9,"chr20",1,0.00949367088607595
"22972","chr20.33455000.33460000","chr20.33690000.33695000",235000,15,3.49088e-05,33455000,33690000,33460000,33695000,"chr20",657130,4,26,17,47,"chr20",1,0.0826300984528833
"22973","chr20.5535000.5540000","chr20.5805000.5810000",270000,15,1.036689e-05,5535000,5805000,5540000,5810000,"chr20",657151,4,26,23,53,"chr20",1,0.0931786216596343
"22974","chr20.48635000.48640000","chr20.48690000.48695000",55000,23,0.001208811,48635000,48690000,48640000,48695000,"chr20",657190,3,2,7,12,"chr20",1,0.0323488045007032
"22975","chr20.50295000.50300000","chr20.50400000.50405000",105000,15,0.009913256,50295000,50400000,50300000,50405000,"chr20",657214,0,1,0,1,"chr20",1,0.00175808720112518
"22976","chr20.3350000.3355000","chr20.3380000.3385000",30000,34,0.0002555851,3350000,3380000,3355000,3385000,"chr20",657222,5,18,9,32,"chr20",1,0.127519924988279
"22977","chr20.33410000.33415000","chr20.33665000.33670000",255000,11,0.005718121,33410000,33665000,33415000,33670000,"chr20",657223,0,4,6,10,"chr20",1,0.012892639474918
"22978","chr20.33565000.33570000","chr20.33665000.33670000",100000,17,0.001754789,33565000,33665000,33570000,33670000,"chr20",657237,0,4,6,10,"chr20",1,0.0199249882794187
"22979","chr20.44650000.44655000","chr20.44700000.44705000",50000,26,0.0001916593,44650000,44700000,44655000,44705000,"chr20",657367,0,2,1,3,"chr20",1,0.00914205344585091
"22980","chr20.5730000.5735000","chr20.5930000.5935000",200000,22,1.093362e-09,5730000,5930000,5735000,5935000,"chr20",657382,1,8,5,14,"chr20",1,0.0360993905297703
"22981","chr20.5610000.5615000","chr20.5750000.5755000",140000,15,0.001757301,5610000,5750000,5615000,5755000,"chr20",657401,3,15,8,26,"chr20",1,0.0457102672292546
"22982","chr20.48690000.48695000","chr20.48790000.48795000",100000,20,5.141393e-05,48690000,48790000,48695000,48795000,"chr20",657402,0,2,5,7,"chr20",1,0.0164088138771683
"22983","chr20.34190000.34195000","chr20.34470000.34475000",280000,18,3.120467e-08,34190000,34470000,34195000,34475000,"chr20",657404,4,5,5,14,"chr20",1,0.029535864978903
"22984","chr20.33650000.33655000","chr20.33675000.33680000",25000,57,1.3088e-12,33650000,33675000,33655000,33680000,"chr20",657418,5,8,6,19,"chr20",1,0.126933895921238
"22985","chr20.32540000.32545000","chr20.32570000.32575000",30000,30,0.005403861,32540000,32570000,32545000,32575000,"chr20",657431,2,3,2,7,"chr20",1,0.0246132208157525
"22986","chr20.48765000.48770000","chr20.49165000.49170000",400000,11,0.0004892615,48765000,49165000,48770000,49170000,"chr20",657438,0,2,1,3,"chr20",1,0.00386779184247539
"22987","chr20.17555000.17560000","chr20.17880000.17885000",325000,10,0.006075625,17555000,17880000,17560000,17885000,"chr20",657440,3,6,2,11,"chr20",1,0.012892639474918
"22988","chr20.17535000.17540000","chr20.17880000.17885000",345000,15,1.311098e-06,17535000,17880000,17540000,17885000,"chr20",657477,5,10,5,20,"chr20",1,0.0351617440225035
"22989","chr20.32525000.32530000","chr20.32625000.32630000",100000,17,0.001754789,32525000,32625000,32530000,32630000,"chr20",657489,2,3,1,6,"chr20",1,0.0119549929676512
"22990","chr20.46130000.46135000","chr20.46170000.46175000",40000,27,0.0009900562,46130000,46170000,46135000,46175000,"chr20",657519,0,2,0,2,"chr20",1,0.00632911392405063
"22991","chr20.5580000.5585000","chr20.5750000.5755000",170000,14,0.001739905,5580000,5750000,5585000,5755000,"chr20",657544,4,25,15,44,"chr20",1,0.0721987810595406
"22992","chr20.47280000.47285000","chr20.47500000.47505000",220000,13,0.001088438,47280000,47500000,47285000,47505000,"chr20",657628,0,4,3,7,"chr20",1,0.0106657290201594
"22993","chr20.17660000.17665000","chr20.17855000.17860000",195000,13,0.002454964,17660000,17855000,17665000,17860000,"chr20",657629,3,0,3,6,"chr20",1,0.00914205344585091
"22994","chr20.33650000.33655000","chr20.33665000.33670000",15000,42,9.262009e-05,33650000,33665000,33655000,33670000,"chr20",657645,0,4,6,10,"chr20",1,0.0492264416315049
"22995","chr20.35780000.35785000","chr20.36125000.36130000",345000,10,0.004624395,35780000,36125000,35785000,36130000,"chr20",657656,4,17,24,45,"chr20",1,0.0527426160337553
"22996","chr20.45375000.45380000","chr20.46255000.46260000",880000,12,1.028382e-07,45375000,46255000,45380000,46260000,"chr20",657695,2,3,3,8,"chr20",1,0.0112517580872011
"22997","chr20.46415000.46420000","chr20.46925000.46930000",510000,18,3.469901e-11,46415000,46925000,46420000,46930000,"chr20",657711,0,0,3,3,"chr20",1,0.00632911392405063
"22998","chr20.44735000.44740000","chr20.45055000.45060000",320000,16,3.802658e-07,44735000,45055000,44740000,45060000,"chr20",657756,0,4,2,6,"chr20",1,0.0112517580872011
"22999","chr20.48235000.48240000","chr20.48460000.48465000",225000,21,1.439958e-09,48235000,48460000,48240000,48465000,"chr20",657757,0,2,3,5,"chr20",1,0.0123066104078762
"23000","chr20.38805000.38810000","chr20.38830000.38835000",25000,37,0.0006739899,38805000,38830000,38810000,38835000,"chr20",657764,0,4,1,5,"chr20",1,0.0216830754805438
"23001","chr20.5555000.5560000","chr20.5925000.5930000",370000,10,0.003368382,5555000,5925000,5560000,5930000,"chr20",657818,2,8,6,16,"chr20",1,0.0187529301453352
"23002","chr20.10415000.10420000","chr20.10615000.10620000",200000,12,0.006934724,10415000,10615000,10420000,10620000,"chr20",657820,3,1,0,4,"chr20",1,0.00562587904360056
"23003","chr20.20845000.20850000","chr20.21180000.21185000",335000,10,0.005321539,20845000,21180000,20850000,21185000,"chr20",657835,0,2,1,3,"chr20",1,0.00351617440225035
"23004","chr20.32510000.32515000","chr20.32725000.32730000",215000,14,0.0003243528,32510000,32725000,32515000,32730000,"chr20",657839,4,2,5,11,"chr20",1,0.0180496952648851
"23005","chr20.33530000.33535000","chr20.33685000.33690000",155000,14,0.0030839,33530000,33685000,33535000,33690000,"chr20",658000,2,12,9,23,"chr20",1,0.0377402719174871
"23006","chr20.47270000.47275000","chr20.47365000.47370000",95000,27,4.156492e-09,47270000,47365000,47275000,47370000,"chr20",658009,9,42,39,90,"chr20",1,0.284810126582278
"23007","chr20.33455000.33460000","chr20.33700000.33705000",245000,11,0.00715125,33455000,33700000,33460000,33705000,"chr20",658016,5,21,27,53,"chr20",1,0.0683309892170652
"23008","chr20.20070000.20075000","chr20.20330000.20335000",260000,11,0.00519589,20070000,20330000,20075000,20335000,"chr20",658029,0,0,3,3,"chr20",1,0.00386779184247539
"23009","chr20.44420000.44425000","chr20.44485000.44490000",65000,25,1.82987e-05,44420000,44485000,44425000,44490000,"chr20",658038,4,17,6,27,"chr20",1,0.0791139240506329
"23010","chr20.1775000.1780000","chr20.1825000.1830000",50000,23,0.003079098,1775000,1825000,1780000,1830000,"chr20",658044,0,1,1,2,"chr20",1,0.00539146741678387
"23011","chr20.35445000.35450000","chr20.35510000.35515000",65000,22,0.0004999589,35445000,35510000,35450000,35515000,"chr20",658052,2,16,20,38,"chr20",1,0.0979840600093765
"23012","chr20.35900000.35905000","chr20.35995000.36000000",95000,25,9.290998e-08,35900000,35995000,35905000,3.6e+07,"chr20",658072,1,9,5,15,"chr20",1,0.0439521800281294
"23013","chr20.45855000.45860000","chr20.45880000.45885000",25000,35,0.002779009,45855000,45880000,45860000,45885000,"chr20",658092,4,7,6,17,"chr20",1,0.0697374589779653
"23014","chr20.32520000.32525000","chr20.32670000.32675000",150000,15,0.001170465,32520000,32670000,32525000,32675000,"chr20",658111,0,0,7,7,"chr20",1,0.0123066104078762
"23015","chr20.34580000.34585000","chr20.34715000.34720000",135000,30,7.987255e-14,34580000,34715000,34585000,34720000,"chr20",658115,1,16,8,25,"chr20",1,0.0879043600562588
"23016","chr20.35360000.35365000","chr20.35495000.35500000",135000,18,5.11077e-05,35360000,35495000,35365000,35500000,"chr20",658150,0,2,0,2,"chr20",1,0.00421940928270042
"23017","chr20.46375000.46380000","chr20.46395000.46400000",20000,46,3.289417e-06,46375000,46395000,46380000,46400000,"chr20",658186,0,3,1,4,"chr20",1,0.0215658696671355
"23018","chr20.3100000.3105000","chr20.3290000.3295000",190000,13,0.002874117,3100000,3290000,3105000,3295000,"chr20",658209,0,13,8,21,"chr20",1,0.0319971870604782
"23019","chr20.32515000.32520000","chr20.32725000.32730000",210000,19,1.433965e-07,32515000,32725000,32520000,32730000,"chr20",658215,3,2,8,13,"chr20",1,0.0289498359118612
"23020","chr20.4720000.4725000","chr20.4935000.4940000",215000,13,0.001265942,4720000,4935000,4725000,4940000,"chr20",658240,1,1,0,2,"chr20",1,0.00304735114861697
"23021","chr20.44420000.44425000","chr20.44600000.44605000",180000,15,0.0003213966,44420000,44600000,44425000,44605000,"chr20",658275,1,5,3,9,"chr20",1,0.0158227848101266
"23022","chr20.62180000.62185000","chr20.62615000.62620000",435000,11,0.0002925694,62180000,62615000,62185000,62620000,"chr20",658306,0,7,5,12,"chr20",1,0.0154711673699015
"23023","chr20.34575000.34580000","chr20.34715000.34720000",140000,16,0.0005295075,34575000,34715000,34580000,34720000,"chr20",658343,1,19,14,34,"chr20",1,0.0637599624941397
"23024","chr20.44755000.44760000","chr20.45050000.45055000",295000,17,1.237782e-07,44755000,45050000,44760000,45055000,"chr20",658379,1,0,1,2,"chr20",1,0.00398499765588373
"23025","chr20.62180000.62185000","chr20.62540000.62545000",360000,12,0.0001834878,62180000,62540000,62185000,62545000,"chr20",658383,0,3,2,5,"chr20",1,0.0070323488045007
"23026","chr20.5110000.5115000","chr20.5170000.5175000",60000,31,3.296223e-08,5110000,5170000,5115000,5175000,"chr20",658402,0,1,4,5,"chr20",1,0.0181669010782935
"23027","chr20.15755000.15760000","chr20.15785000.15790000",30000,31,0.002646902,15755000,15785000,15760000,15790000,"chr20",658420,1,9,2,12,"chr20",1,0.0436005625879044
"23028","chr20.33560000.33565000","chr20.33665000.33670000",105000,18,0.000387431,33560000,33665000,33565000,33670000,"chr20",658427,0,4,6,10,"chr20",1,0.0210970464135021
"23029","chr20.5125000.5130000","chr20.5170000.5175000",45000,23,0.007616206,5125000,5170000,5130000,5175000,"chr20",658434,0,1,4,5,"chr20",1,0.0134786685419597
"23030","chr20.46170000.46175000","chr20.46245000.46250000",75000,18,0.006336967,46170000,46245000,46175000,46250000,"chr20",658437,0,2,0,2,"chr20",1,0.00421940928270042
"23031","chr20.2870000.2875000","chr20.2995000.3000000",125000,17,0.0003323257,2870000,2995000,2875000,3e+06,"chr20",658441,0,1,1,2,"chr20",1,0.00398499765588373
"23032","chr20.17530000.17535000","chr20.17935000.17940000",405000,13,1.477853e-05,17530000,17935000,17535000,17940000,"chr20",658451,6,6,8,20,"chr20",1,0.0304735114861697
"23033","chr20.5750000.5755000","chr20.5870000.5875000",120000,15,0.004389974,5750000,5870000,5755000,5875000,"chr20",658481,8,11,13,32,"chr20",1,0.0562587904360056
"23034","chr20.36850000.36855000","chr20.36950000.36955000",100000,28,3.61917e-10,36850000,36950000,36855000,36955000,"chr20",658509,1,4,0,5,"chr20",1,0.0164088138771683
"23035","chr20.19825000.19830000","chr20.19845000.19850000",20000,48,5.278176e-07,19825000,19845000,19830000,19850000,"chr20",658569,0,2,3,5,"chr20",1,0.0281293952180028
"23036","chr20.20845000.20850000","chr20.21550000.21555000",705000,14,9.072414e-09,20845000,21550000,20850000,21555000,"chr20",658570,0,2,1,3,"chr20",1,0.00492264416315049
"23037","chr20.1310000.1315000","chr20.1775000.1780000",465000,12,3.196391e-05,1310000,1775000,1315000,1780000,"chr20",658593,0,1,1,2,"chr20",1,0.00281293952180028
"23038","chr20.35360000.35365000","chr20.35540000.35545000",180000,15,0.0003213966,35360000,35540000,35365000,35545000,"chr20",658615,0,2,0,2,"chr20",1,0.00351617440225035
"23039","chr20.17525000.17530000","chr20.17875000.17880000",350000,10,0.004329685,17525000,17875000,17530000,17880000,"chr20",658618,0,7,7,14,"chr20",1,0.0164088138771683
"23040","chr20.10430000.10435000","chr20.10510000.10515000",80000,18,0.003776418,10430000,10510000,10435000,10515000,"chr20",658630,1,3,4,8,"chr20",1,0.0168776371308017
"23041","chr20.4760000.4765000","chr20.4935000.4940000",175000,13,0.004764841,4760000,4935000,4765000,4940000,"chr20",658637,7,15,4,26,"chr20",1,0.0396155649320206
"23042","chr20.44600000.44605000","chr20.44710000.44715000",110000,19,7.426045e-05,44600000,44710000,44605000,44715000,"chr20",658643,1,5,3,9,"chr20",1,0.020042194092827
"23043","chr20.34355000.34360000","chr20.34470000.34475000",115000,37,1.040312e-18,34355000,34470000,34360000,34475000,"chr20",658688,4,5,5,14,"chr20",1,0.0607126113455227
"23044","chr20.3100000.3105000","chr20.3200000.3205000",100000,17,0.001754789,3100000,3200000,3105000,3205000,"chr20",658716,3,11,8,22,"chr20",1,0.0438349742147211
"23045","chr20.37445000.37450000","chr20.37470000.37475000",25000,44,1.892005e-06,37445000,37470000,37450000,37475000,"chr20",658729,2,0,1,3,"chr20",1,0.0154711673699015
"23046","chr20.45935000.45940000","chr20.45970000.45975000",35000,33,3.321509e-05,45935000,45970000,45940000,45975000,"chr20",658772,5,7,9,21,"chr20",1,0.0812236286919831
"23047","chr20.43505000.43510000","chr20.43580000.43585000",75000,20,0.000899924,43505000,43580000,43510000,43585000,"chr20",658784,6,9,15,30,"chr20",1,0.070323488045007
"23048","chr20.33645000.33650000","chr20.33685000.33690000",40000,26,0.002312805,33645000,33685000,33650000,33690000,"chr20",658789,3,8,7,18,"chr20",1,0.0548523206751055
"23049","chr20.32515000.32520000","chr20.32625000.32630000",110000,16,0.002614106,32515000,32625000,32520000,32630000,"chr20",658795,2,2,1,5,"chr20",1,0.00937646507266761
"23050","chr20.45940000.45945000","chr20.45985000.45990000",45000,23,0.007616206,45940000,45985000,45945000,45990000,"chr20",658853,7,27,31,65,"chr20",1,0.175222691045476
"23051","chr20.35540000.35545000","chr20.35560000.35565000",20000,45,7.907322e-06,35540000,35560000,35545000,35565000,"chr20",658878,3,5,6,14,"chr20",1,0.0738396624472574
"23052","chr20.350000.355000","chr20.460000.465000",110000,17,0.0008610726,350000,460000,355000,465000,"chr20",658881,8,15,8,31,"chr20",1,0.0617674636661978
"23053","chr20.17615000.17620000","chr20.17940000.17945000",325000,12,0.0003383907,17615000,17940000,17620000,17945000,"chr20",658926,1,5,1,7,"chr20",1,0.00984528832630099
"23054","chr20.33685000.33690000","chr20.33730000.33735000",45000,27,0.0002382565,33685000,33730000,33690000,33735000,"chr20",658959,2,12,9,23,"chr20",1,0.0727848101265823
"23055","chr20.45820000.45825000","chr20.46255000.46260000",435000,14,1.270119e-06,45820000,46255000,45825000,46260000,"chr20",659031,4,3,3,10,"chr20",1,0.0164088138771683
"23056","chr20.25235000.25240000","chr20.25385000.25390000",150000,14,0.003728512,25235000,25385000,25240000,25390000,"chr20",659036,5,23,21,49,"chr20",1,0.0804031879981247
"23057","chr20.5555000.5560000","chr20.6005000.6010000",450000,9,0.005443356,5555000,6005000,5560000,6010000,"chr20",659065,3,8,4,15,"chr20",1,0.0158227848101266
"23058","chr20.35815000.35820000","chr20.36150000.36155000",335000,17,3.443656e-08,35815000,36150000,35820000,36155000,"chr20",659080,0,2,3,5,"chr20",1,0.00996249413970933
"23059","chr20.3045000.3050000","chr20.3460000.3465000",415000,10,0.001867039,3045000,3460000,3050000,3465000,"chr20",659083,0,2,3,5,"chr20",1,0.00586029067041725
"23060","chr20.50325000.50330000","chr20.50400000.50405000",75000,22,9.979179e-05,50325000,50400000,50330000,50405000,"chr20",659093,3,6,5,14,"chr20",1,0.0360993905297703
"23061","chr20.19780000.19785000","chr20.19940000.19945000",160000,14,0.002575879,19780000,19940000,19785000,19945000,"chr20",659168,0,6,3,9,"chr20",1,0.0147679324894515
"23062","chr20.8015000.8020000","chr20.8645000.8650000",630000,9,0.0008610726,8015000,8645000,8020000,8650000,"chr20",659220,1,3,6,10,"chr20",1,0.0105485232067511
"23063","chr20.45830000.45835000","chr20.46245000.46250000",415000,18,4.450833e-10,45830000,46245000,45835000,46250000,"chr20",659230,0,8,6,14,"chr20",1,0.029535864978903
"23064","chr20.3765000.3770000","chr20.3795000.3800000",30000,37,1.815754e-05,3765000,3795000,3770000,3800000,"chr20",659243,0,2,1,3,"chr20",1,0.0130098452883263
"23065","chr20.46345000.46350000","chr20.46405000.46410000",60000,26,1.799659e-05,46345000,46405000,46350000,46410000,"chr20",659287,2,9,8,19,"chr20",1,0.0578996718237225
"23066","chr20.49130000.49135000","chr20.49185000.49190000",55000,33,1.154356e-08,49130000,49185000,49135000,49190000,"chr20",659311,1,11,7,19,"chr20",1,0.0734880450070323
"23067","chr20.46395000.46400000","chr20.46415000.46420000",20000,38,0.001739905,46395000,46415000,46400000,46420000,"chr20",659330,0,0,3,3,"chr20",1,0.0133614627285513
"23068","chr20.34745000.34750000","chr20.34765000.34770000",20000,37,0.003368382,34745000,34765000,34750000,34770000,"chr20",659336,3,0,5,8,"chr20",1,0.0346929207688701
"23069","chr20.35850000.35855000","chr20.35995000.36000000",145000,18,2.886475e-05,35850000,35995000,35855000,3.6e+07,"chr20",659351,1,9,5,15,"chr20",1,0.0316455696202532
"23070","chr20.33700000.33705000","chr20.33720000.33725000",20000,45,7.907322e-06,33700000,33720000,33705000,33725000,"chr20",659386,5,21,26,52,"chr20",1,0.274261603375527
"23071","chr20.48280000.48285000","chr20.48435000.48440000",155000,13,0.009425255,48280000,48435000,48285000,48440000,"chr20",659388,3,3,3,9,"chr20",1,0.0137130801687764
"23072","chr20.45960000.45965000","chr20.46125000.46130000",165000,13,0.00665912,45960000,46125000,45965000,46130000,"chr20",659458,1,1,3,5,"chr20",1,0.00761837787154243
"23073","chr20.33440000.33445000","chr20.33560000.33565000",120000,15,0.004389974,33440000,33560000,33445000,33565000,"chr20",659459,7,24,21,52,"chr20",1,0.0914205344585091
"23074","chr20.2000000.2005000","chr20.2135000.2140000",135000,14,0.006636427,2e+06,2135000,2005000,2140000,"chr20",659477,3,4,6,13,"chr20",1,0.0213314580403188
"23075","chr20.6140000.6145000","chr20.6800000.6805000",660000,8,0.003518434,6140000,6800000,6145000,6805000,"chr20",659491,0,1,2,3,"chr20",1,0.00281293952180028
"23076","chr20.25235000.25240000","chr20.25395000.25400000",160000,19,2.739215e-06,25235000,25395000,25240000,25400000,"chr20",659492,0,3,3,6,"chr20",1,0.0133614627285513
"23077","chr20.4895000.4900000","chr20.4915000.4920000",20000,43,4.195558e-05,4895000,4915000,4900000,4920000,"chr20",659509,0,2,0,2,"chr20",1,0.0100796999531177
"23078","chr20.2870000.2875000","chr20.3010000.3015000",140000,15,0.001757301,2870000,3010000,2875000,3015000,"chr20",659570,0,1,1,2,"chr20",1,0.00351617440225035
"23079","chr20.3200000.3205000","chr20.3290000.3295000",90000,22,1.248814e-05,3200000,3290000,3205000,3295000,"chr20",659598,0,11,16,27,"chr20",1,0.069620253164557
"23080","chr20.35435000.35440000","chr20.35500000.35505000",65000,21,0.001362274,35435000,35500000,35440000,35505000,"chr20",659606,3,3,5,11,"chr20",1,0.0270745428973277
"23081","chr20.35995000.36000000","chr20.36015000.36020000",20000,41,0.0002028225,35995000,36015000,3.6e+07,36020000,"chr20",659642,1,5,4,10,"chr20",1,0.0480543834974215
"23082","chr20.45910000.45915000","chr20.46245000.46250000",335000,12,0.000282803,45910000,46245000,45915000,46250000,"chr20",659650,0,8,6,14,"chr20",1,0.019690576652602
"23083","chr20.49610000.49615000","chr20.50240000.50245000",630000,10,0.0001404722,49610000,50240000,49615000,50245000,"chr20",659659,4,10,11,25,"chr20",1,0.0293014533520863
"23084","chr20.50305000.50310000","chr20.50400000.50405000",95000,17,0.002638389,50305000,50400000,50310000,50405000,"chr20",659663,0,3,1,4,"chr20",1,0.00796999531176746
"23085","chr20.32540000.32545000","chr20.32560000.32565000",20000,39,0.0008736849,32540000,32560000,32545000,32565000,"chr20",659699,3,1,4,8,"chr20",1,0.0365682137834037
"23086","chr20.46415000.46420000","chr20.46580000.46585000",165000,16,0.0001630582,46415000,46580000,46420000,46585000,"chr20",659708,0,0,3,3,"chr20",1,0.00562587904360056
"23087","chr20.37445000.37450000","chr20.37500000.37505000",55000,36,1.697806e-10,37445000,37500000,37450000,37505000,"chr20",659728,0,0,2,2,"chr20",1,0.00843881856540084
"23088","chr20.25335000.25340000","chr20.25355000.25360000",20000,37,0.003368382,25335000,25355000,25340000,25360000,"chr20",659751,1,1,1,3,"chr20",1,0.0130098452883263
"23089","chr20.33490000.33495000","chr20.33700000.33705000",210000,17,4.189671e-06,33490000,33700000,33495000,33705000,"chr20",659795,5,21,27,53,"chr20",1,0.105602437880919
"23090","chr20.35815000.35820000","chr20.36155000.36160000",340000,22,5.718477e-13,35815000,36155000,35820000,36160000,"chr20",659796,0,2,2,4,"chr20",1,0.0103141115799344
"23091","chr20.34330000.34335000","chr20.34470000.34475000",140000,59,3.516609e-44,34330000,34470000,34335000,34475000,"chr20",659830,4,5,5,14,"chr20",1,0.096812001875293
"23092","chr20.35850000.35855000","chr20.36125000.36130000",275000,13,0.0002195022,35850000,36125000,35855000,36130000,"chr20",659857,4,17,20,41,"chr20",1,0.0624706985466479
"23093","chr20.34310000.34315000","chr20.34435000.34440000",125000,17,0.0003323257,34310000,34435000,34315000,34440000,"chr20",659899,6,9,5,20,"chr20",1,0.0398499765588373
"23094","chr20.1465000.1470000","chr20.1775000.1780000",310000,10,0.007495908,1465000,1775000,1470000,1780000,"chr20",659902,0,1,1,2,"chr20",1,0.0023441162681669
"23095","chr20.34265000.34270000","chr20.34470000.34475000",205000,21,5.072808e-09,34265000,34470000,34270000,34475000,"chr20",659943,4,5,5,14,"chr20",1,0.0344585091420534
"23096","chr20.8015000.8020000","chr20.8700000.8705000",685000,16,9.308533e-11,8015000,8700000,8020000,8705000,"chr20",659962,0,2,0,2,"chr20",1,0.00375058602906704
"23097","chr20.3100000.3105000","chr20.3160000.3165000",60000,20,0.007320993,3100000,3160000,3105000,3165000,"chr20",659990,7,13,8,28,"chr20",1,0.0656352555086732
"23098","chr20.5100000.5105000","chr20.5170000.5175000",70000,34,1.698503e-11,5100000,5170000,5105000,5175000,"chr20",659999,0,1,4,5,"chr20",1,0.0199249882794187
"23099","chr20.45935000.45940000","chr20.46125000.46130000",190000,12,0.009329695,45935000,46125000,45940000,46130000,"chr20",660016,1,1,3,5,"chr20",1,0.0070323488045007
"23100","chr20.17660000.17665000","chr20.17875000.17880000",215000,16,1.654577e-05,17660000,17875000,17665000,17880000,"chr20",660031,3,2,4,9,"chr20",1,0.0168776371308017
"23101","chr20.16800000.16805000","chr20.17225000.17230000",425000,9,0.007101225,16800000,17225000,16805000,17230000,"chr20",660060,0,1,1,2,"chr20",1,0.00210970464135021
"23102","chr20.3310000.3315000","chr20.3460000.3465000",150000,14,0.003728512,3310000,3460000,3315000,3465000,"chr20",660077,4,9,14,27,"chr20",1,0.0443037974683544
"23103","chr20.48795000.48800000","chr20.49045000.49050000",250000,11,0.00639397,48795000,49045000,48800000,49050000,"chr20",660081,1,4,4,9,"chr20",1,0.0116033755274262
"23104","chr20.33455000.33460000","chr20.33650000.33655000",195000,12,0.007957573,33455000,33650000,33460000,33655000,"chr20",660118,6,8,13,27,"chr20",1,0.0379746835443038
"23105","chr20.48765000.48770000","chr20.49185000.49190000",420000,13,1.127881e-05,48765000,49185000,48770000,49190000,"chr20",660171,0,2,1,3,"chr20",1,0.00457102672292546
"23106","chr20.34360000.34365000","chr20.34435000.34440000",75000,22,9.979179e-05,34360000,34435000,34365000,34440000,"chr20",660216,7,9,5,21,"chr20",1,0.0541490857946554
"23107","chr20.33465000.33470000","chr20.33530000.33535000",65000,20,0.003473761,33465000,33530000,33470000,33535000,"chr20",660217,2,20,18,40,"chr20",1,0.093764650726676
"23108","chr20.35845000.35850000","chr20.36170000.36175000",325000,10,0.006075625,35845000,36170000,35850000,36175000,"chr20",660238,3,12,9,24,"chr20",1,0.0281293952180028
"23109","chr20.37170000.37175000","chr20.37195000.37200000",25000,44,1.892005e-06,37170000,37195000,37175000,37200000,"chr20",660244,3,12,10,25,"chr20",1,0.12892639474918
"23110","chr20.34065000.34070000","chr20.34470000.34475000",405000,9,0.008871052,34065000,34470000,34070000,34475000,"chr20",660304,4,5,5,14,"chr20",1,0.0147679324894515
"23111","chr20.47325000.47330000","chr20.47410000.47415000",85000,19,0.0008163845,47325000,47410000,47330000,47415000,"chr20",660356,7,30,31,68,"chr20",1,0.151429910923582
"23112","chr20.47325000.47330000","chr20.47500000.47505000",175000,13,0.004764841,47325000,47500000,47330000,47505000,"chr20",660375,1,9,4,14,"chr20",1,0.0213314580403188
"23113","chr20.45820000.45825000","chr20.46215000.46220000",395000,11,0.0005228272,45820000,46215000,45825000,46220000,"chr20",660384,0,3,8,11,"chr20",1,0.0141819034224098
"23114","chr20.33645000.33650000","chr20.33665000.33670000",20000,58,1.491106e-11,33645000,33665000,33650000,33670000,"chr20",660400,0,4,6,10,"chr20",1,0.0679793717768401
"23115","chr20.19770000.19775000","chr20.19940000.19945000",170000,16,0.0001287352,19770000,19940000,19775000,19945000,"chr20",660409,0,1,1,2,"chr20",1,0.00375058602906704
"23116","chr20.48245000.48250000","chr20.48445000.48450000",200000,12,0.006934724,48245000,48445000,48250000,48450000,"chr20",660436,1,4,4,9,"chr20",1,0.0126582278481013
"23117","chr20.24965000.24970000","chr20.25040000.25045000",75000,19,0.002482901,24965000,25040000,24970000,25045000,"chr20",660442,0,1,0,1,"chr20",1,0.00222691045475856
"23118","chr20.5100000.5105000","chr20.5210000.5215000",110000,16,0.002614106,5100000,5210000,5105000,5215000,"chr20",660483,2,5,2,9,"chr20",1,0.0168776371308017
"23119","chr20.46405000.46410000","chr20.47235000.47240000",830000,15,9.916347e-11,46405000,47235000,46410000,47240000,"chr20",660484,0,6,2,8,"chr20",1,0.0140646976090014
"23120","chr20.31585000.31590000","chr20.31880000.31885000",295000,12,0.000610635,31585000,31880000,31590000,31885000,"chr20",660500,8,11,12,31,"chr20",1,0.0436005625879044
"23121","chr20.17685000.17690000","chr20.17880000.17885000",195000,12,0.007957573,17685000,17880000,17690000,17885000,"chr20",660565,2,4,2,8,"chr20",1,0.0112517580872011
"23122","chr20.20070000.20075000","chr20.20565000.20570000",495000,14,3.855447e-07,20070000,20565000,20075000,20570000,"chr20",660582,0,0,3,3,"chr20",1,0.00492264416315049
"23123","chr20.49610000.49615000","chr20.49950000.49955000",340000,10,0.004966881,49610000,49950000,49615000,49955000,"chr20",660622,6,8,10,24,"chr20",1,0.0281293952180028
"23124","chr20.5130000.5135000","chr20.5160000.5165000",30000,41,3.488186e-07,5130000,5160000,5135000,5165000,"chr20",660640,5,12,15,32,"chr20",1,0.153774027191749
"23125","chr20.34190000.34195000","chr20.34265000.34270000",75000,20,0.000899924,34190000,34265000,34195000,34270000,"chr20",660658,5,11,7,23,"chr20",1,0.0539146741678387
"23126","chr20.34330000.34335000","chr20.34355000.34360000",25000,151,2.365347e-87,34330000,34355000,34335000,34360000,"chr20",660698,7,25,20,52,"chr20",1,0.920300046882325
"23127","chr20.33465000.33470000","chr20.33665000.33670000",200000,12,0.006934724,33465000,33665000,33470000,33670000,"chr20",660713,0,4,6,10,"chr20",1,0.0140646976090014
"23128","chr20.45820000.45825000","chr20.46250000.46255000",430000,16,2.362701e-08,45820000,46250000,45825000,46255000,"chr20",660815,0,2,2,4,"chr20",1,0.00750117205813408
"23129","chr20.35300000.35305000","chr20.35510000.35515000",210000,15,9.262009e-05,35300000,35510000,35305000,35515000,"chr20",660826,2,8,6,16,"chr20",1,0.0281293952180028
"23130","chr20.34360000.34365000","chr20.34535000.34540000",175000,14,0.001422586,34360000,34535000,34365000,34540000,"chr20",660867,7,15,8,30,"chr20",1,0.0492264416315049
"23131","chr20.2870000.2875000","chr20.2945000.2950000",75000,22,9.979179e-05,2870000,2945000,2875000,2950000,"chr20",660910,0,1,1,2,"chr20",1,0.00515705578996718
"23132","chr20.5535000.5540000","chr20.5730000.5735000",195000,14,0.0006739899,5535000,5730000,5540000,5735000,"chr20",660926,3,8,16,27,"chr20",1,0.0443037974683544
"23133","chr20.24965000.24970000","chr20.25175000.25180000",210000,12,0.005224406,24965000,25175000,24970000,25180000,"chr20",660933,0,2,0,2,"chr20",1,0.00281293952180028
"23134","chr20.5540000.5545000","chr20.5730000.5735000",190000,16,5.066773e-05,5540000,5730000,5545000,5735000,"chr20",660955,3,8,16,27,"chr20",1,0.0506329113924051
"23135","chr20.4945000.4950000","chr20.5070000.5075000",125000,19,2.424599e-05,4945000,5070000,4950000,5075000,"chr20",660959,1,4,5,10,"chr20",1,0.0222691045475856
"23136","chr20.5535000.5540000","chr20.5580000.5585000",45000,23,0.007616206,5535000,5580000,5540000,5585000,"chr20",660986,4,25,15,44,"chr20",1,0.118612283169245
"23137","chr20.45960000.45965000","chr20.46245000.46250000",285000,11,0.003092193,45960000,46245000,45965000,46250000,"chr20",660999,0,8,6,14,"chr20",1,0.0180496952648851
"23138","chr20.45910000.45915000","chr20.45960000.45965000",50000,23,0.003079098,45910000,45960000,45915000,45965000,"chr20",661012,2,10,16,28,"chr20",1,0.0754805438349742
"23139","chr20.44735000.44740000","chr20.45050000.45055000",315000,12,0.0004158209,44735000,45050000,44740000,45055000,"chr20",661023,4,0,2,6,"chr20",1,0.00843881856540084
"23140","chr20.45855000.45860000","chr20.46170000.46175000",315000,12,0.0004158209,45855000,46170000,45860000,46175000,"chr20",661025,1,2,0,3,"chr20",1,0.00421940928270042
"23141","chr20.44460000.44465000","chr20.44485000.44490000",25000,47,1.028382e-07,44460000,44485000,44465000,44490000,"chr20",661038,7,17,6,30,"chr20",1,0.165260196905767
"23142","chr20.48795000.48800000","chr20.49165000.49170000",370000,12,0.0001557801,48795000,49165000,48800000,49170000,"chr20",661046,1,4,4,9,"chr20",1,0.0126582278481013
"23143","chr20.34110000.34115000","chr20.34520000.34525000",410000,11,0.0004254974,34110000,34520000,34115000,34525000,"chr20",661080,5,6,10,21,"chr20",1,0.0270745428973277
"23144","chr20.5540000.5545000","chr20.5910000.5915000",370000,10,0.003368382,5540000,5910000,5545000,5915000,"chr20",661112,0,2,1,3,"chr20",1,0.00351617440225035
"23145","chr20.33420000.33425000","chr20.33730000.33735000",310000,12,0.0004537566,33420000,33730000,33425000,33735000,"chr20",661132,2,23,36,61,"chr20",1,0.0857946554149086
"23146","chr20.35390000.35395000","chr20.35505000.35510000",115000,16,0.001920685,35390000,35505000,35395000,35510000,"chr20",661155,0,6,2,8,"chr20",1,0.0150023441162682
"23147","chr20.48765000.48770000","chr20.49340000.49345000",575000,8,0.007101225,48765000,49340000,48770000,49345000,"chr20",661159,0,2,1,3,"chr20",1,0.00281293952180028
"23148","chr20.45935000.45940000","chr20.45960000.45965000",25000,40,6.445395e-05,45935000,45960000,45940000,45965000,"chr20",661160,2,7,9,18,"chr20",1,0.0843881856540084
"23149","chr20.45790000.45795000","chr20.46250000.46255000",460000,9,0.004908147,45790000,46250000,45795000,46255000,"chr20",661173,0,2,2,4,"chr20",1,0.00421940928270042
"23150","chr20.32725000.32730000","chr20.32760000.32765000",35000,30,0.0005042418,32725000,32760000,32730000,32765000,"chr20",661188,0,3,2,5,"chr20",1,0.0175808720112518
"23151","chr20.35595000.35600000","chr20.35635000.35640000",40000,26,0.002312805,35595000,35635000,35600000,35640000,"chr20",661213,2,5,4,11,"chr20",1,0.0335208626347867
"23152","chr20.17530000.17535000","chr20.17895000.17900000",365000,10,0.003533016,17530000,17895000,17535000,17900000,"chr20",661215,4,6,8,18,"chr20",1,0.0210970464135021
"23153","chr20.5500000.5505000","chr20.5785000.5790000",285000,13,0.0001708339,5500000,5785000,5505000,5790000,"chr20",661249,1,1,4,6,"chr20",1,0.00914205344585091
"23154","chr20.32455000.32460000","chr20.32675000.32680000",220000,14,0.0002704971,32455000,32675000,32460000,32680000,"chr20",661280,2,8,4,14,"chr20",1,0.0229723394280356
"23155","chr20.35825000.35830000","chr20.35995000.36000000",170000,13,0.005627825,35825000,35995000,35830000,3.6e+07,"chr20",661281,1,9,5,15,"chr20",1,0.0228551336146273
"23156","chr20.4600000.4605000","chr20.4685000.4690000",85000,17,0.006202879,4600000,4685000,4605000,4690000,"chr20",661311,2,1,1,4,"chr20",1,0.00796999531176746
"23157","chr20.19740000.19745000","chr20.19935000.19940000",195000,12,0.007957573,19740000,19935000,19745000,19940000,"chr20",661329,0,1,1,2,"chr20",1,0.00281293952180028
"23158","chr20.265000.270000","chr20.295000.300000",30000,31,0.002646902,265000,295000,270000,3e+05,"chr20",661375,0,0,3,3,"chr20",1,0.0109001406469761
"23159","chr20.36700000.36705000","chr20.36950000.36955000",250000,18,1.136865e-07,36700000,36950000,36705000,36955000,"chr20",661420,3,18,17,38,"chr20",1,0.080168776371308
"23160","chr20.33490000.33495000","chr20.33690000.33695000",200000,12,0.006934724,33490000,33690000,33495000,33695000,"chr20",661446,4,26,17,47,"chr20",1,0.0661040787623066
"23161","chr20.49975000.49980000","chr20.50585000.50590000",610000,9,0.001035026,49975000,50585000,49980000,50590000,"chr20",661452,1,3,3,7,"chr20",1,0.00738396624472574
"23162","chr20.5590000.5595000","chr20.5730000.5735000",140000,47,1.190143e-30,5590000,5730000,5595000,5735000,"chr20",661475,0,3,6,9,"chr20",1,0.04957805907173
"23163","chr20.5730000.5735000","chr20.5935000.5940000",205000,13,0.001741295,5730000,5935000,5735000,5940000,"chr20",661482,3,8,16,27,"chr20",1,0.0411392405063291
"23164","chr20.35820000.35825000","chr20.36155000.36160000",335000,45,2.388038e-40,35820000,36155000,35825000,36160000,"chr20",661511,0,2,2,4,"chr20",1,0.0210970464135021
"23165","chr20.47270000.47275000","chr20.47500000.47505000",230000,19,4.746866e-08,47270000,47500000,47275000,47505000,"chr20",661524,1,9,4,14,"chr20",1,0.0311767463666198
"23166","chr20.20405000.20410000","chr20.20530000.20535000",125000,20,6.001317e-06,20405000,20530000,20410000,20535000,"chr20",661530,0,0,1,1,"chr20",1,0.0023441162681669
"23167","chr20.34335000.34340000","chr20.34470000.34475000",135000,23,2.641316e-08,34335000,34470000,34340000,34475000,"chr20",661619,4,5,5,14,"chr20",1,0.0377402719174871
"23168","chr20.34330000.34335000","chr20.34360000.34365000",30000,70,1.931174e-24,34330000,34360000,34335000,34365000,"chr20",661637,7,25,25,57,"chr20",1,0.467651195499297
"23169","chr20.35235000.35240000","chr20.35495000.35500000",260000,13,0.0003300426,35235000,35495000,35240000,35500000,"chr20",661652,0,6,2,8,"chr20",1,0.0121894045944679
"23170","chr20.25320000.25325000","chr20.25375000.25380000",55000,35,7.176679e-10,25320000,25375000,25325000,25380000,"chr20",661660,1,6,4,11,"chr20",1,0.0451242381622128
"23171","chr20.5590000.5595000","chr20.5765000.5770000",175000,16,0.0001001787,5590000,5765000,5595000,5770000,"chr20",661663,0,3,6,9,"chr20",1,0.0168776371308017
"23172","chr20.46410000.46415000","chr20.47235000.47240000",825000,17,4.519043e-13,46410000,47235000,46415000,47240000,"chr20",661688,0,5,2,7,"chr20",1,0.0139474917955931
"23173","chr20.44755000.44760000","chr20.45320000.45325000",565000,8,0.007705082,44755000,45320000,44760000,45325000,"chr20",661694,1,3,1,5,"chr20",1,0.0046882325363338
"23174","chr21.17450000.17455000","chr21.17845000.17850000",395000,11,0.0003712771,17450000,17845000,17455000,17850000,"chr21",661726,0,6,4,10,"chr21",1,0.012892639474918
"23175","chr21.17460000.17465000","chr21.17545000.17550000",85000,17,0.003209563,17460000,17545000,17465000,17550000,"chr21",661739,3,13,6,22,"chr21",1,0.0438349742147211
"23176","chr21.15835000.15840000","chr21.16100000.16105000",265000,14,3.698384e-05,15835000,16100000,15840000,16105000,"chr21",661748,0,1,1,2,"chr21",1,0.00328176277543366
"23177","chr21.34580000.34585000","chr21.34600000.34605000",20000,35,0.003940045,34580000,34600000,34585000,34605000,"chr21",661761,0,1,1,2,"chr21",1,0.00820440693858415
"23178","chr21.32610000.32615000","chr21.32975000.32980000",365000,10,0.002629513,32610000,32975000,32615000,32980000,"chr21",661846,0,3,2,5,"chr21",1,0.00586029067041725
"23179","chr21.17450000.17455000","chr21.17865000.17870000",415000,9,0.006188441,17450000,17865000,17455000,17870000,"chr21",661855,1,4,0,5,"chr21",1,0.00527426160337553
"23180","chr21.44535000.44540000","chr21.45055000.45060000",520000,8,0.009899097,44535000,45055000,44540000,45060000,"chr21",661890,1,4,5,10,"chr21",1,0.00937646507266761
"23181","chr21.32485000.32490000","chr21.32975000.32980000",490000,23,8.08523e-17,32485000,32975000,32490000,32980000,"chr21",661920,0,3,2,5,"chr21",1,0.0134786685419597
"23182","chr21.34590000.34595000","chr21.34700000.34705000",110000,25,3.16807e-09,34590000,34700000,34595000,34705000,"chr21",661954,0,0,1,1,"chr21",1,0.00293014533520863
"23183","chr21.28145000.28150000","chr21.29070000.29075000",925000,12,8.392754e-08,28145000,29070000,28150000,29075000,"chr21",661996,2,5,4,11,"chr21",1,0.0154711673699015
"23184","chr21.15855000.15860000","chr21.16650000.16655000",795000,7,0.008233319,15855000,16650000,15860000,16655000,"chr21",661998,1,1,3,5,"chr21",1,0.00410220346929208
"23185","chr21.17450000.17455000","chr21.17675000.17680000",225000,34,5.637187e-23,17450000,17675000,17455000,17680000,"chr21",662006,1,2,4,7,"chr21",1,0.0278949835911861
"23186","chr21.36915000.36920000","chr21.36935000.36940000",20000,37,0.00101296,36915000,36935000,36920000,36940000,"chr21",662031,3,0,3,6,"chr21",1,0.0260196905766526
"23187","chr21.32480000.32485000","chr21.32515000.32520000",35000,37,9.959739e-08,32480000,32515000,32485000,32520000,"chr21",662105,3,10,6,19,"chr21",1,0.0823956868260666
"23188","chr21.33360000.33365000","chr21.33380000.33385000",20000,36,0.002052153,33360000,33380000,33365000,33385000,"chr21",662143,6,24,11,41,"chr21",1,0.172995780590717
"23189","chr21.32480000.32485000","chr21.32955000.32960000",475000,13,2.814231e-06,32480000,32955000,32485000,32960000,"chr21",662150,4,2,5,11,"chr21",1,0.0167604313173933
"23190","chr21.17455000.17460000","chr21.17660000.17665000",205000,16,1.382779e-05,17455000,17660000,17460000,17665000,"chr21",662313,0,7,7,14,"chr21",1,0.0262541022034693
"23191","chr21.17400000.17405000","chr21.17885000.17890000",485000,11,0.0001078545,17400000,17885000,17405000,17890000,"chr21",662319,1,1,1,3,"chr21",1,0.00386779184247539
"23192","chr21.17455000.17460000","chr21.17825000.17830000",370000,14,2.771903e-06,17455000,17825000,17460000,17830000,"chr21",662416,3,7,7,17,"chr21",1,0.0278949835911861
"23193","chr21.17460000.17465000","chr21.17690000.17695000",230000,15,2.42141e-05,17460000,17690000,17465000,17695000,"chr21",662442,2,10,12,24,"chr21",1,0.0421940928270042
"23194","chr21.17610000.17615000","chr21.17675000.17680000",65000,20,0.001567407,17610000,17675000,17615000,17680000,"chr21",662549,1,1,0,2,"chr21",1,0.0046882325363338
"23195","chr21.46355000.46360000","chr21.46555000.46560000",200000,17,3.391614e-06,46355000,46555000,46360000,46560000,"chr21",662589,2,3,3,8,"chr21",1,0.0159399906235349
"23196","chr21.44335000.44340000","chr21.45075000.45080000",740000,8,0.002159317,44335000,45075000,44340000,45080000,"chr21",662677,0,1,2,3,"chr21",1,0.00281293952180028
"23197","chr21.17845000.17850000","chr21.17865000.17870000",20000,54,9.710716e-11,17845000,17865000,17850000,17870000,"chr21",662746,0,4,0,4,"chr21",1,0.0253164556962025
"23198","chr21.44345000.44350000","chr21.45070000.45075000",725000,8,0.002373657,44345000,45070000,44350000,45075000,"chr21",662777,3,10,14,27,"chr21",1,0.0253164556962025
"23199","chr21.44300000.44305000","chr21.45080000.45085000",780000,10,3.523279e-05,44300000,45080000,44305000,45085000,"chr21",662800,1,1,2,4,"chr21",1,0.0046882325363338
"23200","chr21.32480000.32485000","chr21.32975000.32980000",495000,22,1.005197e-15,32480000,32975000,32485000,32980000,"chr21",662892,0,3,2,5,"chr21",1,0.012892639474918
"23201","chr21.17450000.17455000","chr21.17975000.17980000",525000,8,0.009564655,17450000,17975000,17455000,17980000,"chr21",662961,1,18,12,31,"chr21",1,0.0290670417252696
"23202","chr21.15855000.15860000","chr21.16100000.16105000",245000,11,0.005081672,15855000,16100000,15860000,16105000,"chr21",662964,0,1,1,2,"chr21",1,0.00257852789498359
"23203","chr21.34700000.34705000","chr21.34910000.34915000",210000,15,5.337691e-05,34700000,34910000,34705000,34915000,"chr21",662966,0,0,8,8,"chr21",1,0.0140646976090014
"23204","chr21.31395000.31400000","chr21.31515000.31520000",120000,14,0.007295918,31395000,31515000,31400000,31520000,"chr21",662985,0,4,4,8,"chr21",1,0.0131270511017346
"23205","chr21.17845000.17850000","chr21.17870000.17875000",25000,50,3.433611e-10,17845000,17870000,17850000,17875000,"chr21",662987,0,5,4,9,"chr21",1,0.0527426160337553
"23206","chr21.32795000.32800000","chr21.32825000.32830000",30000,35,2.481842e-05,32795000,32825000,32800000,32830000,"chr21",662997,2,6,9,17,"chr21",1,0.0697374589779653
"23207","chr21.34200000.34205000","chr21.34700000.34705000",500000,11,8.77359e-05,34200000,34700000,34205000,34705000,"chr21",663027,0,0,5,5,"chr21",1,0.00644631973745898
"23208","chr21.28330000.28335000","chr21.29070000.29075000",740000,8,0.002159317,28330000,29070000,28335000,29075000,"chr21",663061,2,3,6,11,"chr21",1,0.0103141115799344
"23209","chr21.27160000.27165000","chr21.27565000.27570000",405000,14,1.370708e-06,27160000,27565000,27165000,27570000,"chr21",663101,0,2,1,3,"chr21",1,0.00492264416315049
"23210","chr21.33230000.33235000","chr21.33585000.33590000",355000,10,0.003013356,33230000,33585000,33235000,33590000,"chr21",663178,1,3,1,5,"chr21",1,0.00586029067041725
"23211","chr21.17455000.17460000","chr21.17670000.17675000",215000,23,1.814632e-11,17455000,17670000,17460000,17675000,"chr21",663191,2,6,5,13,"chr21",1,0.0350445382090952
"23212","chr21.34600000.34605000","chr21.34700000.34705000",100000,18,0.0002670046,34600000,34700000,34605000,34705000,"chr21",663257,0,0,2,2,"chr21",1,0.00421940928270042
"23213","chr21.40900000.40905000","chr21.41065000.41070000",165000,17,1.993507e-05,40900000,41065000,40905000,41070000,"chr21",663327,1,6,7,14,"chr21",1,0.0278949835911861
"23214","chr21.44335000.44340000","chr21.45070000.45075000",735000,9,0.0003672933,44335000,45070000,44340000,45075000,"chr21",663419,0,2,2,4,"chr21",1,0.00421940928270042
"23215","chr21.33115000.33120000","chr21.33750000.33755000",635000,10,0.0001263136,33115000,33750000,33120000,33755000,"chr21",663468,1,5,4,10,"chr21",1,0.0117205813408345
"23216","chr21.34590000.34595000","chr21.34745000.34750000",155000,20,3.101413e-07,34590000,34745000,34595000,34750000,"chr21",663543,0,3,1,4,"chr21",1,0.00937646507266761
"23217","chr21.45555000.45560000","chr21.45720000.45725000",165000,25,1.642199e-11,45555000,45720000,45560000,45725000,"chr21",663548,0,3,1,4,"chr21",1,0.0117205813408345
"23218","chr21.17455000.17460000","chr21.17900000.17905000",445000,11,0.0001832577,17455000,17900000,17460000,17905000,"chr21",663582,5,2,7,14,"chr21",1,0.0180496952648851
"23219","chr21.17870000.17875000","chr21.17900000.17905000",30000,29,0.003919425,17870000,17900000,17875000,17905000,"chr21",663592,2,2,6,10,"chr21",1,0.0339896858884201
"23220","chr21.34200000.34205000","chr21.34780000.34785000",580000,9,0.001270617,34200000,34780000,34205000,34785000,"chr21",663675,0,3,3,6,"chr21",1,0.00632911392405063
"23221","chr21.17825000.17830000","chr21.17885000.17890000",60000,21,0.001290864,17825000,17885000,17830000,17890000,"chr21",663684,1,1,1,3,"chr21",1,0.00738396624472574
"23222","chr21.17460000.17465000","chr21.17660000.17665000",200000,12,0.004703761,17460000,17660000,17465000,17665000,"chr21",663718,0,7,8,15,"chr21",1,0.0210970464135021
"23223","chr21.36335000.36340000","chr21.37220000.37225000",885000,8,0.0008470832,36335000,37220000,36340000,37225000,"chr21",663735,2,9,11,22,"chr21",1,0.0206282231598687
"23224","chr21.34590000.34595000","chr21.34615000.34620000",25000,34,0.00165088,34590000,34615000,34595000,34620000,"chr21",663780,0,3,1,4,"chr21",1,0.0159399906235349
"23225","chr21.32515000.32520000","chr21.32825000.32830000",310000,10,0.005538319,32515000,32825000,32520000,32830000,"chr21",663851,2,6,9,17,"chr21",1,0.0199249882794187
"23226","chr21.17540000.17545000","chr21.17675000.17680000",135000,19,5.358011e-06,17540000,17675000,17545000,17680000,"chr21",663853,1,1,4,6,"chr21",1,0.0133614627285513
"23227","chr21.15855000.15860000","chr21.16580000.16585000",725000,8,0.002373657,15855000,16580000,15860000,16585000,"chr21",663863,0,4,3,7,"chr21",1,0.00656352555086732
"23228","chr21.17455000.17460000","chr21.17885000.17890000",430000,17,1.427046e-09,17455000,17885000,17460000,17890000,"chr21",663869,1,1,1,3,"chr21",1,0.0059774964838256
"23229","chr21.32485000.32490000","chr21.32530000.32535000",45000,32,2.545866e-07,32485000,32530000,32490000,32535000,"chr21",663964,1,0,1,2,"chr21",1,0.00750117205813408
"23230","chr21.44350000.44355000","chr21.44535000.44540000",185000,13,0.002194963,44350000,44535000,44355000,44540000,"chr21",663971,0,2,1,3,"chr21",1,0.00457102672292546
"23231","chr21.37860000.37865000","chr21.38395000.38400000",535000,8,0.008781585,37860000,38395000,37865000,38400000,"chr21",663999,0,3,1,4,"chr21",1,0.00375058602906704
"23232","chr21.32520000.32525000","chr21.32975000.32980000",455000,11,0.000160278,32520000,32975000,32525000,32980000,"chr21",664031,0,3,2,5,"chr21",1,0.00644631973745898
"23233","chr21.32600000.32605000","chr21.32975000.32980000",375000,9,0.009357206,32600000,32975000,32605000,32980000,"chr21",664090,0,0,2,2,"chr21",1,0.00210970464135021
"23234","chr21.46295000.46300000","chr21.46355000.46360000",60000,19,0.008040835,46295000,46355000,46300000,46360000,"chr21",664096,1,12,8,21,"chr21",1,0.0467651195499297
"23235","chr21.27305000.27310000","chr21.27565000.27570000",260000,11,0.003684297,27305000,27565000,27310000,27570000,"chr21",664204,0,2,1,3,"chr21",1,0.00386779184247539
"23236","chr21.34265000.34270000","chr21.34590000.34595000",325000,10,0.004415526,34265000,34590000,34270000,34595000,"chr21",664219,0,0,1,1,"chr21",1,0.00117205813408345
"23237","chr21.42145000.42150000","chr21.42190000.42195000",45000,29,8.870672e-06,42145000,42190000,42150000,42195000,"chr21",664267,0,1,2,3,"chr21",1,0.010196905766526
"23238","chr21.15835000.15840000","chr21.15855000.15860000",20000,44,3.193156e-06,15835000,15855000,15840000,15860000,"chr21",664270,0,3,1,4,"chr21",1,0.0206282231598687
"23239","chr21.42095000.42100000","chr21.42115000.42120000",20000,52,9.519026e-10,42095000,42115000,42100000,42120000,"chr21",664292,1,4,3,8,"chr21",1,0.0487576183778715
"23240","chr21.17825000.17830000","chr21.17845000.17850000",20000,39,0.0002220917,17825000,17845000,17830000,17850000,"chr21",664337,0,6,4,10,"chr21",1,0.0457102672292546
"23241","chr21.34575000.34580000","chr21.34745000.34750000",170000,21,2.073481e-08,34575000,34745000,34580000,34750000,"chr21",664397,4,9,9,22,"chr21",1,0.0541490857946554
"23242","chr21.34590000.34595000","chr21.34715000.34720000",125000,22,1.002543e-07,34590000,34715000,34595000,34720000,"chr21",664416,0,3,1,4,"chr21",1,0.0103141115799344
"23243","chr21.17865000.17870000","chr21.17885000.17890000",20000,43,7.980444e-06,17865000,17885000,17870000,17890000,"chr21",664430,1,1,0,2,"chr21",1,0.0100796999531177
"23244","chr21.17455000.17460000","chr21.17610000.17615000",155000,15,0.0005295642,17455000,17610000,17460000,17615000,"chr21",664548,1,1,0,2,"chr21",1,0.00351617440225035
"23245","chr21.31085000.31090000","chr21.31195000.31200000",110000,18,0.0001184305,31085000,31195000,31090000,31200000,"chr21",664556,1,5,4,10,"chr21",1,0.0210970464135021
"23246","chr21.40150000.40155000","chr21.40435000.40440000",285000,11,0.002194963,40150000,40435000,40155000,40440000,"chr21",664591,0,1,2,3,"chr21",1,0.00386779184247539
"23247","chr21.17455000.17460000","chr21.17550000.17555000",95000,17,0.001326389,17455000,17550000,17460000,17555000,"chr21",664633,1,14,7,22,"chr21",1,0.0438349742147211
"23248","chr21.34615000.34620000","chr21.34910000.34915000",295000,10,0.007106328,34615000,34910000,34620000,34915000,"chr21",664716,0,7,1,8,"chr21",1,0.00937646507266761
"23249","chr21.32770000.32775000","chr21.32835000.32840000",65000,22,0.0001877994,32770000,32835000,32775000,32840000,"chr21",664727,0,4,2,6,"chr21",1,0.0154711673699015
"23250","chr21.45005000.45010000","chr21.45055000.45060000",50000,24,0.0004700334,45005000,45055000,45010000,45060000,"chr21",664815,0,1,4,5,"chr21",1,0.0140646976090014
"23251","chr21.32655000.32660000","chr21.32825000.32830000",170000,13,0.00362061,32655000,32825000,32660000,32830000,"chr21",664833,2,2,1,5,"chr21",1,0.00761837787154243
"23252","chr21.44345000.44350000","chr21.44535000.44540000",190000,16,2.677994e-05,44345000,44535000,44350000,44540000,"chr21",664878,2,9,8,19,"chr21",1,0.0356305672761369
"23253","chr21.17450000.17455000","chr21.17870000.17875000",420000,12,4.554573e-05,17450000,17870000,17455000,17875000,"chr21",664894,2,5,6,13,"chr21",1,0.0182841068917018
"23254","chr21.32485000.32490000","chr21.32955000.32960000",470000,12,2.111916e-05,32485000,32955000,32490000,32960000,"chr21",664931,1,2,5,8,"chr21",1,0.0112517580872011
"23255","chr21.17585000.17590000","chr21.17675000.17680000",90000,19,0.000207223,17585000,17675000,17590000,17680000,"chr21",664945,1,2,4,7,"chr21",1,0.0155883731833099
"23256","chr21.17455000.17460000","chr21.17870000.17875000",415000,10,0.001411403,17455000,17870000,17460000,17875000,"chr21",664957,2,5,6,13,"chr21",1,0.0152367557430849
"23257","chr21.34200000.34205000","chr21.34590000.34595000",390000,12,7.267652e-05,34200000,34590000,34205000,34595000,"chr21",664961,0,3,1,4,"chr21",1,0.00562587904360056
"23258","chr21.31140000.31145000","chr21.31195000.31200000",55000,20,0.00728697,31140000,31195000,31145000,31200000,"chr21",664989,1,5,3,9,"chr21",1,0.0210970464135021
"23259","chr21.44335000.44340000","chr21.44535000.44540000",200000,28,1.25716e-15,44335000,44535000,44340000,44540000,"chr21",664999,0,2,2,4,"chr21",1,0.0131270511017346
"23260","chr21.36450000.36455000","chr21.37265000.37270000",815000,9,0.0002007655,36450000,37265000,36455000,37270000,"chr21",665083,0,4,2,6,"chr21",1,0.00632911392405063
"23261","chr21.44300000.44305000","chr21.44535000.44540000",235000,15,2.005263e-05,44300000,44535000,44305000,44540000,"chr21",665092,2,9,8,19,"chr21",1,0.0334036568213783
"23262","chr21.34200000.34205000","chr21.34615000.34620000",415000,9,0.006188441,34200000,34615000,34205000,34620000,"chr21",665148,0,5,1,6,"chr21",1,0.00632911392405063
"23263","chr21.17435000.17440000","chr21.17885000.17890000",450000,9,0.004291028,17435000,17885000,17440000,17890000,"chr21",665149,1,1,1,3,"chr21",1,0.00316455696202532
"23264","chr21.34600000.34605000","chr21.34715000.34720000",115000,16,0.001014747,34600000,34715000,34605000,34720000,"chr21",665151,0,2,2,4,"chr21",1,0.00750117205813408
"23265","chr21.33125000.33130000","chr21.33665000.33670000",540000,8,0.008370528,33125000,33665000,33130000,33670000,"chr21",665192,0,2,0,2,"chr21",1,0.00187529301453352
"23266","chr21.34590000.34595000","chr21.34780000.34785000",190000,12,0.00628583,34590000,34780000,34595000,34785000,"chr21",665276,0,3,1,4,"chr21",1,0.00562587904360056
"23267","chr21.17460000.17465000","chr21.17610000.17615000",150000,14,0.002264569,17460000,17610000,17465000,17615000,"chr21",665362,1,1,0,2,"chr21",1,0.00328176277543366
"23268","chr21.40115000.40120000","chr21.40485000.40490000",370000,9,0.009899097,40115000,40485000,40120000,40490000,"chr21",665381,1,0,3,4,"chr21",1,0.00421940928270042
"23269","chr21.45080000.45085000","chr21.45165000.45170000",85000,17,0.003209563,45080000,45165000,45085000,45170000,"chr21",665391,0,1,1,2,"chr21",1,0.00398499765588373
"23270","chr21.17455000.17460000","chr21.17540000.17545000",85000,24,5.194009e-07,17455000,17540000,17460000,17545000,"chr21",665423,2,1,5,8,"chr21",1,0.0225035161744023
"23271","chr21.17450000.17455000","chr21.17550000.17555000",100000,18,0.0002670046,17450000,17550000,17455000,17555000,"chr21",665528,1,14,14,29,"chr21",1,0.0611814345991561
"23272","chr21.28990000.28995000","chr21.29055000.29060000",65000,20,0.001567407,28990000,29055000,28995000,29060000,"chr21",665556,4,9,8,21,"chr21",1,0.0492264416315049
"23273","chr21.31395000.31400000","chr21.31825000.31830000",430000,9,0.005284775,31395000,31825000,31400000,31830000,"chr21",665561,0,4,4,8,"chr21",1,0.00843881856540084
"23274","chr21.17885000.17890000","chr21.17975000.17980000",90000,16,0.005634111,17885000,17975000,17890000,17980000,"chr21",665622,1,1,1,3,"chr21",1,0.00562587904360056
"23275","chr21.32795000.32800000","chr21.32830000.32835000",35000,28,0.0009626731,32795000,32830000,32800000,32835000,"chr21",665735,3,10,11,24,"chr21",1,0.0787623066104079
"23276","chr21.27160000.27165000","chr21.27245000.27250000",85000,23,2.160739e-06,27160000,27245000,27165000,27250000,"chr21",665739,2,10,6,18,"chr21",1,0.0485232067510548
"23277","chr21.32825000.32830000","chr21.32975000.32980000",150000,20,4.326453e-07,32825000,32975000,32830000,32980000,"chr21",665796,0,3,2,5,"chr21",1,0.0117205813408345
"23278","chr21.34600000.34605000","chr21.34745000.34750000",145000,13,0.008270683,34600000,34745000,34605000,34750000,"chr21",665834,0,2,2,4,"chr21",1,0.00609470229723394
"23279","chr21.34145000.34150000","chr21.34580000.34585000",435000,10,0.0011096,34145000,34580000,34150000,34585000,"chr21",665861,0,0,1,1,"chr21",1,0.00117205813408345
"23280","chr21.33230000.33235000","chr21.33640000.33645000",410000,12,5.337691e-05,33230000,33640000,33235000,33645000,"chr21",665867,1,5,3,9,"chr21",1,0.0126582278481013
"23281","chr21.44305000.44310000","chr21.44535000.44540000",230000,13,0.0005106677,44305000,44535000,44310000,44540000,"chr21",665877,0,2,0,2,"chr21",1,0.00304735114861697
"23282","chr21.43645000.43650000","chr21.43670000.43675000",25000,36,0.0003646821,43645000,43670000,43650000,43675000,"chr21",665931,3,11,15,29,"chr21",1,0.122362869198312
"23283","chr21.17455000.17460000","chr21.17975000.17980000",520000,8,0.009899097,17455000,17975000,17460000,17980000,"chr21",665949,1,18,7,26,"chr21",1,0.0243788091889358
"23284","chr21.32610000.32615000","chr21.32825000.32830000",215000,12,0.003116158,32610000,32825000,32615000,32830000,"chr21",665978,2,6,9,17,"chr21",1,0.0239099859353024
"23285","chr21.17435000.17440000","chr21.17675000.17680000",240000,12,0.001567407,17435000,17675000,17440000,17680000,"chr21",665988,1,2,4,7,"chr21",1,0.00984528832630099
"23286","chr21.32480000.32485000","chr21.32530000.32535000",50000,29,1.914725e-06,32480000,32530000,32485000,32535000,"chr21",666009,2,0,1,3,"chr21",1,0.010196905766526
"23287","chr21.17265000.17270000","chr21.17865000.17870000",600000,8,0.005436264,17265000,17865000,17270000,17870000,"chr21",666083,1,4,0,5,"chr21",1,0.0046882325363338
"23288","chr21.44535000.44540000","chr21.45070000.45075000",535000,12,8.307079e-06,44535000,45070000,44540000,45075000,"chr21",666144,2,9,8,19,"chr21",1,0.0267229254571027
"23289","chr21.25295000.25300000","chr21.25940000.25945000",645000,8,0.003957909,25295000,25940000,25300000,25945000,"chr21",666160,0,2,0,2,"chr21",1,0.00187529301453352
"23290","chr21.37615000.37620000","chr21.37700000.37705000",85000,23,2.160739e-06,37615000,37700000,37620000,37705000,"chr21",666203,0,1,0,1,"chr21",1,0.00269573370839194
"23291","chr21.40115000.40120000","chr21.40150000.40155000",35000,26,0.004722023,40115000,40150000,40120000,40155000,"chr21",666278,1,1,3,5,"chr21",1,0.0152367557430849
"23292","chr21.31335000.31340000","chr21.31390000.31395000",55000,20,0.00728697,31335000,31390000,31340000,31395000,"chr21",666331,0,4,3,7,"chr21",1,0.0164088138771683
"23293","chr21.31090000.31095000","chr21.31220000.31225000",130000,14,0.004804372,31090000,31220000,31095000,31225000,"chr21",666353,1,1,0,2,"chr21",1,0.00328176277543366
"23294","chr21.34595000.34600000","chr21.34700000.34705000",105000,18,0.0001734448,34595000,34700000,34600000,34705000,"chr21",666376,0,0,6,6,"chr21",1,0.0126582278481013
"23295","chr21.43970000.43975000","chr21.43995000.44000000",25000,33,0.003330143,43970000,43995000,43975000,4.4e+07,"chr21",666449,0,5,5,10,"chr21",1,0.0386779184247539
"23296","chr21.44580000.44585000","chr21.45070000.45075000",490000,9,0.002972365,44580000,45070000,44585000,45075000,"chr21",666451,1,5,1,7,"chr21",1,0.00738396624472574
"23297","chr21.17825000.17830000","chr21.17865000.17870000",40000,25,0.002152015,17825000,17865000,17830000,17870000,"chr21",666467,1,4,0,5,"chr21",1,0.0146507266760431
"23298","chr21.17450000.17455000","chr21.17690000.17695000",240000,18,8.50405e-08,17450000,17690000,17455000,17695000,"chr21",666480,2,10,12,24,"chr21",1,0.0506329113924051
"23299","chr21.33035000.33040000","chr21.33055000.33060000",20000,44,3.193156e-06,33035000,33055000,33040000,33060000,"chr21",666491,1,4,1,6,"chr21",1,0.0309423347398031
"23300","chr21.30560000.30565000","chr21.30715000.30720000",155000,14,0.00188532,30560000,30715000,30565000,30720000,"chr21",666503,0,6,0,6,"chr21",1,0.00984528832630099
"23301","chr21.15750000.15755000","chr21.16425000.16430000",675000,10,8.669896e-05,15750000,16425000,15755000,16430000,"chr21",666508,2,4,6,12,"chr21",1,0.0140646976090014
"23302","chr21.45570000.45575000","chr21.45720000.45725000",150000,18,9.916255e-06,45570000,45720000,45575000,45725000,"chr21",666515,0,4,3,7,"chr21",1,0.0147679324894515
"23303","chr21.42065000.42070000","chr21.42190000.42195000",125000,14,0.005882543,42065000,42190000,42070000,42195000,"chr21",666533,1,1,3,5,"chr21",1,0.00820440693858415
"23304","chr21.34745000.34750000","chr21.34780000.34785000",35000,29,0.0004013126,34745000,34780000,34750000,34785000,"chr21",666539,0,3,3,6,"chr21",1,0.020393811533052
"23305","chr21.28145000.28150000","chr21.29095000.29100000",950000,9,6.39773e-05,28145000,29095000,28150000,29100000,"chr21",666569,1,2,3,6,"chr21",1,0.00632911392405063
"23306","chr21.34590000.34595000","chr21.34630000.34635000",40000,25,0.002152015,34590000,34630000,34595000,34635000,"chr21",666652,0,3,1,4,"chr21",1,0.0117205813408345
"23307","chr21.31335000.31340000","chr21.31395000.31400000",60000,21,0.001290864,31335000,31395000,31340000,31400000,"chr21",666668,0,4,4,8,"chr21",1,0.019690576652602
"23308","chr21.44410000.44415000","chr21.45125000.45130000",715000,8,0.002539001,44410000,45125000,44415000,45130000,"chr21",666724,0,1,2,3,"chr21",1,0.00281293952180028
"23309","chr21.18275000.18280000","chr21.18295000.18300000",20000,38,0.0004820582,18275000,18295000,18280000,18300000,"chr21",666751,0,0,3,3,"chr21",1,0.0133614627285513
"23310","chr21.36330000.36335000","chr21.36925000.36930000",595000,8,0.00561577,36330000,36925000,36335000,36930000,"chr21",666774,5,9,5,19,"chr21",1,0.0178152836380684
"23311","chr21.32485000.32490000","chr21.32515000.32520000",30000,35,2.481842e-05,32485000,32515000,32490000,32520000,"chr21",666791,1,16,13,30,"chr21",1,0.123066104078762
"23312","chr21.42065000.42070000","chr21.42115000.42120000",50000,25,0.0001691101,42065000,42115000,42070000,42120000,"chr21",666800,1,4,3,8,"chr21",1,0.023441162681669
"23313","chr21.32480000.32485000","chr21.33035000.33040000",555000,8,0.007543705,32480000,33035000,32485000,33040000,"chr21",666822,1,4,1,6,"chr21",1,0.00562587904360056
"23314","chr21.36290000.36295000","chr21.36990000.36995000",700000,8,0.002792474,36290000,36990000,36295000,36995000,"chr21",666823,7,23,20,50,"chr21",1,0.046882325363338
"23315","chr21.32520000.32525000","chr21.32955000.32960000",435000,11,0.0002104958,32520000,32955000,32525000,32960000,"chr21",666912,0,2,5,7,"chr21",1,0.00902484763244257
"23316","chr21.27245000.27250000","chr21.27565000.27570000",320000,10,0.004754699,27245000,27565000,27250000,27570000,"chr21",666977,0,2,1,3,"chr21",1,0.00351617440225035
"23317","chr21.32780000.32785000","chr21.32835000.32840000",55000,23,0.0004469249,32780000,32835000,32785000,32840000,"chr21",667015,1,4,2,7,"chr21",1,0.0188701359587436
"23318","chr21.17585000.17590000","chr21.17670000.17675000",85000,16,0.008332583,17585000,17670000,17590000,17675000,"chr21",667091,2,5,5,12,"chr21",1,0.0225035161744023
"23319","chr21.42115000.42120000","chr21.42145000.42150000",30000,51,1.553407e-13,42115000,42145000,42120000,42150000,"chr21",667109,0,2,2,4,"chr21",1,0.0239099859353024
"23320","chr21.44300000.44305000","chr21.45070000.45075000",770000,9,0.0002794752,44300000,45070000,44305000,45075000,"chr21",667137,3,10,15,28,"chr21",1,0.029535864978903
"23321","chr21.17460000.17465000","chr21.17540000.17545000",80000,21,6.018019e-05,17460000,17540000,17465000,17545000,"chr21",667166,2,1,5,8,"chr21",1,0.019690576652602
"23322","chr21.17845000.17850000","chr21.17900000.17905000",55000,21,0.003082852,17845000,17900000,17850000,17905000,"chr21",667189,0,2,4,6,"chr21",1,0.0147679324894515
"23323","chr21.17460000.17465000","chr21.17670000.17675000",210000,24,3.171927e-12,17460000,17670000,17465000,17675000,"chr21",667196,2,6,5,13,"chr21",1,0.0365682137834037
"23324","chr21.31970000.31975000","chr21.31990000.31995000",20000,40,0.0001011381,31970000,31990000,31975000,31995000,"chr21",667207,0,3,1,4,"chr21",1,0.0187529301453352
"23325","chr21.34580000.34585000","chr21.34715000.34720000",135000,14,0.003957909,34580000,34715000,34585000,34720000,"chr21",667242,0,1,1,2,"chr21",1,0.00328176277543366
"23326","chr21.34630000.34635000","chr21.34700000.34705000",70000,19,0.0021114,34630000,34700000,34635000,34705000,"chr21",667392,0,0,6,6,"chr21",1,0.0133614627285513
"23327","chr21.45610000.45615000","chr21.45640000.45645000",30000,29,0.003919425,45610000,45640000,45615000,45645000,"chr21",667425,1,1,0,2,"chr21",1,0.00679793717768401
"23328","chr21.32955000.32960000","chr21.32975000.32980000",20000,36,0.002052153,32955000,32975000,32960000,32980000,"chr21",667616,0,2,2,4,"chr21",1,0.0168776371308017
"23329","chr21.17435000.17440000","chr21.17900000.17905000",465000,9,0.003742668,17435000,17900000,17440000,17905000,"chr21",667617,3,2,7,12,"chr21",1,0.0126582278481013
"23330","chr21.17545000.17550000","chr21.17675000.17680000",130000,16,0.0004552624,17545000,17675000,17550000,17680000,"chr21",667639,1,2,4,7,"chr21",1,0.0131270511017346
"23331","chr21.17450000.17455000","chr21.17660000.17665000",210000,16,1.10009e-05,17450000,17660000,17455000,17665000,"chr21",667656,0,7,8,15,"chr21",1,0.0281293952180028
"23332","chr21.34200000.34205000","chr21.34630000.34635000",430000,12,3.911058e-05,34200000,34630000,34205000,34635000,"chr21",667716,1,5,5,11,"chr21",1,0.0154711673699015
"23333","chr21.32770000.32775000","chr21.32830000.32835000",60000,23,0.0001605206,32770000,32830000,32775000,32835000,"chr21",667759,0,10,3,13,"chr21",1,0.0350445382090952
"23334","chr21.41870000.41875000","chr21.42115000.42120000",245000,11,0.005081672,41870000,42115000,41875000,42120000,"chr21",667792,1,3,0,4,"chr21",1,0.00515705578996718
"23335","chr21.34700000.34705000","chr21.34745000.34750000",45000,23,0.00336115,34700000,34745000,34705000,34750000,"chr21",667889,0,0,8,8,"chr21",1,0.0215658696671355
"23336","chr21.34600000.34605000","chr21.34630000.34635000",30000,46,1.158985e-10,34600000,34630000,34605000,34635000,"chr21",667934,0,2,2,4,"chr21",1,0.0215658696671355
"23337","chr21.36250000.36255000","chr21.37205000.37210000",955000,8,0.0004898856,36250000,37205000,36255000,37210000,"chr21",667947,7,7,17,31,"chr21",1,0.0290670417252696
"23338","chr21.29090000.29095000","chr21.29155000.29160000",65000,20,0.001567407,29090000,29155000,29095000,29160000,"chr21",668010,1,4,2,7,"chr21",1,0.0164088138771683
"23339","chr21.17455000.17460000","chr21.17865000.17870000",410000,11,0.0002986716,17455000,17865000,17460000,17870000,"chr21",668033,1,4,0,5,"chr21",1,0.00644631973745898
"23340","chr21.17450000.17455000","chr21.17540000.17545000",90000,23,1.038885e-06,17450000,17540000,17455000,17545000,"chr21",668059,2,1,5,8,"chr21",1,0.0215658696671355
"23341","chr21.17435000.17440000","chr21.17975000.17980000",540000,10,0.0003368041,17435000,17975000,17440000,17980000,"chr21",668093,1,5,7,13,"chr21",1,0.0152367557430849
"23342","chr21.16065000.16070000","chr21.16100000.16105000",35000,32,2.329205e-05,16065000,16100000,16070000,16105000,"chr21",668113,0,1,1,2,"chr21",1,0.00750117205813408
"23343","chr21.17450000.17455000","chr21.17545000.17550000",95000,16,0.003896897,17450000,17545000,17455000,17550000,"chr21",668145,3,13,6,22,"chr21",1,0.0412564463197375
"23344","chr21.17610000.17615000","chr21.17660000.17665000",50000,24,0.0004700334,17610000,17660000,17615000,17665000,"chr21",668157,0,1,0,1,"chr21",1,0.00281293952180028
"23345","chr21.17460000.17465000","chr21.17865000.17870000",405000,12,5.771993e-05,17460000,17865000,17465000,17870000,"chr21",668207,1,4,0,5,"chr21",1,0.0070323488045007
"23346","chr21.17450000.17455000","chr21.17670000.17675000",220000,18,2.266541e-07,17450000,17670000,17455000,17675000,"chr21",668277,2,6,5,13,"chr21",1,0.0274261603375527
"23347","chr21.45570000.45575000","chr21.45605000.45610000",35000,27,0.002188685,45570000,45605000,45575000,45610000,"chr21",668327,0,1,1,2,"chr21",1,0.00632911392405063
"23348","chr21.17460000.17465000","chr21.17675000.17680000",215000,22,1.411988e-10,17460000,17675000,17465000,17680000,"chr21",668357,1,2,4,7,"chr21",1,0.0180496952648851
"23349","chr21.32480000.32485000","chr21.32940000.32945000",460000,14,4.818086e-07,32480000,32940000,32485000,32945000,"chr21",668358,8,10,6,24,"chr21",1,0.0393811533052039
"23350","chr21.17825000.17830000","chr21.17975000.17980000",150000,15,0.0006577064,17825000,17975000,17830000,17980000,"chr21",668362,1,7,12,20,"chr21",1,0.0351617440225035
"23351","chr21.42115000.42120000","chr21.42190000.42195000",75000,26,1.763284e-07,42115000,42190000,42120000,42195000,"chr21",668425,1,1,3,5,"chr21",1,0.0152367557430849
"23352","chr21.36810000.36815000","chr21.36830000.36835000",20000,43,7.980444e-06,36810000,36830000,36815000,36835000,"chr21",668443,3,4,4,11,"chr21",1,0.0554383497421472
"23353","chr21.33230000.33235000","chr21.33605000.33610000",375000,9,0.009357206,33230000,33605000,33235000,33610000,"chr21",668454,1,7,5,13,"chr21",1,0.0137130801687764
"23354","chr21.32790000.32795000","chr21.32825000.32830000",35000,27,0.002188685,32790000,32825000,32795000,32830000,"chr21",668604,2,6,9,17,"chr21",1,0.0537974683544304
"23355","chr21.31865000.31870000","chr21.32400000.32405000",535000,8,0.008781585,31865000,32400000,31870000,32405000,"chr21",668611,4,6,5,15,"chr21",1,0.0140646976090014
"23356","chr21.32790000.32795000","chr21.32835000.32840000",45000,22,0.007562865,32790000,32835000,32795000,32840000,"chr21",668651,1,4,2,7,"chr21",1,0.0180496952648851
"23357","chr21.36345000.36350000","chr21.37255000.37260000",910000,9,9.375279e-05,36345000,37255000,36350000,37260000,"chr21",668703,2,3,2,7,"chr21",1,0.00738396624472574
"23358","chr21.36060000.36065000","chr21.36810000.36815000",750000,9,0.0003285079,36060000,36810000,36065000,36815000,"chr21",668770,0,0,4,4,"chr21",1,0.00421940928270042
"23359","chr21.17435000.17440000","chr21.17870000.17875000",435000,9,0.005023372,17435000,17870000,17440000,17875000,"chr21",668827,2,5,6,13,"chr21",1,0.0137130801687764
"23360","chr21.40115000.40120000","chr21.40465000.40470000",350000,12,0.000141102,40115000,40465000,40120000,40470000,"chr21",668842,1,2,1,4,"chr21",1,0.00562587904360056
"23361","chr21.36915000.36920000","chr21.37205000.37210000",290000,10,0.007562865,36915000,37205000,36920000,37210000,"chr21",668938,3,0,12,15,"chr21",1,0.0175808720112518
"23362","chr21.17455000.17460000","chr21.17690000.17695000",235000,17,6.550951e-07,17455000,17690000,17460000,17695000,"chr21",668950,2,10,7,19,"chr21",1,0.0378574777308955
"23363","chr21.44345000.44350000","chr21.45075000.45080000",730000,8,0.002297272,44345000,45075000,44350000,45080000,"chr21",668992,0,1,3,4,"chr21",1,0.00375058602906704
"23364","chr21.45550000.45555000","chr21.45720000.45725000",170000,21,2.073481e-08,45550000,45720000,45555000,45725000,"chr21",668998,0,5,2,7,"chr21",1,0.0172292545710267
"23365","chr21.17435000.17440000","chr21.17660000.17665000",225000,11,0.008051342,17435000,17660000,17440000,17665000,"chr21",669010,0,5,7,12,"chr21",1,0.0154711673699015
"23366","chr21.43640000.43645000","chr21.43675000.43680000",35000,26,0.004722023,43640000,43675000,43645000,43680000,"chr21",669048,2,10,5,17,"chr21",1,0.0518049695264885
"23367","chr21.36285000.36290000","chr21.36915000.36920000",630000,8,0.004378964,36285000,36915000,36290000,36920000,"chr21",669097,3,0,12,15,"chr21",1,0.0140646976090014
"23368","chr21.17670000.17675000","chr21.17885000.17890000",215000,12,0.003116158,17670000,17885000,17675000,17890000,"chr21",669231,1,1,1,3,"chr21",1,0.00421940928270042
"23369","chr21.34715000.34720000","chr21.34780000.34785000",65000,18,0.009899097,34715000,34780000,34720000,34785000,"chr21",669336,0,3,3,6,"chr21",1,0.0126582278481013
"23370","chr21.44345000.44350000","chr21.45055000.45060000",710000,8,0.002623989,44345000,45055000,44350000,45060000,"chr21",669364,1,4,5,10,"chr21",1,0.00937646507266761
"23371","chr21.34615000.34620000","chr21.34700000.34705000",85000,22,8.465178e-06,34615000,34700000,34620000,34705000,"chr21",669365,0,0,1,1,"chr21",1,0.00257852789498359
"23372","chr21.34190000.34195000","chr21.34555000.34560000",365000,12,0.0001098049,34190000,34555000,34195000,34560000,"chr21",669376,0,8,1,9,"chr21",1,0.0126582278481013
"23373","chr21.31800000.31805000","chr21.31950000.31955000",150000,16,0.0001732414,31800000,31950000,31805000,31955000,"chr21",669441,1,6,4,11,"chr21",1,0.0206282231598687
"23374","chr21.34350000.34355000","chr21.34700000.34705000",350000,10,0.003203503,34350000,34700000,34355000,34705000,"chr21",669470,0,0,8,8,"chr21",1,0.00937646507266761
"23375","chr21.17385000.17390000","chr21.17425000.17430000",40000,26,0.0009066524,17385000,17425000,17390000,17430000,"chr21",669546,2,0,1,3,"chr21",1,0.00914205344585091
"23376","chr21.36085000.36090000","chr21.36980000.36985000",895000,7,0.004804372,36085000,36980000,36090000,36985000,"chr21",669586,6,12,11,29,"chr21",1,0.023792780121894
"23377","chr21.44350000.44355000","chr21.44405000.44410000",55000,22,0.001204287,44350000,44405000,44355000,44410000,"chr21",669604,0,2,1,3,"chr21",1,0.00773558368495077
"23378","chr21.34600000.34605000","chr21.34910000.34915000",310000,11,0.001374235,34600000,34910000,34605000,34915000,"chr21",669620,0,2,2,4,"chr21",1,0.00515705578996718
"23379","chr21.32480000.32485000","chr21.32830000.32835000",350000,10,0.003203503,32480000,32830000,32485000,32835000,"chr21",669673,3,10,6,19,"chr21",1,0.0222691045475856
"23380","chr21.15835000.15840000","chr21.16065000.16070000",230000,12,0.002052153,15835000,16065000,15840000,16070000,"chr21",669703,0,3,1,4,"chr21",1,0.00562587904360056
"23381","chr21.17455000.17460000","chr21.17675000.17680000",220000,54,5.559977e-47,17455000,17675000,17460000,17680000,"chr21",669712,1,2,4,7,"chr21",1,0.0443037974683544
"23382","chr21.16240000.16245000","chr21.16425000.16430000",185000,18,1.406843e-06,16240000,16425000,16245000,16430000,"chr21",669725,2,4,6,12,"chr21",1,0.0253164556962025
"23383","chr21.31160000.31165000","chr21.31220000.31225000",60000,19,0.008040835,31160000,31220000,31165000,31225000,"chr21",669772,0,1,0,1,"chr21",1,0.00222691045475856
"23384","chr21.31780000.31785000","chr21.31800000.31805000",20000,39,0.0002220917,31780000,31800000,31785000,31805000,"chr21",669780,1,10,12,23,"chr21",1,0.105133614627286
"23385","chr21.17850000.17855000","chr21.17870000.17875000",20000,34,0.007403229,17850000,17870000,17855000,17875000,"chr21",669789,1,4,6,11,"chr21",1,0.0438349742147211
"23386","chr21.32780000.32785000","chr21.32825000.32830000",45000,27,7.602704e-05,32780000,32825000,32785000,32830000,"chr21",669897,2,6,9,17,"chr21",1,0.0537974683544304
"23387","chr21.17450000.17455000","chr21.17825000.17830000",375000,16,4.706503e-08,17450000,17825000,17455000,17830000,"chr21",669913,3,7,18,28,"chr21",1,0.0525082044069386
"23388","chr21.34580000.34585000","chr21.34700000.34705000",120000,18,5.798623e-05,34580000,34700000,34585000,34705000,"chr21",669923,0,0,1,1,"chr21",1,0.00210970464135021
"23389","chr21.34200000.34205000","chr21.34580000.34585000",380000,15,3.155518e-07,34200000,34580000,34205000,34585000,"chr21",669931,0,1,1,2,"chr21",1,0.00351617440225035
"23390","chr21.43320000.43325000","chr21.43355000.43360000",35000,26,0.004722023,43320000,43355000,43325000,43360000,"chr21",669936,2,0,0,2,"chr21",1,0.00609470229723394
"23391","chr21.36345000.36350000","chr21.36380000.36385000",35000,32,2.329205e-05,36345000,36380000,36350000,36385000,"chr21",669967,13,24,23,60,"chr21",1,0.225035161744022
"23392","chr21.31170000.31175000","chr21.31195000.31200000",25000,39,2.911965e-05,31170000,31195000,31175000,31200000,"chr21",670052,1,5,4,10,"chr21",1,0.0457102672292546
"23393","chr21.17540000.17545000","chr21.17670000.17675000",130000,19,7.417257e-06,17540000,17670000,17545000,17675000,"chr21",670100,2,1,5,8,"chr21",1,0.0178152836380684
"23394","chr21.45555000.45560000","chr21.45640000.45645000",85000,17,0.003209563,45555000,45640000,45560000,45645000,"chr21",670125,0,1,0,1,"chr21",1,0.00199249882794187
"23395","chr21.17450000.17455000","chr21.17885000.17890000",435000,10,0.0011096,17450000,17885000,17455000,17890000,"chr21",670161,1,1,1,3,"chr21",1,0.00351617440225035
"23396","chr21.36250000.36255000","chr21.36980000.36985000",730000,8,0.002297272,36250000,36980000,36255000,36985000,"chr21",670339,8,20,25,53,"chr21",1,0.0496952648851383
"23397","chr21.34200000.34205000","chr21.34600000.34605000",400000,13,1.019555e-05,34200000,34600000,34205000,34605000,"chr21",670355,0,2,2,4,"chr21",1,0.00609470229723394
"23398","chr22.30210000.30215000","chr22.30395000.30400000",185000,17,7.748484e-06,30210000,30395000,30215000,30400000,"chr22",670400,0,2,5,7,"chr22",1,0.0139474917955931
"23399","chr22.30175000.30180000","chr22.30400000.30405000",225000,13,0.0005419572,30175000,30400000,30180000,30405000,"chr22",670407,4,1,3,8,"chr22",1,0.0121894045944679
"23400","chr22.40950000.40955000","chr22.41035000.41040000",85000,21,4.189076e-05,40950000,41035000,40955000,41040000,"chr22",670423,2,16,12,30,"chr22",1,0.0738396624472574
"23401","chr22.37995000.38000000","chr22.38195000.38200000",200000,15,7.748443e-05,37995000,38195000,3.8e+07,38200000,"chr22",670429,2,0,6,8,"chr22",1,0.0140646976090014
"23402","chr22.41270000.41275000","chr22.41500000.41505000",230000,12,0.001812437,41270000,41500000,41275000,41505000,"chr22",670460,9,19,15,43,"chr22",1,0.060478199718706
"23403","chr22.38515000.38520000","chr22.38715000.38720000",200000,13,0.001253207,38515000,38715000,38520000,38720000,"chr22",670461,3,6,17,26,"chr22",1,0.0396155649320206
"23404","chr22.41410000.41415000","chr22.41440000.41445000",30000,29,0.003132604,41410000,41440000,41415000,41445000,"chr22",670487,0,6,5,11,"chr22",1,0.0373886544772621
"23405","chr22.30175000.30180000","chr22.30210000.30215000",35000,29,0.0003410527,30175000,30210000,30180000,30215000,"chr22",670524,2,1,3,6,"chr22",1,0.020393811533052
"23406","chr22.17920000.17925000","chr22.17940000.17945000",20000,44,1.951385e-06,17920000,17940000,17925000,17945000,"chr22",670554,1,3,1,5,"chr22",1,0.0257852789498359
"23407","chr22.36145000.36150000","chr22.36320000.36325000",175000,16,5.668214e-05,36145000,36320000,36150000,36325000,"chr22",670557,1,4,1,6,"chr22",1,0.0112517580872011
"23408","chr22.41480000.41485000","chr22.41585000.41590000",105000,19,6.160153e-05,41480000,41585000,41485000,41590000,"chr22",670565,6,22,12,40,"chr22",1,0.0890764181903422
"23409","chr22.29040000.29045000","chr22.29715000.29720000",675000,7,0.0074729,29040000,29715000,29045000,29720000,"chr22",670574,0,4,1,5,"chr22",1,0.00410220346929208
"23410","chr22.17720000.17725000","chr22.17845000.17850000",125000,16,0.0006555978,17720000,17845000,17725000,17850000,"chr22",670576,5,6,8,19,"chr22",1,0.0356305672761369
"23411","chr22.38565000.38570000","chr22.38700000.38705000",135000,17,0.0001084025,38565000,38700000,38570000,38705000,"chr22",670630,0,6,2,8,"chr22",1,0.0159399906235349
"23412","chr22.36320000.36325000","chr22.36470000.36475000",150000,24,6.70011e-10,36320000,36470000,36325000,36475000,"chr22",670632,1,4,1,6,"chr22",1,0.0168776371308017
"23413","chr22.17720000.17725000","chr22.17835000.17840000",115000,15,0.003489312,17720000,17835000,17725000,17840000,"chr22",670634,2,23,21,46,"chr22",1,0.0808720112517581
"23414","chr22.41285000.41290000","chr22.41535000.41540000",250000,13,0.000249248,41285000,41535000,41290000,41540000,"chr22",670649,3,21,8,32,"chr22",1,0.0487576183778715
"23415","chr22.38270000.38275000","chr22.38325000.38330000",55000,22,0.001247915,38270000,38325000,38275000,38330000,"chr22",670652,0,6,3,9,"chr22",1,0.0232067510548523
"23416","chr22.41500000.41505000","chr22.41525000.41530000",25000,44,1.833116e-07,41500000,41525000,41505000,41530000,"chr22",670663,0,1,1,2,"chr22",1,0.0103141115799344
"23417","chr22.41275000.41280000","chr22.41555000.41560000",280000,10,0.007568597,41275000,41555000,41280000,41560000,"chr22",670667,1,16,11,28,"chr22",1,0.0328176277543366
"23418","chr22.36340000.36345000","chr22.36455000.36460000",115000,14,0.009570719,36340000,36455000,36345000,36460000,"chr22",670683,0,5,6,11,"chr22",1,0.0180496952648851
"23419","chr22.41800000.41805000","chr22.41940000.41945000",140000,14,0.00343542,41800000,41940000,41805000,41945000,"chr22",670693,7,20,18,45,"chr22",1,0.0738396624472574
"23420","chr22.41400000.41405000","chr22.41425000.41430000",25000,42,1.336454e-06,41400000,41425000,41405000,41430000,"chr22",670740,4,24,27,55,"chr22",1,0.270745428973277
"23421","chr22.30035000.30040000","chr22.30635000.30640000",600000,8,0.002671157,30035000,30635000,30040000,30640000,"chr22",670763,1,5,7,13,"chr22",1,0.0121894045944679
"23422","chr22.30005000.30010000","chr22.30830000.30835000",825000,7,0.002779768,30005000,30830000,30010000,30835000,"chr22",670776,2,1,6,9,"chr22",1,0.00738396624472574
"23423","chr22.42070000.42075000","chr22.42270000.42275000",200000,13,0.001253207,42070000,42270000,42075000,42275000,"chr22",670792,2,3,1,6,"chr22",1,0.00914205344585091
"23424","chr22.30085000.30090000","chr22.30395000.30400000",310000,20,6.679642e-11,30085000,30395000,30090000,30400000,"chr22",670818,0,5,5,10,"chr22",1,0.023441162681669
"23425","chr22.30835000.30840000","chr22.30870000.30875000",35000,26,0.004071823,30835000,30870000,30840000,30875000,"chr22",670827,3,12,10,25,"chr22",1,0.0761837787154243
"23426","chr22.30210000.30215000","chr22.30390000.30395000",180000,16,4.528862e-05,30210000,30390000,30215000,30395000,"chr22",670831,2,2,4,8,"chr22",1,0.0150023441162682
"23427","chr22.17955000.17960000","chr22.18095000.18100000",140000,14,0.00343542,17955000,18095000,17960000,18100000,"chr22",670873,0,14,13,27,"chr22",1,0.0443037974683544
"23428","chr22.41540000.41545000","chr22.41560000.41565000",20000,50,5.162368e-09,41540000,41560000,41545000,41565000,"chr22",670877,0,1,9,10,"chr22",1,0.0586029067041725
"23429","chr22.17920000.17925000","chr22.17955000.17960000",35000,47,2.382249e-13,17920000,17955000,17925000,17960000,"chr22",670881,0,3,1,4,"chr22",1,0.0220346929207689
"23430","chr22.30085000.30090000","chr22.30420000.30425000",335000,11,0.0006951465,30085000,30420000,30090000,30425000,"chr22",670898,0,2,1,3,"chr22",1,0.00386779184247539
"23431","chr22.28325000.28330000","chr22.28975000.28980000",650000,9,0.000281393,28325000,28975000,28330000,28980000,"chr22",670948,3,4,2,9,"chr22",1,0.00949367088607595
"23432","chr22.30835000.30840000","chr22.31160000.31165000",325000,11,0.0008320611,30835000,31160000,30840000,31165000,"chr22",670953,3,12,13,28,"chr22",1,0.0360993905297703
"23433","chr22.41410000.41415000","chr22.41525000.41530000",115000,17,0.0003462602,41410000,41525000,41415000,41530000,"chr22",670954,0,1,1,2,"chr22",1,0.00398499765588373
"23434","chr22.41350000.41355000","chr22.41530000.41535000",180000,18,2.104982e-06,41350000,41530000,41355000,41535000,"chr22",670978,2,7,7,16,"chr22",1,0.0337552742616034
"23435","chr22.40490000.40495000","chr22.40565000.40570000",75000,17,0.008927889,40490000,40565000,40495000,40570000,"chr22",670984,4,2,7,13,"chr22",1,0.0259024847632443
"23436","chr22.30005000.30010000","chr22.30390000.30395000",385000,9,0.006099697,30005000,30390000,30010000,30395000,"chr22",671007,2,1,4,7,"chr22",1,0.00738396624472574
"23437","chr22.39405000.39410000","chr22.39510000.39515000",105000,41,6.118814e-22,39405000,39510000,39410000,39515000,"chr22",671010,1,7,7,15,"chr22",1,0.0720815752461322
"23438","chr22.41475000.41480000","chr22.41500000.41505000",25000,33,0.002429394,41475000,41500000,41480000,41505000,"chr22",671055,7,25,15,47,"chr22",1,0.181786216596343
"23439","chr22.28430000.28435000","chr22.28740000.28745000",310000,15,1.483448e-06,28430000,28740000,28435000,28745000,"chr22",671059,0,4,0,4,"chr22",1,0.0070323488045007
"23440","chr22.30015000.30020000","chr22.30395000.30400000",380000,17,3.679202e-09,30015000,30395000,30020000,30400000,"chr22",671075,0,5,5,10,"chr22",1,0.0199249882794187
"23441","chr22.20770000.20775000","chr22.20805000.20810000",35000,26,0.004071823,20770000,20805000,20775000,20810000,"chr22",671083,3,23,14,40,"chr22",1,0.121894045944679
"23442","chr22.17845000.17850000","chr22.17985000.17990000",140000,16,0.0003060548,17845000,17985000,17850000,17990000,"chr22",671114,4,6,8,18,"chr22",1,0.0337552742616034
"23443","chr22.40950000.40955000","chr22.41020000.41025000",70000,23,3.19797e-05,40950000,41020000,40955000,41025000,"chr22",671120,2,16,12,30,"chr22",1,0.0808720112517581
"23444","chr22.39490000.39495000","chr22.39510000.39515000",20000,45,7.648344e-07,39490000,39510000,39495000,39515000,"chr22",671138,0,3,0,3,"chr22",1,0.0158227848101266
"23445","chr22.30000000.30005000","chr22.30015000.30020000",15000,35,0.002598659,3e+07,30015000,30005000,30020000,"chr22",671154,5,6,9,20,"chr22",1,0.0820440693858415
"23446","chr22.41425000.41430000","chr22.41445000.41450000",20000,37,0.0006443857,41425000,41445000,41430000,41450000,"chr22",671181,3,5,5,13,"chr22",1,0.056375996249414
"23447","chr22.42265000.42270000","chr22.42290000.42295000",25000,37,0.0001158603,42265000,42290000,42270000,42295000,"chr22",671208,0,2,0,2,"chr22",1,0.00867323019221753
"23448","chr22.41365000.41370000","chr22.41500000.41505000",135000,21,3.261177e-07,41365000,41500000,41370000,41505000,"chr22",671217,1,3,4,8,"chr22",1,0.019690576652602
"23449","chr22.17845000.17850000","chr22.17940000.17945000",95000,17,0.001514334,17845000,17940000,17850000,17945000,"chr22",671226,3,6,8,17,"chr22",1,0.0338724800750117
"23450","chr22.29970000.29975000","chr22.30015000.30020000",45000,24,0.001324582,29970000,30015000,29975000,30020000,"chr22",671241,5,6,9,20,"chr22",1,0.0562587904360056
"23451","chr22.38655000.38660000","chr22.38715000.38720000",60000,33,5.617283e-10,38655000,38715000,38660000,38720000,"chr22",671260,0,6,14,20,"chr22",1,0.0773558368495077
"23452","chr22.33000000.33005000","chr22.33380000.33385000",380000,11,0.0003179595,3.3e+07,33380000,33005000,33385000,"chr22",671265,0,4,0,4,"chr22",1,0.00515705578996718
"23453","chr22.28450000.28455000","chr22.28770000.28775000",320000,11,0.000909283,28450000,28770000,28455000,28775000,"chr22",671309,0,1,1,2,"chr22",1,0.00257852789498359
"23454","chr22.42090000.42095000","chr22.42230000.42235000",140000,33,4.127011e-17,42090000,42230000,42095000,42235000,"chr22",671312,2,12,8,22,"chr22",1,0.0850914205344585
"23455","chr22.38440000.38445000","chr22.38655000.38660000",215000,15,4.236114e-05,38440000,38655000,38445000,38660000,"chr22",671323,0,11,12,23,"chr22",1,0.040436005625879
"23456","chr22.50540000.50545000","chr22.50560000.50565000",20000,44,1.951385e-06,50540000,50560000,50545000,50565000,"chr22",671324,1,8,6,15,"chr22",1,0.0773558368495077
"23457","chr22.20955000.20960000","chr22.21030000.21035000",75000,18,0.003540361,20955000,21030000,20960000,21035000,"chr22",671339,7,16,30,53,"chr22",1,0.111814345991561
"23458","chr22.36320000.36325000","chr22.36465000.36470000",145000,21,1.60228e-07,36320000,36465000,36325000,36470000,"chr22",671340,1,4,1,6,"chr22",1,0.0147679324894515
"23459","chr22.17900000.17905000","chr22.17955000.17960000",55000,23,0.0004738486,17900000,17955000,17905000,17960000,"chr22",671351,0,5,1,6,"chr22",1,0.0161744022503516
"23460","chr22.36335000.36340000","chr22.36470000.36475000",135000,20,1.559988e-06,36335000,36470000,36340000,36475000,"chr22",671372,0,5,1,6,"chr22",1,0.0140646976090014
"23461","chr22.28300000.28305000","chr22.28370000.28375000",70000,18,0.006078377,28300000,28370000,28305000,28375000,"chr22",671392,5,6,10,21,"chr22",1,0.0443037974683544
"23462","chr22.39310000.39315000","chr22.39545000.39550000",235000,11,0.005693124,39310000,39545000,39315000,39550000,"chr22",671401,1,2,6,9,"chr22",1,0.0116033755274262
"23463","chr22.28600000.28605000","chr22.29245000.29250000",645000,7,0.009136658,28600000,29245000,28605000,29250000,"chr22",671418,6,10,8,24,"chr22",1,0.019690576652602
"23464","chr22.41285000.41290000","chr22.41945000.41950000",660000,8,0.001553862,41285000,41945000,41290000,41950000,"chr22",671420,3,21,8,32,"chr22",1,0.0300046882325363
"23465","chr22.36300000.36305000","chr22.36470000.36475000",170000,14,0.001052504,36300000,36470000,36305000,36475000,"chr22",671435,3,3,10,16,"chr22",1,0.0262541022034693
"23466","chr22.28430000.28435000","chr22.29070000.29075000",640000,10,4.587893e-05,28430000,29070000,28435000,29075000,"chr22",671444,4,6,3,13,"chr22",1,0.0152367557430849
"23467","chr22.39290000.39295000","chr22.39495000.39500000",205000,13,0.001056446,39290000,39495000,39295000,39500000,"chr22",671458,0,1,1,2,"chr22",1,0.00304735114861697
"23468","chr22.29245000.29250000","chr22.29265000.29270000",20000,35,0.002598659,29245000,29265000,29250000,29270000,"chr22",671488,1,4,13,18,"chr22",1,0.0738396624472574
"23469","chr22.20915000.20920000","chr22.21045000.21050000",130000,22,1.011678e-07,20915000,21045000,20920000,21050000,"chr22",671511,4,13,11,28,"chr22",1,0.0721987810595406
"23470","chr22.17555000.17560000","chr22.18000000.18005000",445000,11,0.0001071318,17555000,1.8e+07,17560000,18005000,"chr22",671517,1,6,10,17,"chr22",1,0.0219174871073605
"23471","chr22.41350000.41355000","chr22.41685000.41690000",335000,12,0.0001436542,41350000,41685000,41355000,41690000,"chr22",671527,8,14,16,38,"chr22",1,0.0534458509142053
"23472","chr22.23125000.23130000","chr22.23145000.23150000",20000,34,0.004961105,23125000,23145000,23130000,23150000,"chr22",671584,0,2,0,2,"chr22",1,0.00796999531176746
"23473","chr22.17670000.17675000","chr22.17985000.17990000",315000,12,0.0002185896,17670000,17985000,17675000,17990000,"chr22",671594,4,12,8,24,"chr22",1,0.0337552742616034
"23474","chr22.20320000.20325000","chr22.20720000.20725000",400000,9,0.005001296,20320000,20720000,20325000,20725000,"chr22",671608,3,13,12,28,"chr22",1,0.029535864978903
"23475","chr22.28580000.28585000","chr22.28600000.28605000",20000,35,0.002598659,28580000,28600000,28585000,28605000,"chr22",671611,5,10,8,23,"chr22",1,0.0943506797937178
"23476","chr22.28430000.28435000","chr22.28975000.28980000",545000,13,3.616061e-07,28430000,28975000,28435000,28980000,"chr22",671627,3,10,7,20,"chr22",1,0.0304735114861697
"23477","chr22.39250000.39255000","chr22.39555000.39560000",305000,11,0.0012285,39250000,39555000,39255000,39560000,"chr22",671686,1,3,2,6,"chr22",1,0.00773558368495077
"23478","chr22.41235000.41240000","chr22.41535000.41540000",300000,10,0.005297361,41235000,41535000,41240000,41540000,"chr22",671692,1,3,3,7,"chr22",1,0.00820440693858415
"23479","chr22.29245000.29250000","chr22.29480000.29485000",235000,20,2.71822e-09,29245000,29480000,29250000,29485000,"chr22",671696,7,16,6,29,"chr22",1,0.0679793717768401
"23480","chr22.36595000.36600000","chr22.36655000.36660000",60000,20,0.003540361,36595000,36655000,36600000,36660000,"chr22",671770,0,3,1,4,"chr22",1,0.00937646507266761
"23481","chr22.38515000.38520000","chr22.38570000.38575000",55000,24,0.0001718746,38515000,38570000,38520000,38575000,"chr22",671773,4,11,8,23,"chr22",1,0.0646976090014065
"23482","chr22.37930000.37935000","chr22.37985000.37990000",55000,48,7.487994e-20,37930000,37985000,37935000,37990000,"chr22",671826,0,5,6,11,"chr22",1,0.0618846694796062
"23483","chr22.39400000.39405000","chr22.39510000.39515000",110000,28,3.532264e-11,39400000,39510000,39405000,39515000,"chr22",671857,2,9,7,18,"chr22",1,0.0590717299578059
"23484","chr22.30000000.30005000","chr22.30390000.30395000",390000,11,0.0002695156,3e+07,30390000,30005000,30395000,"chr22",671871,3,6,4,13,"chr22",1,0.0167604313173933
"23485","chr22.32880000.32885000","chr22.33380000.33385000",500000,11,4.482113e-05,32880000,33380000,32885000,33385000,"chr22",671889,0,4,0,4,"chr22",1,0.00515705578996718
"23486","chr22.29685000.29690000","chr22.29715000.29720000",30000,34,5.139416e-05,29685000,29715000,29690000,29720000,"chr22",671895,0,4,1,5,"chr22",1,0.0199249882794187
"23487","chr22.38515000.38520000","chr22.38730000.38735000",215000,13,0.0007532948,38515000,38730000,38520000,38735000,"chr22",671896,0,4,1,5,"chr22",1,0.00761837787154243
"23488","chr22.30390000.30395000","chr22.30480000.30485000",90000,16,0.006287205,30390000,30480000,30395000,30485000,"chr22",671908,3,6,4,13,"chr22",1,0.0243788091889358
"23489","chr22.38655000.38660000","chr22.38750000.38755000",95000,25,4.307033e-08,38655000,38750000,38660000,38755000,"chr22",671928,0,11,4,15,"chr22",1,0.0439521800281294
"23490","chr22.40490000.40495000","chr22.40560000.40565000",70000,21,0.0003060548,40490000,40560000,40495000,40565000,"chr22",671960,4,2,7,13,"chr22",1,0.0319971870604782
"23491","chr22.38305000.38310000","chr22.38325000.38330000",20000,38,0.0003031305,38305000,38325000,38310000,38330000,"chr22",671980,3,10,14,27,"chr22",1,0.120253164556962
"23492","chr22.17860000.17865000","chr22.17910000.17915000",50000,34,3.988712e-09,17860000,17910000,17865000,17915000,"chr22",671990,0,1,1,2,"chr22",1,0.00796999531176746
"23493","chr22.17865000.17870000","chr22.17910000.17915000",45000,32,2.886991e-07,17865000,17910000,17870000,17915000,"chr22",672001,3,9,1,13,"chr22",1,0.0487576183778715
"23494","chr22.30075000.30080000","chr22.30480000.30485000",405000,16,1.5025e-08,30075000,30480000,30080000,30485000,"chr22",672030,2,10,6,18,"chr22",1,0.0337552742616034
"23495","chr22.31565000.31570000","chr22.31605000.31610000",40000,24,0.004347397,31565000,31605000,31570000,31610000,"chr22",672050,9,23,13,45,"chr22",1,0.126582278481013
"23496","chr22.41325000.41330000","chr22.41515000.41520000",190000,19,2.269338e-07,41325000,41515000,41330000,41520000,"chr22",672056,3,7,7,17,"chr22",1,0.0378574777308955
"23497","chr22.43270000.43275000","chr22.43485000.43490000",215000,12,0.002812266,43270000,43485000,43275000,43490000,"chr22",672064,0,0,1,1,"chr22",1,0.00140646976090014
"23498","chr22.39250000.39255000","chr22.39495000.39500000",245000,11,0.004441243,39250000,39495000,39255000,39500000,"chr22",672099,1,3,6,10,"chr22",1,0.012892639474918
"23499","chr22.41235000.41240000","chr22.41480000.41485000",245000,11,0.004441243,41235000,41480000,41240000,41485000,"chr22",672133,1,3,3,7,"chr22",1,0.00902484763244257
"23500","chr22.41305000.41310000","chr22.41560000.41565000",255000,11,0.003540361,41305000,41560000,41310000,41565000,"chr22",672148,0,1,9,10,"chr22",1,0.012892639474918
"23501","chr22.30085000.30090000","chr22.30400000.30405000",315000,10,0.00416684,30085000,30400000,30090000,30405000,"chr22",672152,1,17,17,35,"chr22",1,0.0410220346929208
"23502","chr22.37950000.37955000","chr22.37985000.37990000",35000,30,0.000140409,37950000,37985000,37955000,37990000,"chr22",672154,0,5,6,11,"chr22",1,0.0386779184247539
"23503","chr22.30255000.30260000","chr22.30345000.30350000",90000,17,0.002341554,30255000,30345000,30260000,30350000,"chr22",672187,5,12,12,29,"chr22",1,0.0577824660103141
"23504","chr22.41275000.41280000","chr22.41480000.41485000",205000,12,0.003731101,41275000,41480000,41280000,41485000,"chr22",672192,6,22,12,40,"chr22",1,0.0562587904360056
"23505","chr22.40855000.40860000","chr22.41035000.41040000",180000,25,7.5202e-12,40855000,41035000,40860000,41040000,"chr22",672231,6,13,19,38,"chr22",1,0.111345522737928
"23506","chr22.17845000.17850000","chr22.17955000.17960000",110000,41,1.92254e-22,17845000,17955000,17850000,17960000,"chr22",672234,0,6,8,14,"chr22",1,0.0672761368963901
"23507","chr22.40855000.40860000","chr22.41535000.41540000",680000,7,0.007230084,40855000,41535000,40860000,41540000,"chr22",672249,6,13,19,38,"chr22",1,0.0311767463666198
"23508","chr22.40865000.40870000","chr22.41035000.41040000",170000,17,1.714176e-05,40865000,41035000,40870000,41040000,"chr22",672252,9,20,19,48,"chr22",1,0.0956399437412096
"23509","chr22.29150000.29155000","chr22.29480000.29485000",330000,10,0.003253496,29150000,29480000,29155000,29485000,"chr22",672276,7,16,6,29,"chr22",1,0.0339896858884201
"23510","chr22.30085000.30090000","chr22.30480000.30485000",395000,23,1.665225e-15,30085000,30480000,30090000,30485000,"chr22",672277,1,17,14,32,"chr22",1,0.086263478668542
"23511","chr22.31920000.31925000","chr22.31940000.31945000",20000,39,0.000140409,31920000,31940000,31925000,31945000,"chr22",672295,7,16,18,41,"chr22",1,0.187412095639944
"23512","chr22.25875000.25880000","chr22.26095000.26100000",220000,11,0.008274323,25875000,26095000,25880000,26100000,"chr22",672319,0,4,2,6,"chr22",1,0.00773558368495077
"23513","chr22.17560000.17565000","chr22.18085000.18090000",525000,9,0.001100571,17560000,18085000,17565000,18090000,"chr22",672327,6,29,23,58,"chr22",1,0.0611814345991561
"23514","chr22.39310000.39315000","chr22.39520000.39525000",210000,13,0.0008830862,39310000,39520000,39315000,39525000,"chr22",672343,1,2,6,9,"chr22",1,0.0137130801687764
"23515","chr22.30210000.30215000","chr22.30485000.30490000",275000,11,0.00226871,30210000,30485000,30215000,30490000,"chr22",672358,2,2,8,12,"chr22",1,0.0154711673699015
"23516","chr22.31190000.31195000","chr22.31290000.31295000",100000,18,0.0003215354,31190000,31290000,31195000,31295000,"chr22",672367,1,13,11,25,"chr22",1,0.0527426160337553
"23517","chr22.30325000.30330000","chr22.30395000.30400000",70000,18,0.006078377,30325000,30395000,30330000,30400000,"chr22",672371,0,2,1,3,"chr22",1,0.00632911392405063
"23518","chr22.25850000.25855000","chr22.26095000.26100000",245000,12,0.001204698,25850000,26095000,25855000,26100000,"chr22",672387,6,5,8,19,"chr22",1,0.0267229254571027
"23519","chr22.31605000.31610000","chr22.31645000.31650000",40000,24,0.004347397,31605000,31645000,31610000,31650000,"chr22",672424,9,23,13,45,"chr22",1,0.126582278481013
"23520","chr22.28580000.28585000","chr22.28915000.28920000",335000,10,0.003035822,28580000,28915000,28585000,28920000,"chr22",672428,3,11,8,22,"chr22",1,0.0257852789498359
"23521","chr22.37930000.37935000","chr22.37995000.38000000",65000,36,1.011957e-12,37930000,37995000,37935000,3.8e+07,"chr22",672457,2,0,6,8,"chr22",1,0.0337552742616034
"23522","chr22.42580000.42585000","chr22.42645000.42650000",65000,21,0.0006443857,42580000,42645000,42585000,42650000,"chr22",672470,5,11,11,27,"chr22",1,0.0664556962025316
"23523","chr22.31345000.31350000","chr22.31490000.31495000",145000,17,6.292341e-05,31345000,31490000,31350000,31495000,"chr22",672477,5,15,9,29,"chr22",1,0.0577824660103141
"23524","chr22.30420000.30425000","chr22.30480000.30485000",60000,23,0.0001856321,30420000,30480000,30425000,30485000,"chr22",672497,0,2,1,3,"chr22",1,0.00808720112517581
"23525","chr22.21920000.21925000","chr22.22005000.22010000",85000,23,3.171989e-06,21920000,22005000,21925000,22010000,"chr22",672500,0,7,5,12,"chr22",1,0.0323488045007032
"23526","chr22.29970000.29975000","chr22.30570000.30575000",600000,8,0.002671157,29970000,30570000,29975000,30575000,"chr22",672509,0,3,3,6,"chr22",1,0.00562587904360056
"23527","chr22.41400000.41405000","chr22.41525000.41530000",125000,14,0.006253832,41400000,41525000,41405000,41530000,"chr22",672513,0,1,1,2,"chr22",1,0.00328176277543366
"23528","chr22.30005000.30010000","chr22.30480000.30485000",475000,17,2.262292e-10,30005000,30480000,30010000,30485000,"chr22",672553,2,1,6,9,"chr22",1,0.0179324894514768
"23529","chr22.38245000.38250000","chr22.38305000.38310000",60000,22,0.0005233012,38245000,38305000,38250000,38310000,"chr22",672556,3,9,10,22,"chr22",1,0.056727613689639
"23530","chr22.17855000.17860000","chr22.18000000.18005000",145000,13,0.008387263,17855000,1.8e+07,17860000,18005000,"chr22",672570,1,0,3,4,"chr22",1,0.00609470229723394
"23531","chr22.30175000.30180000","chr22.30480000.30485000",305000,10,0.004898442,30175000,30480000,30180000,30485000,"chr22",672590,4,1,3,8,"chr22",1,0.00937646507266761
"23532","chr22.41795000.41800000","chr22.41920000.41925000",125000,31,1.759282e-14,41795000,41920000,41800000,41925000,"chr22",672610,2,8,9,19,"chr22",1,0.0690342240975152
"23533","chr22.31945000.31950000","chr22.32030000.32035000",85000,17,0.003561074,31945000,32030000,31950000,32035000,"chr22",672626,8,17,13,38,"chr22",1,0.0757149554617909
"23534","chr22.41380000.41385000","chr22.41465000.41470000",85000,16,0.009169427,41380000,41465000,41385000,41470000,"chr22",672629,0,6,2,8,"chr22",1,0.0150023441162682
"23535","chr22.39150000.39155000","chr22.39510000.39515000",360000,10,0.002087052,39150000,39510000,39155000,39515000,"chr22",672635,2,4,4,10,"chr22",1,0.0117205813408345
"23536","chr22.39950000.39955000","chr22.40435000.40440000",485000,9,0.00175756,39950000,40435000,39955000,40440000,"chr22",672642,0,5,1,6,"chr22",1,0.00632911392405063
"23537","chr22.40645000.40650000","chr22.40675000.40680000",30000,33,0.0001252315,40645000,40675000,40650000,40680000,"chr22",672689,1,15,13,29,"chr22",1,0.112165963431786
"23538","chr22.30015000.30020000","chr22.30410000.30415000",395000,16,1.986124e-08,30015000,30410000,30020000,30415000,"chr22",672690,5,6,9,20,"chr22",1,0.0375058602906704
"23539","chr22.41595000.41600000","chr22.41680000.41685000",85000,24,8.093556e-07,41595000,41680000,41600000,41685000,"chr22",672711,0,5,3,8,"chr22",1,0.0225035161744023
"23540","chr22.30085000.30090000","chr22.30390000.30395000",305000,23,9.830567e-14,30085000,30390000,30090000,30395000,"chr22",672763,1,6,4,11,"chr22",1,0.0296530707923113
"23541","chr22.40595000.40600000","chr22.40645000.40650000",50000,23,0.001220688,40595000,40645000,40600000,40650000,"chr22",672765,9,19,22,50,"chr22",1,0.134786685419597
"23542","chr22.41325000.41330000","chr22.41475000.41480000",150000,20,5.596744e-07,41325000,41475000,41330000,41480000,"chr22",672772,3,7,7,17,"chr22",1,0.0398499765588373
"23543","chr22.40855000.40860000","chr22.41515000.41520000",660000,7,0.008322047,40855000,41515000,40860000,41520000,"chr22",672789,3,13,16,32,"chr22",1,0.0262541022034693
"23544","chr22.41325000.41330000","chr22.41500000.41505000",175000,15,0.0002299763,41325000,41500000,41330000,41505000,"chr22",672794,3,7,7,17,"chr22",1,0.029887482419128
"23545","chr22.31940000.31945000","chr22.32180000.32185000",240000,13,0.0003323685,31940000,32180000,31945000,32185000,"chr22",672801,2,5,5,12,"chr22",1,0.0182841068917018
"23546","chr22.36275000.36280000","chr22.36480000.36485000",205000,12,0.003731101,36275000,36480000,36280000,36485000,"chr22",672836,0,10,2,12,"chr22",1,0.0168776371308017
"23547","chr22.41285000.41290000","chr22.41540000.41545000",255000,11,0.003540361,41285000,41540000,41290000,41545000,"chr22",672838,3,13,8,24,"chr22",1,0.0309423347398031
"23548","chr22.17855000.17860000","chr22.17895000.17900000",40000,26,0.0008176467,17855000,17895000,17860000,17900000,"chr22",672855,0,0,1,1,"chr22",1,0.00304735114861697
"23549","chr22.41365000.41370000","chr22.41425000.41430000",60000,23,0.0001856321,41365000,41425000,41370000,41430000,"chr22",672869,1,3,4,8,"chr22",1,0.0215658696671355
"23550","chr22.30085000.30090000","chr22.30385000.30390000",300000,10,0.005297361,30085000,30385000,30090000,30390000,"chr22",672886,1,9,17,27,"chr22",1,0.0316455696202532
"23551","chr22.41410000.41415000","chr22.41460000.41465000",50000,21,0.006788298,41410000,41460000,41415000,41465000,"chr22",672894,0,6,5,11,"chr22",1,0.0270745428973277
"23552","chr22.40565000.40570000","chr22.40710000.40715000",145000,17,6.292341e-05,40565000,40710000,40570000,40715000,"chr22",672912,7,13,11,31,"chr22",1,0.0617674636661978
"23553","chr22.41350000.41355000","chr22.41585000.41590000",235000,13,0.0003933763,41350000,41585000,41355000,41590000,"chr22",672928,8,14,16,38,"chr22",1,0.0578996718237225
"23554","chr22.42515000.42520000","chr22.42855000.42860000",340000,11,0.0006443857,42515000,42855000,42520000,42860000,"chr22",672951,0,10,6,16,"chr22",1,0.0206282231598687
"23555","chr22.40855000.40860000","chr22.41020000.41025000",165000,24,1.875739e-10,40855000,41020000,40860000,41025000,"chr22",672957,5,13,12,30,"chr22",1,0.0843881856540084
"23556","chr22.20060000.20065000","chr22.20080000.20085000",20000,36,0.001310711,20060000,20080000,20065000,20085000,"chr22",672998,0,3,4,7,"chr22",1,0.029535864978903
"23557","chr22.17670000.17675000","chr22.17955000.17960000",285000,10,0.006905091,17670000,17955000,17675000,17960000,"chr22",673027,0,18,24,42,"chr22",1,0.0492264416315049
"23558","chr22.36450000.36455000","chr22.36470000.36475000",20000,44,1.951385e-06,36450000,36470000,36455000,36475000,"chr22",673031,3,11,14,28,"chr22",1,0.144397562119081
"23559","chr22.27840000.27845000","chr22.28180000.28185000",340000,10,0.002816079,27840000,28180000,27845000,28185000,"chr22",673065,2,2,3,7,"chr22",1,0.00820440693858415
"23560","chr22.38460000.38465000","chr22.38750000.38755000",290000,12,0.0003802171,38460000,38750000,38465000,38755000,"chr22",673071,1,13,4,18,"chr22",1,0.0253164556962025
"23561","chr22.36320000.36325000","chr22.36505000.36510000",185000,12,0.006825847,36320000,36505000,36325000,36510000,"chr22",673128,1,4,1,6,"chr22",1,0.00843881856540084
"23562","chr22.41095000.41100000","chr22.41285000.41290000",190000,14,0.0004775159,41095000,41285000,41100000,41290000,"chr22",673144,0,8,8,16,"chr22",1,0.0262541022034693
"23563","chr22.17855000.17860000","chr22.17920000.17925000",65000,38,3.849694e-14,17855000,17920000,17860000,17925000,"chr22",673161,1,0,1,2,"chr22",1,0.00890764181903422
"23564","chr22.30175000.30180000","chr22.30455000.30460000",280000,10,0.007568597,30175000,30455000,30180000,30460000,"chr22",673171,4,1,3,8,"chr22",1,0.00937646507266761
"23565","chr22.38695000.38700000","chr22.38715000.38720000",20000,34,0.004961105,38695000,38715000,38700000,38720000,"chr22",673172,2,6,3,11,"chr22",1,0.0438349742147211
"23566","chr22.42645000.42650000","chr22.42855000.42860000",210000,14,0.0002241505,42645000,42855000,42650000,42860000,"chr22",673191,5,17,14,36,"chr22",1,0.0590717299578059
"23567","chr22.41365000.41370000","chr22.41585000.41590000",220000,12,0.002427979,41365000,41585000,41370000,41590000,"chr22",673210,1,3,4,8,"chr22",1,0.0112517580872011
"23568","chr22.23315000.23320000","chr22.23385000.23390000",70000,18,0.006078377,23315000,23385000,23320000,23390000,"chr22",673242,2,0,1,3,"chr22",1,0.00632911392405063
"23569","chr22.42090000.42095000","chr22.42855000.42860000",765000,7,0.004143139,42090000,42855000,42095000,42860000,"chr22",673255,2,17,8,27,"chr22",1,0.0221518987341772
"23570","chr22.30835000.30840000","chr22.30875000.30880000",40000,27,0.000328204,30835000,30875000,30840000,30880000,"chr22",673267,0,2,2,4,"chr22",1,0.0126582278481013
"23571","chr22.41365000.41370000","chr22.41480000.41485000",115000,18,0.0001000846,41365000,41480000,41370000,41485000,"chr22",673278,1,3,4,8,"chr22",1,0.0168776371308017
"23572","chr22.39185000.39190000","chr22.39510000.39515000",325000,15,9.487251e-07,39185000,39510000,39190000,39515000,"chr22",673285,2,9,7,18,"chr22",1,0.0316455696202532
"23573","chr22.41480000.41485000","chr22.41560000.41565000",80000,19,0.0007532948,41480000,41560000,41485000,41565000,"chr22",673293,0,1,9,10,"chr22",1,0.0222691045475856
"23574","chr22.41480000.41485000","chr22.41855000.41860000",375000,11,0.000344767,41480000,41855000,41485000,41860000,"chr22",673313,6,22,12,40,"chr22",1,0.0515705578996718
"23575","chr22.37660000.37665000","chr22.37860000.37865000",200000,12,0.004347397,37660000,37860000,37665000,37865000,"chr22",673353,3,16,16,35,"chr22",1,0.0492264416315049
"23576","chr22.41365000.41370000","chr22.41510000.41515000",145000,13,0.008387263,41365000,41510000,41370000,41515000,"chr22",673368,1,3,4,8,"chr22",1,0.0121894045944679
"23577","chr22.31825000.31830000","chr22.31855000.31860000",30000,30,0.001466729,31825000,31855000,31830000,31860000,"chr22",673394,3,14,11,28,"chr22",1,0.0984528832630098
"23578","chr22.50325000.50330000","chr22.50640000.50645000",315000,11,0.00101238,50325000,50640000,50330000,50645000,"chr22",673409,3,17,19,39,"chr22",1,0.05028129395218
"23579","chr22.41365000.41370000","chr22.41445000.41450000",80000,18,0.002135357,41365000,41445000,41370000,41450000,"chr22",673412,1,3,4,8,"chr22",1,0.0168776371308017
"23580","chr22.30345000.30350000","chr22.30400000.30405000",55000,23,0.0004738486,30345000,30400000,30350000,30405000,"chr22",673427,10,12,12,34,"chr22",1,0.0916549460853258
"23581","chr22.46050000.46055000","chr22.46265000.46270000",215000,16,8.864919e-06,46050000,46265000,46055000,46270000,"chr22",673446,2,0,0,2,"chr22",1,0.00375058602906704
"23582","chr22.31345000.31350000","chr22.31630000.31635000",285000,10,0.006905091,31345000,31630000,31350000,31635000,"chr22",673457,4,5,9,18,"chr22",1,0.0210970464135021
"23583","chr22.38565000.38570000","chr22.38720000.38725000",155000,13,0.005978956,38565000,38720000,38570000,38725000,"chr22",673458,0,6,2,8,"chr22",1,0.0121894045944679
"23584","chr22.23750000.23755000","chr22.23885000.23890000",135000,19,6.840724e-06,23750000,23885000,23755000,23890000,"chr22",673459,0,3,3,6,"chr22",1,0.0133614627285513
"23585","chr22.41535000.41540000","chr22.41555000.41560000",20000,43,4.869486e-06,41535000,41555000,41540000,41560000,"chr22",673477,1,16,11,28,"chr22",1,0.141115799343647
"23586","chr22.41830000.41835000","chr22.41860000.41865000",30000,31,0.000671973,41830000,41860000,41835000,41865000,"chr22",673523,1,8,5,14,"chr22",1,0.0508673230192218
"23587","chr22.39310000.39315000","chr22.39490000.39495000",180000,12,0.007976258,39310000,39490000,39315000,39495000,"chr22",673549,0,2,0,2,"chr22",1,0.00281293952180028
"23588","chr22.25940000.25945000","chr22.26095000.26100000",155000,16,0.0001482969,25940000,26095000,25945000,26100000,"chr22",673566,0,6,1,7,"chr22",1,0.0131270511017346
"23589","chr22.38520000.38525000","chr22.38700000.38705000",180000,12,0.007976258,38520000,38700000,38525000,38705000,"chr22",673579,2,8,12,22,"chr22",1,0.0309423347398031
"23590","chr22.17865000.17870000","chr22.17920000.17925000",55000,21,0.003093944,17865000,17920000,17870000,17925000,"chr22",673582,1,3,1,5,"chr22",1,0.0123066104078762
"23591","chr22.42230000.42235000","chr22.42930000.42935000",700000,8,0.00114435,42230000,42930000,42235000,42935000,"chr22",673603,1,1,5,7,"chr22",1,0.00656352555086732
"23592","chr22.41445000.41450000","chr22.41475000.41480000",30000,37,2.905319e-06,41445000,41475000,41450000,41480000,"chr22",673628,3,5,5,13,"chr22",1,0.056375996249414
"23593","chr22.17845000.17850000","chr22.17920000.17925000",75000,24,4.108642e-06,17845000,17920000,17850000,17925000,"chr22",673649,1,3,1,5,"chr22",1,0.0140646976090014
"23594","chr22.41535000.41540000","chr22.41680000.41685000",145000,17,6.292341e-05,41535000,41680000,41540000,41685000,"chr22",673659,6,25,23,54,"chr22",1,0.107594936708861
"23595","chr22.37930000.37935000","chr22.38195000.38200000",265000,10,0.009885447,37930000,38195000,37935000,38200000,"chr22",673694,5,11,12,28,"chr22",1,0.0328176277543366
"23596","chr22.30175000.30180000","chr22.30410000.30415000",235000,14,8.953319e-05,30175000,30410000,30180000,30415000,"chr22",673731,4,1,3,8,"chr22",1,0.0131270511017346
"23597","chr22.41525000.41530000","chr22.41555000.41560000",30000,29,0.003132604,41525000,41555000,41530000,41560000,"chr22",673732,0,1,1,2,"chr22",1,0.00679793717768401
"23598","chr22.38190000.38195000","chr22.38260000.38265000",70000,18,0.006078377,38190000,38260000,38195000,38265000,"chr22",673736,0,8,6,14,"chr22",1,0.029535864978903
"23599","chr22.33015000.33020000","chr22.33380000.33385000",365000,9,0.007855832,33015000,33380000,33020000,33385000,"chr22",673738,0,4,0,4,"chr22",1,0.00421940928270042
"23600","chr22.41760000.41765000","chr22.41795000.41800000",35000,26,0.004071823,41760000,41795000,41765000,41800000,"chr22",673749,2,15,9,26,"chr22",1,0.0792311298640413
"23601","chr22.38270000.38275000","chr22.38350000.38355000",80000,18,0.002135357,38270000,38350000,38275000,38355000,"chr22",673764,0,6,3,9,"chr22",1,0.0189873417721519
"23602","chr22.40895000.40900000","chr22.41035000.41040000",140000,16,0.0003060548,40895000,41035000,40900000,41040000,"chr22",673785,3,17,12,32,"chr22",1,0.0600093764650727
"23603","chr22.41390000.41395000","chr22.41410000.41415000",20000,38,0.0003031305,41390000,41410000,41395000,41415000,"chr22",673826,0,6,5,11,"chr22",1,0.0489920300046882
"23604","chr22.39555000.39560000","chr22.39690000.39695000",135000,16,0.000393971,39555000,39690000,39560000,39695000,"chr22",673836,0,2,2,4,"chr22",1,0.00750117205813408
"23605","chr22.20855000.20860000","chr22.20890000.20895000",35000,26,0.004071823,20855000,20890000,20860000,20895000,"chr22",673852,1,11,7,19,"chr22",1,0.0578996718237225
"23606","chr22.41285000.41290000","chr22.41525000.41530000",240000,15,1.571598e-05,41285000,41525000,41290000,41530000,"chr22",673895,0,1,1,2,"chr22",1,0.00351617440225035
"23607","chr22.38200000.38205000","chr22.38240000.38245000",40000,26,0.0008176467,38200000,38240000,38205000,38245000,"chr22",673898,3,9,13,25,"chr22",1,0.0761837787154243
"23608","chr22.38210000.38215000","chr22.38335000.38340000",125000,16,0.0006555978,38210000,38335000,38215000,38340000,"chr22",673902,3,7,4,14,"chr22",1,0.0262541022034693
"23609","chr22.20035000.20040000","chr22.20060000.20065000",25000,49,8.778017e-10,20035000,20060000,20040000,20065000,"chr22",673905,2,2,6,10,"chr22",1,0.0574308485700891
"23610","chr22.39555000.39560000","chr22.39725000.39730000",170000,15,0.0002861077,39555000,39725000,39560000,39730000,"chr22",673944,1,3,2,6,"chr22",1,0.0105485232067511
"23611","chr22.29715000.29720000","chr22.29765000.29770000",50000,30,6.672039e-07,29715000,29765000,29720000,29770000,"chr22",673946,0,4,1,5,"chr22",1,0.0175808720112518
"23612","chr22.30205000.30210000","chr22.30410000.30415000",205000,12,0.003731101,30205000,30410000,30210000,30415000,"chr22",673959,4,11,10,25,"chr22",1,0.0351617440225035
"23613","chr22.40645000.40650000","chr22.40665000.40670000",20000,35,0.002598659,40645000,40665000,40650000,40670000,"chr22",674001,2,19,16,37,"chr22",1,0.151781528363807
"23614","chr22.28895000.28900000","chr22.28915000.28920000",20000,42,1.16894e-05,28895000,28915000,28900000,28920000,"chr22",674007,3,19,19,41,"chr22",1,0.20182841068917
"23615","chr22.38485000.38490000","chr22.38570000.38575000",85000,17,0.003561074,38485000,38570000,38490000,38575000,"chr22",674034,0,7,8,15,"chr22",1,0.029887482419128
"23616","chr22.41195000.41200000","chr22.41515000.41520000",320000,10,0.003814055,41195000,41515000,41200000,41520000,"chr22",674043,3,12,16,31,"chr22",1,0.036333802156587
"23617","chr22.40855000.40860000","chr22.41235000.41240000",380000,9,0.006464769,40855000,41235000,40860000,41240000,"chr22",674049,1,3,3,7,"chr22",1,0.00738396624472574
"23618","chr22.25360000.25365000","chr22.25435000.25440000",75000,25,1.091146e-06,25360000,25435000,25365000,25440000,"chr22",674052,0,3,4,7,"chr22",1,0.0205110173464604
"23619","chr22.36275000.36280000","chr22.36320000.36325000",45000,29,9.246323e-06,36275000,36320000,36280000,36325000,"chr22",674107,1,4,1,6,"chr22",1,0.020393811533052
"23620","chr22.40490000.40495000","chr22.40510000.40515000",20000,34,0.004961105,40490000,40510000,40495000,40515000,"chr22",674131,4,2,6,12,"chr22",1,0.0478199718706048
"23621","chr22.41235000.41240000","chr22.41515000.41520000",280000,10,0.007568597,41235000,41515000,41240000,41520000,"chr22",674134,1,3,3,7,"chr22",1,0.00820440693858415
"23622","chr22.30255000.30260000","chr22.30395000.30400000",140000,23,9.039532e-09,30255000,30395000,30260000,30400000,"chr22",674146,0,5,5,10,"chr22",1,0.0269573370839194
"23623","chr22.41400000.41405000","chr22.41465000.41470000",65000,21,0.0006443857,41400000,41465000,41405000,41470000,"chr22",674159,6,10,16,32,"chr22",1,0.0787623066104079
"23624","chr22.28450000.28455000","chr22.28975000.28980000",525000,10,0.0001912227,28450000,28975000,28455000,28980000,"chr22",674166,0,1,1,2,"chr22",1,0.0023441162681669
"23625","chr22.28580000.28585000","chr22.28890000.28895000",310000,12,0.0002449904,28580000,28890000,28585000,28895000,"chr22",674170,5,5,8,18,"chr22",1,0.0253164556962025
"23626","chr22.39250000.39255000","chr22.39510000.39515000",260000,15,7.508977e-06,39250000,39510000,39255000,39515000,"chr22",674171,2,3,6,11,"chr22",1,0.0193389592123769
"23627","chr22.38440000.38445000","chr22.38715000.38720000",275000,12,0.0005461857,38440000,38715000,38445000,38720000,"chr22",674233,3,6,12,21,"chr22",1,0.029535864978903
"23628","chr22.39485000.39490000","chr22.39510000.39515000",25000,31,0.009016804,39485000,39510000,39490000,39515000,"chr22",674235,1,5,2,8,"chr22",1,0.0290670417252696
"23629","chr22.33200000.33205000","chr22.33380000.33385000",180000,13,0.002496001,33200000,33380000,33205000,33385000,"chr22",674241,0,4,0,4,"chr22",1,0.00609470229723394
"23630","chr22.36190000.36195000","chr22.36480000.36485000",290000,11,0.001635352,36190000,36480000,36195000,36485000,"chr22",674252,0,0,3,3,"chr22",1,0.00386779184247539
"23631","chr22.38055000.38060000","chr22.38190000.38195000",135000,15,0.001324582,38055000,38190000,38060000,38195000,"chr22",674253,1,9,7,17,"chr22",1,0.029887482419128
"23632","chr22.37930000.37935000","chr22.37950000.37955000",20000,34,0.004961105,37930000,37950000,37935000,37955000,"chr22",674268,6,11,12,29,"chr22",1,0.115564932020628
"23633","chr22.41350000.41355000","chr22.41525000.41530000",175000,17,1.297854e-05,41350000,41525000,41355000,41530000,"chr22",674283,0,1,1,2,"chr22",1,0.00398499765588373
"23634","chr22.39315000.39320000","chr22.39555000.39560000",240000,12,0.001352461,39315000,39555000,39320000,39560000,"chr22",674288,0,3,2,5,"chr22",1,0.0070323488045007
"23635","chr22.46560000.46565000","chr22.46630000.46635000",70000,19,0.002408535,46560000,46630000,46565000,46635000,"chr22",674295,0,8,5,13,"chr22",1,0.0289498359118612
"23636","chr22.32485000.32490000","chr22.32795000.32800000",310000,10,0.004470966,32485000,32795000,32490000,32800000,"chr22",674298,0,0,3,3,"chr22",1,0.00351617440225035
"23637","chr22.41020000.41025000","chr22.41300000.41305000",280000,10,0.007568597,41020000,41300000,41025000,41305000,"chr22",674309,4,17,12,33,"chr22",1,0.0386779184247539
"23638","chr22.39430000.39435000","chr22.39455000.39460000",25000,33,0.002429394,39430000,39455000,39435000,39460000,"chr22",674315,0,0,2,2,"chr22",1,0.00773558368495077
"23639","chr22.41500000.41505000","chr22.41530000.41535000",30000,35,2.060942e-05,41500000,41530000,41505000,41535000,"chr22",674322,2,7,7,16,"chr22",1,0.0656352555086732
"23640","chr22.30075000.30080000","chr22.30395000.30400000",320000,12,0.0001955526,30075000,30395000,30080000,30400000,"chr22",674367,0,5,5,10,"chr22",1,0.0140646976090014
"23641","chr22.30005000.30010000","chr22.30410000.30415000",405000,12,3.755956e-05,30005000,30410000,30010000,30415000,"chr22",674424,2,1,6,9,"chr22",1,0.0126582278481013
"23642","chr22.33240000.33245000","chr22.33600000.33605000",360000,9,0.008387263,33240000,33600000,33245000,33605000,"chr22",674447,0,0,2,2,"chr22",1,0.00210970464135021
"23643","chr22.41350000.41355000","chr22.41515000.41520000",165000,14,0.001284656,41350000,41515000,41355000,41520000,"chr22",674468,3,14,16,33,"chr22",1,0.0541490857946554
"23644","chr22.30400000.30405000","chr22.30480000.30485000",80000,25,4.567621e-07,30400000,30480000,30405000,30485000,"chr22",674476,6,17,14,37,"chr22",1,0.108415377402719
"23645","chr22.21920000.21925000","chr22.21980000.21985000",60000,30,3.959135e-08,21920000,21980000,21925000,21985000,"chr22",674501,0,7,5,12,"chr22",1,0.0421940928270042
"23646","chr22.41795000.41800000","chr22.41910000.41915000",115000,77,6.126192e-64,41795000,41910000,41800000,41915000,"chr22",674533,0,2,0,2,"chr22",1,0.0180496952648851
"23647","chr22.30760000.30765000","chr22.31160000.31165000",400000,9,0.005001296,30760000,31160000,30765000,31165000,"chr22",674536,3,17,15,35,"chr22",1,0.0369198312236287
"23648","chr22.40855000.40860000","chr22.40920000.40925000",65000,24,2.384147e-05,40855000,40920000,40860000,40925000,"chr22",674551,6,13,19,38,"chr22",1,0.106891701828411
"23649","chr22.38210000.38215000","chr22.38260000.38265000",50000,41,1.368962e-13,38210000,38260000,38215000,38265000,"chr22",674575,0,7,4,11,"chr22",1,0.0528598218471636
"23650","chr22.39950000.39955000","chr22.40710000.40715000",760000,7,0.004272602,39950000,40710000,39955000,40715000,"chr22",674604,3,7,1,11,"chr22",1,0.00902484763244257
"23651","chr22.26460000.26465000","chr22.26480000.26485000",20000,41,2.722559e-05,26460000,26480000,26465000,26485000,"chr22",674617,0,0,3,3,"chr22",1,0.0144163150492264
"23652","chr22.17895000.17900000","chr22.17910000.17915000",15000,33,0.009136658,17895000,17910000,17900000,17915000,"chr22",674628,0,2,1,3,"chr22",1,0.0116033755274262
"23653","chr22.33920000.33925000","chr22.33970000.33975000",50000,21,0.006788298,33920000,33970000,33925000,33975000,"chr22",674642,0,1,4,5,"chr22",1,0.0123066104078762
"23654","chr22.39405000.39410000","chr22.39500000.39505000",95000,18,0.0005023736,39405000,39500000,39410000,39505000,"chr22",674666,1,3,3,7,"chr22",1,0.0147679324894515
"23655","chr22.41020000.41025000","chr22.41350000.41355000",330000,11,0.0007614463,41020000,41350000,41025000,41355000,"chr22",674676,5,14,12,31,"chr22",1,0.0399671823722457
"23656","chr22.17560000.17565000","chr22.17940000.17945000",380000,9,0.006464769,17560000,17940000,17565000,17945000,"chr22",674722,3,14,9,26,"chr22",1,0.0274261603375527
"23657","chr22.39405000.39410000","chr22.39490000.39495000",85000,24,8.093556e-07,39405000,39490000,39410000,39495000,"chr22",674754,0,3,0,3,"chr22",1,0.00843881856540084
"23658","chr22.41020000.41025000","chr22.41285000.41290000",265000,11,0.002824053,41020000,41285000,41025000,41290000,"chr22",674767,3,20,8,31,"chr22",1,0.0399671823722457
"23659","chr22.40675000.40680000","chr22.40750000.40755000",75000,17,0.008927889,40675000,40750000,40680000,40755000,"chr22",674775,1,8,13,22,"chr22",1,0.0438349742147211
"23660","chr22.17570000.17575000","chr22.17635000.17640000",65000,26,2.104982e-06,17570000,17635000,17575000,17640000,"chr22",674780,9,33,30,72,"chr22",1,0.219409282700422
"23661","chr22.41350000.41355000","chr22.41505000.41510000",155000,15,0.0005516541,41350000,41505000,41355000,41510000,"chr22",674790,8,14,16,38,"chr22",1,0.0668073136427567
"23662","chr22.39185000.39190000","chr22.39555000.39560000",370000,9,0.007335908,39185000,39555000,39190000,39560000,"chr22",674801,1,3,2,6,"chr22",1,0.00632911392405063
"23663","chr22.38195000.38200000","chr22.38270000.38275000",75000,19,0.00132059,38195000,38270000,38200000,38275000,"chr22",674820,0,6,3,9,"chr22",1,0.020042194092827
"23664","chr22.43175000.43180000","chr22.43485000.43490000",310000,32,8.732667e-24,43175000,43485000,43180000,43490000,"chr22",674821,0,1,2,3,"chr22",1,0.0112517580872011
"23665","chr22.41560000.41565000","chr22.41585000.41590000",25000,34,0.001204568,41560000,41585000,41565000,41590000,"chr22",674828,0,1,9,10,"chr22",1,0.0398499765588373
"23666","chr22.40865000.40870000","chr22.41075000.41080000",210000,13,0.0008830862,40865000,41075000,40870000,41080000,"chr22",674849,9,19,19,47,"chr22",1,0.0716127519924988
"23667","chr22.44035000.44040000","chr22.44125000.44130000",90000,23,1.586115e-06,44035000,44125000,44040000,44130000,"chr22",674853,1,2,3,6,"chr22",1,0.0161744022503516
"23668","chr22.22075000.22080000","chr22.22295000.22300000",220000,12,0.002427979,22075000,22295000,22080000,22300000,"chr22",674866,0,1,4,5,"chr22",1,0.0070323488045007
"23669","chr22.30015000.30020000","chr22.30480000.30485000",465000,20,2.105498e-13,30015000,30480000,30020000,30485000,"chr22",674869,5,6,9,20,"chr22",1,0.046882325363338
"23670","chr22.41350000.41355000","chr22.41855000.41860000",505000,9,0.001368342,41350000,41855000,41355000,41860000,"chr22",674876,8,14,16,38,"chr22",1,0.040084388185654
"23671","chr22.42230000.42235000","chr22.42255000.42260000",25000,40,8.679682e-06,42230000,42255000,42235000,42260000,"chr22",674878,3,6,7,16,"chr22",1,0.0750117205813408
"23672","chr22.41830000.41835000","chr22.41910000.41915000",80000,18,0.002135357,41830000,41910000,41835000,41915000,"chr22",674900,0,2,0,2,"chr22",1,0.00421940928270042
"23673","chr22.41795000.41800000","chr22.41940000.41945000",145000,14,0.002824053,41795000,41940000,41800000,41945000,"chr22",674912,2,15,9,26,"chr22",1,0.0426629160806376
"23674","chr22.40675000.40680000","chr22.41035000.41040000",360000,14,2.53809e-06,40675000,41035000,40680000,41040000,"chr22",674944,1,15,13,29,"chr22",1,0.0475855602437881
"23675","chr22.17835000.17840000","chr22.17920000.17925000",85000,19,0.000438336,17835000,17920000,17840000,17925000,"chr22",674957,1,3,1,5,"chr22",1,0.0111345522737928
"23676","chr22.38210000.38215000","chr22.38245000.38250000",35000,37,9.832886e-08,38210000,38245000,38215000,38250000,"chr22",674970,3,7,4,14,"chr22",1,0.0607126113455227
"23677","chr22.41800000.41805000","chr22.41855000.41860000",55000,29,5.573145e-07,41800000,41855000,41805000,41860000,"chr22",674995,8,21,33,62,"chr22",1,0.210736052508204
"23678","chr22.41680000.41685000","chr22.41920000.41925000",240000,11,0.004980044,41680000,41920000,41685000,41925000,"chr22",675014,7,8,23,38,"chr22",1,0.0489920300046882
"23679","chr22.42645000.42650000","chr22.42865000.42870000",220000,11,0.008274323,42645000,42865000,42650000,42870000,"chr22",675025,5,14,14,33,"chr22",1,0.0425457102672293
"23680","chr22.41350000.41355000","chr22.41860000.41865000",510000,11,3.803946e-05,41350000,41860000,41355000,41865000,"chr22",675084,7,14,16,37,"chr22",1,0.0477027660571964
"23681","chr22.41410000.41415000","chr22.41475000.41480000",65000,23,7.5407e-05,41410000,41475000,41415000,41480000,"chr22",675090,0,6,5,11,"chr22",1,0.0296530707923113
"23682","chr22.29090000.29095000","chr22.29110000.29115000",20000,34,0.004961105,29090000,29110000,29095000,29115000,"chr22",675097,1,3,3,7,"chr22",1,0.0278949835911861
"23683","chr22.30085000.30090000","chr22.30485000.30490000",400000,13,6.713939e-06,30085000,30485000,30090000,30490000,"chr22",675102,1,10,8,19,"chr22",1,0.0289498359118612
"23684","chr22.29245000.29250000","chr22.29465000.29470000",220000,14,0.0001528684,29245000,29465000,29250000,29470000,"chr22",675103,6,7,11,24,"chr22",1,0.0393811533052039
"23685","chr22.30015000.30020000","chr22.30485000.30490000",470000,12,1.11365e-05,30015000,30485000,30020000,30490000,"chr22",675113,5,6,8,19,"chr22",1,0.0267229254571027
"23686","chr22.41535000.41540000","chr22.41760000.41765000",225000,11,0.007230084,41535000,41760000,41540000,41765000,"chr22",675128,6,24,21,51,"chr22",1,0.0657524613220816
"23687","chr22.17855000.17860000","chr22.17955000.17960000",100000,26,4.395383e-09,17855000,17955000,17860000,17960000,"chr22",675156,0,0,3,3,"chr22",1,0.00914205344585091
"23688","chr22.22060000.22065000","chr22.22210000.22215000",150000,13,0.007059049,22060000,22210000,22065000,22215000,"chr22",675158,0,3,7,10,"chr22",1,0.0152367557430849
"23689","chr22.37930000.37935000","chr22.37965000.37970000",35000,45,3.961856e-12,37930000,37965000,37935000,37970000,"chr22",675159,2,4,3,9,"chr22",1,0.0474683544303797
"23690","chr22.19100000.19105000","chr22.19445000.19450000",345000,9,0.009975485,19100000,19445000,19105000,19450000,"chr22",675171,8,15,21,44,"chr22",1,0.0464135021097046
"23691","chr22.31155000.31160000","chr22.31310000.31315000",155000,18,8.864919e-06,31155000,31310000,31160000,31315000,"chr22",675183,6,22,18,46,"chr22",1,0.0970464135021097
"23692","chr22.28355000.28360000","chr22.29265000.29270000",910000,7,0.001446781,28355000,29265000,28360000,29270000,"chr22",675187,1,1,2,4,"chr22",1,0.00328176277543366
"23693","chr22.31565000.31570000","chr22.31630000.31635000",65000,19,0.004411413,31565000,31630000,31570000,31635000,"chr22",675216,4,5,21,30,"chr22",1,0.0668073136427567
"23694","chr22.41480000.41485000","chr22.41665000.41670000",185000,13,0.002106068,41480000,41665000,41485000,41670000,"chr22",675226,6,22,12,40,"chr22",1,0.0609470229723394
"23695","chr22.41365000.41370000","chr22.41475000.41480000",110000,16,0.001537107,41365000,41475000,41370000,41480000,"chr22",675238,1,3,4,8,"chr22",1,0.0150023441162682
"23696","chr22.28440000.28445000","chr22.28975000.28980000",535000,10,0.0001680228,28440000,28975000,28445000,28980000,"chr22",675251,0,2,1,3,"chr22",1,0.00351617440225035
"23697","chr22.39955000.39960000","chr22.40425000.40430000",470000,13,1.57242e-06,39955000,40425000,39960000,40430000,"chr22",675253,2,1,1,4,"chr22",1,0.00609470229723394
"23698","chr22.41350000.41355000","chr22.41665000.41670000",315000,12,0.0002185896,41350000,41665000,41355000,41670000,"chr22",675260,8,14,16,38,"chr22",1,0.0534458509142053
"23699","chr22.42090000.42095000","chr22.42270000.42275000",180000,14,0.000702072,42090000,42270000,42095000,42275000,"chr22",675267,2,3,1,6,"chr22",1,0.00984528832630099
"23700","chr22.37965000.37970000","chr22.37985000.37990000",20000,48,4.139542e-08,37965000,37985000,37970000,37990000,"chr22",675270,0,4,3,7,"chr22",1,0.0393811533052039
"23701","chr22.39545000.39550000","chr22.39725000.39730000",180000,27,1.315324e-13,39545000,39725000,39550000,39730000,"chr22",675287,2,3,2,7,"chr22",1,0.0221518987341772
"23702","chr22.20010000.20015000","chr22.20060000.20065000",50000,42,3.009189e-14,20010000,20060000,20015000,20065000,"chr22",675304,0,7,5,12,"chr22",1,0.0590717299578059
"23703","chr22.41480000.41485000","chr22.41535000.41540000",55000,22,0.001247915,41480000,41535000,41485000,41540000,"chr22",675317,6,22,12,40,"chr22",1,0.103141115799344
"23704","chr22.20855000.20860000","chr22.20915000.20920000",60000,22,0.0005233012,20855000,20915000,20860000,20920000,"chr22",675321,1,11,7,19,"chr22",1,0.0489920300046882
"23705","chr22.38570000.38575000","chr22.38715000.38720000",145000,22,3.193079e-08,38570000,38715000,38575000,38720000,"chr22",675327,3,6,8,17,"chr22",1,0.0438349742147211
"23706","chr22.30330000.30335000","chr22.30390000.30395000",60000,22,0.0005233012,30330000,30390000,30335000,30395000,"chr22",675336,3,6,4,13,"chr22",1,0.0335208626347867
"23707","chr22.40665000.40670000","chr22.40750000.40755000",85000,16,0.009169427,40665000,40750000,40670000,40755000,"chr22",675351,2,8,13,23,"chr22",1,0.043131739334271
"23708","chr22.17720000.17725000","chr22.17955000.17960000",235000,14,8.953319e-05,17720000,17955000,17725000,17960000,"chr22",675353,0,18,21,39,"chr22",1,0.0639943741209564
"23709","chr22.28450000.28455000","chr22.28895000.28900000",445000,11,0.0001071318,28450000,28895000,28455000,28900000,"chr22",675361,0,1,1,2,"chr22",1,0.00257852789498359
"23710","chr22.36250000.36255000","chr22.36275000.36280000",25000,41,3.422522e-06,36250000,36275000,36255000,36280000,"chr22",675389,1,5,2,8,"chr22",1,0.0384435067979372
"23711","chr22.36235000.36240000","chr22.36275000.36280000",40000,23,0.009169427,36235000,36275000,36240000,36280000,"chr22",675395,1,5,2,8,"chr22",1,0.0215658696671355
"23712","chr22.41380000.41385000","chr22.41585000.41590000",205000,12,0.003731101,41380000,41585000,41385000,41590000,"chr22",675417,0,6,2,8,"chr22",1,0.0112517580872011
"23713","chr22.41500000.41505000","chr22.41940000.41945000",440000,9,0.003071297,41500000,41940000,41505000,41945000,"chr22",675419,7,20,15,42,"chr22",1,0.0443037974683544
"23714","chr22.41500000.41505000","chr22.41560000.41565000",60000,22,0.0005233012,41500000,41560000,41505000,41565000,"chr22",675452,0,1,9,10,"chr22",1,0.0257852789498359
"23715","chr22.17560000.17565000","chr22.17955000.17960000",395000,13,7.420907e-06,17560000,17955000,17565000,17960000,"chr22",675453,0,18,23,41,"chr22",1,0.0624706985466479
"23716","chr22.30330000.30335000","chr22.30395000.30400000",65000,28,1.565037e-07,30330000,30395000,30335000,30400000,"chr22",675479,0,5,5,10,"chr22",1,0.0328176277543366
"23717","chr22.30395000.30400000","chr22.30420000.30425000",25000,36,0.0002583265,30395000,30420000,30400000,30425000,"chr22",675483,0,2,1,3,"chr22",1,0.0126582278481013
"23718","chr22.41325000.41330000","chr22.41555000.41560000",230000,13,0.0004650823,41325000,41555000,41330000,41560000,"chr22",675499,1,7,7,15,"chr22",1,0.0228551336146273
"23719","chr22.31800000.31805000","chr22.31855000.31860000",55000,20,0.007230084,31800000,31855000,31805000,31860000,"chr22",675509,6,19,20,45,"chr22",1,0.105485232067511
"23720","chr22.41350000.41355000","chr22.41680000.41685000",330000,13,2.995425e-05,41350000,41680000,41355000,41685000,"chr22",675529,7,14,16,37,"chr22",1,0.056375996249414
"23721","chr22.41365000.41370000","chr22.41415000.41420000",50000,22,0.002962451,41365000,41415000,41370000,41420000,"chr22",675541,1,3,4,8,"chr22",1,0.0206282231598687
"23722","chr22.31155000.31160000","chr22.31290000.31295000",135000,19,6.840724e-06,31155000,31290000,31160000,31295000,"chr22",675547,1,13,12,26,"chr22",1,0.0578996718237225
"23723","chr22.41350000.41355000","chr22.41410000.41415000",60000,38,2.385315e-13,41350000,41410000,41355000,41415000,"chr22",675607,0,6,5,11,"chr22",1,0.0489920300046882
"23724","chr22.39400000.39405000","chr22.39725000.39730000",325000,11,0.0008320611,39400000,39725000,39405000,39730000,"chr22",675651,2,3,2,7,"chr22",1,0.00902484763244257
"23725","chr22.38520000.38525000","chr22.38680000.38685000",160000,13,0.00496831,38520000,38680000,38525000,38685000,"chr22",675666,5,10,7,22,"chr22",1,0.0335208626347867
"23726","chr22.29780000.29785000","chr22.30480000.30485000",700000,8,0.00114435,29780000,30480000,29785000,30485000,"chr22",675667,5,10,3,18,"chr22",1,0.0168776371308017
"23727","chr22.17570000.17575000","chr22.18105000.18110000",535000,10,0.0001680228,17570000,18105000,17575000,18110000,"chr22",675671,0,5,3,8,"chr22",1,0.00937646507266761
"23728","chr22.41285000.41290000","chr22.41515000.41520000",230000,12,0.001812437,41285000,41515000,41290000,41520000,"chr22",675687,3,16,8,27,"chr22",1,0.0379746835443038
"23729","chr22.37930000.37935000","chr22.38000000.38005000",70000,18,0.006078377,37930000,3.8e+07,37935000,38005000,"chr22",675691,6,11,12,29,"chr22",1,0.0611814345991561
"23730","chr22.40435000.40440000","chr22.40675000.40680000",240000,11,0.004980044,40435000,40675000,40440000,40680000,"chr22",675710,0,5,5,10,"chr22",1,0.012892639474918
"23731","chr22.42090000.42095000","chr22.42180000.42185000",90000,19,0.0002575645,42090000,42180000,42095000,42185000,"chr22",675774,2,16,8,26,"chr22",1,0.0578996718237225
"23732","chr22.29040000.29045000","chr22.29110000.29115000",70000,20,0.0008801365,29040000,29110000,29045000,29115000,"chr22",675789,1,3,3,7,"chr22",1,0.0164088138771683
"23733","chr22.39955000.39960000","chr22.40595000.40600000",640000,8,0.001867701,39955000,40595000,39960000,40600000,"chr22",675833,6,7,11,24,"chr22",1,0.0225035161744023
"23734","chr22.42180000.42185000","chr22.42865000.42870000",685000,7,0.00698087,42180000,42865000,42185000,42870000,"chr22",675852,4,14,9,27,"chr22",1,0.0221518987341772
"23735","chr22.26610000.26615000","chr22.26645000.26650000",35000,25,0.008387263,26610000,26645000,26615000,26650000,"chr22",675876,0,3,0,3,"chr22",1,0.00879043600562588
"23736","chr22.28440000.28445000","chr22.28795000.28800000",355000,10,0.002246081,28440000,28795000,28445000,28800000,"chr22",675900,0,2,1,3,"chr22",1,0.00351617440225035
"23737","chr22.40490000.40495000","chr22.40675000.40680000",185000,14,0.0005807213,40490000,40675000,40495000,40680000,"chr22",675908,1,2,7,10,"chr22",1,0.0164088138771683
"23738","chr22.30015000.30020000","chr22.30390000.30395000",375000,15,2.515814e-07,30015000,30390000,30020000,30395000,"chr22",675912,3,6,4,13,"chr22",1,0.0228551336146273
"23739","chr22.17560000.17565000","chr22.17635000.17640000",75000,27,7.142557e-08,17560000,17635000,17565000,17640000,"chr22",675926,6,31,23,60,"chr22",1,0.189873417721519
"23740","chr22.38470000.38475000","chr22.38735000.38740000",265000,10,0.009885447,38470000,38735000,38475000,38740000,"chr22",675937,2,1,1,4,"chr22",1,0.0046882325363338
"23741","chr22.39980000.39985000","chr22.40360000.40365000",380000,9,0.006464769,39980000,40360000,39985000,40365000,"chr22",675942,4,14,21,39,"chr22",1,0.0411392405063291
"23742","chr22.17865000.17870000","chr22.17940000.17945000",75000,18,0.003540361,17865000,17940000,17870000,17945000,"chr22",675943,3,12,2,17,"chr22",1,0.0358649789029536
"23743","chr22.41515000.41520000","chr22.41535000.41540000",20000,43,4.869486e-06,41515000,41535000,41520000,41540000,"chr22",675947,3,16,16,35,"chr22",1,0.176394749179559
"23744","chr22.19145000.19150000","chr22.19290000.19295000",145000,13,0.008387263,19145000,19290000,19150000,19295000,"chr22",675964,0,3,2,5,"chr22",1,0.00761837787154243
"23745","chr22.41325000.41330000","chr22.41530000.41535000",205000,15,6.292341e-05,41325000,41530000,41330000,41535000,"chr22",675968,2,7,7,16,"chr22",1,0.0281293952180028
"23746","chr22.29765000.29770000","chr22.30410000.30415000",645000,7,0.009136658,29765000,30410000,29770000,30415000,"chr22",675982,7,9,10,26,"chr22",1,0.0213314580403188
"23747","chr22.20025000.20030000","chr22.20060000.20065000",35000,40,2.733355e-09,20025000,20060000,20030000,20065000,"chr22",675987,6,19,19,44,"chr22",1,0.206282231598687
"23748","chr22.41305000.41310000","chr22.41325000.41330000",20000,43,4.869486e-06,41305000,41325000,41310000,41330000,"chr22",676039,3,7,7,17,"chr22",1,0.0856774496015002
"23749","chr22.30005000.30010000","chr22.30455000.30460000",450000,11,9.860442e-05,30005000,30455000,30010000,30460000,"chr22",676048,2,1,6,9,"chr22",1,0.0116033755274262
"23750","chr22.41285000.41290000","chr22.41325000.41330000",40000,25,0.001925366,41285000,41325000,41290000,41330000,"chr22",676082,3,7,7,17,"chr22",1,0.0498124706985466
"23751","chr22.41440000.41445000","chr22.41475000.41480000",35000,27,0.001861379,41440000,41475000,41445000,41480000,"chr22",676148,7,29,17,53,"chr22",1,0.167721518987342
"23752","chr22.28510000.28515000","chr22.28975000.28980000",465000,9,0.002258492,28510000,28975000,28515000,28980000,"chr22",676159,3,14,11,28,"chr22",1,0.029535864978903
"23753","chr22.41795000.41800000","chr22.41855000.41860000",60000,26,6.406586e-06,41795000,41855000,41800000,41860000,"chr22",676166,2,15,9,26,"chr22",1,0.0792311298640413
"23754","chr22.40980000.40985000","chr22.41285000.41290000",305000,10,0.004898442,40980000,41285000,40985000,41290000,"chr22",676170,3,21,8,32,"chr22",1,0.0375058602906704
"23755","chr22.28450000.28455000","chr22.29150000.29155000",700000,7,0.006307246,28450000,29150000,28455000,29155000,"chr22",676191,0,1,1,2,"chr22",1,0.00164088138771683
"23756","chr22.36590000.36595000","chr22.36655000.36660000",65000,27,5.839264e-07,36590000,36655000,36595000,36660000,"chr22",676215,0,1,1,2,"chr22",1,0.00632911392405063
"23757","chr22.39185000.39190000","chr22.39545000.39550000",360000,10,0.002087052,39185000,39545000,39190000,39550000,"chr22",676227,5,5,9,19,"chr22",1,0.0222691045475856
"23758","chr22.19930000.19935000","chr22.20015000.20020000",85000,17,0.003561074,19930000,20015000,19935000,20020000,"chr22",676257,0,3,0,3,"chr22",1,0.0059774964838256
"23759","chr22.40635000.40640000","chr22.41020000.41025000",385000,9,0.006099697,40635000,41020000,40640000,41025000,"chr22",676290,0,2,7,9,"chr22",1,0.00949367088607595
"23760","chr22.29265000.29270000","chr22.29290000.29295000",25000,35,0.0005622099,29265000,29290000,29270000,29295000,"chr22",676350,1,4,13,18,"chr22",1,0.0738396624472574
"23761","chr22.31810000.31815000","chr22.31870000.31875000",60000,26,6.406586e-06,31810000,31870000,31815000,31875000,"chr22",676363,0,9,8,17,"chr22",1,0.0518049695264885
"23762","chr22.17855000.17860000","chr22.17890000.17895000",35000,38,3.093577e-08,17855000,17890000,17860000,17895000,"chr22",676392,1,0,3,4,"chr22",1,0.0178152836380684
"23763","chr22.39555000.39560000","chr22.39715000.39720000",160000,26,6.536156e-12,39555000,39715000,39560000,39720000,"chr22",676397,1,3,2,6,"chr22",1,0.0182841068917018
"23764","chr22.50325000.50330000","chr22.50415000.50420000",90000,31,6.130145e-12,50325000,50415000,50330000,50420000,"chr22",676405,1,7,7,15,"chr22",1,0.0545007032348805
"23765","chr22.38565000.38570000","chr22.38680000.38685000",115000,14,0.009570719,38565000,38680000,38570000,38685000,"chr22",676411,0,6,2,8,"chr22",1,0.0131270511017346
"23766","chr22.41500000.41505000","chr22.41545000.41550000",45000,26,0.0002076745,41500000,41545000,41505000,41550000,"chr22",676424,7,25,15,47,"chr22",1,0.143225503984998
"23767","chr22.41020000.41025000","chr22.41515000.41520000",495000,8,0.007231147,41020000,41515000,41025000,41520000,"chr22",676427,3,16,12,31,"chr22",1,0.0290670417252696
"23768","chr22.30075000.30080000","chr22.30425000.30430000",350000,12,0.0001070397,30075000,30425000,30080000,30430000,"chr22",676441,2,4,1,7,"chr22",1,0.00984528832630099
"23769","chr22.50360000.50365000","chr22.50415000.50420000",55000,39,3.540728e-13,50360000,50415000,50365000,50420000,"chr22",676462,1,7,6,14,"chr22",1,0.0639943741209564
"23770","chr22.41500000.41505000","chr22.41680000.41685000",180000,12,0.007976258,41500000,41680000,41505000,41685000,"chr22",676487,7,25,15,47,"chr22",1,0.0661040787623066
"23771","chr22.42550000.42555000","chr22.42855000.42860000",305000,12,0.0002695156,42550000,42855000,42555000,42860000,"chr22",676494,3,9,16,28,"chr22",1,0.0393811533052039
"23772","chr22.30175000.30180000","chr22.30390000.30395000",215000,11,0.009169427,30175000,30390000,30180000,30395000,"chr22",676498,3,1,3,7,"chr22",1,0.00902484763244257
"23773","chr22.39950000.39955000","chr22.40360000.40365000",410000,9,0.004441243,39950000,40360000,39955000,40365000,"chr22",676520,3,7,1,11,"chr22",1,0.0116033755274262
"23774","chr22.39435000.39440000","chr22.39485000.39490000",50000,22,0.002962451,39435000,39485000,39440000,39490000,"chr22",676535,1,5,2,8,"chr22",1,0.0206282231598687
"23775","chr22.42580000.42585000","chr22.42660000.42665000",80000,21,7.77697e-05,42580000,42660000,42585000,42665000,"chr22",676545,5,11,11,27,"chr22",1,0.0664556962025316
"23776","chr22.41510000.41515000","chr22.41560000.41565000",50000,24,0.0004738486,41510000,41560000,41515000,41565000,"chr22",676563,0,1,6,7,"chr22",1,0.019690576652602
"23777","chr22.29040000.29045000","chr22.29265000.29270000",225000,12,0.002106068,29040000,29265000,29045000,29270000,"chr22",676572,1,4,10,15,"chr22",1,0.0210970464135021
"23778","chr22.50415000.50420000","chr22.50560000.50565000",145000,14,0.002824053,50415000,50560000,50420000,50565000,"chr22",676575,1,7,6,14,"chr22",1,0.0229723394280356
"23779","chr22.19100000.19105000","chr22.19290000.19295000",190000,16,2.749533e-05,19100000,19290000,19105000,19295000,"chr22",676602,0,3,2,5,"chr22",1,0.00937646507266761
"23780","chr22.19205000.19210000","chr22.19290000.19295000",85000,19,0.000438336,19205000,19290000,19210000,19295000,"chr22",676621,0,3,2,5,"chr22",1,0.0111345522737928
"23781","chr22.17890000.17895000","chr22.17955000.17960000",65000,24,2.384147e-05,17890000,17955000,17895000,17960000,"chr22",676637,0,6,5,11,"chr22",1,0.0309423347398031
"23782","chr22.30005000.30010000","chr22.30590000.30595000",585000,9,0.0005534384,30005000,30590000,30010000,30595000,"chr22",676653,2,1,6,9,"chr22",1,0.00949367088607595
"23783","chr22.31160000.31165000","chr22.31310000.31315000",150000,16,0.0001895536,31160000,31310000,31165000,31315000,"chr22",676669,3,22,15,40,"chr22",1,0.0750117205813408
"23784","chr22.41560000.41565000","chr22.41680000.41685000",120000,14,0.007734492,41560000,41680000,41565000,41685000,"chr22",676676,0,1,9,10,"chr22",1,0.0164088138771683
"23785","chr22.38715000.38720000","chr22.38750000.38755000",35000,26,0.004071823,38715000,38750000,38720000,38755000,"chr22",676712,1,6,4,11,"chr22",1,0.0335208626347867
"23786","chr22.38570000.38575000","chr22.38680000.38685000",110000,15,0.004533004,38570000,38680000,38575000,38685000,"chr22",676718,4,10,7,21,"chr22",1,0.0369198312236287
"23787","chr22.46045000.46050000","chr22.46265000.46270000",220000,11,0.008274323,46045000,46265000,46050000,46270000,"chr22",676727,2,14,10,26,"chr22",1,0.0335208626347867
"23788","chr22.28510000.28515000","chr22.28915000.28920000",405000,9,0.004744512,28510000,28915000,28515000,28920000,"chr22",676764,3,19,12,34,"chr22",1,0.0358649789029536
"23789","chr22.36730000.36735000","chr22.36780000.36785000",50000,31,1.941189e-07,36730000,36780000,36735000,36785000,"chr22",676768,1,2,4,7,"chr22",1,0.0254336615096109
"23790","chr22.42515000.42520000","chr22.42865000.42870000",350000,9,0.009341668,42515000,42865000,42520000,42870000,"chr22",676790,0,10,6,16,"chr22",1,0.0168776371308017
"23791","chr22.30015000.30020000","chr22.30330000.30335000",315000,11,0.00101238,30015000,30330000,30020000,30335000,"chr22",676791,3,6,9,18,"chr22",1,0.0232067510548523
"23792","chr22.38305000.38310000","chr22.38335000.38340000",30000,29,0.003132604,38305000,38335000,38310000,38340000,"chr22",676803,3,10,14,27,"chr22",1,0.0917721518987342
"23793","chr22.29470000.29475000","chr22.29550000.29555000",80000,17,0.005654572,29470000,29550000,29475000,29555000,"chr22",676873,6,5,4,15,"chr22",1,0.029887482419128
"23794","chr22.41235000.41240000","chr22.41555000.41560000",320000,10,0.003814055,41235000,41555000,41240000,41560000,"chr22",676894,1,3,3,7,"chr22",1,0.00820440693858415
"23795","chr22.38680000.38685000","chr22.38700000.38705000",20000,42,1.16894e-05,38680000,38700000,38685000,38705000,"chr22",676898,2,8,7,17,"chr22",1,0.0836849507735584
"23796","chr22.38570000.38575000","chr22.38700000.38705000",130000,14,0.005009774,38570000,38700000,38575000,38705000,"chr22",676904,2,8,8,18,"chr22",1,0.029535864978903
"23797","chr22.39185000.39190000","chr22.39315000.39320000",130000,18,3.803946e-05,39185000,39315000,39190000,39320000,"chr22",676906,0,6,4,10,"chr22",1,0.0210970464135021
"23798","chr22.23145000.23150000","chr22.23305000.23310000",160000,13,0.00496831,23145000,23305000,23150000,23310000,"chr22",676908,3,6,4,13,"chr22",1,0.0198077824660103
"23799","chr22.41855000.41860000","chr22.41910000.41915000",55000,20,0.007230084,41855000,41910000,41860000,41915000,"chr22",676920,0,2,0,2,"chr22",1,0.0046882325363338
"23800","chr22.30075000.30080000","chr22.30390000.30395000",315000,15,1.280769e-06,30075000,30390000,30080000,30395000,"chr22",676932,2,6,4,12,"chr22",1,0.0210970464135021
"23801","chr22.23750000.23755000","chr22.23855000.23860000",105000,15,0.006089166,23750000,23855000,23755000,23860000,"chr22",676971,0,3,3,6,"chr22",1,0.0105485232067511
"23802","chr22.50415000.50420000","chr22.50475000.50480000",60000,20,0.003540361,50415000,50475000,50420000,50480000,"chr22",676982,1,7,7,15,"chr22",1,0.0351617440225035
"23803","chr22.30255000.30260000","chr22.30390000.30395000",135000,17,0.0001084025,30255000,30390000,30260000,30395000,"chr22",677042,3,6,4,13,"chr22",1,0.0259024847632443
"23804","chr22.38050000.38055000","chr22.38070000.38075000",20000,38,0.0003031305,38050000,38070000,38055000,38075000,"chr22",677090,0,7,7,14,"chr22",1,0.0623534927332396
"23805","chr22.31080000.31085000","chr22.31155000.31160000",75000,17,0.008927889,31080000,31155000,31085000,31160000,"chr22",677099,0,3,1,4,"chr22",1,0.00796999531176746
"23806","chr22.17845000.17850000","chr22.17910000.17915000",65000,28,1.565037e-07,17845000,17910000,17850000,17915000,"chr22",677108,5,6,1,12,"chr22",1,0.0393811533052039
"23807","chr22.41195000.41200000","chr22.41285000.41290000",90000,16,0.006287205,41195000,41285000,41200000,41290000,"chr22",677115,3,12,8,23,"chr22",1,0.043131739334271
"23808","chr22.38570000.38575000","chr22.38730000.38735000",160000,15,0.0004459218,38570000,38730000,38575000,38735000,"chr22",677123,0,4,1,5,"chr22",1,0.00879043600562588
"23809","chr22.22060000.22065000","chr22.22295000.22300000",235000,15,1.91338e-05,22060000,22295000,22065000,22300000,"chr22",677132,0,1,4,5,"chr22",1,0.00879043600562588
"23810","chr22.17720000.17725000","chr22.18000000.18005000",280000,13,0.0001042902,17720000,1.8e+07,17725000,18005000,"chr22",677146,3,11,10,24,"chr22",1,0.0365682137834037
"23811","chr22.40675000.40680000","chr22.40710000.40715000",35000,27,0.001861379,40675000,40710000,40680000,40715000,"chr22",677149,1,15,13,29,"chr22",1,0.0917721518987342
"23812","chr22.31800000.31805000","chr22.32030000.32035000",230000,11,0.006357752,31800000,32030000,31805000,32035000,"chr22",677181,6,17,13,36,"chr22",1,0.0464135021097046
"23813","chr22.17860000.17865000","chr22.17985000.17990000",125000,16,0.0006555978,17860000,17985000,17865000,17990000,"chr22",677184,0,1,3,4,"chr22",1,0.00750117205813408
"23814","chr22.31645000.31650000","chr22.31675000.31680000",30000,28,0.006307246,31645000,31675000,31650000,31680000,"chr22",677198,9,36,36,81,"chr22",1,0.265822784810127
"23815","chr22.37660000.37665000","chr22.37845000.37850000",185000,12,0.006825847,37660000,37845000,37665000,37850000,"chr22",677202,6,15,18,39,"chr22",1,0.0548523206751055
"23816","chr22.41500000.41505000","chr22.41535000.41540000",35000,25,0.008387263,41500000,41535000,41505000,41540000,"chr22",677239,6,25,15,46,"chr22",1,0.134786685419597
"23817","chr22.24145000.24150000","chr22.24175000.24180000",30000,30,0.001466729,24145000,24175000,24150000,24180000,"chr22",677257,0,1,0,1,"chr22",1,0.00351617440225035
"23818","chr22.38565000.38570000","chr22.38765000.38770000",200000,14,0.0003228688,38565000,38765000,38570000,38770000,"chr22",677260,0,4,2,6,"chr22",1,0.00984528832630099
"23819","chr22.41095000.41100000","chr22.41195000.41200000",100000,17,0.001033145,41095000,41195000,41100000,41200000,"chr22",677279,0,8,10,18,"chr22",1,0.0358649789029536
"23820","chr22.30035000.30040000","chr22.30390000.30395000",355000,10,0.002246081,30035000,30390000,30040000,30395000,"chr22",677293,1,5,4,10,"chr22",1,0.0117205813408345
"23821","chr22.22075000.22080000","chr22.22195000.22200000",120000,15,0.002692994,22075000,22195000,22080000,22200000,"chr22",677306,0,0,3,3,"chr22",1,0.00527426160337553
"23822","chr22.28440000.28445000","chr22.29070000.29075000",630000,8,0.002050795,28440000,29070000,28445000,29075000,"chr22",677307,0,2,1,3,"chr22",1,0.00281293952180028
"23823","chr22.17075000.17080000","chr22.17985000.17990000",910000,6,0.009066607,17075000,17985000,17080000,17990000,"chr22",677317,4,12,8,24,"chr22",1,0.0168776371308017
"23824","chr22.39305000.39310000","chr22.39510000.39515000",205000,16,1.380065e-05,39305000,39510000,39310000,39515000,"chr22",677323,2,9,7,18,"chr22",1,0.0337552742616034
"23825","chr22.41215000.41220000","chr22.41235000.41240000",20000,33,0.009136658,41215000,41235000,41220000,41240000,"chr22",677330,0,3,3,6,"chr22",1,0.0232067510548523
"23826","chr22.50325000.50330000","chr22.50475000.50480000",150000,26,1.693158e-11,50325000,50475000,50330000,50480000,"chr22",677338,5,24,24,53,"chr22",1,0.161509610876699
"23827","chr22.39310000.39315000","chr22.39485000.39490000",175000,12,0.009169427,39310000,39485000,39315000,39490000,"chr22",677350,1,2,2,5,"chr22",1,0.0070323488045007
"23828","chr22.41800000.41805000","chr22.41910000.41915000",110000,56,5.372824e-38,41800000,41910000,41805000,41915000,"chr22",677382,0,2,0,2,"chr22",1,0.0131270511017346
"23829","chr22.41305000.41310000","chr22.41530000.41535000",225000,12,0.002106068,41305000,41530000,41310000,41535000,"chr22",677390,2,7,7,16,"chr22",1,0.0225035161744023
"23830","chr22.41285000.41290000","chr22.41500000.41505000",215000,17,1.732394e-06,41285000,41500000,41290000,41505000,"chr22",677405,3,21,8,32,"chr22",1,0.0637599624941397
"23831","chr22.46025000.46030000","chr22.46295000.46300000",270000,12,0.0006231557,46025000,46295000,46030000,46300000,"chr22",677420,0,5,3,8,"chr22",1,0.0112517580872011
"23832","chr22.37995000.38000000","chr22.38190000.38195000",195000,12,0.005001296,37995000,38190000,3.8e+07,38195000,"chr22",677460,2,0,6,8,"chr22",1,0.0112517580872011
"23833","chr22.32820000.32825000","chr22.33520000.33525000",700000,7,0.006307246,32820000,33520000,32825000,33525000,"chr22",677493,0,3,2,5,"chr22",1,0.00410220346929208
"23834","chr22.27090000.27095000","chr22.28010000.28015000",920000,6,0.0084048,27090000,28010000,27095000,28015000,"chr22",677507,2,2,3,7,"chr22",1,0.00492264416315049
"23835","chr22.41325000.41330000","chr22.41425000.41430000",100000,20,2.706805e-05,41325000,41425000,41330000,41430000,"chr22",677510,3,7,7,17,"chr22",1,0.0398499765588373
"23836","chr22.17570000.17575000","chr22.17955000.17960000",385000,10,0.001413194,17570000,17955000,17575000,17960000,"chr22",677514,0,18,24,42,"chr22",1,0.0492264416315049
"23837","chr22.28430000.28435000","chr22.29145000.29150000",715000,8,0.001010512,28430000,29145000,28435000,29150000,"chr22",677561,0,4,5,9,"chr22",1,0.00843881856540084
"23838","chr22.46050000.46055000","chr22.46120000.46125000",70000,20,0.0008801365,46050000,46120000,46055000,46125000,"chr22",677605,1,0,0,1,"chr22",1,0.0023441162681669
"23839","chr22.41365000.41370000","chr22.41460000.41465000",95000,17,0.001514334,41365000,41460000,41370000,41465000,"chr22",677624,1,3,4,8,"chr22",1,0.0159399906235349
"23840","chr22.41305000.41310000","chr22.41500000.41505000",195000,13,0.001466729,41305000,41500000,41310000,41505000,"chr22",677657,3,20,13,36,"chr22",1,0.0548523206751055
"23841","chr22.20750000.20755000","chr22.20855000.20860000",105000,16,0.002146194,20750000,20855000,20755000,20860000,"chr22",677663,1,7,7,15,"chr22",1,0.0281293952180028
"23842","chr22.42090000.42095000","chr22.42295000.42300000",205000,13,0.001056446,42090000,42295000,42095000,42300000,"chr22",677666,0,2,1,3,"chr22",1,0.00457102672292546
"23843","chr22.41380000.41385000","chr22.41475000.41480000",95000,22,3.225685e-06,41380000,41475000,41385000,41480000,"chr22",677679,0,6,2,8,"chr22",1,0.0206282231598687
"23844","chr22.35775000.35780000","chr22.35930000.35935000",155000,13,0.005978956,35775000,35930000,35780000,35935000,"chr22",677697,3,6,3,12,"chr22",1,0.0182841068917018
"23845","chr22.40565000.40570000","chr22.41240000.41245000",675000,7,0.0074729,40565000,41240000,40570000,41245000,"chr22",677713,7,13,11,31,"chr22",1,0.0254336615096109
"23846","chr22.17835000.17840000","chr22.17955000.17960000",120000,16,0.0008583397,17835000,17955000,17840000,17960000,"chr22",677745,0,18,23,41,"chr22",1,0.0768870135958744
"23847","chr22.41350000.41355000","chr22.41940000.41945000",590000,8,0.002938761,41350000,41940000,41355000,41945000,"chr22",677751,7,14,16,37,"chr22",1,0.0346929207688701
"23848","chr22.38460000.38465000","chr22.38715000.38720000",255000,22,1.464364e-11,38460000,38715000,38465000,38720000,"chr22",677765,3,6,24,33,"chr22",1,0.0850914205344585
"23849","chr22.41305000.41310000","chr22.41535000.41540000",230000,11,0.006357752,41305000,41535000,41310000,41540000,"chr22",677804,3,20,13,36,"chr22",1,0.0464135021097046
"23850","chr22.32180000.32185000","chr22.32200000.32205000",20000,38,0.0003031305,32180000,32200000,32185000,32205000,"chr22",677818,0,2,5,7,"chr22",1,0.0311767463666198
"23851","chr22.28450000.28455000","chr22.28890000.28895000",440000,9,0.003071297,28450000,28890000,28455000,28895000,"chr22",677915,0,1,1,2,"chr22",1,0.00210970464135021
"23852","chr22.30075000.30080000","chr22.30565000.30570000",490000,8,0.007652372,30075000,30565000,30080000,30570000,"chr22",677937,2,10,6,18,"chr22",1,0.0168776371308017
"23853","chr22.29265000.29270000","chr22.29730000.29735000",465000,8,0.009752407,29265000,29730000,29270000,29735000,"chr22",677989,0,0,3,3,"chr22",1,0.00281293952180028
"23854","chr22.39405000.39410000","chr22.39460000.39465000",55000,22,0.001247915,39405000,39460000,39410000,39465000,"chr22",677995,1,6,10,17,"chr22",1,0.0438349742147211
"23855","chr22.36275000.36280000","chr22.36300000.36305000",25000,36,0.0002583265,36275000,36300000,36280000,36305000,"chr22",678008,1,3,2,6,"chr22",1,0.0253164556962025
"23856","chr22.41480000.41485000","chr22.41500000.41505000",20000,33,0.009136658,41480000,41500000,41485000,41505000,"chr22",678011,6,22,12,40,"chr22",1,0.154711673699015
"23857","chr22.38210000.38215000","chr22.38270000.38275000",60000,25,2.061286e-05,38210000,38270000,38215000,38275000,"chr22",678025,0,6,3,9,"chr22",1,0.0263713080168776
"23858","chr22.39245000.39250000","chr22.39520000.39525000",275000,13,0.0001200186,39245000,39520000,39250000,39525000,"chr22",678033,5,13,6,24,"chr22",1,0.0365682137834037
"23859","chr22.39290000.39295000","chr22.39310000.39315000",20000,36,0.001310711,39290000,39310000,39295000,39315000,"chr22",678039,0,1,1,2,"chr22",1,0.00843881856540084
"23860","chr22.39185000.39190000","chr22.39520000.39525000",335000,12,0.0001436542,39185000,39520000,39190000,39525000,"chr22",678043,5,13,6,24,"chr22",1,0.0337552742616034
"23861","chr22.41410000.41415000","chr22.41595000.41600000",185000,13,0.002106068,41410000,41595000,41415000,41600000,"chr22",678052,0,5,3,8,"chr22",1,0.0121894045944679
"23862","chr22.30210000.30215000","chr22.30400000.30405000",190000,24,2.353743e-11,30210000,30400000,30215000,30405000,"chr22",678079,2,2,8,12,"chr22",1,0.0337552742616034
"23863","chr22.31895000.31900000","chr22.31935000.31940000",40000,24,0.004347397,31895000,31935000,31900000,31940000,"chr22",678112,1,8,6,15,"chr22",1,0.0421940928270042
"23864","chr22.42550000.42555000","chr22.42645000.42650000",95000,20,4.587893e-05,42550000,42645000,42555000,42650000,"chr22",678113,3,9,14,26,"chr22",1,0.0609470229723394
"23865","chr22.30000000.30005000","chr22.30650000.30655000",650000,7,0.008927889,3e+07,30650000,30005000,30655000,"chr22",678120,5,15,14,34,"chr22",1,0.0278949835911861
"23866","chr22.31890000.31895000","chr22.32030000.32035000",140000,17,8.237957e-05,31890000,32030000,31895000,32035000,"chr22",678138,0,13,10,23,"chr22",1,0.0458274730426629
"23867","chr22.29290000.29295000","chr22.29395000.29400000",105000,15,0.006089166,29290000,29395000,29295000,29400000,"chr22",678143,2,14,13,29,"chr22",1,0.0509845288326301
"23868","chr22.31895000.31900000","chr22.32030000.32035000",135000,15,0.001324582,31895000,32030000,31900000,32035000,"chr22",678164,1,8,6,15,"chr22",1,0.0263713080168776
"23869","chr22.28740000.28745000","chr22.28760000.28765000",20000,33,0.009136658,28740000,28760000,28745000,28765000,"chr22",678174,0,4,0,4,"chr22",1,0.0154711673699015
"23870","chr22.17635000.17640000","chr22.18040000.18045000",405000,12,3.755956e-05,17635000,18040000,17640000,18045000,"chr22",678189,6,14,17,37,"chr22",1,0.0520393811533052
"23871","chr22.38245000.38250000","chr22.38350000.38355000",105000,19,6.160153e-05,38245000,38350000,38250000,38355000,"chr22",678192,3,9,10,22,"chr22",1,0.0489920300046882
"23872","chr22.41800000.41805000","chr22.41860000.41865000",60000,21,0.001381974,41800000,41860000,41805000,41865000,"chr22",678217,7,21,24,52,"chr22",1,0.127988748241913
"23873","chr22.46560000.46565000","chr22.46600000.46605000",40000,30,1.761848e-05,46560000,46600000,46565000,46605000,"chr22",678220,0,9,10,19,"chr22",1,0.0668073136427567
"23874","chr22.40750000.40755000","chr22.41195000.41200000",445000,9,0.002887782,40750000,41195000,40755000,41200000,"chr22",678232,3,8,13,24,"chr22",1,0.0253164556962025
"23875","chr22.38270000.38275000","chr22.38305000.38310000",35000,34,2.681295e-06,38270000,38305000,38275000,38310000,"chr22",678248,0,6,3,9,"chr22",1,0.0358649789029536
"23876","chr22.36145000.36150000","chr22.36455000.36460000",310000,12,0.0002449904,36145000,36455000,36150000,36460000,"chr22",678249,0,6,6,12,"chr22",1,0.0168776371308017
"23877","chr22.28370000.28375000","chr22.29265000.29270000",895000,6,0.009885447,28370000,29265000,28375000,29270000,"chr22",678269,1,4,13,18,"chr22",1,0.0126582278481013
"23878","chr22.41695000.41700000","chr22.41760000.41765000",65000,25,7.336114e-06,41695000,41760000,41700000,41765000,"chr22",678273,0,15,6,21,"chr22",1,0.0615330520393812
"23879","chr22.41305000.41310000","chr22.41555000.41560000",250000,12,0.001049321,41305000,41555000,41310000,41560000,"chr22",678329,1,16,11,28,"chr22",1,0.0393811533052039
"23880","chr22.41285000.41290000","chr22.41480000.41485000",195000,15,9.642189e-05,41285000,41480000,41290000,41485000,"chr22",678335,3,21,8,32,"chr22",1,0.0562587904360056
"23881","chr22.40565000.40570000","chr22.40635000.40640000",70000,21,0.0003060548,40565000,40635000,40570000,40640000,"chr22",678336,0,2,7,9,"chr22",1,0.0221518987341772
"23882","chr22.41505000.41510000","chr22.41525000.41530000",20000,34,0.004961105,41505000,41525000,41510000,41530000,"chr22",678387,0,1,1,2,"chr22",1,0.00796999531176746
"23883","chr22.20815000.20820000","chr22.20890000.20895000",75000,17,0.008927889,20815000,20890000,20820000,20895000,"chr22",678390,5,20,22,47,"chr22",1,0.0936474449132677
"23884","chr22.41365000.41370000","chr22.41465000.41470000",100000,15,0.008274323,41365000,41465000,41370000,41470000,"chr22",678406,1,3,4,8,"chr22",1,0.0140646976090014
"23885","chr22.41300000.41305000","chr22.41585000.41590000",285000,11,0.001824004,41300000,41585000,41305000,41590000,"chr22",678431,4,17,13,34,"chr22",1,0.0438349742147211
"23886","chr22.39715000.39720000","chr22.39885000.39890000",170000,14,0.001052504,39715000,39885000,39720000,39890000,"chr22",678438,2,6,5,13,"chr22",1,0.0213314580403188
"23887","chr22.31750000.31755000","chr22.31800000.31805000",50000,30,6.672039e-07,31750000,31800000,31755000,31805000,"chr22",678448,6,19,24,49,"chr22",1,0.172292545710267
"23888","chr22.38260000.38265000","chr22.38335000.38340000",75000,22,4.891148e-05,38260000,38335000,38265000,38340000,"chr22",678450,0,8,6,14,"chr22",1,0.0360993905297703
"23889","chr22.41480000.41485000","chr22.41555000.41560000",75000,21,0.0001523903,41480000,41555000,41485000,41560000,"chr22",678462,1,16,11,28,"chr22",1,0.0689170182841069
"23890","chr22.40005000.40010000","chr22.40425000.40430000",420000,9,0.003933228,40005000,40425000,40010000,40430000,"chr22",678474,0,1,0,1,"chr22",1,0.00105485232067511
"23891","chr22.41350000.41355000","chr22.41445000.41450000",95000,21,1.237884e-05,41350000,41445000,41355000,41450000,"chr22",678480,3,5,5,13,"chr22",1,0.0319971870604782
"23892","chr22.41475000.41480000","chr22.41665000.41670000",190000,13,0.00175756,41475000,41665000,41480000,41670000,"chr22",678532,7,29,17,53,"chr22",1,0.0807548054383497
"23893","chr22.40530000.40535000","chr22.41020000.41025000",490000,8,0.007652372,40530000,41020000,40535000,41025000,"chr22",678540,5,6,4,15,"chr22",1,0.0140646976090014
"23894","chr22.33000000.33005000","chr22.33465000.33470000",465000,8,0.009752407,3.3e+07,33465000,33005000,33470000,"chr22",678575,2,5,2,9,"chr22",1,0.00843881856540084
"23895","chr22.38050000.38055000","chr22.38200000.38205000",150000,15,0.0006890921,38050000,38200000,38055000,38205000,"chr22",678599,0,8,7,15,"chr22",1,0.0263713080168776
"23896","chr22.41300000.41305000","chr22.41350000.41355000",50000,24,0.0004738486,41300000,41350000,41305000,41355000,"chr22",678604,4,14,13,31,"chr22",1,0.0872011251758087
"23897","chr22.41350000.41355000","chr22.41760000.41765000",410000,10,0.0009903125,41350000,41760000,41355000,41765000,"chr22",678606,8,14,16,38,"chr22",1,0.0445382090951711
"23898","chr22.28430000.28435000","chr22.28825000.28830000",395000,9,0.005359278,28430000,28825000,28435000,28830000,"chr22",678622,4,10,7,21,"chr22",1,0.0221518987341772
"23899","chr22.19100000.19105000","chr22.19145000.19150000",45000,22,0.007059049,19100000,19145000,19105000,19150000,"chr22",678629,2,15,10,27,"chr22",1,0.069620253164557
"23900","chr22.28440000.28445000","chr22.29000000.29005000",560000,9,0.0007310799,28440000,2.9e+07,28445000,29005000,"chr22",678647,0,2,1,3,"chr22",1,0.00316455696202532
"23901","chr22.28450000.28455000","chr22.29000000.29005000",550000,8,0.004258334,28450000,2.9e+07,28455000,29005000,"chr22",678677,0,1,1,2,"chr22",1,0.00187529301453352
"23902","chr22.39940000.39945000","chr22.40435000.40440000",495000,9,0.001538437,39940000,40435000,39945000,40440000,"chr22",678687,0,5,5,10,"chr22",1,0.0105485232067511
"23903","chr22.39950000.39955000","chr22.40750000.40755000",800000,7,0.003256993,39950000,40750000,39955000,40755000,"chr22",678695,3,7,1,11,"chr22",1,0.00902484763244257
"23904","chr22.27090000.27095000","chr22.27775000.27780000",685000,7,0.00698087,27090000,27775000,27095000,27780000,"chr22",678707,1,4,3,8,"chr22",1,0.00656352555086732
"23905","chr22.42060000.42065000","chr22.42090000.42095000",30000,28,0.006307246,42060000,42090000,42065000,42095000,"chr22",678724,2,10,8,20,"chr22",1,0.0656352555086732
"23906","chr22.40175000.40180000","chr22.40360000.40365000",185000,12,0.006825847,40175000,40360000,40180000,40365000,"chr22",678749,0,6,5,11,"chr22",1,0.0154711673699015
"23907","chr22.36410000.36415000","chr22.36470000.36475000",60000,21,0.001381974,36410000,36470000,36415000,36475000,"chr22",678767,3,11,16,30,"chr22",1,0.0738396624472574
"23908","chr22.30000000.30005000","chr22.30480000.30485000",480000,16,2.038675e-09,3e+07,30480000,30005000,30485000,"chr22",678770,6,15,14,35,"chr22",1,0.0656352555086732
"23909","chr22.41350000.41355000","chr22.41460000.41465000",110000,15,0.004533004,41350000,41460000,41355000,41465000,"chr22",678777,6,14,15,35,"chr22",1,0.0615330520393812
"23910","chr22.41000000.41005000","chr22.41020000.41025000",20000,44,1.951385e-06,4.1e+07,41020000,41005000,41025000,"chr22",678781,5,17,12,34,"chr22",1,0.175339896858884
"23911","chr22.31880000.31885000","chr22.32030000.32035000",150000,15,0.0006890921,31880000,32030000,31885000,32035000,"chr22",678789,3,10,13,26,"chr22",1,0.0457102672292546
"23912","chr22.23305000.23310000","chr22.23385000.23390000",80000,29,1.356226e-09,23305000,23385000,23310000,23390000,"chr22",678799,2,1,4,7,"chr22",1,0.023792780121894
"23913","chr22.42090000.42095000","chr22.42215000.42220000",125000,19,1.297854e-05,42090000,42215000,42095000,42220000,"chr22",678800,2,8,8,18,"chr22",1,0.040084388185654
"23914","chr22.38530000.38535000","chr22.38565000.38570000",35000,30,0.000140409,38530000,38565000,38535000,38570000,"chr22",678818,0,6,2,8,"chr22",1,0.0281293952180028
"23915","chr22.41515000.41520000","chr22.41540000.41545000",25000,32,0.004759008,41515000,41540000,41520000,41545000,"chr22",678838,3,13,16,32,"chr22",1,0.120018752930145
"23916","chr22.42230000.42235000","chr22.42275000.42280000",45000,22,0.007059049,42230000,42275000,42235000,42280000,"chr22",678917,1,4,1,6,"chr22",1,0.0154711673699015
"23917","chr22.41350000.41355000","chr22.41595000.41600000",245000,14,6.292341e-05,41350000,41595000,41355000,41600000,"chr22",678929,0,5,3,8,"chr22",1,0.0131270511017346
"23918","chr22.39940000.39945000","chr22.40425000.40430000",485000,13,1.148342e-06,39940000,40425000,39945000,40430000,"chr22",678938,2,1,1,4,"chr22",1,0.00609470229723394
"23919","chr22.38530000.38535000","chr22.38750000.38755000",220000,11,0.008274323,38530000,38750000,38535000,38755000,"chr22",678957,1,14,4,19,"chr22",1,0.0244960150023441
"23920","chr22.38055000.38060000","chr22.38195000.38200000",140000,13,0.009878643,38055000,38195000,38060000,38200000,"chr22",678973,1,9,7,17,"chr22",1,0.0259024847632443
"23921","chr22.42215000.42220000","chr22.42275000.42280000",60000,19,0.008387263,42215000,42275000,42220000,42280000,"chr22",678990,1,4,1,6,"chr22",1,0.0133614627285513
"23922","chr22.40600000.40605000","chr22.40675000.40680000",75000,18,0.003540361,40600000,40675000,40605000,40680000,"chr22",679039,1,15,13,29,"chr22",1,0.0611814345991561
"23923","chr22.41560000.41565000","chr22.41665000.41670000",105000,15,0.006089166,41560000,41665000,41565000,41670000,"chr22",679045,0,1,9,10,"chr22",1,0.0175808720112518
"23924","chr22.46050000.46055000","chr22.46230000.46235000",180000,13,0.002496001,46050000,46230000,46055000,46235000,"chr22",679049,2,0,0,2,"chr22",1,0.00304735114861697
"23925","chr22.41365000.41370000","chr22.41410000.41415000",45000,22,0.007059049,41365000,41410000,41370000,41415000,"chr22",679061,0,3,4,7,"chr22",1,0.0180496952648851
"23926","chr22.28740000.28745000","chr22.28770000.28775000",30000,30,0.001466729,28740000,28770000,28745000,28775000,"chr22",679063,0,4,0,4,"chr22",1,0.0140646976090014
"23927","chr22.39400000.39405000","chr22.39500000.39505000",100000,15,0.008274323,39400000,39500000,39405000,39505000,"chr22",679072,4,3,3,10,"chr22",1,0.0175808720112518
"23928","chr22.41285000.41290000","chr22.42230000.42235000",945000,6,0.007053838,41285000,42230000,41290000,42235000,"chr22",679102,3,12,8,23,"chr22",1,0.0161744022503516
"23929","chr22.30005000.30010000","chr22.30820000.30825000",815000,7,0.002970205,30005000,30820000,30010000,30825000,"chr22",679149,2,1,6,9,"chr22",1,0.00738396624472574
"23930","chr22.42230000.42235000","chr22.42265000.42270000",35000,41,7.862369e-10,42230000,42265000,42235000,42270000,"chr22",679165,3,9,11,23,"chr22",1,0.110525082044069
"23931","chr22.23120000.23125000","chr22.23305000.23310000",185000,14,0.0005807213,23120000,23305000,23125000,23310000,"chr22",679184,0,3,0,3,"chr22",1,0.00492264416315049
"23932","chr22.30005000.30010000","chr22.30420000.30425000",415000,9,0.004194908,30005000,30420000,30010000,30425000,"chr22",679197,0,1,1,2,"chr22",1,0.00210970464135021
"23933","chr22.41365000.41370000","chr22.41515000.41520000",150000,15,0.0006890921,41365000,41515000,41370000,41520000,"chr22",679219,1,3,4,8,"chr22",1,0.0140646976090014
"23934","chr22.28740000.28745000","chr22.28825000.28830000",85000,18,0.001299488,28740000,28825000,28745000,28830000,"chr22",679242,0,4,0,4,"chr22",1,0.00843881856540084
"23935","chr22.41275000.41280000","chr22.41515000.41520000",240000,13,0.0003323685,41275000,41515000,41280000,41520000,"chr22",679244,3,16,16,35,"chr22",1,0.053328645100797
"23936","chr22.30035000.30040000","chr22.30480000.30485000",445000,15,4.383508e-08,30035000,30480000,30040000,30485000,"chr22",679264,1,5,7,13,"chr22",1,0.0228551336146273
"23937","chr22.43775000.43780000","chr22.44200000.44205000",425000,10,0.0007933618,43775000,44200000,43780000,44205000,"chr22",679270,0,2,1,3,"chr22",1,0.00351617440225035
"23938","chr22.37020000.37025000","chr22.37065000.37070000",45000,22,0.007059049,37020000,37065000,37025000,37070000,"chr22",679280,1,1,1,3,"chr22",1,0.00773558368495077
"23939","chr22.31345000.31350000","chr22.31495000.31500000",150000,16,0.0001895536,31345000,31495000,31350000,31500000,"chr22",679282,5,19,9,33,"chr22",1,0.0618846694796062
"23940","chr22.42090000.42095000","chr22.43000000.43005000",910000,6,0.009066607,42090000,4.3e+07,42095000,43005000,"chr22",679298,0,0,3,3,"chr22",1,0.00210970464135021
"23941","chr22.41325000.41330000","chr22.41525000.41530000",200000,15,7.748443e-05,41325000,41525000,41330000,41530000,"chr22",679299,0,1,1,2,"chr22",1,0.00351617440225035
"23942","chr22.41860000.41865000","chr22.41910000.41915000",50000,27,2.134499e-05,41860000,41910000,41865000,41915000,"chr22",679307,0,2,0,2,"chr22",1,0.00632911392405063
"23943","chr22.36320000.36325000","chr22.36480000.36485000",160000,15,0.0004459218,36320000,36480000,36325000,36485000,"chr22",679312,0,4,1,5,"chr22",1,0.00879043600562588
"23944","chr22.38195000.38200000","chr22.38245000.38250000",50000,21,0.006788298,38195000,38245000,38200000,38250000,"chr22",679326,3,9,10,22,"chr22",1,0.0541490857946554
"23945","chr22.36585000.36590000","chr22.36655000.36660000",70000,21,0.0003060548,36585000,36655000,36590000,36660000,"chr22",679369,0,2,1,3,"chr22",1,0.00738396624472574
"23946","chr22.36335000.36340000","chr22.36455000.36460000",120000,14,0.007734492,36335000,36455000,36340000,36460000,"chr22",679371,0,5,1,6,"chr22",1,0.00984528832630099
"23947","chr22.22080000.22085000","chr22.22295000.22300000",215000,15,4.236114e-05,22080000,22295000,22085000,22300000,"chr22",679384,0,1,0,1,"chr22",1,0.00175808720112518
"23948","chr22.30205000.30210000","chr22.30395000.30400000",190000,13,0.00175756,30205000,30395000,30210000,30400000,"chr22",679403,0,5,5,10,"chr22",1,0.0152367557430849
"23949","chr22.41515000.41520000","chr22.41560000.41565000",45000,31,9.443353e-07,41515000,41560000,41520000,41565000,"chr22",679487,0,1,9,10,"chr22",1,0.036333802156587
"23950","chr22.42615000.42620000","chr22.42660000.42665000",45000,32,2.886991e-07,42615000,42660000,42620000,42665000,"chr22",679499,6,15,13,34,"chr22",1,0.127519924988279
"23951","chr22.42930000.42935000","chr22.43000000.43005000",70000,18,0.006078377,42930000,4.3e+07,42935000,43005000,"chr22",679522,0,0,3,3,"chr22",1,0.00632911392405063
"23952","chr22.41350000.41355000","chr22.41500000.41505000",150000,20,5.596744e-07,41350000,41500000,41355000,41505000,"chr22",679535,8,14,15,37,"chr22",1,0.0867323019221753
"23953","chr22.30075000.30080000","chr22.30410000.30415000",335000,14,4.68116e-06,30075000,30410000,30080000,30415000,"chr22",679550,2,10,6,18,"chr22",1,0.029535864978903
"23954","chr22.29265000.29270000","chr22.29525000.29530000",260000,14,3.881771e-05,29265000,29525000,29270000,29530000,"chr22",679595,1,4,13,18,"chr22",1,0.029535864978903
"23955","chr22.41535000.41540000","chr22.41585000.41590000",50000,24,0.0004738486,41535000,41585000,41540000,41590000,"chr22",679621,6,39,41,86,"chr22",1,0.241912798874824
"23956","chr22.17860000.17865000","chr22.17955000.17960000",95000,17,0.001514334,17860000,17955000,17865000,17960000,"chr22",679645,0,1,3,4,"chr22",1,0.00796999531176746
"23957","chr22.41680000.41685000","chr22.41860000.41865000",180000,16,4.528862e-05,41680000,41860000,41685000,41865000,"chr22",679661,7,25,23,55,"chr22",1,0.103141115799344
"23958","chr22.19930000.19935000","chr22.20010000.20015000",80000,17,0.005654572,19930000,20010000,19935000,20015000,"chr22",679670,0,7,5,12,"chr22",1,0.0239099859353024
"23959","chr22.41425000.41430000","chr22.41480000.41485000",55000,21,0.003093944,41425000,41480000,41430000,41485000,"chr22",679751,4,22,12,38,"chr22",1,0.0935302390998594
"23960","chr22.31090000.31095000","chr22.31155000.31160000",65000,19,0.004411413,31090000,31155000,31095000,31160000,"chr22",679776,2,1,3,6,"chr22",1,0.0133614627285513
"23961","chr22.46120000.46125000","chr22.46265000.46270000",145000,13,0.008387263,46120000,46265000,46125000,46270000,"chr22",679788,1,4,2,7,"chr22",1,0.0106657290201594
"23962","chr22.29580000.29585000","chr22.29600000.29605000",20000,33,0.009136658,29580000,29600000,29585000,29605000,"chr22",679797,8,24,39,71,"chr22",1,0.274613220815752
"23963","chr22.41350000.41355000","chr22.41440000.41445000",90000,18,0.0008008678,41350000,41440000,41355000,41445000,"chr22",679798,8,14,16,38,"chr22",1,0.080168776371308
"23964","chr22.39545000.39550000","chr22.39715000.39720000",170000,20,1.492522e-07,39545000,39715000,39550000,39720000,"chr22",679805,2,5,5,12,"chr22",1,0.0281293952180028
"23965","chr22.30075000.30080000","chr22.30400000.30405000",325000,10,0.003540361,30075000,30400000,30080000,30405000,"chr22",679827,2,10,6,18,"chr22",1,0.0210970464135021
"23966","chr22.33210000.33215000","chr22.33380000.33385000",170000,17,1.714176e-05,33210000,33380000,33215000,33385000,"chr22",679850,0,4,0,4,"chr22",1,0.00796999531176746
"23967","chr22.17890000.17895000","chr22.17910000.17915000",20000,55,1.920358e-11,17890000,17910000,17895000,17915000,"chr22",679851,3,6,1,10,"chr22",1,0.0644631973745898
"23968","chr22.41270000.41275000","chr22.41540000.41545000",270000,12,0.0006231557,41270000,41540000,41275000,41545000,"chr22",679872,3,13,19,35,"chr22",1,0.0492264416315049
"23969","chr22.41425000.41430000","chr22.41475000.41480000",50000,34,3.988712e-09,41425000,41475000,41430000,41480000,"chr22",679916,4,24,17,45,"chr22",1,0.179324894514768
"23970","chr22.38515000.38520000","chr22.38750000.38755000",235000,12,0.001551407,38515000,38750000,38520000,38755000,"chr22",679959,1,14,4,19,"chr22",1,0.0267229254571027
"23971","chr22.38570000.38575000","chr22.38785000.38790000",215000,14,0.0001851479,38570000,38785000,38575000,38790000,"chr22",679972,2,7,5,14,"chr22",1,0.0229723394280356
"23972","chr22.31940000.31945000","chr22.31975000.31980000",35000,25,0.008387263,31940000,31975000,31945000,31980000,"chr22",679979,7,16,18,41,"chr22",1,0.120135958743554
"23973","chr22.41680000.41685000","chr22.41760000.41765000",80000,28,6.170578e-09,41680000,41760000,41685000,41765000,"chr22",679984,7,24,21,52,"chr22",1,0.17065166432255
"23974","chr22.29465000.29470000","chr22.29550000.29555000",85000,17,0.003561074,29465000,29550000,29470000,29555000,"chr22",679992,6,7,11,24,"chr22",1,0.0478199718706048
"23975","chr22.42090000.42095000","chr22.42255000.42260000",165000,14,0.001284656,42090000,42255000,42095000,42260000,"chr22",680001,2,6,7,15,"chr22",1,0.0246132208157525
"23976","chr22.41235000.41240000","chr22.41285000.41290000",50000,22,0.002962451,41235000,41285000,41240000,41290000,"chr22",680022,1,3,3,7,"chr22",1,0.0180496952648851
"23977","chr22.39290000.39295000","chr22.39395000.39400000",105000,15,0.006089166,39290000,39395000,39295000,39400000,"chr22",680038,0,1,1,2,"chr22",1,0.00351617440225035
"23978","chr22.31345000.31350000","chr22.31565000.31570000",220000,12,0.002427979,31345000,31565000,31350000,31570000,"chr22",680049,5,19,9,33,"chr22",1,0.0464135021097046
"23979","chr22.17865000.17870000","chr22.17955000.17960000",90000,16,0.006287205,17865000,17955000,17870000,17960000,"chr22",680050,0,12,2,14,"chr22",1,0.0262541022034693
"23980","chr22.38195000.38200000","chr22.38260000.38265000",65000,19,0.004411413,38195000,38260000,38200000,38265000,"chr22",680070,0,8,6,14,"chr22",1,0.0311767463666198
"23981","chr22.38655000.38660000","chr22.38700000.38705000",45000,35,6.879784e-09,38655000,38700000,38660000,38705000,"chr22",680075,0,8,12,20,"chr22",1,0.0820440693858415
"23982","chr22.41090000.41095000","chr22.41195000.41200000",105000,17,0.0006980753,41090000,41195000,41095000,41200000,"chr22",680087,0,2,0,2,"chr22",1,0.00398499765588373
"23983","chr22.41240000.41245000","chr22.41940000.41945000",700000,8,0.00114435,41240000,41940000,41245000,41945000,"chr22",680098,7,20,18,45,"chr22",1,0.0421940928270042
"23984","chr22.28430000.28435000","chr22.29265000.29270000",835000,7,0.002591131,28430000,29265000,28435000,29270000,"chr22",680099,1,4,7,12,"chr22",1,0.00984528832630099
"23985","chr22.39315000.39320000","chr22.39520000.39525000",205000,15,6.292341e-05,39315000,39520000,39320000,39525000,"chr22",680103,0,6,4,10,"chr22",1,0.0175808720112518
"23986","chr22.36190000.36195000","chr22.36275000.36280000",85000,17,0.003561074,36190000,36275000,36195000,36280000,"chr22",680158,0,0,2,2,"chr22",1,0.00398499765588373
"23987","chr22.30680000.30685000","chr22.30820000.30825000",140000,15,0.001074801,30680000,30820000,30685000,30825000,"chr22",680163,2,6,11,19,"chr22",1,0.0334036568213783
"23988","chr22.40635000.40640000","chr22.40665000.40670000",30000,34,5.139416e-05,40635000,40665000,40640000,40670000,"chr22",680171,0,2,7,9,"chr22",1,0.0358649789029536
"23989","chr22.31105000.31110000","chr22.31290000.31295000",185000,12,0.006825847,31105000,31290000,31110000,31295000,"chr22",680185,1,13,12,26,"chr22",1,0.0365682137834037
"23990","chr22.41275000.41280000","chr22.41460000.41465000",185000,14,0.0005807213,41275000,41460000,41280000,41465000,"chr22",680196,6,31,15,52,"chr22",1,0.0853258321612752
"23991","chr22.39185000.39190000","chr22.39530000.39535000",345000,10,0.002598659,39185000,39530000,39190000,39535000,"chr22",680209,1,4,2,7,"chr22",1,0.00820440693858415
"23992","chr22.17555000.17560000","chr22.18025000.18030000",470000,8,0.009201209,17555000,18025000,17560000,18030000,"chr22",680232,1,6,12,19,"chr22",1,0.0178152836380684
"23993","chr22.42080000.42085000","chr22.42230000.42235000",150000,15,0.0006890921,42080000,42230000,42085000,42235000,"chr22",680252,1,8,8,17,"chr22",1,0.029887482419128
"23994","chr22.28450000.28455000","chr22.28825000.28830000",375000,9,0.006905091,28450000,28825000,28455000,28830000,"chr22",680254,0,1,1,2,"chr22",1,0.00210970464135021
"23995","chr22.42230000.42235000","chr22.42270000.42275000",40000,24,0.004347397,42230000,42270000,42235000,42275000,"chr22",680255,2,3,1,6,"chr22",1,0.0168776371308017
"23996","chr22.40645000.40650000","chr22.41275000.41280000",630000,9,0.0003410527,40645000,41275000,40650000,41280000,"chr22",680289,7,19,22,48,"chr22",1,0.0506329113924051
"23997","chr22.38210000.38215000","chr22.38230000.38235000",20000,39,0.000140409,38210000,38230000,38215000,38235000,"chr22",680298,3,7,4,14,"chr22",1,0.0639943741209564
"23998","chr22.41325000.41330000","chr22.41665000.41670000",340000,10,0.002816079,41325000,41665000,41330000,41670000,"chr22",680309,3,7,7,17,"chr22",1,0.0199249882794187
"23999","chr22.42060000.42065000","chr22.42230000.42235000",170000,13,0.003540361,42060000,42230000,42065000,42235000,"chr22",680315,2,10,12,24,"chr22",1,0.0365682137834037
"24000","chr22.37950000.37955000","chr22.37995000.38000000",45000,24,0.001324582,37950000,37995000,37955000,3.8e+07,"chr22",680342,2,0,6,8,"chr22",1,0.0225035161744023
"24001","chr22.41410000.41415000","chr22.41425000.41430000",15000,34,0.004961105,41410000,41425000,41415000,41430000,"chr22",680344,0,6,5,11,"chr22",1,0.0438349742147211
"24002","chr22.28600000.28605000","chr22.28740000.28745000",140000,15,0.001074801,28600000,28740000,28605000,28745000,"chr22",680349,0,4,0,4,"chr22",1,0.0070323488045007
"24003","chr22.20915000.20920000","chr22.21030000.21035000",115000,14,0.009570719,20915000,21030000,20920000,21035000,"chr22",680352,5,13,15,33,"chr22",1,0.0541490857946554
"24004","chr22.37840000.37845000","chr22.37930000.37935000",90000,16,0.006287205,37840000,37930000,37845000,37935000,"chr22",680370,6,11,12,29,"chr22",1,0.0543834974214721
"24005","chr22.41665000.41670000","chr22.41920000.41925000",255000,11,0.003540361,41665000,41920000,41670000,41925000,"chr22",680405,8,8,25,41,"chr22",1,0.0528598218471636
"24006","chr22.42090000.42095000","chr22.42435000.42440000",345000,9,0.009975485,42090000,42435000,42095000,42440000,"chr22",680409,1,19,8,28,"chr22",1,0.029535864978903
"24007","chr22.33015000.33020000","chr22.33035000.33040000",20000,38,0.0003031305,33015000,33035000,33020000,33040000,"chr22",680430,1,9,6,16,"chr22",1,0.0712611345522738
"24008","chr22.41410000.41415000","chr22.41480000.41485000",70000,30,2.787172e-09,41410000,41480000,41415000,41485000,"chr22",680441,0,6,5,11,"chr22",1,0.0386779184247539
"24009","chr22.42435000.42440000","chr22.42615000.42620000",180000,12,0.007976258,42435000,42615000,42440000,42620000,"chr22",680448,1,15,14,30,"chr22",1,0.0421940928270042
"24010","chr22.37965000.37970000","chr22.37995000.38000000",30000,29,0.003132604,37965000,37995000,37970000,3.8e+07,"chr22",680449,2,0,3,5,"chr22",1,0.01699484294421
"24011","chr22.41440000.41445000","chr22.41480000.41485000",40000,25,0.001925366,41440000,41480000,41445000,41485000,"chr22",680476,6,22,12,40,"chr22",1,0.117205813408345
"24012","chr22.38570000.38575000","chr22.38750000.38755000",180000,13,0.002496001,38570000,38750000,38575000,38755000,"chr22",680483,1,11,4,16,"chr22",1,0.0243788091889358
"24013","chr22.41350000.41355000","chr22.41465000.41470000",115000,17,0.0003462602,41350000,41465000,41355000,41470000,"chr22",680489,8,10,16,34,"chr22",1,0.0677449601500234
"24014","chr22.41260000.41265000","chr22.41285000.41290000",25000,34,0.001204568,41260000,41285000,41265000,41290000,"chr22",680516,0,6,1,7,"chr22",1,0.0278949835911861
"24015","chr22.30005000.30010000","chr22.30570000.30575000",565000,9,0.0006905731,30005000,30570000,30010000,30575000,"chr22",680523,0,1,3,4,"chr22",1,0.00421940928270042
"24016","chr22.30175000.30180000","chr22.30395000.30400000",220000,13,0.0006443857,30175000,30395000,30180000,30400000,"chr22",680530,0,1,3,4,"chr22",1,0.00609470229723394
"24017","chr22.39290000.39295000","chr22.39315000.39320000",25000,32,0.004759008,39290000,39315000,39295000,39320000,"chr22",680548,0,1,1,2,"chr22",1,0.00750117205813408
"24018","chr22.38715000.38720000","chr22.38735000.38740000",20000,44,1.951385e-06,38715000,38735000,38720000,38740000,"chr22",680590,2,1,1,4,"chr22",1,0.0206282231598687
"24019","chr22.41480000.41485000","chr22.41680000.41685000",200000,17,3.61902e-06,41480000,41680000,41485000,41685000,"chr22",680594,6,22,12,40,"chr22",1,0.0796999531176746
"24020","chr22.41350000.41355000","chr22.41475000.41480000",125000,30,1.185294e-13,41350000,41475000,41355000,41480000,"chr22",680610,7,14,16,37,"chr22",1,0.130098452883263
"24021","chr22.41325000.41330000","chr22.41680000.41685000",355000,12,9.668035e-05,41325000,41680000,41330000,41685000,"chr22",680612,3,7,7,17,"chr22",1,0.0239099859353024
"24022","chr22.41535000.41540000","chr22.41725000.41730000",190000,12,0.005915139,41535000,41725000,41540000,41730000,"chr22",680620,6,26,23,55,"chr22",1,0.0773558368495077
"24023","chr22.40645000.40650000","chr22.40855000.40860000",210000,12,0.003226746,40645000,40855000,40650000,40860000,"chr22",680631,6,13,19,38,"chr22",1,0.0534458509142053
"24024","chr22.29290000.29295000","chr22.29340000.29345000",50000,22,0.002962451,29290000,29340000,29295000,29345000,"chr22",680639,2,4,3,9,"chr22",1,0.0232067510548523
"24025","chr22.41300000.41305000","chr22.41945000.41950000",645000,9,0.0002950473,41300000,41945000,41305000,41950000,"chr22",680652,4,17,13,34,"chr22",1,0.0358649789029536
"24026","chr22.39715000.39720000","chr22.40435000.40440000",720000,7,0.005550813,39715000,40435000,39720000,40440000,"chr22",680658,0,5,5,10,"chr22",1,0.00820440693858415
"24027","chr22.38050000.38055000","chr22.38195000.38200000",145000,25,1.723357e-10,38050000,38195000,38055000,38200000,"chr22",680683,0,8,7,15,"chr22",1,0.0439521800281294
"24028","chr22.40750000.40755000","chr22.41020000.41025000",270000,12,0.0006231557,40750000,41020000,40755000,41025000,"chr22",680694,3,8,12,23,"chr22",1,0.0323488045007032
"24029","chr22.41325000.41330000","chr22.41410000.41415000",85000,20,0.0001391422,41325000,41410000,41330000,41415000,"chr22",680702,0,6,5,11,"chr22",1,0.0257852789498359
"24030","chr22.41800000.41805000","chr22.41920000.41925000",120000,28,9.416631e-12,41800000,41920000,41805000,41925000,"chr22",680710,8,8,25,41,"chr22",1,0.13455227379278
"24031","chr22.40920000.40925000","chr22.41020000.41025000",100000,25,2.12507e-08,40920000,41020000,40925000,41025000,"chr22",680732,5,20,12,37,"chr22",1,0.108415377402719
"24032","chr22.30035000.30040000","chr22.30400000.30405000",365000,14,2.226983e-06,30035000,30400000,30040000,30405000,"chr22",680735,1,5,7,13,"chr22",1,0.0213314580403188
"24033","chr22.40510000.40515000","chr22.41090000.41095000",580000,8,0.003190844,40510000,41090000,40515000,41095000,"chr22",680769,0,2,0,2,"chr22",1,0.00187529301453352
"24034","chr22.38570000.38575000","chr22.38720000.38725000",150000,13,0.007059049,38570000,38720000,38575000,38725000,"chr22",680778,4,8,8,20,"chr22",1,0.0304735114861697
"24035","chr22.46120000.46125000","chr22.46235000.46240000",115000,18,0.0001000846,46120000,46235000,46125000,46240000,"chr22",680794,1,3,2,6,"chr22",1,0.0126582278481013
"24036","chr22.31800000.31805000","chr22.31880000.31885000",80000,20,0.0002519784,31800000,31880000,31805000,31885000,"chr22",680814,3,10,16,29,"chr22",1,0.0679793717768401
"24037","chr22.28325000.28330000","chr22.29265000.29270000",940000,6,0.007290955,28325000,29265000,28330000,29270000,"chr22",680853,1,4,2,7,"chr22",1,0.00492264416315049
"24038","chr22.17845000.17850000","chr22.17900000.17905000",55000,25,5.969414e-05,17845000,17900000,17850000,17905000,"chr22",680858,3,5,1,9,"chr22",1,0.0263713080168776
"24039","chr22.39950000.39955000","chr22.40425000.40430000",475000,11,6.482245e-05,39950000,40425000,39955000,40430000,"chr22",680867,2,1,1,4,"chr22",1,0.00515705578996718
"24040","chr22.17855000.17860000","chr22.17900000.17905000",45000,27,7.587316e-05,17855000,17900000,17860000,17905000,"chr22",680889,1,0,1,2,"chr22",1,0.00632911392405063
"24041","chr22.28450000.28455000","chr22.29070000.29075000",620000,9,0.000381032,28450000,29070000,28455000,29075000,"chr22",680914,0,1,1,2,"chr22",1,0.00210970464135021
"24042","chr22.38485000.38490000","chr22.38750000.38755000",265000,12,0.0006984838,38485000,38750000,38490000,38755000,"chr22",680964,0,7,4,11,"chr22",1,0.0154711673699015
"24043","chr22.41350000.41355000","chr22.41480000.41485000",130000,52,6.475998e-36,41350000,41480000,41355000,41485000,"chr22",680967,6,14,12,32,"chr22",1,0.195030473511486
"24044","chr22.38270000.38275000","chr22.38335000.38340000",65000,21,0.0006443857,38270000,38335000,38275000,38340000,"chr22",680970,0,6,3,9,"chr22",1,0.0221518987341772
"24045","chr22.17845000.17850000","chr22.17890000.17895000",45000,25,0.0005379221,17845000,17890000,17850000,17895000,"chr22",680975,3,6,5,14,"chr22",1,0.0410220346929208
"24046","chr22.30015000.30020000","chr22.30400000.30405000",385000,15,1.946937e-07,30015000,30400000,30020000,30405000,"chr22",681051,5,6,9,20,"chr22",1,0.0351617440225035
"24047","chr22.29245000.29250000","chr22.29550000.29555000",305000,11,0.0012285,29245000,29550000,29250000,29555000,"chr22",681054,7,31,22,60,"chr22",1,0.0773558368495077
"24048","chr22.23520000.23525000","chr22.23610000.23615000",90000,25,9.189075e-08,23520000,23610000,23525000,23615000,"chr22",681110,0,3,6,9,"chr22",1,0.0263713080168776
"24049","chr22.41350000.41355000","chr22.41415000.41420000",65000,24,2.384147e-05,41350000,41415000,41355000,41420000,"chr22",681124,7,14,16,37,"chr22",1,0.10407876230661
"24050","chr22.28325000.28330000","chr22.28370000.28375000",45000,24,0.001324582,28325000,28370000,28330000,28375000,"chr22",681139,3,4,2,9,"chr22",1,0.0253164556962025
"24051","chr22.39405000.39410000","chr22.39430000.39435000",25000,32,0.004759008,39405000,39430000,39410000,39435000,"chr22",681143,0,0,3,3,"chr22",1,0.0112517580872011
"24052","chr22.31160000.31165000","chr22.31290000.31295000",130000,17,0.0001426998,31160000,31290000,31165000,31295000,"chr22",681166,1,13,12,26,"chr22",1,0.0518049695264885
"24053","chr22.41745000.41750000","chr22.41910000.41915000",165000,13,0.004208436,41745000,41910000,41750000,41915000,"chr22",681216,0,2,0,2,"chr22",1,0.00304735114861697
"24054","chr22.17555000.17560000","chr22.17635000.17640000",80000,19,0.0007532948,17555000,17635000,17560000,17640000,"chr22",681255,1,6,12,19,"chr22",1,0.0423112986404126
"24055","chr22.41350000.41355000","chr22.41560000.41565000",210000,22,2.660105e-10,41350000,41560000,41355000,41565000,"chr22",681263,0,1,9,10,"chr22",1,0.0257852789498359
"24056","chr22.40750000.40755000","chr22.41460000.41465000",710000,7,0.005952194,40750000,41460000,40755000,41465000,"chr22",681266,3,8,13,24,"chr22",1,0.019690576652602
"24057","chr22.41680000.41685000","chr22.41795000.41800000",115000,14,0.009570719,41680000,41795000,41685000,41800000,"chr22",681284,2,15,9,26,"chr22",1,0.0426629160806376
"24058","chr22.46560000.46565000","chr22.46615000.46620000",55000,26,1.996672e-05,46560000,46615000,46565000,46620000,"chr22",681318,0,3,9,12,"chr22",1,0.0365682137834037
"24059","chr22.19145000.19150000","chr22.19445000.19450000",300000,16,3.087853e-07,19145000,19445000,19150000,19450000,"chr22",681328,2,15,10,27,"chr22",1,0.0506329113924051
"24060","chr22.46525000.46530000","chr22.46690000.46695000",165000,13,0.004208436,46525000,46690000,46530000,46695000,"chr22",681331,0,5,11,16,"chr22",1,0.0243788091889358
"24061","chr22.42230000.42235000","chr22.42660000.42665000",430000,9,0.003486766,42230000,42660000,42235000,42665000,"chr22",681348,6,12,13,31,"chr22",1,0.0327004219409283
"24062","chr22.40035000.40040000","chr22.40425000.40430000",390000,10,0.00132059,40035000,40425000,40040000,40430000,"chr22",681353,2,1,1,4,"chr22",1,0.0046882325363338
"24063","chr22.36275000.36280000","chr22.36545000.36550000",270000,10,0.009080215,36275000,36545000,36280000,36550000,"chr22",681365,1,10,2,13,"chr22",1,0.0152367557430849
"24064","chr22.38530000.38535000","chr22.38730000.38735000",200000,12,0.004347397,38530000,38730000,38535000,38735000,"chr22",681383,0,4,1,5,"chr22",1,0.0070323488045007
"24065","chr22.41350000.41355000","chr22.41425000.41430000",75000,20,0.0004667181,41350000,41425000,41355000,41430000,"chr22",681385,4,14,16,34,"chr22",1,0.0796999531176746
"24066","chr22.38570000.38575000","chr22.38655000.38660000",85000,19,0.000438336,38570000,38655000,38575000,38660000,"chr22",681390,0,11,8,19,"chr22",1,0.0423112986404126
"24067","chr22.46120000.46125000","chr22.46145000.46150000",25000,37,0.0001158603,46120000,46145000,46125000,46150000,"chr22",681398,0,4,2,6,"chr22",1,0.0260196905766526
"24068","chr22.20015000.20020000","chr22.20060000.20065000",45000,40,6.590823e-12,20015000,20060000,20020000,20065000,"chr22",681421,0,3,0,3,"chr22",1,0.0140646976090014
"24069","chr22.41695000.41700000","chr22.41795000.41800000",100000,15,0.008274323,41695000,41795000,41700000,41800000,"chr22",681432,0,15,6,21,"chr22",1,0.0369198312236287
"24070","chr22.38235000.38240000","chr22.38260000.38265000",25000,36,0.0002583265,38235000,38260000,38240000,38265000,"chr22",681453,0,8,3,11,"chr22",1,0.0464135021097046
"24071","chr22.29685000.29690000","chr22.29780000.29785000",95000,19,0.0001541394,29685000,29780000,29690000,29785000,"chr22",681459,5,10,3,18,"chr22",1,0.040084388185654
"24072","chr22.19145000.19150000","chr22.19430000.19435000",285000,12,0.0004315667,19145000,19430000,19150000,19435000,"chr22",681461,2,7,4,13,"chr22",1,0.0182841068917018
"24073","chr22.25870000.25875000","chr22.26750000.26755000",880000,7,0.001861375,25870000,26750000,25875000,26755000,"chr22",681463,0,2,2,4,"chr22",1,0.00328176277543366
"24074","chr22.41525000.41530000","chr22.41560000.41565000",35000,30,0.000140409,41525000,41560000,41530000,41565000,"chr22",681473,0,1,1,2,"chr22",1,0.0070323488045007
"24075","chr22.43010000.43015000","chr22.43485000.43490000",475000,8,0.008927889,43010000,43485000,43015000,43490000,"chr22",681514,0,1,2,3,"chr22",1,0.00281293952180028
"24076","chr22.40920000.40925000","chr22.41035000.41040000",115000,43,6.919471e-25,40920000,41035000,40925000,41040000,"chr22",681545,9,26,27,62,"chr22",1,0.312470698546648
"24077","chr22.43810000.43815000","chr22.44210000.44215000",400000,11,0.0002286845,43810000,44210000,43815000,44215000,"chr22",681553,1,2,4,7,"chr22",1,0.00902484763244257
"24078","chr22.17910000.17915000","chr22.17955000.17960000",45000,37,4.658193e-10,17910000,17955000,17915000,17960000,"chr22",681562,0,9,1,10,"chr22",1,0.0433661509610877
"24079","chr22.17635000.17640000","chr22.17955000.17960000",320000,12,0.0001955526,17635000,17955000,17640000,17960000,"chr22",681563,0,18,24,42,"chr22",1,0.0590717299578059
"24080","chr22.18030000.18035000","chr22.18105000.18110000",75000,18,0.003540361,18030000,18105000,18035000,18110000,"chr22",681572,0,5,3,8,"chr22",1,0.0168776371308017
"24081","chr22.33765000.33770000","chr22.33970000.33975000",205000,12,0.003731101,33765000,33970000,33770000,33975000,"chr22",681582,0,1,4,5,"chr22",1,0.0070323488045007
"24082","chr22.30255000.30260000","chr22.30400000.30405000",145000,15,0.0008583397,30255000,30400000,30260000,30405000,"chr22",681593,5,15,20,40,"chr22",1,0.070323488045007
"24083","chr22.17855000.17860000","chr22.17910000.17915000",55000,32,1.155464e-08,17855000,17910000,17860000,17915000,"chr22",681645,1,0,1,2,"chr22",1,0.00750117205813408
"24084","chr22.40855000.40860000","chr22.41195000.41200000",340000,13,2.388358e-05,40855000,41195000,40860000,41200000,"chr22",681653,3,12,16,31,"chr22",1,0.0472339428035631
"24085","chr22.40560000.40565000","chr22.41095000.41100000",535000,8,0.004903528,40560000,41095000,40565000,41100000,"chr22",681663,0,8,10,18,"chr22",1,0.0168776371308017
"24086","chr22.30035000.30040000","chr22.30395000.30400000",360000,9,0.008387263,30035000,30395000,30040000,30400000,"chr22",681673,0,5,5,10,"chr22",1,0.0105485232067511
"24087","chr22.39955000.39960000","chr22.40750000.40755000",795000,10,8.38428e-06,39955000,40750000,39960000,40755000,"chr22",681720,3,7,11,21,"chr22",1,0.0246132208157525
"24088","chr22.30535000.30540000","chr22.30590000.30595000",55000,21,0.003093944,30535000,30590000,30540000,30595000,"chr22",681732,3,19,7,29,"chr22",1,0.0713783403656821
"24089","chr22.39315000.39320000","chr22.39545000.39550000",230000,11,0.006357752,39315000,39545000,39320000,39550000,"chr22",681755,0,5,4,9,"chr22",1,0.0116033755274262
"24090","chr22.19145000.19150000","chr22.19420000.19425000",275000,12,0.0005461857,19145000,19420000,19150000,19425000,"chr22",681763,2,12,7,21,"chr22",1,0.029535864978903
"24091","chr22.19290000.19295000","chr22.19445000.19450000",155000,15,0.0005516541,19290000,19445000,19295000,19450000,"chr22",681764,0,3,2,5,"chr22",1,0.00879043600562588
"24092","chr22.39185000.39190000","chr22.39245000.39250000",60000,19,0.008387263,39185000,39245000,39190000,39250000,"chr22",681781,5,15,12,32,"chr22",1,0.0712611345522738
"24093","chr22.41285000.41290000","chr22.41665000.41670000",380000,9,0.006464769,41285000,41665000,41290000,41670000,"chr22",681786,3,21,8,32,"chr22",1,0.0337552742616034
"24094","chr22.41500000.41505000","chr22.41585000.41590000",85000,19,0.000438336,41500000,41585000,41505000,41590000,"chr22",681788,9,25,15,49,"chr22",1,0.109118612283169
"24095","chr22.40565000.40570000","chr22.40675000.40680000",110000,16,0.001537107,40565000,40675000,40570000,40680000,"chr22",681822,1,13,11,25,"chr22",1,0.046882325363338
"24096","chr22.38515000.38520000","chr22.38565000.38570000",50000,22,0.002962451,38515000,38565000,38520000,38570000,"chr22",681838,0,6,2,8,"chr22",1,0.0206282231598687
"24097","chr22.46540000.46545000","chr22.46690000.46695000",150000,29,4.934143e-14,46540000,46690000,46545000,46695000,"chr22",681901,3,18,16,37,"chr22",1,0.125761837787154
"24098","chr22.31495000.31500000","chr22.31565000.31570000",70000,18,0.006078377,31495000,31565000,31500000,31570000,"chr22",681915,10,24,31,65,"chr22",1,0.137130801687764
"24099","chr22.35840000.35845000","chr22.35960000.35965000",120000,14,0.007734492,35840000,35960000,35845000,35965000,"chr22",681921,0,3,1,4,"chr22",1,0.00656352555086732
"24100","chr22.17555000.17560000","chr22.17845000.17850000",290000,12,0.0003802171,17555000,17845000,17560000,17850000,"chr22",681936,1,6,8,15,"chr22",1,0.0210970464135021
"24101","chr22.41325000.41330000","chr22.41560000.41565000",235000,16,3.6889e-06,41325000,41560000,41330000,41565000,"chr22",681955,0,1,7,8,"chr22",1,0.0150023441162682
"24102","chr22.41325000.41330000","chr22.41480000.41485000",155000,28,2.105498e-13,41325000,41480000,41330000,41485000,"chr22",681971,3,7,7,17,"chr22",1,0.0557899671823722
"24103","chr22.42060000.42065000","chr22.42080000.42085000",20000,47,1.112648e-07,42060000,42080000,42065000,42085000,"chr22",681993,1,8,8,17,"chr22",1,0.0936474449132677
"24104","chr22.41390000.41395000","chr22.41535000.41540000",145000,13,0.008387263,41390000,41535000,41395000,41540000,"chr22",682003,2,16,14,32,"chr22",1,0.0487576183778715
"24105","chr22.39305000.39310000","chr22.39555000.39560000",250000,15,1.076745e-05,39305000,39555000,39310000,39560000,"chr22",682083,1,3,2,6,"chr22",1,0.0105485232067511
"24106","chr22.30925000.30930000","chr22.31560000.31565000",635000,7,0.009778765,30925000,31560000,30930000,31565000,"chr22",682105,0,3,7,10,"chr22",1,0.00820440693858415
"24107","chr22.40595000.40600000","chr22.40710000.40715000",115000,15,0.003489312,40595000,40710000,40600000,40715000,"chr22",682119,10,19,15,44,"chr22",1,0.0773558368495077
"24108","chr22.38460000.38465000","chr22.38730000.38735000",270000,12,0.0006231557,38460000,38730000,38465000,38735000,"chr22",682122,0,4,1,5,"chr22",1,0.0070323488045007
"24109","chr22.38210000.38215000","chr22.38240000.38245000",30000,37,2.905319e-06,38210000,38240000,38215000,38245000,"chr22",682142,3,7,4,14,"chr22",1,0.0607126113455227
"24110","chr22.38565000.38570000","chr22.38715000.38720000",150000,16,0.0001895536,38565000,38715000,38570000,38720000,"chr22",682183,0,6,2,8,"chr22",1,0.0150023441162682
"24111","chr22.36320000.36325000","chr22.36455000.36460000",135000,20,1.559988e-06,36320000,36455000,36325000,36460000,"chr22",682184,0,4,1,5,"chr22",1,0.0117205813408345
"24112","chr22.41475000.41480000","chr22.41515000.41520000",40000,27,0.000328204,41475000,41515000,41480000,41520000,"chr22",682205,3,16,16,35,"chr22",1,0.110759493670886
"24113","chr22.24120000.24125000","chr22.24175000.24180000",55000,20,0.007230084,24120000,24175000,24125000,24180000,"chr22",682233,0,1,0,1,"chr22",1,0.0023441162681669
"24114","chr22.41680000.41685000","chr22.41695000.41700000",15000,36,0.001310711,41680000,41695000,41685000,41700000,"chr22",682239,0,15,6,21,"chr22",1,0.0886075949367089
"24115","chrX.48505000.48510000","chrX.48800000.48805000",295000,15,2.588901e-08,48505000,48800000,48510000,48805000,"chrX",682382,0,2,0,2,"chrX",1,0.00351617440225035
"24116","chrX.13760000.13765000","chrX.14035000.14040000",275000,10,0.001064613,13760000,14035000,13765000,14040000,"chrX",682395,0,2,1,3,"chrX",1,0.00351617440225035
"24117","chrX.24425000.24430000","chrX.24515000.24520000",90000,15,0.0008001986,24425000,24515000,24430000,24520000,"chrX",682849,1,9,2,12,"chrX",1,0.0210970464135021
"24118","chrX.18425000.18430000","chrX.19340000.19345000",915000,6,0.009976533,18425000,19340000,18430000,19345000,"chrX",683152,1,3,3,7,"chrX",1,0.00492264416315049
"24119","chrX.9975000.9980000","chrX.10070000.10075000",95000,16,0.0001219076,9975000,10070000,9980000,10075000,"chrX",683156,3,13,7,23,"chrX",1,0.043131739334271
"24120","chrX.45130000.45135000","chrX.45150000.45155000",20000,29,0.005046742,45130000,45150000,45135000,45155000,"chrX",683716,3,2,0,5,"chrX",1,0.01699484294421
"24121","chrX.10155000.10160000","chrX.10565000.10570000",410000,17,8.88276e-12,10155000,10565000,10160000,10570000,"chrX",683771,0,2,0,2,"chrX",1,0.00398499765588373
"24122","chrX.10010000.10015000","chrX.10070000.10075000",60000,16,0.007212007,10010000,10070000,10015000,10075000,"chrX",683775,2,13,7,22,"chrX",1,0.0412564463197375
"24123","chrX.28900000.28905000","chrX.28920000.28925000",20000,38,1.22684e-06,28900000,28920000,28905000,28925000,"chrX",684323,0,3,1,4,"chrX",1,0.0178152836380684
"24124","chrX.68690000.68695000","chrX.69285000.69290000",595000,7,0.00827358,68690000,69285000,68695000,69290000,"chrX",684437,1,4,5,10,"chrX",1,0.00820440693858415
"24125","chrX.100860000.100865000","chrX.101050000.101055000",190000,12,0.0003890653,100860000,101050000,100865000,101055000,"chrX",684466,1,5,5,11,"chrX",1,0.0154711673699015
"24126","chrX.48520000.48525000","chrX.48645000.48650000",125000,12,0.004461279,48520000,48645000,48525000,48650000,"chrX",684607,4,18,13,35,"chrX",1,0.0492264416315049
"24127","chrX.38675000.38680000","chrX.38695000.38700000",20000,41,4.141195e-08,38675000,38695000,38680000,38700000,"chrX",684817,1,4,3,8,"chrX",1,0.0384435067979372
"24128","chrX.16990000.16995000","chrX.17035000.17040000",45000,19,0.004230437,16990000,17035000,16995000,17040000,"chrX",684939,0,2,0,2,"chrX",1,0.00445382090951711
"24129","chrX.13195000.13200000","chrX.13485000.13490000",290000,9,0.004230437,13195000,13485000,13200000,13490000,"chrX",685082,0,3,0,3,"chrX",1,0.00316455696202532
"24130","chrX.48535000.48540000","chrX.48595000.48600000",60000,21,1.644528e-05,48535000,48595000,48540000,48600000,"chrX",685249,6,12,9,27,"chrX",1,0.0664556962025316
"24131","chrX.15850000.15855000","chrX.16710000.16715000",860000,8,0.0001987414,15850000,16710000,15855000,16715000,"chrX",685285,1,3,2,6,"chrX",1,0.00562587904360056
"24132","chrX.102830000.102835000","chrX.102900000.102905000",70000,15,0.00596831,102830000,102900000,102835000,102905000,"chrX",685532,0,2,2,4,"chrX",1,0.0070323488045007
"24133","chrX.13685000.13690000","chrX.13750000.13755000",65000,30,1.149851e-12,13685000,13750000,13690000,13755000,"chrX",685789,0,4,2,6,"chrX",1,0.0210970464135021
"24134","chrX.13885000.13890000","chrX.13905000.13910000",20000,30,0.002349683,13885000,13905000,13890000,13910000,"chrX",685955,0,3,1,4,"chrX",1,0.0140646976090014
"24135","chrX.48505000.48510000","chrX.48595000.48600000",90000,27,5.578985e-13,48505000,48595000,48510000,48600000,"chrX",686077,4,11,2,17,"chrX",1,0.0537974683544304
"24136","chrX.48895000.48900000","chrX.48955000.48960000",60000,20,6.23193e-05,48895000,48955000,48900000,48960000,"chrX",686498,2,0,1,3,"chrX",1,0.0070323488045007
"24137","chrX.111445000.111450000","chrX.111465000.111470000",20000,29,0.005046742,111445000,111465000,111450000,111470000,"chrX",686537,0,5,5,10,"chrX",1,0.0339896858884201
"24138","chrX.48595000.48600000","chrX.48800000.48805000",205000,16,1.151372e-07,48595000,48800000,48600000,48805000,"chrX",686563,0,2,0,2,"chrX",1,0.00375058602906704
"24139","chrX.18390000.18395000","chrX.19340000.19345000",950000,6,0.008649684,18390000,19340000,18395000,19345000,"chrX",686627,1,3,8,12,"chrX",1,0.00843881856540084
"24140","chrX.103215000.103220000","chrX.103355000.103360000",140000,12,0.00247645,103215000,103355000,103220000,103360000,"chrX",686718,2,3,2,7,"chrX",1,0.00984528832630099
"24141","chrX.10155000.10160000","chrX.11110000.11115000",955000,6,0.008580596,10155000,11110000,10160000,11115000,"chrX",686961,2,3,1,6,"chrX",1,0.00421940928270042
"24142","chrX.153605000.153610000","chrX.153760000.153765000",155000,11,0.005774467,153605000,153760000,153610000,153765000,"chrX",687315,2,5,5,12,"chrX",1,0.0154711673699015
"24143","chrX.40735000.40740000","chrX.40995000.41000000",260000,12,4.055473e-05,40735000,40995000,40740000,4.1e+07,"chrX",687382,0,3,1,4,"chrX",1,0.00562587904360056
"24144","chrX.103210000.103215000","chrX.103375000.103380000",165000,11,0.004230437,103210000,103375000,103215000,103380000,"chrX",687530,0,6,3,9,"chrX",1,0.0116033755274262
"24145","chrX.48505000.48510000","chrX.48955000.48960000",450000,9,0.0006773651,48505000,48955000,48510000,48960000,"chrX",687764,2,0,1,3,"chrX",1,0.00316455696202532
"24146","chrX.40400000.40405000","chrX.40420000.40425000",20000,36,1.012947e-05,40400000,40420000,40405000,40425000,"chrX",687776,3,2,3,8,"chrX",1,0.0337552742616034
"24147","chrX.13685000.13690000","chrX.13745000.13750000",60000,17,0.002425562,13685000,13745000,13690000,13750000,"chrX",688109,0,1,2,3,"chrX",1,0.0059774964838256
"24148","chrX.47075000.47080000","chrX.47380000.47385000",305000,9,0.003452645,47075000,47380000,47080000,47385000,"chrX",688267,3,13,14,30,"chrX",1,0.0316455696202532
"24149","chrX.48595000.48600000","chrX.48675000.48680000",80000,14,0.00687422,48595000,48675000,48600000,48680000,"chrX",688305,4,7,4,15,"chrX",1,0.0246132208157525
"24150","chrX.119510000.119515000","chrX.119570000.119575000",60000,17,0.002425562,119510000,119570000,119515000,119575000,"chrX",688377,3,10,8,21,"chrX",1,0.0418424753867792
"24151","chrX.13915000.13920000","chrX.14035000.14040000",120000,12,0.005529021,13915000,14035000,13920000,14040000,"chrX",688382,0,2,1,3,"chrX",1,0.00421940928270042
"24152","chrX.18425000.18430000","chrX.18980000.18985000",555000,8,0.001761948,18425000,18980000,18430000,18985000,"chrX",688427,0,2,2,4,"chrX",1,0.00375058602906704
"24153","chrX.13665000.13670000","chrX.13750000.13755000",85000,15,0.001284393,13665000,13750000,13670000,13755000,"chrX",688638,3,5,8,16,"chrX",1,0.0281293952180028
